lettersIn,batchIn,wordIn,wordLengthIn,numWordsOut,numReadLettersOut,numNewLettersOut,timeOut
10,0,a,1,0,0,1,0.08
10,0,absence,7,1,1,6,0.4
10,0,absorb,6,2,3,3,0.2
10,0,absurd,6,3,3,3,0.2
10,0,academic,8,4,1,7,0.32
10,0,accelerate,10,5,2,8,0.48
10,0,accept,6,6,4,2,0.16
10,0,acceptable,10,7,6,4,0.28
10,0,accident,8,8,3,5,0.36
10,0,accomplish,10,9,3,7,0.36
10,0,accordance,10,10,4,6,0.32
10,0,accounting,10,11,4,6,0.44
10,0,accurate,8,12,3,5,0.28
10,0,activate,8,13,2,6,0.32
10,0,additional,10,14,1,9,0.52
10,0,adj,3,15,2,1,0.12
10,0,adjacent,8,16,3,5,0.28
10,0,adoption,8,17,2,6,0.32
10,0,aesthetic,9,18,1,8,0.44
10,0,affordable,10,19,1,9,0.4
10,0,afterwards,10,20,2,8,0.4
10,0,again,5,21,1,4,0.28
10,0,agree,5,22,2,3,0.2
10,0,ahead,5,23,1,4,0.2
10,0,aids,4,24,1,3,0.16
10,0,allocation,10,25,1,9,0.4
10,0,alongside,9,26,2,7,0.44
10,0,ambassador,10,27,1,9,0.4
10,0,ambulance,9,28,3,6,0.44
10,0,analysis,8,29,1,7,0.32
10,0,ancient,7,30,2,5,0.28
10,0,anger,5,31,2,3,0.2
10,0,annoyed,7,32,2,5,0.36
10,0,annoying,8,33,5,3,0.24
10,0,anybody,7,34,2,5,0.28
10,0,app,3,35,1,2,0.12
10,0,apparently,10,36,3,7,0.44
10,0,applaud,7,37,3,4,0.24
10,0,appreciate,10,38,3,7,0.36
10,0,approach,8,39,4,4,0.24
10,0,arguably,8,40,1,7,0.4
10,0,argue,5,41,4,1,0.12
10,0,army,4,42,2,2,0.16
10,0,around,6,43,2,4,0.24
10,0,artist,6,44,2,4,0.32
10,0,assault,7,45,1,6,0.32
10,0,assistant,9,46,3,6,0.32
10,0,associate,9,47,3,6,0.36
10,0,at,2,48,1,1,0.2
10,0,atrocity,8,49,2,6,0.32
10,0,authorize,9,50,1,8,0.4
10,0,average,7,51,1,6,0.28
10,0,baby,4,52,0,4,0.32
10,0,backing,7,53,2,5,0.48
10,0,balance,7,54,2,5,0.28
10,0,barrel,6,55,2,4,0.24
10,0,base,4,56,2,2,0.24
10,0,bat,3,57,2,1,0.08
10,0,bath,4,58,3,1,0.12
10,0,bay,3,59,2,1,0.08
10,0,beat,4,60,1,3,0.16
10,0,beauty,6,61,3,3,0.2
10,0,beer,4,62,2,2,0.12
10,0,beg,3,63,2,1,0.2
10,0,behalf,6,64,2,4,0.2
10,0,behave,6,65,4,2,0.2
10,0,belief,6,66,2,4,0.24
10,0,bell,4,67,3,1,0.12
10,0,belong,6,68,3,3,0.28
10,0,below,5,69,4,1,0.12
10,0,benchmark,9,70,2,7,0.32
10,0,betray,6,71,2,4,0.24
10,0,between,7,72,3,4,0.32
10,0,bin,3,73,1,2,0.12
10,0,birthday,8,74,2,6,0.32
10,0,biscuit,7,75,2,5,0.28
10,0,bite,4,76,2,2,0.16
10,0,blade,5,77,1,4,0.28
10,0,bless,5,78,2,3,0.2
10,0,blind,5,79,2,3,0.16
10,0,bomb,4,80,1,3,0.16
10,0,boost,5,81,2,3,0.16
10,0,boot,4,82,3,1,0.32
10,0,bother,6,83,2,4,0.64
10,0,bottle,6,84,3,3,0.8
10,0,boundary,8,85,2,6,0.56
10,0,box,3,86,2,1,0.16
10,0,boyfriend,9,87,2,7,0.68
10,0,brand,5,88,1,4,0.52
10,0,breach,6,89,2,4,0.36
10,0,breathe,7,90,4,3,0.36
10,0,breathing,9,91,6,3,0.24
10,0,bride,5,92,2,3,0.24
10,0,bright,6,93,3,3,0.2
10,0,buffer,6,94,1,5,0.24
10,0,bug,3,95,2,1,0.12
10,0,burden,6,96,2,4,0.24
10,0,business,8,97,2,6,0.4
10,0,can,3,98,0,3,0.16
10,0,cap,3,99,2,1,0.08
10,0,capable,7,100,3,4,0.24
10,0,capitalist,10,101,3,7,0.44
10,0,career,6,102,2,4,0.24
10,0,carpet,6,103,3,3,0.2
10,0,cartoon,7,104,3,4,0.24
10,0,carve,5,105,3,2,0.16
10,0,cave,4,106,2,2,0.24
10,0,cease,5,107,1,4,0.2
10,0,celebrity,9,108,2,7,0.36
10,0,central,7,109,2,5,0.28
10,0,ceremony,8,110,2,6,0.4
10,0,certain,7,111,3,4,0.32
10,0,certainty,9,112,7,2,0.28
10,0,chair,5,113,1,4,0.28
10,0,character,9,114,3,6,0.44
10,0,charm,5,115,4,1,0.16
10,0,charter,7,116,4,3,0.28
10,0,check,5,117,2,3,0.2
10,0,cheerful,8,118,3,5,0.32
10,0,chicken,7,119,2,5,0.28
10,0,choir,5,120,2,3,0.24
10,0,choose,6,121,3,3,0.28
10,0,chop,4,122,3,1,0.16
10,0,chunk,5,123,2,3,0.24
10,0,circle,6,124,1,5,0.24
10,0,clarity,7,125,1,6,0.32
10,0,clean,5,126,2,3,0.2
10,0,clearly,7,127,4,3,0.28
10,0,clerk,5,128,3,2,0.16
10,0,clinical,8,129,2,6,0.32
10,0,closely,7,130,2,5,0.28
10,0,cloud,5,131,3,2,0.2
10,0,coach,5,132,1,4,0.28
10,0,collective,10,133,2,8,0.4
10,0,colony,6,134,3,3,0.2
10,0,colourful,9,135,4,5,0.36
10,0,comedy,6,136,2,4,0.24
10,0,comfort,7,137,3,4,0.24
10,0,comment,7,138,3,4,0.24
10,0,commodity,9,139,4,5,0.36
10,0,company,7,140,3,4,0.24
10,0,comparable,10,141,5,5,0.32
10,0,compassion,10,142,5,5,0.36
10,0,compensate,10,143,4,6,0.36
10,0,conceal,7,144,2,5,0.28
10,0,conceive,8,145,5,3,0.24
10,0,concert,7,146,5,2,0.24
10,0,conclusion,10,147,4,6,0.32
10,0,conduct,7,148,3,4,0.28
10,0,confer,6,149,3,3,0.28
10,0,conference,10,150,6,4,0.28
10,0,confidence,10,151,4,6,0.36
10,0,conscious,9,152,3,6,0.36
10,0,consent,7,153,4,3,0.2
10,0,consult,7,154,4,3,0.2
10,0,contempt,8,155,3,5,0.28
10,0,contrast,8,156,4,4,0.32
10,0,convenient,10,157,3,7,0.36
10,0,conversion,10,158,5,5,0.32
10,0,convey,6,159,5,1,0.16
10,0,coordinate,10,160,2,8,0.44
10,0,cope,4,161,2,2,0.16
10,0,correct,7,162,2,5,0.28
10,0,correctly,9,163,7,2,0.36
10,0,cost,4,164,2,2,0.16
10,0,cottage,7,165,2,5,0.28
10,0,could,5,166,2,3,0.2
10,0,counter,7,167,3,4,0.24
10,0,county,6,168,5,1,0.2
10,0,couple,6,169,3,3,0.2
10,0,course,6,170,3,3,0.2
10,0,court,5,171,4,1,0.12
10,0,create,6,172,1,5,0.24
10,0,credible,8,173,3,5,0.32
10,0,criminal,8,174,2,6,0.32
10,0,crisis,6,175,3,3,0.2
10,0,crowd,5,176,2,3,0.2
10,0,crude,5,177,2,3,0.24
10,0,cruise,6,178,3,3,0.2
10,0,current,7,179,1,6,0.28
10,0,cycle,5,180,1,4,0.2
10,0,darkness,8,181,0,8,0.4
10,0,december,8,182,1,7,0.32
10,0,declare,7,183,3,4,0.24
10,0,deed,4,184,2,2,0.16
10,0,default,7,185,2,5,0.36
10,0,defender,8,186,3,5,0.32
10,0,definitely,10,187,3,7,0.36
10,0,delight,7,188,2,5,0.32
10,0,delighted,9,189,7,2,0.24
10,0,deliver,7,190,4,3,0.2
10,0,dentist,7,191,2,5,0.28
10,0,depressing,10,192,2,8,0.44
10,0,deputy,6,193,3,3,0.2
10,0,desktop,7,194,2,5,0.28
10,0,detect,6,195,2,4,0.24
10,0,develop,7,196,2,5,0.36
10,0,devil,5,197,3,2,0.16
10,0,diagnosis,9,198,1,8,0.36
10,0,diagram,7,199,4,3,0.2
10,0,dictate,7,200,2,5,0.32
10,0,dictator,8,201,6,2,0.2
10,0,dig,3,202,2,1,0.08
10,0,digital,7,203,3,4,0.24
10,0,dinner,6,204,2,4,0.32
10,0,diplomatic,10,205,2,8,0.4
10,0,director,8,206,2,6,0.32
10,0,disabled,8,207,2,6,0.32
10,0,disastrous,10,208,4,6,0.44
10,0,disclosure,10,209,3,7,0.4
10,0,discovery,9,210,4,5,0.4
10,0,discretion,10,211,4,6,0.36
10,0,discussion,10,212,4,6,0.36
10,0,distribute,10,213,3,7,0.44
10,0,dollar,6,214,1,5,0.24
10,0,dot,3,215,2,1,0.08
10,0,double,6,216,2,4,0.24
10,0,downstairs,10,217,2,8,0.44
10,0,duration,8,218,1,7,0.32
10,0,dust,4,219,2,2,0.16
10,0,ear,3,220,0,3,0.16
10,0,earnings,8,221,3,5,0.28
10,0,earth,5,222,3,2,0.2
10,0,edition,7,223,1,6,0.28
10,0,effective,9,224,1,8,0.36
10,0,either,6,225,1,5,0.24
10,0,elect,5,226,1,4,0.28
10,0,electrical,10,227,5,5,0.32
10,0,eliminate,9,228,2,7,0.32
10,0,elsewhere,9,229,2,7,0.44
10,0,embark,6,230,1,5,0.24
10,0,embody,6,231,3,3,0.2
10,0,emergency,9,232,2,7,0.36
10,0,empower,7,233,2,5,0.32
10,0,enable,6,234,1,5,0.24
10,0,ending,6,235,2,4,0.24
10,0,endless,7,236,3,4,0.32
10,0,enjoy,5,237,2,3,0.24
10,0,enjoyable,9,238,5,4,0.28
10,0,enormous,8,239,2,6,0.28
10,0,enter,5,240,2,3,0.2
10,0,enterprise,10,241,5,5,0.4
10,0,entry,5,242,3,2,0.16
10,0,equality,8,243,1,7,0.32
10,0,equipment,9,244,3,6,0.4
10,0,establish,9,245,1,8,0.36
10,0,euro,4,246,1,3,0.16
10,0,evaluation,10,247,1,9,0.4
10,0,evidence,8,248,2,6,0.36
10,0,evoke,5,249,2,3,0.16
10,0,exact,5,250,1,4,0.2
10,0,exchange,8,251,2,6,0.28
10,0,excited,7,252,3,4,0.28
10,0,exciting,8,253,5,3,0.24
10,0,exclusive,9,254,3,6,0.32
10,0,exercise,8,255,2,6,0.36
10,0,exhibition,10,256,2,8,0.4
10,0,experiment,10,257,2,8,0.4
10,0,expire,6,258,3,3,0.2
10,0,exploit,7,259,3,4,0.32
10,0,extend,6,260,2,4,0.24
10,0,extent,6,261,5,1,0.16
10,0,faculty,7,262,0,7,0.32
10,0,fail,4,263,2,2,0.2
10,0,failed,6,264,4,2,0.16
10,0,failure,7,265,4,3,0.24
10,0,fasten,6,266,2,4,0.4
10,0,fear,4,267,1,3,0.4
10,0,feeding,7,268,2,5,0.72
10,0,fellow,6,269,2,4,0.52
10,0,fibre,5,270,1,4,0.48
10,0,fiction,7,271,2,5,0.72
10,0,fight,5,272,2,3,0.56
10,0,file,4,273,2,2,0.32
10,0,finally,7,274,2,5,0.64
10,0,financial,9,275,4,5,0.68
10,0,fine,4,276,3,1,0.28
10,0,fix,3,277,2,1,0.32
10,0,fixed,5,278,3,2,0.36
10,0,fixture,7,279,3,4,0.56
10,0,flat,4,280,1,3,0.36
10,0,flexible,8,281,2,6,0.68
10,0,folding,7,282,1,6,0.76
10,0,food,4,283,2,2,0.32
10,0,force,5,284,2,3,0.4
10,0,foreigner,9,285,3,6,0.76
10,0,formation,9,286,3,6,0.88
10,0,formerly,8,287,4,4,0.6
10,0,formula,7,288,4,3,0.48
10,0,forward,7,289,3,4,0.64
10,0,founder,7,290,2,5,0.6
10,0,fourteen,8,291,3,5,0.64
10,0,fridge,6,292,1,5,0.56
10,0,friendly,8,293,3,5,0.76
10,0,friendship,10,294,6,4,0.68
10,0,frightened,10,295,3,7,0.84
10,0,frog,4,296,2,2,0.32
10,0,full,4,297,1,3,0.48
10,0,fur,3,298,2,1,0.24
10,0,gallon,6,299,0,6,0.6
10,0,game,4,300,2,2,0.32
10,0,general,7,301,1,6,0.64
10,0,generally,9,302,7,2,0.6
10,0,generate,8,303,6,2,0.48
10,0,genetic,7,304,4,3,0.48
10,0,genuinely,9,305,3,6,0.84
10,0,geography,9,306,2,7,0.8
10,0,god,3,307,1,2,0.28
10,0,goodbye,7,308,2,5,0.6
10,0,govern,6,309,2,4,0.52
10,0,graphics,8,310,1,7,0.84
10,0,grin,4,311,2,2,0.32
10,0,growth,6,312,2,4,0.52
10,0,guest,5,313,1,4,0.48
10,0,guidance,8,314,2,6,0.8
10,0,guide,5,315,4,1,0.32
10,0,gym,3,316,1,2,0.28
10,0,handful,7,317,0,7,0.72
10,0,handy,5,318,4,1,0.32
10,0,harm,4,319,2,2,0.44
10,0,harvest,7,320,3,4,0.56
10,0,hazard,6,321,2,4,0.52
10,0,headline,8,322,1,7,0.76
10,0,herb,4,323,2,2,0.32
10,0,hesitate,8,324,2,6,0.8
10,0,highlight,9,325,1,8,0.84
10,0,highly,6,326,5,1,0.36
10,0,hint,4,327,2,2,0.32
10,0,historical,10,328,2,8,1
10,0,homeland,8,329,1,7,0.84
10,0,honesty,7,330,2,5,0.6
10,0,horror,6,331,2,4,0.6
10,0,however,7,332,2,5,0.6
10,0,humble,6,333,1,5,0.56
10,0,humour,6,334,3,3,0.44
10,0,hunger,6,335,2,4,0.6
10,0,hunt,4,336,3,1,0.28
10,0,hurricane,9,337,2,7,0.8
10,0,i,1,338,0,1,0.16
10,0,icon,4,339,1,3,0.4
10,0,ignorance,9,340,1,8,0.96
10,0,illegal,7,341,1,6,0.68
10,0,image,5,342,1,4,0.48
10,0,imagery,7,343,5,2,0.44
10,0,implement,9,344,2,7,0.88
10,0,import,6,345,3,3,0.48
10,0,inclusion,9,346,1,8,0.84
10,0,incur,5,347,3,2,0.36
10,0,indirect,8,348,2,6,0.8
10,0,infant,6,349,2,4,0.52
10,0,inform,6,350,3,3,0.44
10,0,inherent,8,351,2,6,0.68
10,0,initiate,8,352,2,6,0.8
10,0,injury,6,353,2,4,0.52
10,0,instant,7,354,2,5,0.64
10,0,instruct,8,355,4,4,0.6
10,0,instrument,10,356,6,4,0.76
10,0,intake,6,357,2,4,0.52
10,0,integral,8,358,3,5,0.64
10,0,intense,7,359,4,3,0.6
10,0,into,4,360,3,1,0.28
10,0,invade,6,361,2,4,0.52
10,0,invest,6,362,3,3,0.48
10,0,involve,7,363,3,4,0.6
10,0,involved,8,364,7,1,0.52
10,0,iron,4,365,1,3,0.4
10,0,isolated,8,366,1,7,0.76
10,0,issue,5,367,2,3,0.4
10,0,jewellery,9,368,0,9,1
10,0,job,3,369,1,2,0.28
10,0,journalism,10,370,2,8,0.88
10,0,joy,3,371,2,1,0.24
10,0,judicial,8,372,1,7,0.84
10,0,justify,7,373,2,5,0.6
10,0,key,3,374,0,3,0.32
10,0,kick,4,375,1,3,0.36
10,0,kid,3,376,2,1,0.24
10,0,king,4,377,2,2,0.32
10,0,knife,5,378,1,4,0.6
10,0,lack,4,379,0,4,0.44
10,0,lad,3,380,2,1,0.24
10,0,landmark,8,381,2,6,0.72
10,0,lap,3,382,2,1,0.24
10,0,last,4,383,2,2,0.4
10,0,latest,6,384,2,4,0.52
10,0,lawn,4,385,2,2,0.32
10,0,leading,7,386,1,6,0.68
10,0,leaflet,7,387,3,4,0.56
10,0,legend,6,388,2,4,0.6
10,0,legendary,9,389,6,3,0.56
10,0,legitimate,10,390,3,7,0.84
10,0,letter,6,391,2,4,0.6
10,0,licence,7,392,1,6,0.64
10,0,lie,3,393,2,1,0.24
10,0,lifestyle,9,394,2,7,0.8
10,0,likelihood,10,395,2,8,0.96
10,0,limb,4,396,2,2,0.32
10,0,literature,10,397,2,8,0.88
10,0,little,6,398,3,3,0.44
10,0,long,4,399,1,3,0.48
10,0,loose,5,400,2,3,0.4
10,0,lot,3,401,2,1,0.24
10,0,low,3,402,2,1,0.24
10,0,machinery,9,403,0,9,0.88
10,0,mainland,8,404,2,6,0.8
10,0,mandate,7,405,2,5,0.6
10,0,manuscript,10,406,3,7,0.84
10,0,mask,4,407,2,2,0.32
10,0,meaningful,10,408,1,9,1.04
10,0,mechanical,10,409,2,8,0.88
10,0,media,5,410,2,3,0.4
10,0,medication,10,411,4,6,0.88
10,0,meeting,7,412,2,5,0.64
10,0,melody,6,413,2,4,0.56
10,0,mental,6,414,2,4,0.52
10,0,mentor,6,415,4,2,0.52
10,0,mess,4,416,2,2,0.32
10,0,mind,4,417,1,3,0.36
10,0,mirror,6,418,2,4,0.52
10,0,miserable,9,419,2,7,0.8
10,0,misleading,10,420,3,7,0.92
10,0,missing,7,421,3,4,0.56
10,0,mixed,5,422,2,3,0.4
10,0,mobilize,8,423,1,7,0.84
10,0,modify,6,424,2,4,0.52
10,0,moment,6,425,2,4,0.52
10,0,money,5,426,2,3,0.44
10,0,monument,8,427,3,5,0.72
10,0,movie,5,428,2,3,0.44
10,0,much,4,429,1,3,0.4
10,0,multiple,8,430,2,6,0.68
10,0,municipal,9,431,2,7,0.8
10,0,music,5,432,2,3,0.52
10,0,naked,5,433,0,5,0.52
10,0,nasty,5,434,2,3,0.4
10,0,nature,6,435,2,4,0.52
10,0,necessary,9,436,1,8,1
10,0,neck,4,437,3,1,0.28
10,0,needle,6,438,2,4,0.6
10,0,neutral,7,439,2,5,0.68
10,0,new,3,440,2,1,0.24
10,0,night,5,441,1,4,0.6
10,0,noisy,5,442,1,4,0.48
10,0,north,5,443,2,3,0.44
10,0,northern,8,444,5,3,0.56
10,0,not,3,445,2,1,0.24
10,0,notion,6,446,3,3,0.56
10,0,numerous,8,447,1,7,0.76
10,0,nut,3,448,2,1,0.24
10,0,oblige,6,449,0,6,0.64
10,0,occupation,10,450,1,9,1.12
10,0,ocean,5,451,2,3,0.52
10,0,october,7,452,2,5,0.76
10,0,off,3,453,1,2,0.36
10,0,offence,7,454,3,4,0.6
10,0,offend,6,455,5,1,0.52
10,0,offensive,9,456,5,4,0.72
10,0,official,8,457,3,5,0.72
10,0,opponent,8,458,1,7,0.88
10,0,opposed,7,459,4,3,0.56
10,0,other,5,460,1,4,0.48
10,0,ought,5,461,1,4,0.48
10,0,outbreak,8,462,2,6,0.84
10,0,outdoor,7,463,3,4,0.68
10,0,outdoors,8,464,7,1,0.44
10,0,outing,6,465,3,3,0.48
10,0,outlet,6,466,3,3,0.56
10,0,outlook,7,467,4,3,0.52
10,0,oversee,7,468,1,6,0.68
10,0,owe,3,469,1,2,0.32
10,0,pace,4,470,0,4,0.52
10,0,pad,3,471,2,1,0.28
10,0,page,4,472,2,2,0.48
10,0,painful,7,473,2,5,0.64
10,0,palace,6,474,2,4,0.64
10,0,pants,5,475,2,3,0.44
10,0,parade,6,476,2,4,0.56
10,0,park,4,477,3,1,0.36
10,0,partial,7,478,3,4,0.6
10,0,particular,10,479,5,5,0.76
10,0,partner,7,480,4,3,0.56
10,0,passenger,9,481,2,7,0.92
10,0,password,8,482,4,4,0.44
10,0,patent,6,483,2,4,0.6
10,0,patron,6,484,3,3,0.28
10,0,pause,5,485,2,3,0.2
10,0,peaceful,8,486,1,7,0.32
10,0,peer,4,487,2,2,0.16
10,0,perceive,8,488,2,6,0.32
10,0,perfect,7,489,3,4,0.32
10,0,perhaps,7,490,3,4,0.24
10,0,personnel,9,491,3,6,0.32
10,0,phone,5,492,1,4,0.2
10,0,photo,5,493,3,2,0.24
10,0,pick,4,494,1,3,0.16
10,0,piece,5,495,2,3,0.2
10,0,pig,3,496,2,1,0.08
10,0,pin,3,497,2,1,0.08
10,0,pioneer,7,498,2,5,0.32
10,0,plane,5,499,1,4,0.2
10,0,plastic,7,500,3,4,0.24
10,0,play,4,501,3,1,0.12
10,0,plead,5,502,2,3,0.16
10,0,pleased,7,503,4,3,0.28
10,0,point,5,504,1,4,0.2
10,0,political,9,505,2,7,0.32
10,0,pond,4,506,2,2,0.16
10,0,population,10,507,2,8,0.44
10,0,portion,7,508,2,5,0.28
10,0,position,8,509,2,6,0.28
10,0,possible,8,510,3,5,0.28
10,0,poster,6,511,3,3,0.28
10,0,practical,9,512,1,8,0.36
10,0,prayer,6,513,3,3,0.2
10,0,precedent,9,514,2,7,0.4
10,0,predict,7,515,3,4,0.24
10,0,prediction,10,516,7,3,0.28
10,0,premise,7,517,3,4,0.24
10,0,presently,9,518,3,6,0.4
10,0,previously,10,519,3,7,0.36
10,0,principal,9,520,2,7,0.36
10,0,principle,9,521,7,2,0.28
10,0,printing,8,522,4,4,0.28
10,0,prior,5,523,3,2,0.16
10,0,produce,7,524,2,5,0.28
10,0,profile,7,525,3,4,0.28
10,0,project,7,526,3,4,0.24
10,0,prominent,9,527,3,6,0.32
10,0,propose,7,528,3,4,0.28
10,0,prosperity,10,529,3,7,0.36
10,0,protest,7,530,3,4,0.24
10,0,protester,9,531,7,2,0.24
10,0,purpose,7,532,1,6,0.36
10,0,push,4,533,2,2,0.12
10,0,quality,7,534,0,7,0.32
10,0,query,5,535,2,3,0.16
10,0,quite,5,536,2,3,0.2
10,0,racism,6,537,0,6,0.36
10,0,railway,7,538,2,5,0.28
10,0,raise,5,539,3,2,0.16
10,0,rating,6,540,2,4,0.2
10,0,react,5,541,1,4,0.28
10,0,realistic,9,542,3,6,0.32
10,0,rebel,5,543,2,3,0.16
10,0,recall,6,544,2,4,0.2
10,0,reception,9,545,3,6,0.4
10,0,recognize,9,546,3,6,0.32
10,0,record,6,547,4,2,0.2
10,0,recording,9,548,6,3,0.32
10,0,recount,7,549,4,3,0.2
10,0,reduce,6,550,2,4,0.24
10,0,reduction,9,551,5,4,0.28
10,0,refer,5,552,2,3,0.16
10,0,reference,9,553,5,4,0.36
10,0,refuse,6,554,3,3,0.2
10,0,regional,8,555,2,6,0.32
10,0,regulatory,10,556,3,7,0.4
10,0,reign,5,557,2,3,0.2
10,0,rejection,9,558,2,7,0.36
10,0,relative,8,559,2,6,0.32
10,0,relax,5,560,4,1,0.2
10,0,relevance,9,561,3,6,0.32
10,0,relief,6,562,3,3,0.2
10,0,remainder,9,563,2,7,0.4
10,0,removal,7,564,3,4,0.24
10,0,renew,5,565,2,3,0.16
10,0,replace,7,566,2,5,0.28
10,0,reporting,9,567,3,6,0.36
10,0,republic,8,568,3,5,0.28
10,0,research,8,569,2,6,0.32
10,0,residence,9,570,3,6,0.32
10,0,respective,10,571,3,7,0.44
10,0,rest,4,572,3,1,0.12
10,0,retire,6,573,2,4,0.24
10,0,retirement,10,574,6,4,0.36
10,0,revenge,7,575,2,5,0.28
10,0,rifle,5,576,1,4,0.2
10,0,right,5,577,2,3,0.16
10,0,ritual,6,578,2,4,0.24
10,0,rival,5,579,2,3,0.24
10,0,road,4,580,1,3,0.16
10,0,rob,3,581,2,1,0.08
10,0,robbery,7,582,3,4,0.24
10,0,robust,6,583,3,3,0.2
10,0,roll,4,584,2,2,0.12
10,0,romance,7,585,2,5,0.32
10,0,rotate,6,586,2,4,0.24
10,0,rough,5,587,2,3,0.2
10,0,round,5,588,3,2,0.16
10,0,routine,7,589,3,4,0.32
10,0,rubber,6,590,1,5,0.24
10,0,rubbish,7,591,4,3,0.2
10,0,ruin,4,592,2,2,0.16
10,0,sailor,6,593,0,6,0.28
10,0,salt,4,594,2,2,0.2
10,0,schedule,8,595,1,7,0.32
10,0,scheme,6,596,4,2,0.16
10,0,school,6,597,3,3,0.2
10,0,score,5,598,2,3,0.24
10,0,seal,4,599,1,3,0.16
10,0,secretary,9,600,2,7,0.36
10,0,secure,6,601,3,3,0.2
10,0,security,8,602,5,3,0.32
10,0,seem,4,603,2,2,0.12
10,0,segment,7,604,2,5,0.28
10,0,sensible,8,605,2,6,0.32
10,0,serious,7,606,2,5,0.32
10,0,seriously,9,607,7,2,0.24
10,0,servant,7,608,3,4,0.24
10,0,serve,5,609,4,1,0.12
10,0,settlement,10,610,2,8,0.44
10,0,sexual,6,611,2,4,0.24
10,0,sheer,5,612,1,4,0.2
10,0,shell,5,613,3,2,0.16
10,0,shiny,5,614,2,3,0.16
10,0,ship,4,615,3,1,0.16
10,0,shipping,8,616,4,4,0.24
10,0,shopping,8,617,2,6,0.56
10,0,shortage,8,618,3,5,0.68
10,0,shortly,7,619,5,2,0.44
10,0,silver,6,620,1,5,0.32
10,0,similarly,9,621,2,7,0.36
10,0,sin,3,622,2,1,0.08
10,0,singing,7,623,3,4,0.28
10,0,sink,4,624,3,1,0.12
10,0,sit,3,625,2,1,0.08
10,0,situated,8,626,3,5,0.28
10,0,six,3,627,2,1,0.08
10,0,ski,3,628,1,2,0.12
10,0,skip,4,629,3,1,0.2
10,0,slam,4,630,1,3,0.16
10,0,slice,5,631,2,3,0.2
10,0,smoking,7,632,1,6,0.32
10,0,soap,4,633,1,3,0.16
10,0,solar,5,634,2,3,0.28
10,0,some,4,635,2,2,0.16
10,0,somehow,7,636,4,3,0.2
10,0,soup,4,637,2,2,0.12
10,0,space,5,638,1,4,0.2
10,0,special,7,639,2,5,0.32
10,0,specialist,10,640,7,3,0.4
10,0,specify,7,641,5,2,0.44
10,0,spread,6,642,2,4,0.52
10,0,stable,6,643,1,5,0.76
10,0,stall,5,644,3,2,0.36
10,0,stand,5,645,3,2,0.36
10,0,star,4,646,3,1,0.28
10,0,statistic,9,647,3,6,0.76
10,0,stay,4,648,3,1,0.36
10,0,steer,5,649,2,3,0.4
10,0,stem,4,650,3,1,0.28
10,0,stereotype,10,651,3,7,0.84
10,0,stick,5,652,2,3,0.44
10,0,sticky,6,653,5,1,0.44
10,0,stop,4,654,2,2,0.32
10,0,store,5,655,3,2,0.36
10,0,straight,8,656,2,6,0.72
10,0,strange,7,657,4,3,0.6
10,0,strategic,9,658,4,5,0.68
10,0,stretch,7,659,3,4,0.56
10,0,strike,6,660,3,3,0.48
10,0,striking,8,661,5,3,0.64
10,0,string,6,662,4,2,0.4
10,0,stun,4,663,2,2,0.32
10,0,substance,9,664,1,8,0.84
10,0,successful,10,665,2,8,1.04
10,0,sudden,6,666,2,4,0.6
10,0,sufficient,10,667,2,8,1.08
10,0,sugar,5,668,2,3,0.48
10,0,super,5,669,2,3,0.56
10,0,suppose,7,670,3,4,0.6
10,0,sure,4,671,2,2,0.32
10,0,suspension,10,672,2,8,0.96
10,0,swear,5,673,1,4,0.6
10,0,sweep,5,674,3,2,0.36
10,0,switch,6,675,2,4,0.52
10,0,symbolic,8,676,1,7,0.8
10,0,synthesis,9,677,2,7,1.12
10,0,tale,4,678,0,4,0.44
10,0,talk,4,679,3,1,0.28
10,0,tape,4,680,2,2,0.32
10,0,tea,3,681,1,2,0.28
10,0,team,4,682,3,1,0.32
10,0,tempt,5,683,2,3,0.64
10,0,terrify,7,684,2,5,0.68
10,0,terror,6,685,4,2,0.4
10,0,terrorism,9,686,6,3,0.6
10,0,texture,7,687,2,5,0.72
10,0,thereafter,10,688,1,9,0.96
10,0,thereby,7,689,5,2,0.52
10,0,thirsty,7,690,2,5,0.72
10,0,thoughtful,10,691,2,8,1
10,0,three,5,692,2,3,0.4
10,0,ticket,6,693,1,5,0.64
10,0,till,4,694,2,2,0.32
10,0,tolerance,9,695,1,8,0.96
10,0,tool,4,696,2,2,0.32
10,0,tour,4,697,2,2,0.36
10,0,tragic,6,698,1,5,0.6
10,0,trap,4,699,3,1,0.32
10,0,traveller,9,700,3,6,0.92
10,0,treat,5,701,2,3,0.44
10,0,trial,5,702,2,3,0.44
10,0,tribal,6,703,3,3,0.48
10,0,tropical,8,704,2,6,0.84
10,0,trousers,8,705,3,5,0.64
10,0,truck,5,706,2,3,0.44
10,0,twice,5,707,1,4,0.48
10,0,unable,6,708,0,6,0.8
10,0,underwear,9,709,2,7,0.8
10,0,unify,5,710,2,3,0.44
10,0,unique,6,711,3,3,0.48
10,0,universal,9,712,3,6,0.84
10,0,until,5,713,2,3,0.44
10,0,unusual,7,714,2,5,0.6
10,0,unveil,6,715,2,4,0.52
10,0,uphold,6,716,1,5,0.68
10,0,upon,4,717,2,2,0.32
10,0,utility,7,718,1,6,0.68
10,0,utilize,7,719,5,2,0.44
10,0,vague,5,720,0,5,0.52
10,0,validity,8,721,2,6,0.84
10,0,valley,6,722,3,3,0.44
10,0,valuable,8,723,3,5,0.64
10,0,variety,7,724,2,5,0.6
10,0,vegetable,9,725,1,8,1
10,0,vein,4,726,2,2,0.32
10,0,venture,7,727,2,5,0.6
10,0,verify,6,728,2,4,0.52
10,0,veteran,7,729,2,5,0.72
10,0,viable,6,730,1,5,0.56
10,0,villager,8,731,2,6,0.68
10,0,virtue,6,732,2,4,0.52
10,0,visual,6,733,2,4,0.68
10,0,wait,4,734,0,4,0.44
10,0,walk,4,735,2,2,0.32
10,0,war,3,736,2,1,0.24
10,0,washing,7,737,2,5,0.64
10,0,weird,5,738,1,4,0.6
10,0,welcome,7,739,2,5,0.6
10,0,west,4,740,2,2,0.32
10,0,whatever,8,741,1,7,0.76
10,0,whenever,8,742,2,6,0.8
10,0,which,5,743,2,3,0.44
10,0,whose,5,744,2,3,0.44
10,0,wildlife,8,745,1,7,0.76
10,0,window,6,746,2,4,0.64
10,0,wipe,4,747,2,2,0.32
10,0,wisdom,6,748,2,4,0.6
10,0,within,6,749,2,4,0.6
10,0,work,4,750,1,3,0.44
10,0,workforce,9,751,4,5,0.8
10,0,world,5,752,3,2,0.36
10,0,wow,3,753,2,1,0.24
10,0,youngster,9,754,0,9,1
10,1,a,1,0,0,1,0.16
10,1,absence,7,1,1,6,0.68
10,1,absurd,6,2,3,3,0.56
10,1,academic,8,3,1,7,0.76
10,1,accept,6,4,2,4,0.52
10,1,accident,8,5,3,5,0.72
10,1,accordance,10,6,3,7,0.84
10,1,accounting,10,7,4,6,0.8
10,1,acid,4,8,2,2,0.32
10,1,acre,4,9,2,2,0.44
10,1,actress,7,10,2,5,0.6
10,1,acute,5,11,2,3,0.4
10,1,ad,2,12,1,1,0.2
10,1,adaptation,10,13,2,8,0.88
10,1,add,3,14,2,1,0.32
10,1,adj,3,15,2,1,0.24
10,1,admit,5,16,2,3,0.44
10,1,adopt,5,17,2,3,0.4
10,1,adoption,8,18,5,3,0.52
10,1,advantage,9,19,2,7,0.92
10,1,adventure,9,20,3,6,0.72
10,1,advice,6,21,3,3,0.44
10,1,affordable,10,22,1,9,1.04
10,1,afterwards,10,23,2,8,0.88
10,1,aggression,10,24,1,9,0.92
10,1,alcohol,7,25,1,6,0.76
10,1,allocate,8,26,2,6,0.68
10,1,ally,4,27,3,1,0.28
10,1,analysis,8,28,1,7,0.8
10,1,ancient,7,29,2,5,0.72
10,1,anger,5,30,2,3,0.44
10,1,animal,6,31,2,4,0.52
10,1,annoyed,7,32,2,5,0.6
10,1,anxiety,7,33,2,5,0.72
10,1,anyway,6,34,2,4,0.52
10,1,apology,7,35,1,6,0.64
10,1,app,3,36,2,1,0.24
10,1,apparently,10,37,3,7,1.04
10,1,arguably,8,38,1,7,0.76
10,1,argue,5,39,4,1,0.32
10,1,arise,5,40,2,3,0.4
10,1,arms,4,41,2,2,0.4
10,1,arrest,6,42,2,4,0.64
10,1,artist,6,43,2,4,0.52
10,1,artistic,8,44,6,2,0.48
10,1,ask,3,45,1,2,0.28
10,1,assault,7,46,2,5,0.68
10,1,at,2,47,1,1,0.2
10,1,atrocity,8,48,2,6,0.68
10,1,attachment,10,49,2,8,0.88
10,1,auction,7,50,1,6,0.76
10,1,auto,4,51,2,2,0.32
10,1,baby,4,52,0,4,0.44
10,1,bacteria,8,53,2,6,0.68
10,1,balance,7,54,2,5,0.6
10,1,ballet,6,55,3,3,0.6
10,1,beauty,6,56,1,5,0.56
10,1,bed,3,57,2,1,0.24
10,1,beer,4,58,2,2,0.32
10,1,behave,6,59,2,4,0.6
10,1,belief,6,60,2,4,1.12
10,1,bell,4,61,3,1,0.6
10,1,belong,6,62,3,3,1.4000000000000001
10,1,benchmark,9,63,2,7,0.88
10,1,betray,6,64,2,4,0.52
10,1,between,7,65,3,4,0.64
10,1,bill,4,66,1,3,0.52
10,1,bite,4,67,2,2,0.32
10,1,bitter,6,68,3,3,0.48
10,1,blade,5,69,1,4,0.48
10,1,blame,5,70,3,2,0.36
10,1,blank,5,71,3,2,0.44
10,1,bless,5,72,2,3,0.4
10,1,blow,4,73,2,2,0.32
10,1,boil,4,74,1,3,0.36
10,1,boost,5,75,2,3,0.48
10,1,bother,6,76,2,4,0.56
10,1,bound,5,77,2,3,0.52
10,1,boyfriend,9,78,2,7,0.8
10,1,brand,5,79,1,4,0.52
10,1,breach,6,80,2,4,0.56
10,1,break,5,81,4,1,0.4
10,1,breakdown,9,82,5,4,0.64
10,1,breathe,7,83,4,3,0.48
10,1,breathing,9,84,6,3,0.56
10,1,bride,5,85,2,3,0.52
10,1,bridge,6,86,4,2,0.4
10,1,bright,6,87,3,3,0.44
10,1,buddy,5,88,1,4,0.48
10,1,buffer,6,89,2,4,0.52
10,1,bunch,5,90,2,3,0.48
10,1,burn,4,91,2,2,0.32
10,1,business,8,92,2,6,0.72
10,1,can,3,93,0,3,0.36
10,1,candidate,9,94,3,6,0.84
10,1,carpet,6,95,2,4,0.52
10,1,cd,2,96,1,1,0.2
10,1,cease,5,97,1,4,0.48
10,1,celebrate,9,98,2,7,0.8
10,1,central,7,99,2,5,0.76
10,1,century,7,100,4,3,0.6
10,1,ceremony,8,101,2,6,0.72
10,1,chapter,7,102,1,6,0.64
10,1,charm,5,103,3,2,0.44
10,1,charming,8,104,5,3,0.52
10,1,cheat,5,105,2,3,0.4
10,1,cheerful,8,106,3,5,0.64
10,1,chemical,8,107,3,5,0.72
10,1,chicken,7,108,2,5,0.6
10,1,choose,6,109,2,4,0.52
10,1,chunk,5,110,2,3,0.4
10,1,circle,6,111,1,5,0.64
10,1,circuit,7,112,4,3,0.48
10,1,city,4,113,2,2,0.32
10,1,clarity,7,114,1,6,0.64
10,1,clause,6,115,3,3,0.56
10,1,clean,5,116,2,3,0.44
10,1,clearly,7,117,4,3,0.52
10,1,clerk,5,118,3,2,0.36
10,1,closely,7,119,2,5,0.6
10,1,club,4,120,2,2,0.4
10,1,cluster,7,121,3,4,0.56
10,1,coffee,6,122,1,5,0.56
10,1,coincide,8,123,2,6,0.72
10,1,collection,10,124,2,8,0.96
10,1,colony,6,125,3,3,0.44
10,1,comedy,6,126,2,4,0.52
10,1,comfort,7,127,3,4,0.56
10,1,comment,7,128,3,4,0.72
10,1,commonly,8,129,4,4,0.68
10,1,community,9,130,4,5,0.68
10,1,company,7,131,3,4,0.56
10,1,compete,7,132,4,3,0.6
10,1,comply,6,133,4,2,0.4
10,1,component,9,134,4,5,0.4
10,1,compulsory,10,135,4,6,0.44
10,1,conceive,8,136,2,6,0.32
10,1,concern,7,137,5,2,0.2
10,1,concert,7,138,6,1,0.16
10,1,conference,10,139,3,7,0.4
10,1,confess,7,140,5,2,0.2
10,1,confidence,10,141,4,6,0.32
10,1,confused,8,142,4,4,0.32
10,1,connected,9,143,3,6,0.32
10,1,consent,7,144,3,4,0.24
10,1,contempt,8,145,3,5,0.28
10,1,convey,6,146,3,3,0.24
10,1,correct,7,147,2,5,0.28
10,1,correctly,9,148,7,2,0.2
10,1,cottage,7,149,2,5,0.28
10,1,county,6,150,2,4,0.28
10,1,coup,4,151,3,1,0.12
10,1,couple,6,152,4,2,0.16
10,1,craft,5,153,1,4,0.2
10,1,create,6,154,2,4,0.2
10,1,credible,8,155,3,5,0.36
10,1,criminal,8,156,2,6,0.36
10,1,crucial,7,157,2,5,0.32
10,1,cry,3,158,2,1,0.12
10,1,currency,8,159,1,7,0.4
10,1,damage,6,160,0,6,0.28
10,1,day,3,161,2,1,0.08
10,1,death,5,162,1,4,0.2
10,1,december,8,163,2,6,0.36
10,1,declare,7,164,3,4,0.24
10,1,decline,7,165,4,3,0.24
10,1,deed,4,166,2,2,0.12
10,1,default,7,167,2,5,0.32
10,1,defect,6,168,3,3,0.2
10,1,defender,8,169,4,4,0.28
10,1,definite,8,170,3,5,0.28
10,1,definitely,10,171,8,2,0.28
10,1,delighted,9,172,2,7,0.36
10,1,democracy,9,173,2,7,0.36
10,1,democratic,10,174,7,3,0.32
10,1,demon,5,175,4,1,0.16
10,1,dentist,7,176,2,5,0.24
10,1,departure,9,177,2,7,0.36
10,1,deputy,6,178,3,3,0.28
10,1,detention,9,179,2,7,0.32
10,1,devil,5,180,2,3,0.16
10,1,diagnosis,9,181,1,8,0.36
10,1,diagram,7,182,4,3,0.28
10,1,dig,3,183,2,1,0.08
10,1,digital,7,184,3,4,0.24
10,1,diplomat,8,185,2,6,0.28
10,1,diplomatic,10,186,8,2,0.32
10,1,director,8,187,2,6,0.28
10,1,disabled,8,188,2,6,0.32
10,1,disclosure,10,189,3,7,0.44
10,1,discovery,9,190,4,5,0.28
10,1,discretion,10,191,4,6,0.32
10,1,discuss,7,192,4,3,0.28
10,1,display,7,193,3,4,0.24
10,1,distant,7,194,3,4,0.28
10,1,distort,7,195,4,3,0.2
10,1,disturbing,10,196,4,6,0.4
10,1,divine,6,197,2,4,0.2
10,1,double,6,198,1,5,0.24
10,1,downstairs,10,199,2,8,0.4
10,1,drawing,7,200,1,6,0.36
10,1,drink,5,201,2,3,0.2
10,1,duration,8,202,1,7,0.32
10,1,dust,4,203,2,2,0.12
10,1,edit,4,204,0,4,0.24
10,1,effective,9,205,1,8,0.36
10,1,eighty,6,206,1,5,0.24
10,1,elect,5,207,1,4,0.2
10,1,eleven,6,208,3,3,0.28
10,1,eliminate,9,209,2,7,0.36
10,1,embody,6,210,1,5,0.24
10,1,emergence,9,211,2,7,0.32
10,1,emotion,7,212,2,5,0.32
10,1,employer,8,213,2,6,0.28
10,1,enable,6,214,1,5,0.24
10,1,enemy,5,215,2,3,0.16
10,1,enjoy,5,216,2,3,0.24
10,1,enrich,6,217,2,4,0.24
10,1,enter,5,218,2,3,0.16
10,1,enterprise,10,219,5,5,0.32
10,1,enthusiast,10,220,3,7,0.44
10,1,entitle,7,221,3,4,0.24
10,1,essay,5,222,1,4,0.2
10,1,establish,9,223,2,7,0.36
10,1,evening,7,224,1,6,0.36
10,1,event,5,225,4,1,0.12
10,1,evidence,8,226,2,6,0.32
10,1,evoke,5,227,2,3,0.16
10,1,exact,5,228,1,4,0.28
10,1,excellent,9,229,2,7,0.36
10,1,exception,9,230,4,5,0.28
10,1,exchange,8,231,3,5,0.32
10,1,excited,7,232,3,4,0.24
10,1,exciting,8,233,5,3,0.24
10,1,excuse,6,234,3,3,0.2
10,1,execution,9,235,2,7,0.4
10,1,executive,9,236,7,2,0.24
10,1,exercise,8,237,3,5,0.28
10,1,experiment,10,238,2,8,0.48
10,1,expertise,9,239,5,4,0.32
10,1,exploit,7,240,3,4,0.28
10,1,explosive,9,241,5,4,0.32
10,1,extend,6,242,2,4,0.28
10,1,extensive,9,243,5,4,0.36
10,1,extent,6,244,5,1,0.2
10,1,failed,6,245,0,6,0.28
10,1,failure,7,246,4,3,0.28
10,1,fantastic,9,247,2,7,0.36
10,1,fantasy,7,248,6,1,0.16
10,1,fast,4,249,2,2,0.12
10,1,fasten,6,250,4,2,0.24
10,1,fear,4,251,1,3,0.16
10,1,feeding,7,252,2,5,0.28
10,1,fellow,6,253,2,4,0.2
10,1,fibre,5,254,1,4,0.2
10,1,fiction,7,255,2,5,0.32
10,1,fight,5,256,2,3,0.16
10,1,file,4,257,2,2,0.12
10,1,finally,7,258,2,5,0.24
10,1,financial,9,259,4,5,0.36
10,1,fine,4,260,3,1,0.12
10,1,firm,4,261,2,2,0.16
10,1,fix,3,262,2,1,0.08
10,1,fixture,7,263,3,4,0.24
10,1,flag,4,264,1,3,0.16
10,1,flat,4,265,3,1,0.16
10,1,flavour,7,266,3,4,0.24
10,1,floor,5,267,2,3,0.16
10,1,flourish,8,268,3,5,0.28
10,1,focus,5,269,1,4,0.28
10,1,folding,7,270,2,5,0.24
10,1,food,4,271,2,2,0.12
10,1,foreigner,9,272,2,7,0.36
10,1,formation,9,273,3,6,0.4
10,1,former,6,274,4,2,0.16
10,1,formula,7,275,4,3,0.24
10,1,forward,7,276,3,4,0.24
10,1,founder,7,277,2,5,0.32
10,1,fourteen,8,278,3,5,0.28
10,1,freedom,7,279,1,6,0.28
10,1,fridge,6,280,2,4,0.2
10,1,friendly,8,281,3,5,0.32
10,1,frog,4,282,2,2,0.12
10,1,gallon,6,283,0,6,0.28
10,1,game,4,284,2,2,0.12
10,1,garage,6,285,2,4,0.24
10,1,gene,4,286,1,3,0.48
10,1,genuinely,9,287,3,6,0.72
10,1,giant,5,288,1,4,0.48
10,1,glass,5,289,1,4,0.48
10,1,globe,5,290,2,3,0.52
10,1,go,2,291,1,1,0.2
10,1,good,4,292,2,2,0.32
10,1,goodbye,7,293,4,3,0.52
10,1,grace,5,294,1,4,0.48
10,1,gravity,7,295,3,4,0.56
10,1,grin,4,296,2,2,0.44
10,1,growth,6,297,2,4,0.52
10,1,guess,5,298,1,4,0.48
10,1,guest,5,299,4,1,0.32
10,1,handful,7,300,0,7,0.72
10,1,harbour,7,301,2,5,0.72
10,1,harvest,7,302,3,4,0.56
10,1,hat,3,303,2,1,0.24
10,1,headline,8,304,1,7,0.92
10,1,health,6,305,3,3,0.6
10,1,her,3,306,2,1,0.24
10,1,hers,4,307,3,1,0.28
10,1,hesitate,8,308,2,6,0.68
10,1,highlight,9,309,1,8,0.96
10,1,hint,4,310,2,2,0.32
10,1,holiday,7,311,1,6,0.68
10,1,horror,6,312,2,4,0.52
10,1,household,9,313,2,7,0.88
10,1,how,3,314,2,1,0.24
10,1,humour,6,315,1,5,0.56
10,1,hunger,6,316,2,4,0.52
10,1,hydrogen,8,317,1,7,0.76
10,1,hypothesis,10,318,2,8,1
10,1,i,1,319,0,1,0.16
10,1,icon,4,320,1,3,0.4
10,1,ideal,5,321,1,4,0.48
10,1,identical,9,322,3,6,0.84
10,1,identity,8,323,6,2,0.48
10,1,ignorance,9,324,1,8,0.88
10,1,ill,3,325,1,2,0.32
10,1,illegal,7,326,3,4,0.76
10,1,image,5,327,1,4,0.48
10,1,imagery,7,328,5,2,0.44
10,1,impatient,9,329,2,7,0.8
10,1,import,6,330,3,3,0.56
10,1,important,9,331,6,3,0.6
10,1,improve,7,332,3,4,0.56
10,1,inclusion,9,333,1,8,0.84
10,1,indicate,8,334,2,6,0.8
10,1,inevitable,10,335,2,8,0.92
10,1,inform,6,336,2,4,0.52
10,1,injure,6,337,2,4,0.64
10,1,insert,6,338,2,4,0.52
10,1,inspect,7,339,3,4,0.56
10,1,inspection,10,340,7,3,0.64
10,1,instant,7,341,3,4,0.64
10,1,insurance,9,342,3,6,0.76
10,1,intake,6,343,2,4,0.52
10,1,integral,8,344,3,5,0.64
10,1,intense,7,345,4,3,0.6
10,1,intensify,9,346,6,3,0.6
10,1,interior,8,347,4,4,0.6
10,1,into,4,348,3,1,0.28
10,1,involved,8,349,2,6,0.8
10,1,iron,4,350,1,3,0.36
10,1,jewellery,9,351,0,9,0.92
10,1,journalism,10,352,1,9,1.08
10,1,joy,3,353,2,1,0.24
10,1,just,4,354,1,3,0.4
10,1,justify,7,355,4,3,0.48
10,1,key,3,356,0,3,0.36
10,1,kick,4,357,1,3,0.36
10,1,knife,5,358,1,4,0.6
10,1,know,4,359,2,2,0.4
10,1,lad,3,360,0,3,0.4
10,1,landmark,8,361,2,6,0.84
10,1,laugh,5,362,2,3,0.48
10,1,law,3,363,2,1,0.32
10,1,leadership,10,364,1,9,1.08
10,1,leaf,4,365,3,1,0.32
10,1,leaflet,7,366,4,3,0.56
10,1,league,6,367,3,3,0.52
10,1,legitimate,10,368,2,8,1
10,1,lemon,5,369,2,3,0.44
10,1,lens,4,370,2,2,0.32
10,1,lesbian,7,371,2,5,0.6
10,1,lie,3,372,1,2,0.4
10,1,likelihood,10,373,2,8,0.92
10,1,limb,4,374,2,2,0.32
10,1,lion,4,375,2,2,0.32
10,1,literature,10,376,2,8,1
10,1,litter,6,377,3,3,0.48
10,1,live,4,378,2,2,0.32
10,1,liver,5,379,4,1,0.32
10,1,local,5,380,1,4,0.48
10,1,located,7,381,4,3,0.6
10,1,look,4,382,2,2,0.36
10,1,lot,3,383,2,1,0.24
10,1,loudly,6,384,2,4,0.52
10,1,machinery,9,385,0,9,0.92
10,1,mail,4,386,2,2,0.44
10,1,mandatory,9,387,2,7,0.8
10,1,map,3,388,2,1,0.24
10,1,maximum,7,389,2,5,0.6
10,1,meal,4,390,1,3,0.48
10,1,mean,4,391,3,1,0.28
10,1,mechanical,10,392,2,8,0.92
10,1,media,5,393,2,3,0.44
10,1,medication,10,394,4,6,0.88
10,1,mentor,6,395,2,4,0.56
10,1,merely,6,396,2,4,0.64
10,1,merger,6,397,3,3,0.56
10,1,metre,5,398,2,3,0.48
10,1,mind,4,399,1,3,0.52
10,1,minister,8,400,3,5,0.68
10,1,ministry,8,401,6,2,0.48
10,1,miserable,9,402,2,7,0.8
10,1,misleading,10,403,3,7,0.92
10,1,missing,7,404,3,4,0.56
10,1,model,5,405,1,4,0.48
10,1,moment,6,406,2,4,0.6
10,1,monthly,7,407,2,5,0.6
10,1,most,4,408,2,2,0.32
10,1,mouth,5,409,2,3,0.44
10,1,movie,5,410,2,3,0.48
10,1,mum,3,411,1,2,0.36
10,1,museum,6,412,2,4,0.64
10,1,music,5,413,3,2,0.4
10,1,must,4,414,3,1,0.28
10,1,naked,5,415,0,5,0.52
10,1,nasty,5,416,2,3,0.4
10,1,nature,6,417,2,4,0.68
10,1,needle,6,418,1,5,0.68
10,1,neutral,7,419,2,5,0.76
10,1,night,5,420,1,4,0.56
10,1,noise,5,421,1,4,0.68
10,1,nomination,10,422,2,8,0.92
10,1,norm,4,423,2,2,0.36
10,1,normal,6,424,4,2,0.44
10,1,north,5,425,3,2,0.44
10,1,note,4,426,2,2,0.44
10,1,novel,5,427,2,3,0.44
10,1,numerous,8,428,1,7,0.76
10,1,nut,3,429,2,1,0.24
10,1,obviously,9,430,0,9,1.04
10,1,october,7,431,1,6,0.48
10,1,offence,7,432,1,6,0.4
10,1,offend,6,433,5,1,0.2
10,1,offensive,9,434,5,4,0.4
10,1,official,8,435,3,5,0.28
10,1,once,4,436,1,3,0.16
10,1,online,6,437,2,4,0.24
10,1,opponent,8,438,1,7,0.4
10,1,option,6,439,2,4,0.24
10,1,organic,7,440,1,6,0.28
10,1,outbreak,8,441,1,7,0.32
10,1,outdoor,7,442,3,4,0.28
10,1,outing,6,443,3,3,0.2
10,1,overall,7,444,1,6,0.28
10,1,owe,3,445,1,2,0.12
10,1,pace,4,446,0,4,0.2
10,1,pad,3,447,2,1,0.16
10,1,page,4,448,2,2,0.12
10,1,paint,5,449,2,3,0.2
10,1,palace,6,450,2,4,0.2
10,1,pants,5,451,2,3,0.2
10,1,parade,6,452,2,4,0.28
10,1,park,4,453,3,1,0.12
10,1,partner,7,454,3,4,0.24
10,1,passport,8,455,2,6,0.32
10,1,password,8,456,4,4,0.32
10,1,patience,8,457,2,6,0.28
10,1,peaceful,8,458,1,7,0.32
10,1,peculiar,8,459,2,6,0.32
10,1,perfect,7,460,2,5,0.36
10,1,perhaps,7,461,3,4,0.28
10,1,persistent,10,462,3,7,0.4
10,1,philosophy,10,463,1,9,0.52
10,1,phone,5,464,2,3,0.2
10,1,physician,9,465,2,7,0.36
10,1,picture,7,466,1,6,0.28
10,1,pile,4,467,2,2,0.2
10,1,pioneer,7,468,2,5,0.24
10,1,pipe,4,469,2,2,0.12
10,1,place,5,470,1,4,0.2
10,1,plan,4,471,3,1,0.12
10,1,plane,5,472,4,1,0.2
10,1,planning,8,473,4,4,0.24
10,1,plastic,7,474,3,4,0.24
10,1,pleased,7,475,2,5,0.28
10,1,plot,4,476,2,2,0.2
10,1,police,6,477,1,5,0.24
10,1,pollution,9,478,3,6,0.32
10,1,population,10,479,2,8,0.4
10,1,poster,6,480,2,4,0.28
10,1,practical,9,481,1,8,0.36
10,1,praise,6,482,3,3,0.2
10,1,prayer,6,483,3,3,0.2
10,1,precedent,9,484,2,7,0.4
10,1,precise,7,485,4,3,0.2
10,1,pregnant,8,486,3,5,0.28
10,1,premier,7,487,3,4,0.28
10,1,premise,7,488,5,2,0.2
10,1,presence,8,489,3,5,0.28
10,1,principal,9,490,2,7,0.36
10,1,principle,9,491,7,2,0.32
10,1,printer,7,492,4,3,0.2
10,1,printing,8,493,5,3,0.24
10,1,prior,5,494,3,2,0.16
10,1,procedure,9,495,2,7,0.4
10,1,processing,10,496,5,5,0.32
10,1,processor,9,497,7,2,0.24
10,1,produce,7,498,3,4,0.28
10,1,profile,7,499,3,4,0.6
10,1,project,7,500,3,4,0.24
10,1,propaganda,10,501,3,7,0.36
10,1,proper,6,502,4,2,0.24
10,1,properly,8,503,6,2,0.2
10,1,proportion,10,504,4,6,0.36
10,1,propose,7,505,5,2,0.28
10,1,protester,9,506,3,6,0.32
10,1,pump,4,507,1,3,0.16
10,1,put,3,508,2,1,0.08
10,1,puzzle,6,509,2,4,0.2
10,1,quantity,8,510,0,8,0.4
10,1,race,4,511,0,4,0.2
10,1,radiation,9,512,2,7,0.36
10,1,railway,7,513,2,5,0.28
10,1,rational,8,514,2,6,0.4
10,1,reasoning,9,515,1,8,0.36
10,1,reception,9,516,2,7,0.36
10,1,recognize,9,517,3,6,0.4
10,1,record,6,518,4,2,0.16
10,1,recording,9,519,6,3,0.24
10,1,recount,7,520,4,3,0.2
10,1,recruit,7,521,3,4,0.28
10,1,recycle,7,522,3,4,0.24
10,1,reduce,6,523,2,4,0.2
10,1,reduction,9,524,5,4,0.28
10,1,refer,5,525,2,3,0.24
10,1,referee,7,526,5,2,0.2
10,1,reference,9,527,6,3,0.24
10,1,regard,6,528,2,4,0.2
10,1,regime,6,529,3,3,0.24
10,1,region,6,530,4,2,0.16
10,1,regional,8,531,6,2,0.2
10,1,regulatory,10,532,3,7,0.36
10,1,relative,8,533,2,6,0.36
10,1,religious,9,534,3,6,0.32
10,1,remind,6,535,2,4,0.2
10,1,removal,7,536,3,4,0.28
10,1,remove,6,537,5,1,0.16
10,1,reportedly,10,538,2,8,0.4
10,1,reporting,9,539,6,3,0.24
10,1,republic,8,540,3,5,0.36
10,1,research,8,541,2,6,0.28
10,1,residence,9,542,3,6,0.32
10,1,resolve,7,543,3,4,0.28
10,1,respective,10,544,3,7,0.36
10,1,retire,6,545,2,4,0.2
10,1,retrieve,8,546,3,5,0.28
10,1,reveal,6,547,2,4,0.28
10,1,revenge,7,548,4,3,0.2
10,1,revise,6,549,3,3,0.2
10,1,revival,7,550,4,3,0.2
10,1,revive,6,551,5,1,0.2
10,1,ritual,6,552,1,5,0.24
10,1,road,4,553,1,3,0.16
10,1,robbery,7,554,2,5,0.28
10,1,robust,6,555,3,3,0.2
10,1,root,4,556,2,2,0.2
10,1,routine,7,557,2,5,0.24
10,1,rubbish,7,558,1,6,0.28
10,1,ruin,4,559,2,2,0.12
10,1,sacred,6,560,0,6,0.32
10,1,salt,4,561,2,2,0.16
10,1,satisfied,9,562,2,7,0.36
10,1,satisfy,7,563,6,1,0.16
10,1,schedule,8,564,1,7,0.4
10,1,scheme,6,565,4,2,0.2
10,1,scholar,7,566,3,4,0.24
10,1,scientist,9,567,2,7,0.32
10,1,score,5,568,2,3,0.24
10,1,second,6,569,1,5,0.24
10,1,secret,6,570,3,3,0.2
10,1,secretary,9,571,6,3,0.24
10,1,secure,6,572,3,3,0.24
10,1,security,8,573,5,3,0.24
10,1,seminar,7,574,2,5,0.28
10,1,serious,7,575,2,5,0.24
10,1,seriously,9,576,7,2,0.28
10,1,setting,7,577,2,5,0.28
10,1,settler,7,578,4,3,0.2
10,1,severely,8,579,2,6,0.32
10,1,sexy,4,580,2,2,0.2
10,1,shape,5,581,1,4,0.2
10,1,share,5,582,3,2,0.16
10,1,shell,5,583,2,3,0.2
10,1,shift,5,584,2,3,0.16
10,1,shiny,5,585,3,2,0.2
10,1,shipping,8,586,3,5,0.28
10,1,shortage,8,587,2,6,0.28
10,1,sibling,7,588,1,6,0.28
10,1,signature,9,589,2,7,0.4
10,1,similarly,9,590,2,7,0.36
10,1,singing,7,591,2,5,0.28
10,1,six,3,592,2,1,0.08
10,1,skip,4,593,1,3,0.24
10,1,skirt,5,594,3,2,0.16
10,1,skull,5,595,2,3,0.16
10,1,slam,4,596,1,3,0.16
10,1,slip,4,597,2,2,0.16
10,1,smoking,7,598,1,6,0.36
10,1,soap,4,599,1,3,0.16
10,1,solid,5,600,2,3,0.2
10,1,some,4,601,2,2,0.12
10,1,sometimes,9,602,4,5,0.28
10,1,song,4,603,2,2,0.2
10,1,specify,7,604,1,6,0.28
10,1,speech,6,605,3,3,0.2
10,1,sphere,6,606,2,4,0.24
10,1,spin,4,607,2,2,0.12
10,1,spine,5,608,4,1,0.2
10,1,spokesman,9,609,2,7,0.32
10,1,stable,6,610,1,5,0.24
10,1,stall,5,611,3,2,0.16
10,1,stamp,5,612,3,2,0.2
10,1,stance,6,613,3,3,0.2
10,1,star,4,614,3,1,0.12
10,1,statistic,9,615,3,6,0.32
10,1,statue,6,616,4,2,0.16
10,1,stay,4,617,3,1,0.16
10,1,steadily,8,618,2,6,0.32
10,1,stem,4,619,3,1,0.12
10,1,stick,5,620,2,3,0.16
10,1,stop,4,621,2,2,0.16
10,1,storage,7,622,3,4,0.28
10,1,store,5,623,4,1,0.12
10,1,street,6,624,2,4,0.24
10,1,strength,8,625,4,4,0.28
10,1,strict,6,626,3,3,0.2
10,1,strike,6,627,4,2,0.24
10,1,striking,8,628,5,3,0.24
10,1,string,6,629,4,2,0.16
10,1,strong,6,630,3,3,0.2
10,1,studio,6,631,2,4,0.28
10,1,study,5,632,4,1,0.12
10,1,stumble,7,633,3,4,0.24
10,1,substance,9,634,1,8,0.36
10,1,such,4,635,2,2,0.2
10,1,sugar,5,636,2,3,0.16
10,1,super,5,637,2,3,0.16
10,1,suppose,7,638,3,4,0.24
10,1,surely,6,639,2,4,0.24
10,1,survival,8,640,3,5,0.36
10,1,suspension,10,641,2,8,0.4
10,1,swallow,7,642,1,6,0.28
10,1,sweater,7,643,2,5,0.32
10,1,sweep,5,644,3,2,0.16
10,1,swim,4,645,2,2,0.12
10,1,switch,6,646,3,3,0.2
10,1,symbolic,8,647,1,7,0.32
10,1,sympathy,8,648,3,5,0.36
10,1,symptom,7,649,4,3,0.2
10,1,table,5,650,0,5,0.24
10,1,tail,4,651,2,2,0.16
10,1,talent,6,652,2,4,0.28
10,1,tap,3,653,2,1,0.12
10,1,task,4,654,2,2,0.16
10,1,tea,3,655,1,2,0.12
10,1,television,10,656,2,8,0.36
10,1,tempt,5,657,2,3,0.24
10,1,tender,6,658,2,4,0.2
10,1,terribly,8,659,2,6,0.32
10,1,terrific,8,660,5,3,0.24
10,1,terrify,7,661,6,1,0.24
10,1,terror,6,662,4,2,0.16
10,1,thereafter,10,663,1,9,0.4
10,1,thereby,7,664,5,2,0.2
10,1,this,4,665,2,2,0.2
10,1,thorough,8,666,2,6,0.32
10,1,thumb,5,667,2,3,0.2
10,1,tighten,7,668,1,6,0.32
10,1,till,4,669,2,2,0.16
10,1,timing,6,670,2,4,0.32
10,1,to,2,671,1,1,0.08
10,1,tonight,7,672,2,5,0.24
10,1,tonne,5,673,3,2,0.16
10,1,too,3,674,2,1,0.08
10,1,tool,4,675,3,1,0.12
10,1,topic,5,676,2,3,0.24
10,1,torture,7,677,2,5,0.28
10,1,tournament,10,678,2,8,0.4
10,1,tragic,6,679,1,5,0.32
10,1,trainer,7,680,3,4,0.24
10,1,transport,9,681,3,6,0.32
10,1,trap,4,682,3,1,0.12
10,1,traveller,9,683,3,6,0.4
10,1,treasure,8,684,2,6,0.28
10,1,treat,5,685,4,1,0.12
10,1,tree,4,686,3,1,0.12
10,1,trend,5,687,3,2,0.16
10,1,tribal,6,688,2,4,0.28
10,1,tribe,5,689,4,1,0.12
10,1,tribute,7,690,4,3,0.2
10,1,trio,4,691,3,1,0.12
10,1,tropical,8,692,2,6,0.32
10,1,truck,5,693,2,3,0.24
10,1,twice,5,694,1,4,0.2
10,1,two,3,695,2,1,0.08
10,1,ultimate,8,696,0,8,0.36
10,1,undergo,7,697,1,6,0.36
10,1,undermine,9,698,5,4,0.28
10,1,union,5,699,2,3,0.16
10,1,unique,6,700,3,3,0.2
10,1,universal,9,701,3,6,0.4
10,1,universe,8,702,7,1,0.2
10,1,until,5,703,2,3,0.2
10,1,unusual,7,704,2,5,0.24
10,1,unveil,6,705,2,4,0.28
10,1,upgrade,7,706,1,6,0.28
10,1,uphold,6,707,2,4,0.24
10,1,upon,4,708,2,2,0.12
10,1,urban,5,709,1,4,0.24
10,1,urgent,6,710,2,4,0.28
10,1,usual,5,711,1,4,0.2
10,1,vague,5,712,0,5,0.24
10,1,valuable,8,713,2,6,0.32
10,1,vegetable,9,714,1,8,0.44
10,1,vein,4,715,2,2,0.16
10,1,venture,7,716,2,5,0.28
10,1,verify,6,717,2,4,0.24
10,1,vessel,6,718,2,4,0.28
10,1,veteran,7,719,2,5,0.28
10,1,video,5,720,1,4,0.2
10,1,villager,8,721,2,6,0.28
10,1,violent,7,722,2,5,0.32
10,1,virtual,7,723,2,5,0.24
10,1,virtue,6,724,5,1,0.16
10,1,virus,5,725,3,2,0.16
10,1,visitor,7,726,2,5,0.28
10,1,visual,6,727,3,3,0.28
10,1,voice,5,728,1,4,0.2
10,1,walk,4,729,0,4,0.2
10,1,warning,7,730,2,5,0.28
10,1,way,3,731,2,1,0.08
10,1,weakness,8,732,1,7,0.4
10,1,wealthy,7,733,3,4,0.24
10,1,weapon,6,734,3,3,0.2
10,1,weave,5,735,3,2,0.16
10,1,weekend,7,736,2,5,0.32
10,1,weight,6,737,2,4,0.24
10,1,west,4,738,2,2,0.12
10,1,whenever,8,739,1,7,0.32
10,1,whose,5,740,2,3,0.32
10,1,willing,7,741,1,6,1.08
10,1,wind,4,742,2,2,0.6
10,1,window,6,743,4,2,0.76
10,1,wipe,4,744,2,2,0.6
10,1,wisdom,6,745,2,4,0.96
10,1,within,6,746,2,4,0.28
10,1,woman,5,747,1,4,0.52
10,1,wonderful,9,748,2,7,0.84
10,1,workplace,9,749,2,7,1.08
10,1,world,5,750,3,2,0.52
10,1,wrap,4,751,1,3,0.48
10,1,wrist,5,752,2,3,0.52
10,1,written,7,753,3,4,0.6
10,1,youngster,9,754,0,9,1.08
10,2,a,1,0,0,1,0.2
10,2,absence,7,1,1,6,0.68
10,2,absolutely,10,2,3,7,0.84
10,2,absorb,6,3,4,2,0.52
10,2,accept,6,4,1,5,0.6
10,2,acceptable,10,5,6,4,0.68
10,2,accounting,10,6,3,7,1.12
10,2,acid,4,7,2,2,0.32
10,2,acute,5,8,2,3,0.4
10,2,ad,2,9,1,1,0.2
10,2,add,3,10,2,1,0.24
10,2,address,7,11,3,4,0.56
10,2,adequately,10,12,2,8,1
10,2,adolescent,10,13,2,8,0.88
10,2,adopt,5,14,3,2,0.36
10,2,advantage,9,15,2,7,0.92
10,2,adventure,9,16,3,6,0.76
10,2,aesthetic,9,17,1,8,0.88
10,2,affordable,10,18,1,9,1.04
10,2,again,5,19,1,4,0.48
10,2,against,7,20,5,2,0.44
10,2,aggression,10,21,2,8,0.64
10,2,agree,5,22,2,3,0.28
10,2,ahead,5,23,1,4,0.24
10,2,alcohol,7,24,1,6,0.32
10,2,align,5,25,2,3,0.2
10,2,allocation,10,26,2,8,0.48
10,2,ally,4,27,3,1,0.12
10,2,amateur,7,28,1,6,0.28
10,2,ambassador,10,29,2,8,0.4
10,2,analyse,7,30,1,6,0.36
10,2,analysis,8,31,6,2,0.2
10,2,announce,8,32,2,6,0.32
10,2,annoyed,7,33,4,3,0.28
10,2,annoying,8,34,5,3,0.24
10,2,another,7,35,2,5,0.24
10,2,anybody,7,36,2,5,0.24
10,2,anyway,6,37,3,3,0.28
10,2,app,3,38,1,2,0.12
10,2,apparently,10,39,3,7,0.36
10,2,applaud,7,40,3,4,0.24
10,2,argue,5,41,1,4,0.2
10,2,arms,4,42,2,2,0.2
10,2,army,4,43,3,1,0.12
10,2,arrest,6,44,2,4,0.2
10,2,artist,6,45,2,4,0.2
10,2,ask,3,46,1,2,0.12
10,2,assault,7,47,2,5,0.32
10,2,assessment,10,48,3,7,0.4
10,2,at,2,49,1,1,0.08
10,2,auction,7,50,1,6,0.32
10,2,authorize,9,51,2,7,0.44
10,2,automatic,9,52,3,6,0.32
10,2,average,7,53,1,6,0.28
10,2,bacteria,8,54,0,8,0.44
10,2,balance,7,55,2,5,0.32
10,2,barrel,6,56,2,4,0.24
10,2,base,4,57,2,2,0.16
10,2,bat,3,58,2,1,0.12
10,2,beast,5,59,1,4,0.28
10,2,bed,3,60,2,1,0.12
10,2,behave,6,61,2,4,0.24
10,2,bell,4,62,2,2,0.12
10,2,benchmark,9,63,2,7,0.36
10,2,best,4,64,2,2,0.2
10,2,betray,6,65,2,4,0.24
10,2,between,7,66,3,4,0.24
10,2,bill,4,67,1,3,0.16
10,2,bird,4,68,2,2,0.16
10,2,biscuit,7,69,2,5,0.32
10,2,bishop,6,70,3,3,0.2
10,2,bite,4,71,2,2,0.12
10,2,blade,5,72,1,4,0.24
10,2,blank,5,73,3,2,0.16
10,2,bless,5,74,2,3,0.24
10,2,boom,4,75,1,3,0.16
10,2,boot,4,76,3,1,0.12
10,2,box,3,77,2,1,0.12
10,2,breach,6,78,1,5,0.24
10,2,breathe,7,79,4,3,0.24
10,2,bride,5,80,2,3,0.24
10,2,bright,6,81,3,3,0.2
10,2,buffer,6,82,1,5,0.24
10,2,build,5,83,2,3,0.16
10,2,bunch,5,84,2,3,0.24
10,2,burn,4,85,2,2,0.12
10,2,cake,4,86,0,4,0.2
10,2,can,3,87,2,1,0.08
10,2,candidate,9,88,3,6,0.32
10,2,cap,3,89,2,1,0.08
10,2,capability,10,90,3,7,0.44
10,2,capable,7,91,5,2,0.2
10,2,capitalist,10,92,3,7,0.36
10,2,career,6,93,2,4,0.28
10,2,careful,7,94,4,3,0.24
10,2,carpet,6,95,3,3,0.24
10,2,cartoon,7,96,3,4,0.24
10,2,character,9,97,1,8,0.44
10,2,charity,7,98,4,3,0.24
10,2,chart,5,99,4,1,0.16
10,2,charter,7,100,5,2,0.24
10,2,cheerful,8,101,2,6,0.4
10,2,childhood,9,102,2,7,0.36
10,2,cite,4,103,1,3,0.16
10,2,city,4,104,3,1,0.12
10,2,clearly,7,105,1,6,0.28
10,2,clinical,8,106,2,6,0.36
10,2,closely,7,107,2,5,0.28
10,2,club,4,108,2,2,0.16
10,2,coffee,6,109,1,5,0.24
10,2,colony,6,110,2,4,0.32
10,2,colourful,9,111,4,5,0.28
10,2,comedy,6,112,2,4,0.2
10,2,comfort,7,113,3,4,0.24
10,2,comment,7,114,3,4,0.32
10,2,commodity,9,115,4,5,0.32
10,2,commonly,8,116,5,3,0.24
10,2,company,7,117,3,4,0.32
10,2,comparable,10,118,5,5,0.32
10,2,compensate,10,119,4,6,0.32
10,2,completion,10,120,4,6,0.4
10,2,comply,6,121,5,1,0.16
10,2,component,9,122,4,5,0.28
10,2,concert,7,123,2,5,0.24
10,2,conclusion,10,124,4,6,0.48
10,2,confess,7,125,3,4,0.24
10,2,confidence,10,126,4,6,0.36
10,2,consent,7,127,3,4,0.32
10,2,constantly,10,128,4,6,0.32
10,2,constraint,10,129,5,5,0.32
10,2,contend,7,130,3,4,0.32
10,2,conversion,10,131,3,7,0.4
10,2,coordinate,10,132,2,8,0.4
10,2,correctly,9,133,2,7,0.4
10,2,cottage,7,134,2,5,0.28
10,2,could,5,135,2,3,0.16
10,2,county,6,136,3,3,0.2
10,2,couple,6,137,3,3,0.2
10,2,court,5,138,3,2,0.24
10,2,craft,5,139,1,4,0.2
10,2,credible,8,140,2,6,0.32
10,2,creep,5,141,3,2,0.16
10,2,crime,5,142,2,3,0.2
10,2,criminal,8,143,4,4,0.32
10,2,cross,5,144,2,3,0.16
10,2,crowd,5,145,3,2,0.16
10,2,crowded,7,146,5,2,0.2
10,2,crucial,7,147,2,5,0.32
10,2,cruel,5,148,3,2,0.16
10,2,cultivate,9,149,1,8,0.36
10,2,curriculum,10,150,2,8,0.44
10,2,curved,6,151,3,3,0.2
10,2,cycle,5,152,1,4,0.2
10,2,dam,3,153,0,3,0.16
10,2,damage,6,154,3,3,0.2
10,2,dance,5,155,2,3,0.16
10,2,darkness,8,156,2,6,0.36
10,2,december,8,157,1,7,0.32
10,2,decline,7,158,3,4,0.24
10,2,deed,4,159,2,2,0.16
10,2,deem,4,160,3,1,0.2
10,2,defect,6,161,2,4,0.2
10,2,defender,8,162,4,4,0.28
10,2,definite,8,163,3,5,0.28
10,2,definitely,10,164,8,2,0.32
10,2,delighted,9,165,2,7,0.32
10,2,deliver,7,166,4,3,0.2
10,2,democratic,10,167,2,8,0.44
10,2,deposit,7,168,2,5,0.28
10,2,depressing,10,169,3,7,0.36
10,2,deputy,6,170,3,3,0.24
10,2,despite,7,171,2,5,0.28
10,2,detect,6,172,2,4,0.24
10,2,detention,9,173,4,5,0.28
10,2,dictate,7,174,1,6,0.36
10,2,dig,3,175,2,1,0.12
10,2,diminish,8,176,2,6,0.32
10,2,disabled,8,177,2,6,0.44
10,2,discipline,10,178,3,7,1
10,2,discovery,9,179,4,5,0.76
10,2,discretion,10,180,4,6,1.08
10,2,discuss,7,181,4,3,0.6
10,2,display,7,182,3,4,0.56
10,2,distribute,10,183,3,7,0.84
10,2,divorced,8,184,2,6,0.72
10,2,dollar,6,185,1,5,0.76
10,2,dominant,8,186,2,6,0.8
10,2,donation,8,187,2,6,0.8
10,2,dot,3,188,2,1,0.28
10,2,double,6,189,2,4,0.68
10,2,downstairs,10,190,2,8,1.36
10,2,drama,5,191,1,4,0.72
10,2,drawing,7,192,3,4,1
10,2,duration,8,193,1,7,1.04
10,2,dust,4,194,2,2,0.36
10,2,earnings,8,195,0,8,0.96
10,2,earth,5,196,3,2,0.4
10,2,edition,7,197,1,6,1.08
10,2,editor,6,198,4,2,0.44
10,2,effective,9,199,1,8,1.72
10,2,eight,5,200,1,4,0.76
10,2,eighty,6,201,5,1,0.52
10,2,electrical,10,202,1,9,1.12
10,2,eleven,6,203,3,3,0.56
10,2,embark,6,204,1,5,0.64
10,2,embody,6,205,3,3,0.64
10,2,emergency,9,206,2,7,0.84
10,2,emission,8,207,2,6,0.84
10,2,empirical,9,208,2,7,1.2
10,2,employer,8,209,3,5,0.64
10,2,enable,6,210,1,5,1.04
10,2,ending,6,211,2,4,0.72
10,2,enjoyable,9,212,2,7,0.96
10,2,enrich,6,213,2,4,0.52
10,2,enter,5,214,2,3,0.44
10,2,enthusiast,10,215,3,7,1
10,2,entitle,7,216,3,4,0.64
10,2,entrance,8,217,3,5,0.92
10,2,essay,5,218,1,4,0.56
10,2,essence,7,219,3,4,0.92
10,2,establish,9,220,2,7,0.8
10,2,evaluation,10,221,1,9,0.96
10,2,evening,7,222,2,5,0.72
10,2,evidence,8,223,2,6,0.96
10,2,exact,5,224,1,4,0.48
10,2,exceed,6,225,2,4,0.52
10,2,exception,9,226,4,5,0.68
10,2,exclusive,9,227,3,6,0.88
10,2,excuse,6,228,3,3,0.48
10,2,executive,9,229,2,7,0.96
10,2,exhibition,10,230,2,8,1.08
10,2,exit,4,231,2,2,0.32
10,2,expensive,9,232,2,7,1.12
10,2,expire,6,233,3,3,0.56
10,2,explicitly,10,234,3,7,1
10,2,exploit,7,235,4,3,0.52
10,2,extensive,9,236,2,7,0.8
10,2,extremist,9,237,3,6,0.88
10,2,failed,6,238,0,6,0.64
10,2,failure,7,239,4,3,0.48
10,2,fairly,6,240,3,3,0.44
10,2,fantastic,9,241,2,7,0.96
10,2,fantasy,7,242,6,1,0.44
10,2,fasten,6,243,2,4,0.52
10,2,fee,3,244,1,2,0.28
10,2,few,3,245,2,1,0.24
10,2,fifty,5,246,1,4,0.6
10,2,fight,5,247,2,3,0.4
10,2,file,4,248,2,2,0.32
10,2,finally,7,249,2,5,0.64
10,2,financial,9,250,4,5,0.84
10,2,firm,4,251,2,2,0.36
10,2,fixture,7,252,2,5,0.72
10,2,flag,4,253,1,3,0.4
10,2,flee,4,254,2,2,0.36
10,2,floor,5,255,2,3,0.48
10,2,flourish,8,256,3,5,0.8
10,2,flower,6,257,3,3,0.48
10,2,focus,5,258,1,4,0.48
10,2,food,4,259,2,2,0.32
10,2,for,3,260,2,1,0.24
10,2,force,5,261,3,2,0.48
10,2,foreign,7,262,3,4,0.56
10,2,former,6,263,3,3,0.56
10,2,formula,7,264,4,3,0.56
10,2,forward,7,265,3,4,0.68
10,2,foster,6,266,2,4,0.52
10,2,fourteen,8,267,2,6,0.72
10,2,fragment,8,268,1,7,0.76
10,2,fridge,6,269,2,4,0.64
10,2,friendship,10,270,3,7,0.84
10,2,frightened,10,271,3,7,0.84
10,2,front,5,272,2,3,0.56
10,2,fur,3,273,1,2,0.28
10,2,game,4,274,0,4,0.44
10,2,gaming,6,275,3,3,0.44
10,2,garage,6,276,2,4,0.52
10,2,gender,6,277,1,5,0.68
10,2,generally,9,278,3,6,0.76
10,2,generate,8,279,6,2,0.48
10,2,genetic,7,280,4,3,0.52
10,2,genuinely,9,281,3,6,0.88
10,2,giant,5,282,1,4,0.48
10,2,give,4,283,2,2,0.32
10,2,glass,5,284,1,4,0.56
10,2,glimpse,7,285,2,5,0.8
10,2,gold,4,286,1,3,0.4
10,2,good,4,287,2,2,0.32
10,2,grade,5,288,1,4,0.48
10,2,graphics,8,289,3,5,0.68
10,2,green,5,290,2,3,0.56
10,2,greet,5,291,4,1,0.32
10,2,grid,4,292,2,2,0.32
10,2,grief,5,293,3,2,0.36
10,2,grin,4,294,3,1,0.28
10,2,grind,5,295,4,1,0.32
10,2,guerrilla,9,296,1,8,0.96
10,2,guess,5,297,3,2,0.36
10,2,guitar,6,298,2,4,0.52
10,2,guy,3,299,2,1,0.24
10,2,handful,7,300,0,7,0.8
10,2,harbour,7,301,2,5,0.48
10,2,harvest,7,302,3,4,0.32
10,2,hazard,6,303,2,4,0.24
10,2,health,6,304,1,5,0.24
10,2,heat,4,305,3,1,0.2
10,2,heighten,8,306,2,6,0.32
10,2,herb,4,307,2,2,0.12
10,2,highlight,9,308,1,8,0.36
10,2,hint,4,309,2,2,0.2
10,2,historic,8,310,2,6,0.32
10,2,holiday,7,311,1,6,0.28
10,2,homeland,8,312,2,6,0.32
10,2,horrible,8,313,2,6,0.4
10,2,horror,6,314,4,2,0.2
10,2,humanity,8,315,1,7,0.32
10,2,humble,6,316,3,3,0.2
10,2,hypothesis,10,317,1,9,0.48
10,2,ice,3,318,0,3,0.16
10,2,identical,9,319,1,8,0.36
10,2,identity,8,320,6,2,0.28
10,2,ignorance,9,321,1,8,0.36
10,2,illegal,7,322,1,6,0.28
10,2,image,5,323,1,4,0.2
10,2,imagery,7,324,5,2,0.28
10,2,impatient,9,325,2,7,0.36
10,2,implement,9,326,3,6,0.32
10,2,important,9,327,3,6,0.4
10,2,inclusion,9,328,1,8,0.36
10,2,incorrect,9,329,3,6,0.32
10,2,index,5,330,2,3,0.16
10,2,indicate,8,331,3,5,0.36
10,2,indirect,8,332,4,4,0.32
10,2,inevitable,10,333,2,8,0.44
10,2,influence,9,334,2,7,0.44
10,2,info,4,335,3,1,0.12
10,2,inform,6,336,4,2,0.16
10,2,injure,6,337,2,4,0.24
10,2,insert,6,338,2,4,0.28
10,2,instruct,8,339,3,5,0.28
10,2,intake,6,340,2,4,0.24
10,2,integral,8,341,3,5,0.28
10,2,intense,7,342,4,3,0.28
10,2,intensify,9,343,6,3,0.24
10,2,interior,8,344,4,4,0.28
10,2,into,4,345,3,1,0.12
10,2,invade,6,346,2,4,0.28
10,2,involve,7,347,3,4,0.24
10,2,island,6,348,1,5,0.24
10,2,isolated,8,349,2,6,0.28
10,2,jewellery,9,350,0,9,0.48
10,2,journalism,10,351,1,9,0.4
10,2,judicial,8,352,1,7,0.32
10,2,jump,4,353,2,2,0.16
10,2,just,4,354,2,2,0.2
10,2,justify,7,355,4,3,0.2
10,2,key,3,356,0,3,0.16
10,2,keyboard,8,357,3,5,0.28
10,2,kick,4,358,1,3,0.16
10,2,kid,3,359,2,1,0.16
10,2,king,4,360,2,2,0.12
10,2,lack,4,361,0,4,0.2
10,2,lad,3,362,2,1,0.12
10,2,lake,4,363,2,2,0.12
10,2,laser,5,364,2,3,0.16
10,2,latest,6,365,2,4,0.28
10,2,laugh,5,366,2,3,0.2
10,2,layer,5,367,2,3,0.16
10,2,leading,7,368,1,6,0.28
10,2,leaf,4,369,3,1,0.12
10,2,league,6,370,3,3,0.28
10,2,learning,8,371,3,5,0.28
10,2,left,4,372,2,2,0.12
10,2,legitimate,10,373,2,8,0.4
10,2,lemon,5,374,2,3,0.28
10,2,lethal,6,375,2,4,0.2
10,2,letter,6,376,3,3,0.2
10,2,likelihood,10,377,1,9,0.4
10,2,limited,7,378,2,5,0.36
10,2,link,4,379,2,2,0.12
10,2,lion,4,380,2,2,0.12
10,2,literary,8,381,2,6,0.32
10,2,little,6,382,3,3,0.28
10,2,live,4,383,2,2,0.12
10,2,liver,5,384,4,1,0.12
10,2,local,5,385,1,4,0.2
10,2,location,8,386,4,4,0.24
10,2,long,4,387,2,2,0.2
10,2,look,4,388,2,2,0.12
10,2,loose,5,389,3,2,0.16
10,2,loudly,6,390,2,4,0.24
10,2,love,4,391,2,2,0.16
10,2,lunch,5,392,1,4,0.2
10,2,mail,4,393,0,4,0.28
10,2,main,4,394,3,1,0.12
10,2,manuscript,10,395,2,8,0.4
10,2,map,3,396,2,1,0.12
10,2,marine,6,397,2,4,0.2
10,2,mask,4,398,2,2,0.2
10,2,maximum,7,399,2,5,0.28
10,2,mean,4,400,1,3,0.16
10,2,media,5,401,2,3,0.2
10,2,medication,10,402,4,6,0.44
10,2,melody,6,403,2,4,0.24
10,2,mention,7,404,2,5,0.28
10,2,mentor,6,405,4,2,0.2
10,2,merely,6,406,2,4,0.32
10,2,message,7,407,2,5,0.28
10,2,metre,5,408,2,3,0.16
10,2,midnight,8,409,1,7,0.32
10,2,militia,7,410,2,5,0.32
10,2,mind,4,411,2,2,0.16
10,2,minister,8,412,3,5,0.28
10,2,mirror,6,413,2,4,0.2
10,2,modify,6,414,1,5,0.24
10,2,moment,6,415,2,4,0.28
10,2,monument,8,416,2,6,0.28
10,2,more,4,417,2,2,0.16
10,2,most,4,418,2,2,0.12
10,2,mouth,5,419,2,3,0.16
10,2,movie,5,420,2,3,0.24
10,2,mum,3,421,1,2,0.12
10,2,must,4,422,2,2,0.16
10,2,my,2,423,1,1,0.08
10,2,myth,4,424,2,2,0.12
10,2,name,4,425,0,4,0.2
10,2,narrative,9,426,2,7,0.4
10,2,nation,6,427,2,4,0.24
10,2,nationwide,10,428,6,4,0.28
10,2,nature,6,429,3,3,0.28
10,2,neck,4,430,1,3,0.16
10,2,needle,6,431,2,4,0.2
10,2,negative,8,432,2,6,0.28
10,2,neutral,7,433,2,5,0.28
10,2,newly,5,434,2,3,0.24
10,2,newspaper,9,435,3,6,0.32
10,2,nomination,10,436,1,9,0.4
10,2,non,3,437,2,1,0.08
10,2,norm,4,438,2,2,0.24
10,2,normal,6,439,4,2,0.16
10,2,north,5,440,3,2,0.16
10,2,northern,8,441,5,3,0.24
10,2,nothing,7,442,2,5,0.32
10,2,notice,6,443,3,3,0.2
10,2,novel,5,444,2,3,0.2
10,2,numerous,8,445,1,7,0.36
10,2,nut,3,446,2,1,0.08
10,2,obsess,6,447,0,6,0.32
10,2,occupation,10,448,1,9,0.4
10,2,october,7,449,2,5,0.28
10,2,off,3,450,1,2,0.12
10,2,offence,7,451,3,4,0.32
10,2,offspring,9,452,3,6,0.32
10,2,one,3,453,1,2,0.12
10,2,online,6,454,2,4,0.2
10,2,opponent,8,455,1,7,0.4
10,2,optimistic,10,456,2,8,0.4
10,2,option,6,457,4,2,0.16
10,2,organic,7,458,1,6,0.28
10,2,organized,9,459,6,3,0.32
10,2,ought,5,460,1,4,0.2
10,2,outbreak,8,461,2,6,0.28
10,2,outlet,6,462,3,3,0.2
10,2,oversee,7,463,1,6,0.36
10,2,pack,4,464,0,4,0.2
10,2,page,4,465,2,2,0.16
10,2,palace,6,466,2,4,0.2
10,2,parade,6,467,2,4,0.32
10,2,park,4,468,3,1,0.12
10,2,partial,7,469,3,4,0.24
10,2,particular,10,470,5,5,0.32
10,2,passenger,9,471,2,7,0.44
10,2,password,8,472,4,4,0.28
10,2,patent,6,473,2,4,0.24
10,2,peace,5,474,1,4,0.2
10,2,peer,4,475,2,2,0.16
10,2,perfect,7,476,2,5,0.32
10,2,perhaps,7,477,3,4,0.24
10,2,phone,5,478,1,4,0.2
10,2,photo,5,479,3,2,0.16
10,2,picture,7,480,1,6,0.36
10,2,piece,5,481,2,3,0.16
10,2,pioneer,7,482,2,5,0.28
10,2,place,5,483,1,4,0.24
10,2,plan,4,484,3,1,0.12
10,2,plastic,7,485,3,4,0.32
10,2,play,4,486,3,1,0.12
10,2,plead,5,487,2,3,0.2
10,2,pledge,6,488,3,3,0.2
10,2,plot,4,489,2,2,0.12
10,2,point,5,490,1,4,0.28
10,2,political,9,491,2,7,0.64
10,2,pollution,9,492,3,6,0.36
10,2,portion,7,493,2,5,0.28
10,2,position,8,494,2,6,0.36
10,2,possess,7,495,3,4,0.28
10,2,possible,8,496,4,4,0.28
10,2,pot,3,497,2,1,0.12
10,2,precedent,9,498,1,8,0.44
10,2,precise,7,499,4,3,0.24
10,2,predict,7,500,3,4,0.24
10,2,premise,7,501,3,4,0.32
10,2,prescribe,9,502,3,6,0.32
10,2,presence,8,503,4,4,0.28
10,2,previously,10,504,3,7,0.36
10,2,principal,9,505,2,7,0.4
10,2,printer,7,506,4,3,0.2
10,2,printing,8,507,5,3,0.24
10,2,produce,7,508,2,5,0.32
10,2,profile,7,509,3,4,0.24
10,2,program,7,510,3,4,0.24
10,2,prominent,9,511,3,6,0.32
10,2,proof,5,512,3,2,0.24
10,2,proposal,8,513,3,5,0.28
10,2,propose,7,514,6,1,0.16
10,2,prosecute,9,515,3,6,0.36
10,2,prosperity,10,516,4,6,0.4
10,2,protester,9,517,3,6,0.32
10,2,publicity,9,518,1,8,0.36
10,2,pump,4,519,2,2,0.2
10,2,punk,4,520,2,2,0.12
10,2,pupil,5,521,2,3,0.2
10,2,pure,4,522,2,2,0.12
10,2,pursuit,7,523,3,4,0.24
10,2,push,4,524,2,2,0.2
10,2,puzzle,6,525,2,4,0.24
10,2,query,5,526,0,5,0.24
10,2,quest,5,527,3,2,0.16
10,2,quite,5,528,2,3,0.2
10,2,race,4,529,0,4,0.24
10,2,racial,6,530,3,3,0.2
10,2,radiation,9,531,2,7,0.36
10,2,rail,4,532,2,2,0.16
10,2,railway,7,533,4,3,0.2
10,2,raise,5,534,3,2,0.24
10,2,rally,5,535,2,3,0.2
10,2,realistic,9,536,1,8,0.36
10,2,reasoning,9,537,3,6,0.32
10,2,recall,6,538,2,4,0.28
10,2,reception,9,539,3,6,0.32
10,2,recognize,9,540,3,6,0.32
10,2,recount,7,541,4,3,0.28
10,2,recruit,7,542,3,4,0.24
10,2,reduce,6,543,2,4,0.24
10,2,reduction,9,544,5,4,0.28
10,2,refer,5,545,2,3,0.28
10,2,regard,6,546,2,4,0.24
10,2,regime,6,547,3,3,0.2
10,2,region,6,548,4,2,0.16
10,2,reign,5,549,2,3,0.16
10,2,rejection,9,550,2,7,0.44
10,2,relative,8,551,2,6,0.28
10,2,relax,5,552,4,1,0.12
10,2,relief,6,553,3,3,0.2
10,2,remainder,9,554,2,7,0.44
10,2,remark,6,555,4,2,0.16
10,2,remind,6,556,3,3,0.2
10,2,remove,6,557,3,3,0.2
10,2,renew,5,558,2,3,0.28
10,2,repeat,6,559,2,4,0.24
10,2,replace,7,560,3,4,0.24
10,2,reportedly,10,561,3,7,0.36
10,2,residence,9,562,2,7,0.44
10,2,residue,7,563,5,2,0.2
10,2,rest,4,564,3,1,0.12
10,2,retail,6,565,2,4,0.2
10,2,reveal,6,566,2,4,0.28
10,2,revenge,7,567,4,3,0.2
10,2,revise,6,568,3,3,0.2
10,2,revision,8,569,5,3,0.24
10,2,rifle,5,570,1,4,0.28
10,2,right,5,571,2,3,0.16
10,2,rip,3,572,2,1,0.12
10,2,ritual,6,573,2,4,0.2
10,2,rival,5,574,2,3,0.16
10,2,rotate,6,575,1,5,0.32
10,2,round,5,576,2,3,0.2
10,2,routine,7,577,3,4,0.24
10,2,rub,3,578,1,2,0.12
10,2,rubber,6,579,3,3,0.2
10,2,ruin,4,580,2,2,0.12
10,2,sacred,6,581,0,6,0.36
10,2,sample,6,582,2,4,0.24
10,2,sand,4,583,2,2,0.12
10,2,satisfied,9,584,2,7,0.36
10,2,satisfy,7,585,6,1,0.24
10,2,scared,6,586,1,5,0.24
10,2,scheme,6,587,2,4,0.24
10,2,scholar,7,588,3,4,0.24
10,2,scientific,10,589,2,8,0.48
10,2,score,5,590,2,3,0.16
10,2,seal,4,591,1,3,0.16
10,2,second,6,592,2,4,0.24
10,2,secure,6,593,3,3,0.28
10,2,seeker,6,594,2,4,0.24
10,2,segment,7,595,2,5,0.28
10,2,september,9,596,2,7,0.4
10,2,seriously,9,597,2,7,0.44
10,2,serve,5,598,3,2,0.16
10,2,settlement,10,599,2,8,0.36
10,2,sexy,4,600,2,2,0.12
10,2,shape,5,601,1,4,0.28
10,2,shell,5,602,2,3,0.2
10,2,ship,4,603,2,2,0.12
10,2,shortage,8,604,2,6,0.32
10,2,sight,5,605,1,4,0.2
10,2,simply,6,606,2,4,0.32
10,2,simulation,10,607,3,7,0.36
10,2,sin,3,608,2,1,0.12
10,2,ski,3,609,1,2,0.12
10,2,skip,4,610,3,1,0.12
10,2,skull,5,611,2,3,0.28
10,2,slam,4,612,1,3,0.16
10,2,slice,5,613,2,3,0.2
10,2,smoking,7,614,1,6,0.28
10,2,snow,4,615,1,3,0.16
10,2,solo,4,616,1,3,0.24
10,2,some,4,617,2,2,0.16
10,2,someone,7,618,4,3,0.2
10,2,sometimes,9,619,4,5,0.28
10,2,song,4,620,2,2,0.12
10,2,soup,4,621,2,2,0.2
10,2,south,5,622,3,2,0.16
10,2,space,5,623,1,4,0.2
10,2,special,7,624,2,5,0.24
10,2,specialist,10,625,7,3,0.36
10,2,specify,7,626,5,2,0.2
10,2,spectator,9,627,4,5,0.4
10,2,sphere,6,628,2,4,0.52
10,2,spine,5,629,2,3,0.6
10,2,spokesman,9,630,2,7,0.8
10,2,spread,6,631,2,4,0.52
10,2,stab,4,632,1,3,0.4
10,2,stall,5,633,3,2,0.4
10,2,star,4,634,3,1,0.4
10,2,statistic,9,635,3,6,0.76
10,2,statue,6,636,4,2,0.4
10,2,steadily,8,637,2,6,0.72
10,2,sticky,6,638,2,4,0.64
10,2,stop,4,639,2,2,0.32
10,2,storage,7,640,3,4,0.56
10,2,story,5,641,4,1,0.32
10,2,strange,7,642,2,5,0.64
10,2,street,6,643,3,3,0.56
10,2,stretch,7,644,4,3,0.48
10,2,strict,6,645,3,3,0.44
10,2,studio,6,646,2,4,0.52
10,2,stun,4,647,3,1,0.4
10,2,subject,7,648,1,6,0.72
10,2,super,5,649,2,3,0.48
10,2,suppose,7,650,3,4,0.6
10,2,supreme,7,651,3,4,0.6
10,2,sure,4,652,2,2,0.48
10,2,surely,6,653,4,2,0.44
10,2,survival,8,654,3,5,0.68
10,2,swallow,7,655,1,6,0.68
10,2,swear,5,656,2,3,0.56
10,2,sweep,5,657,3,2,0.36
10,2,switch,6,658,2,4,0.52
10,2,symbolic,8,659,1,7,0.76
10,2,table,5,660,0,5,0.64
10,2,tail,4,661,2,2,0.32
10,2,talent,6,662,2,4,0.52
10,2,talk,4,663,3,1,0.28
10,2,tape,4,664,2,2,0.32
10,2,task,4,665,2,2,0.32
10,2,tea,3,666,1,2,0.28
10,2,tempt,5,667,2,3,0.56
10,2,tendency,8,668,2,6,0.72
10,2,tender,6,669,5,1,0.36
10,2,tension,7,670,3,4,0.56
10,2,terribly,8,671,2,6,0.84
10,2,terrific,8,672,5,3,0.52
10,2,terrify,7,673,6,1,0.4
10,2,textbook,8,674,2,6,0.92
10,2,texture,7,675,4,3,0.52
10,2,themselves,10,676,1,9,0.96
10,2,thereby,7,677,3,4,0.56
10,2,thesis,6,678,3,3,0.6
10,2,thirsty,7,679,2,5,0.6
10,2,thoughtful,10,680,2,8,0.92
10,2,thumb,5,681,2,3,0.44
10,2,till,4,682,1,3,0.52
10,2,timing,6,683,2,4,0.52
10,2,together,8,684,1,7,0.76
10,2,tonight,7,685,2,5,0.6
10,2,tonne,5,686,3,2,0.48
10,2,tool,4,687,2,2,0.32
10,2,torture,7,688,2,5,0.6
10,2,trademark,9,689,1,8,0.84
10,2,transport,9,690,3,6,0.88
10,2,trap,4,691,3,1,0.28
10,2,treat,5,692,2,3,0.4
10,2,tree,4,693,3,1,0.28
10,2,tribal,6,694,2,4,0.52
10,2,tribe,5,695,4,1,0.44
10,2,tribute,7,696,4,3,0.52
10,2,tropical,8,697,2,6,0.72
10,2,truck,5,698,2,3,0.44
10,2,twice,5,699,1,4,0.48
10,2,two,3,700,2,1,0.36
10,2,ultimate,8,701,0,8,0.96
10,2,underlying,10,702,1,9,1.08
10,2,underwear,9,703,5,4,0.8
10,2,unify,5,704,2,3,0.48
10,2,union,5,705,3,2,0.36
10,2,universal,9,706,3,6,0.8
10,2,until,5,707,2,3,0.4
10,2,uphold,6,708,1,5,0.72
10,2,upon,4,709,2,2,0.32
10,2,urban,5,710,1,4,0.48
10,2,utilize,7,711,1,6,0.76
10,2,validity,8,712,0,8,1.08
10,2,variety,7,713,2,5,0.6
10,2,vary,4,714,3,1,0.28
10,2,vein,4,715,1,3,0.4
10,2,venture,7,716,2,5,0.6
10,2,verify,6,717,2,4,0.64
10,2,villager,8,718,1,7,0.76
10,2,violent,7,719,2,5,0.64
10,2,virtue,6,720,2,4,0.52
10,2,vital,5,721,2,3,0.56
10,2,vocal,5,722,1,4,0.48
10,2,voice,5,723,2,3,0.44
10,2,volunteer,9,724,2,7,0.92
10,2,wait,4,725,0,4,0.64
10,2,waiter,6,726,4,2,0.4
10,2,wake,4,727,2,2,0.32
10,2,warrior,7,728,2,5,0.64
10,2,washing,7,729,2,5,0.64
10,2,weapon,6,730,1,5,0.72
10,2,weave,5,731,3,2,0.36
10,2,weekend,7,732,2,5,0.64
10,2,weird,5,733,2,3,0.4
10,2,welcome,7,734,2,5,0.72
10,2,whenever,8,735,1,7,0.76
10,2,which,5,736,2,3,0.44
10,2,whose,5,737,2,3,0.44
10,2,width,5,738,1,4,0.48
10,2,wildlife,8,739,2,6,0.88
10,2,willing,7,740,3,4,0.6
10,2,win,3,741,2,1,0.24
10,2,wind,4,742,3,1,0.28
10,2,window,6,743,4,2,0.6
10,2,wisdom,6,744,2,4,0.6
10,2,within,6,745,2,4,0.56
10,2,without,7,746,4,3,0.6
10,2,wonderful,9,747,1,8,1.28
10,2,word,4,748,2,2,0.32
10,2,workforce,9,749,3,6,1.16
10,2,world,5,750,3,2,0.48
10,2,worry,5,751,3,2,0.64
10,2,wrist,5,752,1,4,1.04
10,2,written,7,753,3,4,1.08
10,2,young,5,754,0,5,0.84
10,3,absence,7,0,0,7,0.92
10,3,absolutely,10,1,3,7,1.04
10,3,accelerate,10,2,1,9,0.96
10,3,acceptable,10,3,4,6,0.76
10,3,accident,8,4,3,5,0.76
10,3,accompany,9,5,3,6,0.72
10,3,accomplish,10,6,6,4,0.68
10,3,accordance,10,7,4,6,0.92
10,3,accurate,8,8,3,5,0.64
10,3,acid,4,9,2,2,0.32
10,3,activate,8,10,2,6,0.72
10,3,acute,5,11,2,3,0.56
10,3,adequately,10,12,1,9,1.04
10,3,adjacent,8,13,2,6,0.88
10,3,admit,5,14,2,3,0.48
10,3,adventure,9,15,2,7,0.92
10,3,advice,6,16,3,3,0.44
10,3,aesthetic,9,17,1,8,0.84
10,3,affordable,10,18,1,9,1.08
10,3,aftermath,9,19,2,7,0.8
10,3,afterwards,10,20,5,5,0.72
10,3,again,5,21,1,4,0.64
10,3,aggression,10,22,2,8,0.88
10,3,agree,5,23,2,3,0.4
10,3,ahead,5,24,1,4,0.48
10,3,aids,4,25,1,3,0.52
10,3,alcohol,7,26,1,6,0.68
10,3,allocation,10,27,2,8,0.48
10,3,alongside,9,28,2,7,0.44
10,3,amateur,7,29,1,6,0.32
10,3,ambassador,10,30,2,8,0.44
10,3,ambulance,9,31,3,6,0.36
10,3,amusing,7,32,2,5,0.48
10,3,analyse,7,33,1,6,0.32
10,3,and,3,34,2,1,0.12
10,3,animal,6,35,2,4,0.24
10,3,announce,8,36,2,6,0.4
10,3,annoyed,7,37,4,3,0.24
10,3,annoying,8,38,5,3,0.24
10,3,anybody,7,39,2,5,0.28
10,3,anyway,6,40,3,3,0.28
10,3,apologize,9,41,1,8,0.36
10,3,apology,7,42,6,1,0.16
10,3,app,3,43,2,1,0.08
10,3,apparently,10,44,3,7,0.44
10,3,arguably,8,45,1,7,0.36
10,3,army,4,46,2,2,0.16
10,3,around,6,47,2,4,0.24
10,3,arrest,6,48,2,4,0.36
10,3,assault,7,49,1,6,0.28
10,3,assistant,9,50,3,6,0.32
10,3,assurance,9,51,3,6,0.4
10,3,at,2,52,1,1,0.08
10,3,attachment,10,53,2,8,0.4
10,3,authorize,9,54,1,8,0.36
10,3,automatic,9,55,3,6,0.4
10,3,average,7,56,1,6,0.28
10,3,baby,4,57,0,4,0.2
10,3,banner,6,58,2,4,0.24
10,3,base,4,59,2,2,0.12
10,3,bay,3,60,2,1,0.16
10,3,beast,5,61,1,4,0.2
10,3,beauty,6,62,3,3,0.2
10,3,betray,6,63,2,4,0.2
10,3,beyond,6,64,2,4,0.2
10,3,bill,4,65,1,3,0.24
10,3,bird,4,66,2,2,0.12
10,3,bishop,6,67,2,4,0.2
10,3,bitter,6,68,2,4,0.24
10,3,bizarre,7,69,2,5,0.36
10,3,blank,5,70,1,4,0.2
10,3,bless,5,71,2,3,0.16
10,3,blog,4,72,2,2,0.12
10,3,blow,4,73,3,1,0.12
10,3,boom,4,74,1,3,0.16
10,3,boundary,8,75,2,6,0.4
10,3,box,3,76,2,1,0.08
10,3,boyfriend,9,77,2,7,0.32
10,3,breach,6,78,1,5,0.24
10,3,break,5,79,4,1,0.2
10,3,breathe,7,80,4,3,0.2
10,3,breathing,9,81,6,3,0.24
10,3,bride,5,82,2,3,0.16
10,3,broken,6,83,2,4,0.32
10,3,buddy,5,84,1,4,0.2
10,3,buffer,6,85,2,4,0.2
10,3,bug,3,86,2,1,0.08
10,3,burn,4,87,2,2,0.12
10,3,cafe,4,88,0,4,0.2
10,3,cake,4,89,2,2,0.2
10,3,cap,3,90,2,1,0.12
10,3,capitalist,10,91,3,7,0.36
10,3,card,4,92,2,2,0.16
10,3,career,6,93,3,3,0.2
10,3,careful,7,94,4,3,0.28
10,3,carpet,6,95,3,3,0.2
10,3,cartoon,7,96,3,4,0.24
10,3,cave,4,97,2,2,0.16
10,3,cd,2,98,1,1,0.08
10,3,ceiling,7,99,1,6,0.36
10,3,celebrate,9,100,2,7,0.32
10,3,celebrity,9,101,6,3,0.24
10,3,cemetery,8,102,2,6,0.36
10,3,central,7,103,2,5,0.28
10,3,century,7,104,4,3,0.2
10,3,ceremony,8,105,2,6,0.32
10,3,certain,7,106,3,4,0.32
10,3,certainty,9,107,7,2,0.24
10,3,challenge,9,108,1,8,0.36
10,3,chapter,7,109,3,4,0.24
10,3,charity,7,110,3,4,0.32
10,3,cheat,5,111,2,3,0.2
10,3,chicken,7,112,2,5,0.24
10,3,childhood,9,113,3,6,0.4
10,3,choir,5,114,2,3,0.24
10,3,chop,4,115,3,1,0.16
10,3,chronic,7,116,2,5,0.28
10,3,circuit,7,117,1,6,0.36
10,3,cite,4,118,2,2,0.24
10,3,clause,6,119,1,5,0.24
10,3,coincide,8,120,1,7,0.32
10,3,colony,6,121,2,4,0.24
10,3,comment,7,122,2,5,0.36
10,3,commonly,8,123,4,4,0.24
10,3,company,7,124,3,4,0.24
10,3,compensate,10,125,4,6,0.32
10,3,compete,7,126,5,2,0.28
10,3,completion,10,127,4,6,0.36
10,3,component,9,128,4,5,0.32
10,3,confer,6,129,2,4,0.28
10,3,conference,10,130,6,4,0.28
10,3,confused,8,131,4,4,0.24
10,3,conscious,9,132,3,6,0.4
10,3,consult,7,133,4,3,0.2
10,3,contend,7,134,3,4,0.24
10,3,contrast,8,135,4,4,0.24
10,3,convenient,10,136,3,7,0.44
10,3,convey,6,137,5,1,0.16
10,3,cooker,6,138,2,4,0.2
10,3,cost,4,139,2,2,0.12
10,3,county,6,140,2,4,0.2
10,3,coup,4,141,3,1,0.2
10,3,coverage,8,142,2,6,0.32
10,3,creature,8,143,1,7,0.32
10,3,crisis,6,144,2,4,0.24
10,3,crucial,7,145,2,5,0.36
10,3,crude,5,146,3,2,0.16
10,3,cruel,5,147,3,2,0.16
10,3,curriculum,10,148,1,9,0.48
10,3,cycle,5,149,1,4,0.32
10,3,darkness,8,150,0,8,0.36
10,3,day,3,151,2,1,0.12
10,3,death,5,152,1,4,0.24
10,3,declare,7,153,2,5,0.28
10,3,decline,7,154,4,3,0.28
10,3,decoration,10,155,3,7,0.36
10,3,default,7,156,2,5,0.24
10,3,defence,7,157,3,4,0.32
10,3,defender,8,158,5,3,0.24
10,3,definite,8,159,3,5,0.28
10,3,delight,7,160,2,5,0.28
10,3,deliver,7,161,4,3,0.28
10,3,demon,5,162,2,3,0.2
10,3,deposit,7,163,2,5,0.28
10,3,deputy,6,164,3,3,0.2
10,3,desktop,7,165,2,5,0.36
10,3,detect,6,166,2,4,0.24
10,3,detention,9,167,4,5,0.28
10,3,develop,7,168,2,5,0.28
10,3,devil,5,169,3,2,0.24
10,3,dictate,7,170,1,6,0.28
10,3,dictator,8,171,6,2,0.2
10,3,dig,3,172,2,1,0.12
10,3,dinner,6,173,2,4,0.2
10,3,diplomatic,10,174,2,8,0.48
10,3,dirt,4,175,2,2,0.16
10,3,disclosure,10,176,2,8,0.4
10,3,discount,8,177,4,4,0.36
10,3,discretion,10,178,4,6,0.32
10,3,discussion,10,179,4,6,0.32
10,3,display,7,180,3,4,0.32
10,3,distort,7,181,3,4,0.24
10,3,disturbing,10,182,4,6,0.36
10,3,divine,6,183,2,4,0.24
10,3,dollar,6,184,1,5,0.32
10,3,dominant,8,185,2,6,0.28
10,3,double,6,186,2,4,0.24
10,3,download,8,187,2,6,0.28
10,3,drama,5,188,1,4,0.28
10,3,drawing,7,189,3,4,0.24
10,3,drink,5,190,2,3,0.16
10,3,duration,8,191,1,7,0.32
10,3,earnings,8,192,0,8,0.44
10,3,edition,7,193,1,6,0.28
10,3,eighty,6,194,1,5,0.24
10,3,elect,5,195,1,4,0.2
10,3,eliminate,9,196,2,7,0.44
10,3,elsewhere,9,197,2,7,0.36
10,3,emergency,9,198,1,8,0.36
10,3,empirical,9,199,2,7,0.44
10,3,empower,7,200,3,4,0.24
10,3,endless,7,201,1,6,0.28
10,3,enemy,5,202,2,3,0.16
10,3,engineer,8,203,2,6,0.4
10,3,enjoyable,9,204,2,7,0.36
10,3,enrich,6,205,2,4,0.2
10,3,enter,5,206,2,3,0.28
10,3,enthusiast,10,207,3,7,0.36
10,3,entitle,7,208,3,4,0.24
10,3,erect,5,209,1,4,0.2
10,3,essay,5,210,1,4,0.28
10,3,evaluation,10,211,1,9,0.4
10,3,evening,7,212,2,5,0.28
10,3,event,5,213,4,1,0.12
10,3,evidence,8,214,2,6,0.4
10,3,evoke,5,215,2,3,0.2
10,3,exact,5,216,1,4,0.2
10,3,examine,7,217,3,4,0.24
10,3,excellent,9,218,2,7,0.44
10,3,exception,9,219,4,5,0.32
10,3,exchange,8,220,3,5,0.28
10,3,exciting,8,221,3,5,0.28
10,3,excuse,6,222,3,3,0.28
10,3,exercise,8,223,2,6,0.28
10,3,exhibition,10,224,2,8,0.52
10,3,existence,9,225,2,7,0.44
10,3,exit,4,226,3,1,0.12
10,3,explain,7,227,2,5,0.28
10,3,explicitly,10,228,4,6,0.36
10,3,exploit,7,229,4,3,0.28
10,3,explosive,9,230,5,4,0.28
10,3,extend,6,231,2,4,0.2
10,3,extent,6,232,5,1,0.16
10,3,eye,3,233,1,2,0.2
10,3,faculty,7,234,0,7,0.32
10,3,fail,4,235,2,2,0.16
10,3,failed,6,236,4,2,0.4
10,3,failure,7,237,4,3,0.56
10,3,fair,4,238,3,1,0.4
10,3,famous,6,239,2,4,0.36
10,3,fat,3,240,2,1,0.16
10,3,fear,4,241,1,3,0.24
10,3,feeding,7,242,2,5,0.32
10,3,few,3,243,2,1,0.16
10,3,fiction,7,244,1,6,0.28
10,3,fight,5,245,2,3,0.16
10,3,finally,7,246,2,5,0.28
10,3,fine,4,247,3,1,0.12
10,3,firm,4,248,2,2,0.24
10,3,fixed,5,249,2,3,0.16
10,3,fixture,7,250,3,4,0.24
10,3,flexible,8,251,1,7,0.32
10,3,floor,5,252,2,3,0.16
10,3,flourish,8,253,3,5,0.36
10,3,flower,6,254,3,3,0.24
10,3,flu,3,255,2,1,0.12
10,3,flying,6,256,2,4,0.24
10,3,focus,5,257,1,4,0.28
10,3,folding,7,258,2,5,0.24
10,3,food,4,259,2,2,0.12
10,3,force,5,260,2,3,0.2
10,3,foreigner,9,261,3,6,0.32
10,3,former,6,262,3,3,0.28
10,3,formerly,8,263,6,2,0.2
10,3,forward,7,264,3,4,0.24
10,3,foster,6,265,2,4,0.24
10,3,founder,7,266,2,5,0.36
10,3,fragment,8,267,1,7,0.32
10,3,frequent,8,268,2,6,0.32
10,3,friday,6,269,2,4,0.2
10,3,friendly,8,270,3,5,0.36
10,3,frightened,10,271,3,7,0.36
10,3,frog,4,272,2,2,0.12
10,3,full,4,273,1,3,0.16
10,3,funding,7,274,2,5,0.36
10,3,fur,3,275,2,1,0.12
10,3,gallery,7,276,0,7,0.32
10,3,garage,6,277,2,4,0.2
10,3,gene,4,278,1,3,0.16
10,3,general,7,279,4,3,0.28
10,3,generally,9,280,7,2,0.24
10,3,generate,8,281,6,2,0.2
10,3,genre,5,282,3,2,0.24
10,3,give,4,283,1,3,0.16
10,3,go,2,284,1,1,0.08
10,3,god,3,285,2,1,0.08
10,3,gold,4,286,2,2,0.12
10,3,governor,8,287,2,6,0.32
10,3,greet,5,288,1,4,0.28
10,3,grey,4,289,3,1,0.12
10,3,grid,4,290,2,2,0.16
10,3,grin,4,291,3,1,0.12
10,3,grind,5,292,4,1,0.16
10,3,guess,5,293,1,4,0.2
10,3,guide,5,294,2,3,0.28
10,3,guitar,6,295,3,3,0.2
10,3,gym,3,296,1,2,0.12
10,3,hair,4,297,0,4,0.2
10,3,handful,7,298,2,5,0.28
10,3,harbour,7,299,2,5,0.32
10,3,harm,4,300,3,1,0.12
10,3,harsh,5,301,3,2,0.16
10,3,hate,4,302,2,2,0.12
10,3,headline,8,303,1,7,0.32
10,3,health,6,304,3,3,0.28
10,3,her,3,305,2,1,0.08
10,3,hers,4,306,3,1,0.12
10,3,hesitate,8,307,2,6,0.32
10,3,highlight,9,308,1,8,0.36
10,3,historical,10,309,2,8,0.48
10,3,homeland,8,310,1,7,0.32
10,3,honesty,7,311,2,5,0.24
10,3,horrible,8,312,2,6,0.4
10,3,horror,6,313,4,2,0.2
10,3,hour,4,314,2,2,0.12
10,3,household,9,315,3,6,0.32
10,3,how,3,316,2,1,0.2
10,3,hunger,6,317,1,5,0.24
10,3,hurricane,9,318,2,7,0.32
10,3,hydrogen,8,319,1,7,0.32
10,3,hypothesis,10,320,2,8,0.48
10,3,i,1,321,0,1,0.08
10,3,ideal,5,322,1,4,0.2
10,3,identical,9,323,3,6,0.32
10,3,ignorance,9,324,1,8,0.48
10,3,illegal,7,325,1,6,0.28
10,3,image,5,326,1,4,0.2
10,3,imaginary,9,327,4,5,0.28
10,3,improve,7,328,2,5,0.36
10,3,include,7,329,1,6,0.28
10,3,incorrect,9,330,3,6,0.32
10,3,indirect,8,331,2,6,0.4
10,3,individual,10,332,4,6,0.36
10,3,infant,6,333,2,4,0.44
10,3,inform,6,334,3,3,0.44
10,3,inherent,8,335,2,6,0.96
10,3,initiate,8,336,2,6,0.84
10,3,injure,6,337,2,4,0.6
10,3,inspect,7,338,2,5,0.72
10,3,inspection,10,339,7,3,0.76
10,3,instant,7,340,3,4,0.56
10,3,instruct,8,341,4,4,0.6
10,3,instrument,10,342,6,4,0.84
10,3,integral,8,343,2,6,0.72
10,3,intended,8,344,4,4,0.64
10,3,intensify,9,345,5,4,0.76
10,3,into,4,346,3,1,0.28
10,3,invade,6,347,2,4,0.52
10,3,involve,7,348,3,4,0.56
10,3,involved,8,349,7,1,0.44
10,3,iron,4,350,1,3,0.48
10,3,island,6,351,1,5,0.56
10,3,isolated,8,352,2,6,0.72
10,3,jet,3,353,0,3,0.36
10,3,jewellery,9,354,2,7,0.92
10,3,joy,3,355,1,2,0.28
10,3,judicial,8,356,1,7,0.76
10,3,jump,4,357,2,2,0.32
10,3,june,4,358,2,2,0.32
10,3,just,4,359,2,2,0.44
10,3,justify,7,360,4,3,0.48
10,3,key,3,361,0,3,0.32
10,3,keyboard,8,362,3,5,0.64
10,3,king,4,363,1,3,0.4
10,3,kingdom,7,364,4,3,0.68
10,3,know,4,365,1,3,0.44
10,3,lap,3,366,0,3,0.36
10,3,laser,5,367,2,3,0.4
10,3,last,4,368,3,1,0.28
10,3,laugh,5,369,2,3,0.44
10,3,lawn,4,370,2,2,0.44
10,3,layer,5,371,2,3,0.4
10,3,leadership,10,372,1,9,0.96
10,3,leaf,4,373,3,1,0.28
10,3,leaflet,7,374,4,3,0.68
10,3,learning,8,375,3,5,0.64
10,3,left,4,376,2,2,0.32
10,3,legend,6,377,2,4,0.52
10,3,legitimate,10,378,3,7,0.96
10,3,lesbian,7,379,2,5,0.6
10,3,lesser,6,380,3,3,0.48
10,3,licence,7,381,1,6,0.68
10,3,license,7,382,5,2,0.56
10,3,lie,3,383,2,1,0.24
10,3,limb,4,384,2,2,0.32
10,3,limited,7,385,3,4,0.56
10,3,litter,6,386,2,4,0.52
10,3,liver,5,387,2,3,0.56
10,3,log,3,388,1,2,0.28
10,3,lonely,6,389,2,4,0.52
10,3,love,4,390,2,2,0.32
10,3,mail,4,391,0,4,0.44
10,3,mainland,8,392,3,5,0.68
10,3,mandate,7,393,2,5,0.76
10,3,mandatory,9,394,6,3,0.6
10,3,map,3,395,2,1,0.24
10,3,marine,6,396,2,4,0.52
10,3,mark,4,397,3,1,0.4
10,3,master,6,398,2,4,0.52
10,3,match,5,399,2,3,0.44
10,3,maximum,7,400,2,5,0.64
10,3,meal,4,401,1,3,0.4
10,3,meaningful,10,402,3,7,1.12
10,3,meanwhile,9,403,4,5,0.76
10,3,media,5,404,2,3,0.44
10,3,meeting,7,405,2,5,0.6
10,3,memory,6,406,2,4,0.68
10,3,mention,7,407,2,5,0.6
10,3,mentor,6,408,4,2,0.4
10,3,merely,6,409,2,4,0.52
10,3,merger,6,410,3,3,0.6
10,3,mess,4,411,2,2,0.32
10,3,metre,5,412,2,3,0.44
10,3,mind,4,413,1,3,0.36
10,3,minister,8,414,3,5,0.64
10,3,misleading,10,415,2,8,1.04
10,3,missing,7,416,3,4,0.56
10,3,modify,6,417,1,5,0.56
10,3,money,5,418,2,3,0.4
10,3,monument,8,419,3,5,0.84
10,3,most,4,420,2,2,0.36
10,3,mouth,5,421,2,3,0.44
10,3,movie,5,422,2,3,0.44
10,3,much,4,423,1,3,0.4
10,3,multiple,8,424,2,6,0.84
10,3,municipal,9,425,2,7,0.8
10,3,musician,8,426,2,6,0.72
10,3,myth,4,427,1,3,0.52
10,3,naked,5,428,0,5,0.52
10,3,name,4,429,2,2,0.32
10,3,narrative,9,430,2,7,0.8
10,3,nasty,5,431,2,3,0.4
10,3,necessary,9,432,1,8,1
10,3,neck,4,433,3,1,0.28
10,3,newly,5,434,2,3,0.44
10,3,noisy,5,435,1,4,0.48
10,3,nomination,10,436,2,8,1.08
10,3,norm,4,437,2,2,0.32
10,3,normal,6,438,4,2,0.44
10,3,north,5,439,3,2,0.36
10,3,northern,8,440,5,3,0.68
10,3,not,3,441,2,1,0.24
10,3,note,4,442,3,1,0.28
10,3,notion,6,443,3,3,0.48
10,3,novel,5,444,2,3,0.44
10,3,obesity,7,445,0,7,0.72
10,3,oblige,6,446,2,4,0.64
10,3,occupation,10,447,1,9,0.96
10,3,ocean,5,448,2,3,0.44
10,3,offence,7,449,1,6,0.8
10,3,offend,6,450,5,1,0.36
10,3,official,8,451,3,5,0.64
10,3,one,3,452,1,2,0.28
10,3,opponent,8,453,1,7,0.8
10,3,opposed,7,454,4,3,0.64
10,3,option,6,455,2,4,0.52
10,3,organic,7,456,1,6,0.68
10,3,organized,9,457,6,3,0.56
10,3,originate,9,458,2,7,0.96
10,3,other,5,459,1,4,0.52
10,3,otherwise,9,460,5,4,0.64
10,3,ought,5,461,1,4,0.6
10,3,outdoor,7,462,2,5,0.64
10,3,outing,6,463,3,3,0.48
10,3,outlet,6,464,3,3,0.44
10,3,outlook,7,465,4,3,0.52
10,3,pace,4,466,0,4,0.56
10,3,painful,7,467,2,5,0.64
10,3,palace,6,468,2,4,0.52
10,3,parade,6,469,2,4,0.52
10,3,park,4,470,3,1,0.28
10,3,patent,6,471,2,4,0.64
10,3,peaceful,8,472,1,7,0.8
10,3,perceive,8,473,2,6,0.72
10,3,perfect,7,474,3,4,0.72
10,3,persistent,10,475,3,7,0.84
10,3,personnel,9,476,4,5,0.68
10,3,pick,4,477,1,3,0.4
10,3,picture,7,478,3,4,0.56
10,3,pig,3,479,2,1,0.16
10,3,pile,4,480,2,2,0.16
10,3,pioneer,7,481,2,5,0.28
10,3,place,5,482,1,4,0.24
10,3,plan,4,483,3,1,0.2
10,3,planning,8,484,4,4,0.28
10,3,plant,5,485,4,1,0.12
10,3,plastic,7,486,3,4,0.24
10,3,pledge,6,487,2,4,0.2
10,3,point,5,488,1,4,0.28
10,3,police,6,489,2,4,0.24
10,3,pollution,9,490,3,6,0.32
10,3,pond,4,491,2,2,0.4
10,3,position,8,492,2,6,0.4
10,3,possible,8,493,3,5,0.28
10,3,pot,3,494,2,1,0.12
10,3,practical,9,495,1,8,0.44
10,3,prayer,6,496,3,3,0.32
10,3,precedent,9,497,2,7,0.32
10,3,prediction,10,498,3,7,0.36
10,3,premier,7,499,3,4,0.32
10,3,prevention,10,500,3,7,0.36
10,3,printer,7,501,2,5,0.28
10,3,prior,5,502,3,2,0.16
10,3,priority,8,503,5,3,0.32
10,3,procedure,9,504,2,7,0.36
10,3,processing,10,505,5,5,0.32
10,3,profound,8,506,3,5,0.36
10,3,program,7,507,3,4,0.24
10,3,proportion,10,508,3,7,0.36
10,3,proposal,8,509,5,3,0.24
10,3,prosecute,9,510,3,6,0.4
10,3,prosperity,10,511,4,6,0.32
10,3,pump,4,512,1,3,0.16
10,3,push,4,513,2,2,0.16
10,3,quantity,8,514,0,8,0.44
10,3,quest,5,515,2,3,0.2
10,3,quite,5,516,2,3,0.2
10,3,race,4,517,0,4,0.2
10,3,rail,4,518,2,2,0.16
10,3,railway,7,519,4,3,0.28
10,3,raise,5,520,3,2,0.16
10,3,rather,6,521,2,4,0.28
10,3,react,5,522,1,4,0.24
10,3,realistic,9,523,3,6,0.44
10,3,reception,9,524,2,7,0.36
10,3,recount,7,525,3,4,0.24
10,3,recruit,7,526,3,4,0.32
10,3,recycle,7,527,3,4,0.24
10,3,reduce,6,528,2,4,0.2
10,3,refer,5,529,2,3,0.2
10,3,reference,9,530,5,4,0.28
10,3,refuse,6,531,3,3,0.32
10,3,regard,6,532,2,4,0.24
10,3,regime,6,533,3,3,0.2
10,3,region,6,534,4,2,0.16
10,3,regional,8,535,6,2,0.28
10,3,relief,6,536,2,4,0.24
10,3,religious,9,537,4,5,0.28
10,3,remainder,9,538,2,7,0.32
10,3,remark,6,539,4,2,0.24
10,3,remind,6,540,3,3,0.2
10,3,removal,7,541,3,4,0.28
10,3,remove,6,542,5,1,0.16
10,3,repeat,6,543,2,4,0.32
10,3,reporting,9,544,3,6,0.32
10,3,research,8,545,2,6,0.32
10,3,residence,9,546,3,6,0.4
10,3,respective,10,547,3,7,0.36
10,3,retail,6,548,2,4,0.24
10,3,retrieve,8,549,3,5,0.28
10,3,reveal,6,550,2,4,0.32
10,3,revise,6,551,3,3,0.2
10,3,rifle,5,552,1,4,0.2
10,3,right,5,553,2,3,0.16
10,3,rise,4,554,2,2,0.16
10,3,ritual,6,555,2,4,0.28
10,3,road,4,556,1,3,0.16
10,3,rob,3,557,2,1,0.08
10,3,robbery,7,558,3,4,0.24
10,3,romance,7,559,2,5,0.28
10,3,roof,4,560,2,2,0.24
10,3,rotate,6,561,2,4,0.24
10,3,rough,5,562,2,3,0.2
10,3,round,5,563,3,2,0.2
10,3,routine,7,564,3,4,0.28
10,3,rub,3,565,1,2,0.2
10,3,ruin,4,566,2,2,0.12
10,3,sacred,6,567,0,6,0.28
10,3,safe,4,568,2,2,0.12
10,3,sale,4,569,2,2,0.16
10,3,sample,6,570,2,4,0.2
10,3,satellite,9,571,2,7,0.44
10,3,satisfied,9,572,3,6,0.32
10,3,schedule,8,573,1,7,0.32
10,3,scholar,7,574,3,4,0.32
10,3,school,6,575,4,2,0.2
10,3,seal,4,576,1,3,0.16
10,3,secretary,9,577,2,7,0.36
10,3,secure,6,578,3,3,0.28
10,3,security,8,579,5,3,0.24
10,3,seem,4,580,2,2,0.16
10,3,segment,7,581,2,5,0.24
10,3,seminar,7,582,2,5,0.32
10,3,sensible,8,583,2,6,0.28
10,3,september,9,584,2,7,0.36
10,3,seriously,9,585,2,7,0.44
10,3,servant,7,586,3,4,0.28
10,3,service,7,587,4,3,0.24
10,3,settlement,10,588,2,8,0.4
10,3,sexual,6,589,2,4,0.32
10,3,sexy,4,590,3,1,0.12
10,3,shallow,7,591,1,6,0.28
10,3,shape,5,592,3,2,0.16
10,3,sheer,5,593,2,3,0.16
10,3,shiny,5,594,2,3,0.28
10,3,shipping,8,595,3,5,0.28
10,3,shoot,5,596,2,3,0.16
10,3,shopping,8,597,3,5,0.28
10,3,shore,5,598,3,2,0.24
10,3,sight,5,599,1,4,0.2
10,3,silver,6,600,2,4,0.24
10,3,similarly,9,601,2,7,0.36
10,3,simply,6,602,3,3,0.28
10,3,sin,3,603,2,1,0.08
10,3,singing,7,604,3,4,0.24
10,3,skip,4,605,1,3,0.16
10,3,slam,4,606,1,3,0.16
10,3,smoking,7,607,1,6,0.36
10,3,snow,4,608,1,3,0.16
10,3,soap,4,609,1,3,0.16
10,3,solar,5,610,2,3,0.16
10,3,solid,5,611,3,2,0.16
10,3,somehow,7,612,2,5,0.24
10,3,someone,7,613,4,3,0.32
10,3,something,9,614,4,5,0.36
10,3,sometimes,9,615,5,4,0.32
10,3,soup,4,616,2,2,0.2
10,3,south,5,617,3,2,0.16
10,3,speak,5,618,1,4,0.2
10,3,special,7,619,3,4,0.24
10,3,specialist,10,620,7,3,0.28
10,3,specify,7,621,5,2,0.28
10,3,speech,6,622,3,3,0.2
10,3,sphere,6,623,2,4,0.24
10,3,spotlight,9,624,2,7,0.32
10,3,spread,6,625,2,4,0.32
10,3,stab,4,626,1,3,0.16
10,3,staff,5,627,3,2,0.16
10,3,stance,6,628,3,3,0.2
10,3,star,4,629,3,1,0.12
10,3,statistic,9,630,3,6,0.4
10,3,stay,4,631,3,1,0.12
10,3,steadily,8,632,2,6,0.32
10,3,stereotype,10,633,3,7,0.44
10,3,sticky,6,634,2,4,0.24
10,3,stop,4,635,2,2,0.12
10,3,storage,7,636,3,4,0.4
10,3,store,5,637,4,1,0.32
10,3,straight,8,638,2,6,0.88
10,3,strange,7,639,4,3,0.6
10,3,strategic,9,640,4,5,0.84
10,3,strategy,8,641,7,1,0.48
10,3,street,6,642,3,3,0.6
10,3,strength,8,643,4,4,0.6
10,3,strict,6,644,3,3,0.48
10,3,string,6,645,4,2,0.48
10,3,strong,6,646,3,3,0.64
10,3,studio,6,647,2,4,0.56
10,3,stumble,7,648,3,4,0.56
10,3,subject,7,649,1,6,0.68
10,3,substance,9,650,3,6,0.88
10,3,successful,10,651,2,8,0.88
10,3,sue,3,652,2,1,0.24
10,3,super,5,653,2,3,0.44
10,3,suppose,7,654,3,4,0.76
10,3,supreme,7,655,3,4,0.6
10,3,surgical,8,656,2,6,0.8
10,3,sympathy,8,657,1,7,0.84
10,3,synthesis,9,658,2,7,0.96
10,3,table,5,659,0,5,0.56
10,3,tactical,8,660,2,6,0.8
10,3,talent,6,661,2,4,0.56
10,3,talk,4,662,3,1,0.4
10,3,tap,3,663,2,1,0.24
10,3,task,4,664,2,2,0.32
10,3,team,4,665,1,3,0.4
10,3,television,10,666,2,8,0.88
10,3,terrific,8,667,2,6,0.84
10,3,terror,6,668,4,2,0.4
10,3,terrorism,9,669,6,3,0.56
10,3,texture,7,670,2,5,0.72
10,3,themselves,10,671,1,9,0.96
10,3,therapist,9,672,3,6,0.8
10,3,thereafter,10,673,4,6,1
10,3,thereby,7,674,5,2,0.44
10,3,thirsty,7,675,2,5,0.6
10,3,this,4,676,3,1,0.28
10,3,thorough,8,677,2,6,0.84
10,3,thoughtful,10,678,3,7,0.84
10,3,three,5,679,2,3,0.44
10,3,thumb,5,680,2,3,0.44
10,3,together,8,681,1,7,0.88
10,3,tolerance,9,682,2,7,0.8
10,3,tonight,7,683,2,5,0.6
10,3,tonne,5,684,3,2,0.36
10,3,topic,5,685,2,3,0.56
10,3,tour,4,686,2,2,0.32
10,3,trademark,9,687,1,8,0.84
10,3,tragic,6,688,3,3,0.44
10,3,trainer,7,689,3,4,0.56
10,3,transcript,10,690,3,7,0.96
10,3,transport,9,691,5,4,0.64
10,3,trap,4,692,3,1,0.28
10,3,traveller,9,693,3,6,0.84
10,3,treat,5,694,2,3,0.4
10,3,tree,4,695,3,1,0.28
10,3,trend,5,696,3,2,0.36
10,3,tribal,6,697,2,4,0.52
10,3,tribute,7,698,4,3,0.64
10,3,trio,4,699,3,1,0.28
10,3,trousers,8,700,2,6,0.68
10,3,truck,5,701,2,3,0.4
10,3,undermine,9,702,0,9,1
10,3,union,5,703,2,3,0.44
10,3,unique,6,704,3,3,0.44
10,3,universal,9,705,3,6,0.72
10,3,universe,8,706,7,1,0.56
10,3,until,5,707,2,3,0.4
10,3,unusual,7,708,2,5,0.6
10,3,upgrade,7,709,1,6,0.68
10,3,usage,5,710,1,4,0.48
10,3,utility,7,711,1,6,0.8
10,3,vague,5,712,0,5,0.52
10,3,valley,6,713,2,4,0.56
10,3,valuable,8,714,3,5,0.64
10,3,variety,7,715,2,5,0.76
10,3,vary,4,716,3,1,0.28
10,3,vein,4,717,1,3,0.36
10,3,venture,7,718,2,5,0.6
10,3,verify,6,719,2,4,0.64
10,3,vessel,6,720,2,4,0.52
10,3,viable,6,721,1,5,0.56
10,3,video,5,722,2,3,0.44
10,3,villager,8,723,2,6,0.72
10,3,violent,7,724,2,5,0.72
10,3,virtue,6,725,2,4,0.52
10,3,visitor,7,726,2,5,0.6
10,3,vital,5,727,2,3,0.44
10,3,vocal,5,728,1,4,0.64
10,3,volunteer,9,729,2,7,0.8
10,3,wait,4,730,0,4,0.44
10,3,wake,4,731,2,2,0.32
10,3,walk,4,732,2,2,0.32
10,3,warning,7,733,2,5,0.76
10,3,water,5,734,2,3,0.44
10,3,weapon,6,735,1,5,0.6
10,3,weekend,7,736,2,5,0.6
10,3,welcome,7,737,2,5,0.76
10,3,whereas,7,738,1,6,0.64
10,3,which,5,739,2,3,0.4
10,3,whose,5,740,2,3,0.4
10,3,width,5,741,1,4,0.64
10,3,wind,4,742,2,2,0.32
10,3,wine,4,743,3,1,0.28
10,3,wipe,4,744,2,2,0.32
10,3,within,6,745,2,4,0.52
10,3,without,7,746,4,3,0.52
10,3,word,4,747,1,3,0.52
10,3,work,4,748,3,1,0.28
10,3,workforce,9,749,4,5,0.8
10,3,worry,5,750,3,2,0.44
10,3,wrist,5,751,1,4,0.52
10,3,written,7,752,3,4,0.68
10,3,yellow,6,753,0,6,0.6
10,3,youngster,9,754,1,8,0.84
10,4,absolutely,10,0,0,10,0.56
10,4,absorb,6,1,4,2,0.2
10,4,academic,8,2,1,7,0.36
10,4,accident,8,3,2,6,0.32
10,4,accomplish,10,4,3,7,0.52
10,4,accounting,10,5,4,6,0.36
10,4,accurate,8,6,3,5,0.32
10,4,activate,8,7,2,6,0.4
10,4,actress,7,8,3,4,0.24
10,4,acute,5,9,2,3,0.2
10,4,ad,2,10,1,1,0.08
10,4,address,7,11,2,5,0.28
10,4,adj,3,12,2,1,0.24
10,4,adopt,5,13,2,3,0.2
10,4,adoption,8,14,5,3,0.28
10,4,advantage,9,15,2,7,0.4
10,4,aesthetic,9,16,1,8,0.52
10,4,affordable,10,17,1,9,0.44
10,4,aftermath,9,18,2,7,0.4
10,4,against,7,19,1,6,0.48
10,4,aggression,10,20,2,8,0.44
10,4,aggressive,10,21,8,2,0.24
10,4,agree,5,22,2,3,0.32
10,4,align,5,23,1,4,0.24
10,4,ally,4,24,2,2,0.2
10,4,alongside,9,25,2,7,0.4
10,4,amateur,7,26,1,6,0.4
10,4,analysis,8,27,1,7,0.36
10,4,ancient,7,28,2,5,0.28
10,4,and,3,29,2,1,0.12
10,4,another,7,30,2,5,0.28
10,4,anxiety,7,31,2,5,0.36
10,4,anybody,7,32,2,5,0.28
10,4,anyway,6,33,3,3,0.2
10,4,apologize,9,34,1,8,0.44
10,4,appreciate,10,35,2,8,0.4
10,4,approach,8,36,4,4,0.24
10,4,approve,7,37,5,2,0.2
10,4,arguably,8,38,1,7,0.4
10,4,argue,5,39,4,1,0.12
10,4,army,4,40,2,2,0.16
10,4,around,6,41,2,4,0.24
10,4,arrest,6,42,2,4,0.32
10,4,arrow,5,43,3,2,0.16
10,4,artistic,8,44,2,6,0.28
10,4,assessment,10,45,1,9,0.4
10,4,associate,9,46,3,6,0.4
10,4,assurance,9,47,3,6,0.32
10,4,at,2,48,1,1,0.08
10,4,attachment,10,49,2,8,0.4
10,4,attract,7,50,3,4,0.32
10,4,auto,4,51,1,3,0.16
10,4,automatic,9,52,4,5,0.32
10,4,bacteria,8,53,0,8,0.44
10,4,balance,7,54,2,5,0.24
10,4,ballet,6,55,3,3,0.2
10,4,banner,6,56,2,4,0.24
10,4,barrel,6,57,2,4,0.2
10,4,base,4,58,2,2,0.24
10,4,bat,3,59,2,1,0.12
10,4,bay,3,60,2,1,0.08
10,4,beat,4,61,1,3,0.16
10,4,beauty,6,62,3,3,0.2
10,4,beer,4,63,2,2,0.12
10,4,behalf,6,64,2,4,0.32
10,4,bell,4,65,2,2,0.16
10,4,below,5,66,3,2,0.16
10,4,betray,6,67,2,4,0.2
10,4,bird,4,68,1,3,0.16
10,4,biscuit,7,69,2,5,0.36
10,4,bishop,6,70,3,3,0.2
10,4,bitter,6,71,2,4,0.24
10,4,bizarre,7,72,2,5,0.28
10,4,blade,5,73,1,4,0.32
10,4,blame,5,74,3,2,0.2
10,4,bless,5,75,2,3,0.2
10,4,boat,4,76,1,3,0.16
10,4,bomb,4,77,2,2,0.16
10,4,boost,5,78,2,3,0.2
10,4,bottle,6,79,2,4,0.28
10,4,boundary,8,80,2,6,0.28
10,4,boyfriend,9,81,2,7,0.32
10,4,breach,6,82,1,5,0.24
10,4,breakdown,9,83,4,5,0.36
10,4,broken,6,84,2,4,0.24
10,4,buffer,6,85,1,5,0.24
10,4,build,5,86,2,3,0.16
10,4,business,8,87,2,6,0.4
10,4,butter,6,88,2,4,0.24
10,4,cake,4,89,0,4,0.2
10,4,can,3,90,2,1,0.12
10,4,cancer,6,91,3,3,0.28
10,4,capability,10,92,2,8,0.56
10,4,capable,7,93,5,2,0.44
10,4,capitalist,10,94,3,7,0.84
10,4,card,4,95,2,2,0.44
10,4,careful,7,96,3,4,0.56
10,4,carpet,6,97,3,3,0.44
10,4,cartoon,7,98,3,4,0.64
10,4,carve,5,99,3,2,0.56
10,4,cd,2,100,1,1,0.2
10,4,ceiling,7,101,1,6,0.64
10,4,celebrate,9,102,2,7,0.8
10,4,central,7,103,2,5,0.6
10,4,certain,7,104,2,5,0.76
10,4,certainty,9,105,7,2,0.52
10,4,character,9,106,1,8,0.88
10,4,charm,5,107,4,1,0.48
10,4,charming,8,108,5,3,0.56
10,4,chart,5,109,4,1,0.32
10,4,charter,7,110,5,2,0.44
10,4,check,5,111,2,3,0.44
10,4,cheerful,8,112,3,5,0.84
10,4,chemical,8,113,3,5,0.64
10,4,choir,5,114,2,3,0.4
10,4,choose,6,115,3,3,0.44
10,4,chop,4,116,3,1,0.4
10,4,chunk,5,117,2,3,0.44
10,4,circle,6,118,1,5,0.56
10,4,circuit,7,119,4,3,0.52
10,4,cite,4,120,2,2,0.32
10,4,city,4,121,3,1,0.4
10,4,civil,5,122,2,3,0.52
10,4,clean,5,123,1,4,0.56
10,4,clearly,7,124,4,3,0.6
10,4,clerk,5,125,3,2,0.44
10,4,coffee,6,126,1,5,0.8
10,4,coincide,8,127,2,6,0.68
10,4,collection,10,128,2,8,0.88
10,4,colony,6,129,3,3,0.44
10,4,comedy,6,130,2,4,0.68
10,4,comfort,7,131,3,4,0.56
10,4,comment,7,132,3,4,0.56
10,4,commission,10,133,4,6,0.92
10,4,commodity,9,134,4,5,0.68
10,4,commonly,8,135,5,3,0.56
10,4,community,9,136,4,5,0.68
10,4,company,7,137,3,4,0.68
10,4,comparable,10,138,5,5,0.72
10,4,comply,6,139,4,2,0.4
10,4,conceive,8,140,2,6,0.84
10,4,concern,7,141,5,2,0.44
10,4,concert,7,142,6,1,0.4
10,4,conduct,7,143,3,4,0.56
10,4,confer,6,144,3,3,0.52
10,4,confess,7,145,5,2,0.6
10,4,confidence,10,146,4,6,0.76
10,4,conscious,9,147,3,6,0.72
10,4,consent,7,148,4,3,0.64
10,4,contempt,8,149,3,5,0.64
10,4,conversion,10,150,3,7,0.88
10,4,county,6,151,2,4,0.52
10,4,coup,4,152,3,1,0.4
10,4,court,5,153,3,2,0.36
10,4,coverage,8,154,2,6,0.76
10,4,create,6,155,1,5,0.64
10,4,creativity,10,156,5,5,0.92
10,4,creep,5,157,3,2,0.4
10,4,crime,5,158,2,3,0.52
10,4,criminal,8,159,4,4,0.72
10,4,crisis,6,160,3,3,0.6
10,4,cross,5,161,2,3,0.4
10,4,crowded,7,162,3,4,0.56
10,4,crucial,7,163,2,5,0.6
10,4,cruise,6,164,3,3,0.44
10,4,cry,3,165,2,1,0.36
10,4,currency,8,166,1,7,0.8
10,4,current,7,167,6,1,0.4
10,4,curved,6,168,3,3,0.44
10,4,cycle,5,169,1,4,0.6
10,4,dare,4,170,0,4,0.44
10,4,darkness,8,171,3,5,0.64
10,4,day,3,172,2,1,0.24
10,4,deal,4,173,1,3,0.36
10,4,decline,7,174,2,5,0.72
10,4,decrease,8,175,3,5,0.64
10,4,deem,4,176,2,2,0.32
10,4,default,7,177,2,5,0.6
10,4,defect,6,178,3,3,0.48
10,4,defence,7,179,4,3,0.64
10,4,dentist,7,180,2,5,0.6
10,4,departure,9,181,2,7,0.8
10,4,depression,10,182,3,7,0.96
10,4,desktop,7,183,2,5,0.6
10,4,despite,7,184,3,4,0.56
10,4,detect,6,185,2,4,0.52
10,4,detention,9,186,4,5,0.84
10,4,develop,7,187,2,5,0.6
10,4,devil,5,188,3,2,0.36
10,4,diagnosis,9,189,1,8,0.84
10,4,diagram,7,190,4,3,0.64
10,4,dictator,8,191,2,6,0.72
10,4,dig,3,192,2,1,0.24
10,4,diminish,8,193,2,6,0.72
10,4,diplomatic,10,194,2,8,1.04
10,4,director,8,195,2,6,0.68
10,4,dirt,4,196,3,1,0.28
10,4,dirty,5,197,4,1,0.32
10,4,disastrous,10,198,2,8,1.04
10,4,discipline,10,199,3,7,0.92
10,4,discretion,10,200,4,6,1
10,4,discussion,10,201,4,6,0.8
10,4,distort,7,202,3,4,0.56
10,4,disturbing,10,203,4,6,0.8
10,4,dollar,6,204,1,5,0.76
10,4,domain,6,205,2,4,0.52
10,4,dominant,8,206,3,5,0.64
10,4,dot,3,207,2,1,0.24
10,4,downstairs,10,208,2,8,1.08
10,4,dust,4,209,1,3,0.36
10,4,edition,7,210,0,7,0.72
10,4,effort,6,211,1,5,0.56
10,4,eight,5,212,1,4,0.64
10,4,either,6,213,2,4,0.52
10,4,electrical,10,214,1,9,0.92
10,4,eleven,6,215,3,3,0.44
10,4,elsewhere,9,216,2,7,0.92
10,4,embark,6,217,1,5,0.56
10,4,embody,6,218,3,3,0.44
10,4,emergency,9,219,2,7,0.8
10,4,emission,8,220,2,6,0.84
10,4,empower,7,221,2,5,0.6
10,4,endless,7,222,1,6,0.64
10,4,enemy,5,223,2,3,0.56
10,4,engineer,8,224,2,6,0.68
10,4,enjoy,5,225,2,3,0.44
10,4,enjoyable,9,226,5,4,0.64
10,4,enrich,6,227,2,4,0.56
10,4,enter,5,228,2,3,0.24
10,4,enterprise,10,229,5,5,0.36
10,4,entitle,7,230,3,4,0.28
10,4,entrance,8,231,3,5,0.36
10,4,entry,5,232,4,1,0.16
10,4,equality,8,233,1,7,0.36
10,4,erect,5,234,1,4,0.2
10,4,evening,7,235,1,6,0.36
10,4,event,5,236,4,1,0.12
10,4,evoke,5,237,2,3,0.16
10,4,exact,5,238,1,4,0.2
10,4,exception,9,239,2,7,0.32
10,4,exchange,8,240,3,5,0.48
10,4,excited,7,241,3,4,0.24
10,4,execution,9,242,2,7,0.32
10,4,existence,9,243,2,7,0.44
10,4,expertise,9,244,2,7,0.32
10,4,expire,6,245,3,3,0.2
10,4,explicitly,10,246,3,7,0.44
10,4,extent,6,247,2,4,0.2
10,4,extremist,9,248,3,6,0.32
10,4,eye,3,249,1,2,0.12
10,4,failed,6,250,0,6,0.28
10,4,fair,4,251,3,1,0.2
10,4,fast,4,252,2,2,0.12
10,4,fat,3,253,2,1,0.08
10,4,fear,4,254,1,3,0.16
10,4,feeding,7,255,2,5,0.24
10,4,few,3,256,2,1,0.08
10,4,fibre,5,257,1,4,0.28
10,4,fiction,7,258,2,5,0.24
10,4,fifty,5,259,2,3,0.16
10,4,fight,5,260,2,3,0.16
10,4,file,4,261,2,2,0.12
10,4,finally,7,262,2,5,0.36
10,4,financial,9,263,4,5,0.28
10,4,fix,3,264,2,1,0.08
10,4,fixed,5,265,3,2,0.16
10,4,flat,4,266,1,3,0.32
10,4,flexible,8,267,2,6,0.32
10,4,flu,3,268,2,1,0.12
10,4,folding,7,269,1,6,0.28
10,4,for,3,270,2,1,0.08
10,4,force,5,271,3,2,0.16
10,4,foreign,7,272,3,4,0.32
10,4,foreigner,9,273,7,2,0.24
10,4,formation,9,274,3,6,0.32
10,4,former,6,275,4,2,0.24
10,4,formerly,8,276,6,2,0.2
10,4,formula,7,277,4,3,0.2
10,4,fragment,8,278,1,7,0.32
10,4,friday,6,279,2,4,0.32
10,4,friendly,8,280,3,5,0.28
10,4,funding,7,281,1,6,0.32
10,4,gallon,6,282,0,6,0.28
10,4,garage,6,283,2,4,0.32
10,4,gender,6,284,1,5,0.24
10,4,general,7,285,3,4,0.24
10,4,generate,8,286,6,2,0.2
10,4,genre,5,287,3,2,0.24
10,4,geography,9,288,2,7,0.32
10,4,giant,5,289,1,4,0.2
10,4,give,4,290,2,2,0.12
10,4,glass,5,291,1,4,0.2
10,4,go,2,292,1,1,0.2
10,4,golf,4,293,2,2,0.16
10,4,good,4,294,2,2,0.16
10,4,goodbye,7,295,4,3,0.2
10,4,governor,8,296,2,6,0.32
10,4,grace,5,297,1,4,0.32
10,4,grade,5,298,3,2,0.16
10,4,graphics,8,299,3,5,0.28
10,4,green,5,300,2,3,0.2
10,4,greet,5,301,4,1,0.12
10,4,grey,4,302,3,1,0.2
10,4,grid,4,303,2,2,0.12
10,4,grief,5,304,3,2,0.16
10,4,grin,4,305,3,1,0.12
10,4,grind,5,306,4,1,0.12
10,4,ground,6,307,2,4,0.24
10,4,growth,6,308,3,3,0.28
10,4,guess,5,309,1,4,0.2
10,4,guitar,6,310,2,4,0.24
10,4,handy,5,311,0,5,0.24
10,4,happen,6,312,2,4,0.32
10,4,harvest,7,313,2,5,0.28
10,4,heat,4,314,1,3,0.16
10,4,heighten,8,315,2,6,0.32
10,4,her,3,316,2,1,0.08
10,4,hers,4,317,3,1,0.24
10,4,hesitate,8,318,2,6,0.32
10,4,hint,4,319,1,3,0.16
10,4,historical,10,320,2,8,0.4
10,4,holiday,7,321,1,6,0.4
10,4,honesty,7,322,2,5,0.28
10,4,hour,4,323,2,2,0.12
10,4,household,9,324,3,6,0.32
10,4,how,3,325,2,1,0.08
10,4,hunger,6,326,1,5,0.36
10,4,hurricane,9,327,2,7,0.36
10,4,hydrogen,8,328,1,7,0.36
10,4,imaginary,9,329,0,9,0.52
10,4,improve,7,330,2,5,0.28
10,4,incur,5,331,1,4,0.24
10,4,indirect,8,332,2,6,0.32
10,4,infant,6,333,2,4,0.32
10,4,informal,8,334,3,5,0.28
10,4,inherent,8,335,2,6,0.28
10,4,initiate,8,336,2,6,0.4
10,4,inspect,7,337,2,5,0.28
10,4,instant,7,338,3,4,0.28
10,4,instruct,8,339,4,4,0.24
10,4,insurance,9,340,3,6,0.4
10,4,intended,8,341,2,6,0.28
10,4,intense,7,342,5,2,0.2
10,4,intensify,9,343,6,3,0.32
10,4,into,4,344,3,1,0.12
10,4,involve,7,345,2,5,0.24
10,4,iron,4,346,1,3,0.16
10,4,island,6,347,1,5,0.24
10,4,isolated,8,348,2,6,0.4
10,4,jewellery,9,349,0,9,0.44
10,4,journalism,10,350,1,9,0.44
10,4,just,4,351,1,3,0.16
10,4,justify,7,352,4,3,0.32
10,4,key,3,353,0,3,0.16
10,4,kid,3,354,1,2,0.12
10,4,king,4,355,2,2,0.12
10,4,kit,3,356,2,1,0.08
10,4,know,4,357,1,3,0.16
10,4,lad,3,358,0,3,0.24
10,4,lake,4,359,2,2,0.16
10,4,landscape,9,360,2,7,0.36
10,4,last,4,361,2,2,0.16
10,4,latest,6,362,2,4,0.24
10,4,law,3,363,2,1,0.2
10,4,layer,5,364,2,3,0.16
10,4,leadership,10,365,1,9,0.4
10,4,leading,7,366,4,3,0.24
10,4,leaf,4,367,3,1,0.2
10,4,leaflet,7,368,4,3,0.24
10,4,learning,8,369,3,5,0.32
10,4,left,4,370,2,2,0.16
10,4,legitimate,10,371,2,8,0.52
10,4,lesbian,7,372,2,5,0.28
10,4,lethal,6,373,2,4,0.24
10,4,license,7,374,1,6,0.28
10,4,lie,3,375,2,1,0.12
10,4,likelihood,10,376,2,8,0.52
10,4,link,4,377,2,2,0.16
10,4,lion,4,378,2,2,0.16
10,4,literary,8,379,2,6,0.32
10,4,litter,6,380,3,3,0.28
10,4,live,4,381,2,2,0.12
10,4,log,3,382,1,2,0.12
10,4,lonely,6,383,2,4,0.2
10,4,long,4,384,3,1,0.12
10,4,look,4,385,2,2,0.24
10,4,loudly,6,386,2,4,0.24
10,4,low,3,387,2,1,0.12
10,4,lunch,5,388,1,4,0.24
10,4,mail,4,389,0,4,0.2
10,4,mandate,7,390,2,5,0.4
10,4,mandatory,9,391,6,3,0.76
10,4,manipulate,10,392,3,7,0.92
10,4,manuscript,10,393,3,7,0.92
10,4,mark,4,394,2,2,0.52
10,4,master,6,395,2,4,0.56
10,4,maximum,7,396,2,5,0.64
10,4,meal,4,397,1,3,0.4
10,4,meaningful,10,398,3,7,1.08
10,4,mechanical,10,399,2,8,0.96
10,4,media,5,400,2,3,0.44
10,4,meeting,7,401,2,5,0.6
10,4,melody,6,402,2,4,0.76
10,4,memory,6,403,2,4,0.64
10,4,mental,6,404,2,4,0.6
10,4,mention,7,405,4,3,0.52
10,4,mentor,6,406,4,2,0.56
10,4,message,7,407,2,5,0.68
10,4,method,6,408,2,4,0.56
10,4,midnight,8,409,1,7,0.84
10,4,militia,7,410,2,5,0.84
10,4,mind,4,411,2,2,0.36
10,4,mirror,6,412,2,4,0.52
10,4,modify,6,413,1,5,0.6
10,4,moment,6,414,2,4,0.56
10,4,month,5,415,2,3,0.56
10,4,more,4,416,2,2,0.32
10,4,movie,5,417,2,3,0.4
10,4,much,4,418,1,3,0.36
10,4,multiple,8,419,2,6,0.84
10,4,mum,3,420,2,1,0.24
10,4,municipal,9,421,2,7,0.84
10,4,museum,6,422,2,4,0.52
10,4,music,5,423,3,2,0.36
10,4,name,4,424,0,4,0.6
10,4,nationwide,10,425,2,8,1.04
10,4,neck,4,426,1,3,0.36
10,4,needle,6,427,2,4,0.52
10,4,neutral,7,428,2,5,0.76
10,4,new,3,429,2,1,0.24
10,4,noise,5,430,1,4,0.52
10,4,noisy,5,431,4,1,0.36
10,4,nomination,10,432,2,8,1
10,4,non,3,433,2,1,0.4
10,4,norm,4,434,2,2,0.32
10,4,normal,6,435,4,2,0.4
10,4,north,5,436,3,2,0.36
10,4,northern,8,437,5,3,0.56
10,4,note,4,438,2,2,0.48
10,4,notice,6,439,3,3,0.52
10,4,notion,6,440,4,2,0.44
10,4,novel,5,441,2,3,0.44
10,4,numerous,8,442,1,7,0.88
10,4,nut,3,443,2,1,0.4
10,4,oblige,6,444,0,6,0.68
10,4,obsess,6,445,2,4,0.56
10,4,ocean,5,446,1,4,0.48
10,4,offence,7,447,1,6,0.72
10,4,offend,6,448,5,1,0.52
10,4,official,8,449,3,5,0.76
10,4,offspring,9,450,3,6,0.84
10,4,one,3,451,1,2,0.32
10,4,online,6,452,2,4,0.72
10,4,opponent,8,453,1,7,0.84
10,4,optimistic,10,454,2,8,1.04
10,4,option,6,455,4,2,0.56
10,4,organic,7,456,1,6,0.72
10,4,organized,9,457,6,3,0.6
10,4,originate,9,458,2,7,0.84
10,4,other,5,459,1,4,0.64
10,4,ought,5,460,1,4,0.56
10,4,outdoor,7,461,2,5,0.68
10,4,outdoors,8,462,7,1,0.48
10,4,outfit,6,463,3,3,0.68
10,4,outing,6,464,3,3,0.48
10,4,outlook,7,465,3,4,0.56
10,4,pace,4,466,0,4,0.44
10,4,pad,3,467,2,1,0.24
10,4,painful,7,468,2,5,0.84
10,4,parade,6,469,2,4,0.52
10,4,parallel,8,470,4,4,0.6
10,4,park,4,471,3,1,0.28
10,4,partial,7,472,3,4,0.72
10,4,particular,10,473,5,5,0.88
10,4,password,8,474,2,6,0.84
10,4,patent,6,475,2,4,0.52
10,4,patience,8,476,3,5,0.84
10,4,patron,6,477,3,3,0.52
10,4,peace,5,478,1,4,0.52
10,4,peculiar,8,479,2,6,0.72
10,4,peer,4,480,2,2,0.48
10,4,pepper,6,481,2,4,0.56
10,4,perfect,7,482,2,5,0.64
10,4,perhaps,7,483,3,4,0.6
10,4,persistent,10,484,3,7,1
10,4,physician,9,485,1,8,0.84
10,4,picture,7,486,1,6,0.68
10,4,pin,3,487,2,1,0.24
10,4,planning,8,488,1,7,0.96
10,4,plastic,7,489,3,4,0.64
10,4,pleased,7,490,2,5,0.68
10,4,pledge,6,491,3,3,0.52
10,4,pollution,9,492,1,8,1.04
10,4,pond,4,493,2,2,0.36
10,4,population,10,494,2,8,1
10,4,portion,7,495,2,5,0.76
10,4,poster,6,496,2,4,0.56
10,4,prayer,6,497,1,5,0.64
10,4,precedent,9,498,2,7,1.48
10,4,pregnant,8,499,3,5,0.84
10,4,prejudice,9,500,3,6,0.76
10,4,presence,8,501,3,5,0.64
10,4,presently,9,502,6,3,0.72
10,4,prevention,10,503,3,7,1.04
10,4,principal,9,504,2,7,1.28
10,4,principle,9,505,7,2,0.52
10,4,printing,8,506,4,4,0.72
10,4,procedure,9,507,2,7,0.92
10,4,process,7,508,5,2,0.44
10,4,processor,9,509,7,2,0.68
10,4,produce,7,510,3,4,0.6
10,4,program,7,511,3,4,0.56
10,4,propaganda,10,512,3,7,0.84
10,4,properly,8,513,4,4,0.76
10,4,proposal,8,514,4,4,0.6
10,4,propose,7,515,6,1,0.4
10,4,prosecute,9,516,3,6,0.92
10,4,prosperity,10,517,4,6,0.6
10,4,protest,7,518,3,4,0.28
10,4,publicity,9,519,1,8,0.52
10,4,punk,4,520,2,2,0.2
10,4,pupil,5,521,2,3,0.2
10,4,put,3,522,2,1,0.12
10,4,query,5,523,0,5,0.24
10,4,quest,5,524,3,2,0.16
10,4,quite,5,525,2,3,0.28
10,4,race,4,526,0,4,0.2
10,4,racial,6,527,3,3,0.2
10,4,radiation,9,528,2,7,0.36
10,4,railway,7,529,2,5,0.36
10,4,raise,5,530,3,2,0.16
10,4,rating,6,531,2,4,0.2
10,4,rational,8,532,4,4,0.24
10,4,react,5,533,1,4,0.2
10,4,realm,5,534,3,2,0.28
10,4,reasoning,9,535,3,6,0.32
10,4,rebel,5,536,2,3,0.2
10,4,reception,9,537,2,7,0.36
10,4,recognize,9,538,3,6,0.44
10,4,recommend,9,539,4,5,0.28
10,4,recount,7,540,4,3,0.24
10,4,refer,5,541,2,3,0.32
10,4,regard,6,542,2,4,0.24
10,4,regime,6,543,3,3,0.2
10,4,regional,8,544,4,4,0.28
10,4,rejection,9,545,2,7,0.44
10,4,relax,5,546,2,3,0.2
10,4,relevance,9,547,3,6,0.32
10,4,religious,9,548,3,6,0.32
10,4,remind,6,549,2,4,0.32
10,4,remove,6,550,3,3,0.24
10,4,repeat,6,551,2,4,0.2
10,4,reportedly,10,552,3,7,0.36
10,4,reporting,9,553,6,3,0.36
10,4,research,8,554,2,6,0.32
10,4,reside,6,555,3,3,0.2
10,4,resolve,7,556,3,4,0.32
10,4,retirement,10,557,2,8,0.36
10,4,revenge,7,558,2,5,0.28
10,4,revise,6,559,3,3,0.2
10,4,revision,8,560,5,3,0.32
10,4,revive,6,561,4,2,0.2
10,4,right,5,562,1,4,0.2
10,4,rise,4,563,2,2,0.16
10,4,rival,5,564,2,3,0.2
10,4,road,4,565,1,3,0.28
10,4,robbery,7,566,2,5,0.24
10,4,roof,4,567,2,2,0.16
10,4,rotate,6,568,2,4,0.2
10,4,rough,5,569,2,3,0.2
10,4,routine,7,570,3,4,0.32
10,4,rubbish,7,571,1,6,0.28
10,4,ruin,4,572,2,2,0.16
10,4,sacred,6,573,0,6,0.24
10,4,safe,4,574,2,2,0.12
10,4,sailor,6,575,2,4,0.32
10,4,salt,4,576,2,2,0.12
10,4,sample,6,577,2,4,0.2
10,4,satisfied,9,578,2,7,0.32
10,4,scan,4,579,1,3,0.24
10,4,scared,6,580,3,3,0.2
10,4,scheme,6,581,2,4,0.24
10,4,school,6,582,3,3,0.2
10,4,scientific,10,583,2,8,0.48
10,4,secretary,9,584,1,8,0.4
10,4,secure,6,585,3,3,0.2
10,4,seeker,6,586,2,4,0.24
10,4,seem,4,587,3,1,0.2
10,4,selective,9,588,2,7,0.36
10,4,service,7,589,2,5,0.28
10,4,settler,7,590,2,5,0.28
10,4,seven,5,591,2,3,0.28
10,4,severely,8,592,4,4,0.24
10,4,sexual,6,593,2,4,0.24
10,4,sexy,4,594,3,1,0.12
10,4,shallow,7,595,1,6,0.36
10,4,shape,5,596,3,2,0.16
10,4,shift,5,597,2,3,0.16
10,4,shiny,5,598,3,2,0.2
10,4,shipping,8,599,3,5,0.32
10,4,shopping,8,600,2,6,0.4
10,4,silver,6,601,1,5,0.24
10,4,simulation,10,602,2,8,0.4
10,4,six,3,603,2,1,0.08
10,4,skip,4,604,1,3,0.24
10,4,skirt,5,605,3,2,0.16
10,4,skull,5,606,2,3,0.2
10,4,slam,4,607,1,3,0.16
10,4,slice,5,608,2,3,0.16
10,4,slip,4,609,3,1,0.12
10,4,smile,5,610,1,4,0.32
10,4,smoking,7,611,2,5,0.24
10,4,snow,4,612,1,3,0.16
10,4,solo,4,613,1,3,0.16
10,4,some,4,614,2,2,0.12
10,4,something,9,615,4,5,0.36
10,4,sometimes,9,616,5,4,0.28
10,4,song,4,617,2,2,0.16
10,4,soup,4,618,2,2,0.16
10,4,spare,5,619,1,4,0.2
10,4,speaker,7,620,2,5,0.36
10,4,special,7,621,3,4,0.24
10,4,specify,7,622,5,2,0.2
10,4,spectator,9,623,4,5,0.4
10,4,sphere,6,624,2,4,0.24
10,4,spotlight,9,625,2,7,0.36
10,4,stable,6,626,1,5,0.24
10,4,staff,5,627,3,2,0.24
10,4,stall,5,628,3,2,0.16
10,4,stamp,5,629,3,2,0.16
10,4,stand,5,630,3,2,0.16
10,4,statistic,9,631,3,6,0.32
10,4,stay,4,632,3,1,0.2
10,4,steer,5,633,2,3,0.16
10,4,sticky,6,634,2,4,0.24
10,4,storage,7,635,2,5,0.24
10,4,store,5,636,4,1,0.16
10,4,strange,7,637,2,5,0.36
10,4,strategy,8,638,4,4,0.28
10,4,strength,8,639,3,5,0.28
10,4,strike,6,640,3,3,0.24
10,4,studio,6,641,2,4,0.32
10,4,study,5,642,4,1,0.16
10,4,subject,7,643,1,6,0.28
10,4,substance,9,644,3,6,0.32
10,4,successful,10,645,2,8,0.48
10,4,such,4,646,3,1,0.12
10,4,sudden,6,647,2,4,0.2
10,4,sufficient,10,648,2,8,0.48
10,4,sugar,5,649,2,3,0.2
10,4,super,5,650,2,3,0.16
10,4,supreme,7,651,3,4,0.24
10,4,surely,6,652,2,4,0.24
10,4,surgical,8,653,3,5,0.4
10,4,sweater,7,654,1,6,0.28
10,4,sweep,5,655,3,2,0.16
10,4,swim,4,656,2,2,0.16
10,4,switch,6,657,3,3,0.32
10,4,sympathy,8,658,1,7,0.4
10,4,symptom,7,659,4,3,0.24
10,4,synthesis,9,660,2,7,0.48
10,4,tale,4,661,0,4,0.4
10,4,tank,4,662,2,2,0.16
10,4,tape,4,663,2,2,0.16
10,4,taxi,4,664,2,2,0.16
10,4,tea,3,665,1,2,0.12
10,4,television,10,666,2,8,0.52
10,4,tempt,5,667,2,3,0.24
10,4,terrify,7,668,2,5,0.32
10,4,terror,6,669,4,2,0.16
10,4,texture,7,670,2,5,0.28
10,4,themselves,10,671,1,9,0.56
10,4,therapist,9,672,3,6,0.36
10,4,thereby,7,673,4,3,0.24
10,4,thesis,6,674,3,3,0.32
10,4,thorough,8,675,2,6,0.36
10,4,thoughtful,10,676,3,7,0.36
10,4,three,5,677,2,3,0.2
10,4,ticket,6,678,1,5,0.36
10,4,tighten,7,679,2,5,0.24
10,4,timing,6,680,2,4,0.24
10,4,to,2,681,1,1,0.08
10,4,tolerance,9,682,2,7,0.44
10,4,too,3,683,2,1,0.08
10,4,tool,4,684,3,1,0.12
10,4,torture,7,685,2,5,0.28
10,4,tour,4,686,2,2,0.12
10,4,trademark,9,687,1,8,0.48
10,4,trainer,7,688,3,4,0.24
10,4,transcript,10,689,3,7,0.44
10,4,trap,4,690,3,1,0.12
10,4,traveller,9,691,3,6,0.44
10,4,treat,5,692,2,3,0.16
10,4,trial,5,693,2,3,0.2
10,4,tribal,6,694,3,3,0.2
10,4,tribe,5,695,4,1,0.24
10,4,tropical,8,696,2,6,0.32
10,4,trousers,8,697,3,5,0.28
10,4,truck,5,698,2,3,0.16
10,4,two,3,699,1,2,0.12
10,4,ultimate,8,700,0,8,0.44
10,4,undergo,7,701,1,6,0.28
10,4,undermine,9,702,5,4,0.28
10,4,underwear,9,703,5,4,0.36
10,4,unfair,6,704,2,4,0.2
10,4,unique,6,705,2,4,0.24
10,4,universal,9,706,3,6,0.32
10,4,until,5,707,2,3,0.28
10,4,unusual,7,708,2,5,0.28
10,4,upgrade,7,709,1,6,0.28
10,4,urgent,6,710,1,5,0.24
10,4,usual,5,711,1,4,0.28
10,4,utility,7,712,1,6,0.28
10,4,vague,5,713,0,5,0.24
10,4,validity,8,714,2,6,0.32
10,4,valley,6,715,3,3,0.32
10,4,variety,7,716,2,5,0.28
10,4,vary,4,717,3,1,0.12
10,4,vegetable,9,718,1,8,0.36
10,4,vein,4,719,2,2,0.16
10,4,veteran,7,720,2,5,0.36
10,4,video,5,721,1,4,0.2
10,4,viewer,6,722,2,4,0.24
10,4,violent,7,723,2,5,0.24
10,4,virtual,7,724,2,5,0.36
10,4,virus,5,725,3,2,0.16
10,4,vital,5,726,2,3,0.2
10,4,vocal,5,727,1,4,0.2
10,4,waiter,6,728,0,6,0.28
10,4,walk,4,729,2,2,0.24
10,4,warrior,7,730,2,5,0.24
10,4,way,3,731,2,1,0.12
10,4,weakness,8,732,1,7,0.32
10,4,wealthy,7,733,3,4,0.36
10,4,weave,5,734,3,2,0.16
10,4,weight,6,735,2,4,0.2
10,4,welcome,7,736,2,5,0.28
10,4,welfare,7,737,3,4,0.24
10,4,west,4,738,2,2,0.24
10,4,whenever,8,739,1,7,0.32
10,4,whereas,7,740,3,4,0.24
10,4,width,5,741,1,4,0.24
10,4,willing,7,742,2,5,0.36
10,4,win,3,743,2,1,0.08
10,4,window,6,744,3,3,0.2
10,4,woman,5,745,1,4,0.2
10,4,wonderful,9,746,2,7,0.44
10,4,word,4,747,2,2,0.12
10,4,work,4,748,3,1,0.12
10,4,workplace,9,749,4,5,0.32
10,4,world,5,750,3,2,0.16
10,4,wrist,5,751,1,4,0.28
10,4,written,7,752,3,4,0.24
10,4,yellow,6,753,0,6,0.28
10,4,young,5,754,1,4,0.2
10,5,absorb,6,0,0,6,0.28
10,5,academic,8,1,1,7,0.44
10,5,accelerate,10,2,2,8,0.4
10,5,accompany,9,3,3,6,0.32
10,5,accordance,10,4,4,6,0.44
10,5,accurate,8,5,3,5,0.28
10,5,activate,8,6,2,6,0.28
10,5,ad,2,7,1,1,0.08
10,5,adaptation,10,8,2,8,0.48
10,5,additional,10,9,2,8,0.36
10,5,adequately,10,10,2,8,0.52
10,5,adjacent,8,11,2,6,0.28
10,5,admit,5,12,2,3,0.16
10,5,adolescent,10,13,2,8,0.36
10,5,adoption,8,14,3,5,0.4
10,5,advantage,9,15,2,7,0.36
10,5,adventure,9,16,3,6,0.32
10,5,aftermath,9,17,1,8,0.48
10,5,afterwards,10,18,5,5,0.32
10,5,again,5,19,1,4,0.2
10,5,against,7,20,5,2,0.2
10,5,aggression,10,21,2,8,0.52
10,5,ahead,5,22,1,4,0.24
10,5,aids,4,23,1,3,0.16
10,5,allocate,8,24,1,7,0.4
10,5,amateur,7,25,1,6,0.4
10,5,amendment,9,26,2,7,0.36
10,5,ancient,7,27,1,6,0.32
10,5,and,3,28,2,1,0.12
10,5,anger,5,29,2,3,0.28
10,5,annoyed,7,30,2,5,0.28
10,5,another,7,31,2,5,0.24
10,5,anxiety,7,32,2,5,0.24
10,5,anybody,7,33,2,5,0.36
10,5,anyway,6,34,3,3,0.2
10,5,app,3,35,1,2,0.12
10,5,apparently,10,36,3,7,0.36
10,5,applaud,7,37,3,4,0.32
10,5,approve,7,38,3,4,0.24
10,5,arguably,8,39,1,7,0.32
10,5,argue,5,40,4,1,0.12
10,5,arise,5,41,2,3,0.28
10,5,arms,4,42,2,2,0.12
10,5,arrow,5,43,2,3,0.2
10,5,artist,6,44,2,4,0.24
10,5,assault,7,45,1,6,0.28
10,5,assurance,9,46,3,6,0.44
10,5,at,2,47,1,1,0.08
10,5,attract,7,48,2,5,0.28
10,5,auction,7,49,1,6,0.28
10,5,authorize,9,50,2,7,0.48
10,5,baby,4,51,0,4,0.2
10,5,backing,7,52,2,5,0.28
10,5,bacteria,8,53,3,5,0.28
10,5,balance,7,54,2,5,0.36
10,5,bath,4,55,2,2,0.16
10,5,beauty,6,56,1,5,0.24
10,5,bed,3,57,2,1,0.08
10,5,beer,4,58,2,2,0.16
10,5,behalf,6,59,2,4,0.32
10,5,behave,6,60,4,2,0.16
10,5,belief,6,61,2,4,0.2
10,5,benchmark,9,62,2,7,0.32
10,5,betray,6,63,2,4,0.32
10,5,between,7,64,3,4,0.24
10,5,beyond,6,65,2,4,0.24
10,5,bill,4,66,1,3,0.16
10,5,bird,4,67,2,2,0.16
10,5,biscuit,7,68,2,5,0.36
10,5,bishop,6,69,3,3,0.2
10,5,bizarre,7,70,2,5,0.28
10,5,blade,5,71,1,4,0.2
10,5,blame,5,72,3,2,0.28
10,5,blog,4,73,2,2,0.12
10,5,boat,4,74,1,3,0.16
10,5,bound,5,75,2,3,0.2
10,5,boundary,8,76,5,3,0.24
10,5,box,3,77,2,1,0.08
10,5,boyfriend,9,78,2,7,0.48
10,5,brand,5,79,1,4,0.2
10,5,break,5,80,2,3,0.16
10,5,breakdown,9,81,5,4,0.28
10,5,breathing,9,82,4,5,0.4
10,5,bright,6,83,2,4,0.24
10,5,broken,6,84,2,4,0.2
10,5,buddy,5,85,1,4,0.2
10,5,buffer,6,86,2,4,0.32
10,5,burden,6,87,2,4,0.2
10,5,business,8,88,2,6,0.32
10,5,cafe,4,89,0,4,0.2
10,5,cake,4,90,2,2,0.24
10,5,can,3,91,2,1,0.12
10,5,cap,3,92,2,1,0.08
10,5,capability,10,93,3,7,0.36
10,5,capable,7,94,5,2,0.2
10,5,capitalist,10,95,3,7,0.44
10,5,card,4,96,2,2,0.12
10,5,careful,7,97,3,4,0.24
10,5,carefully,9,98,7,2,0.2
10,5,cartoon,7,99,3,4,0.32
10,5,carve,5,100,3,2,0.16
10,5,cave,4,101,2,2,0.16
10,5,cd,2,102,1,1,0.08
10,5,cease,5,103,1,4,0.2
10,5,ceiling,7,104,2,5,0.36
10,5,celebrity,9,105,2,7,0.36
10,5,cemetery,8,106,2,6,0.28
10,5,central,7,107,2,5,0.28
10,5,ceremony,8,108,2,6,0.4
10,5,certain,7,109,3,4,0.24
10,5,certainty,9,110,7,2,0.24
10,5,chair,5,111,1,4,0.32
10,5,character,9,112,3,6,0.32
10,5,charming,8,113,4,4,0.24
10,5,charter,7,114,4,3,0.2
10,5,check,5,115,2,3,0.32
10,5,childhood,9,116,2,7,0.36
10,5,choir,5,117,2,3,0.24
10,5,choose,6,118,3,3,0.2
10,5,chop,4,119,3,1,0.12
10,5,cite,4,120,1,3,0.24
10,5,city,4,121,3,1,0.12
10,5,civil,5,122,2,3,0.16
10,5,clean,5,123,1,4,0.24
10,5,clearly,7,124,4,3,0.24
10,5,clinical,8,125,2,6,0.4
10,5,cloud,5,126,2,3,0.2
10,5,club,4,127,2,2,0.12
10,5,cluster,7,128,3,4,0.24
10,5,coach,5,129,1,4,0.2
10,5,coffee,6,130,2,4,0.32
10,5,coincide,8,131,2,6,0.32
10,5,collective,10,132,2,8,0.4
10,5,colony,6,133,3,3,0.28
10,5,comfort,7,134,2,5,0.28
10,5,comment,7,135,3,4,0.24
10,5,community,9,136,4,5,0.28
10,5,company,7,137,3,4,0.32
10,5,comparable,10,138,5,5,0.32
10,5,compassion,10,139,5,5,0.32
10,5,compensate,10,140,4,6,0.44
10,5,completion,10,141,4,6,0.32
10,5,comply,6,142,5,1,0.16
10,5,compulsory,10,143,4,6,0.44
10,5,conceal,7,144,2,5,0.28
10,5,conceive,8,145,5,3,0.24
10,5,concern,7,146,5,2,0.2
10,5,concert,7,147,6,1,0.28
10,5,conduct,7,148,3,4,0.24
10,5,confer,6,149,3,3,0.2
10,5,confidence,10,150,4,6,0.32
10,5,confused,8,151,4,4,0.36
10,5,connected,9,152,3,6,0.32
10,5,constraint,10,153,3,7,0.36
10,5,contrast,8,154,3,5,0.36
10,5,convey,6,155,3,3,0.2
10,5,cope,4,156,2,2,0.16
10,5,cottage,7,157,2,5,0.24
10,5,could,5,158,2,3,0.16
10,5,county,6,159,3,3,0.32
10,5,coup,4,160,3,1,0.12
10,5,course,6,161,3,3,0.2
10,5,court,5,162,4,1,0.12
10,5,coverage,8,163,2,6,0.4
10,5,creativity,10,164,1,9,0.4
10,5,creature,8,165,5,3,0.24
10,5,criminal,8,166,2,6,0.32
10,5,crowded,7,167,2,5,0.36
10,5,crucial,7,168,2,5,0.24
10,5,cruel,5,169,3,2,0.16
10,5,cry,3,170,2,1,0.08
10,5,current,7,171,1,6,0.4
10,5,curved,6,172,3,3,0.2
10,5,dam,3,173,0,3,0.16
10,5,damage,6,174,3,3,0.4
10,5,deal,4,175,1,3,0.36
10,5,death,5,176,3,2,0.36
10,5,december,8,177,2,6,0.84
10,5,declare,7,178,3,4,0.56
10,5,decoration,10,179,3,7,0.84
10,5,decrease,8,180,3,5,0.8
10,5,deed,4,181,2,2,0.32
10,5,deem,4,182,3,1,0.28
10,5,default,7,183,2,5,0.6
10,5,definite,8,184,3,5,0.8
10,5,delight,7,185,2,5,0.6
10,5,delighted,9,186,7,2,0.52
10,5,deliver,7,187,4,3,0.48
10,5,demon,5,188,2,3,0.56
10,5,deposit,7,189,2,5,0.6
10,5,desktop,7,190,2,5,0.6
10,5,despite,7,191,3,4,0.56
10,5,detect,6,192,2,4,0.52
10,5,devil,5,193,2,3,0.56
10,5,diagram,7,194,1,6,0.64
10,5,dictate,7,195,2,5,0.6
10,5,dictator,8,196,6,2,0.48
10,5,dig,3,197,2,1,0.4
10,5,digital,7,198,3,4,0.56
10,5,diminish,8,199,2,6,0.68
10,5,director,8,200,2,6,0.68
10,5,dirt,4,201,3,1,0.4
10,5,dirty,5,202,4,1,0.32
10,5,discipline,10,203,2,8,0.88
10,5,disclosure,10,204,4,6,0.84
10,5,discount,8,205,4,4,0.76
10,5,discuss,7,206,4,3,0.48
10,5,discussion,10,207,7,3,0.6
10,5,display,7,208,3,4,0.68
10,5,distort,7,209,3,4,0.56
10,5,disturbing,10,210,4,6,0.76
10,5,dollar,6,211,1,5,0.56
10,5,domain,6,212,2,4,0.64
10,5,dominant,8,213,3,5,0.64
10,5,dot,3,214,2,1,0.24
10,5,download,8,215,2,6,0.68
10,5,downstairs,10,216,4,6,0.92
10,5,drama,5,217,1,4,0.48
10,5,drawing,7,218,3,4,0.56
10,5,duration,8,219,1,7,0.76
10,5,dust,4,220,2,2,0.48
10,5,ear,3,221,0,3,0.36
10,5,earth,5,222,3,2,0.36
10,5,edition,7,223,1,6,0.64
10,5,editor,6,224,4,2,0.44
10,5,effective,9,225,1,8,1.04
10,5,effort,6,226,3,3,0.48
10,5,either,6,227,1,5,0.56
10,5,elect,5,228,1,4,0.48
10,5,eleven,6,229,3,3,0.6
10,5,eliminate,9,230,2,7,0.8
10,5,embody,6,231,1,5,0.56
10,5,emergency,9,232,2,7,0.8
10,5,empirical,9,233,2,7,0.96
10,5,employer,8,234,3,5,0.64
10,5,ending,6,235,1,5,0.56
10,5,engineer,8,236,2,6,0.92
10,5,enjoyable,9,237,2,7,0.84
10,5,enormous,8,238,2,6,0.72
10,5,entrance,8,239,2,6,0.88
10,5,equipment,9,240,1,8,1.12
10,5,euro,4,241,1,3,0.68
10,5,evaluation,10,242,1,9,1.04
10,5,exact,5,243,1,4,0.8
10,5,exceed,6,244,2,4,0.52
10,5,excited,7,245,3,4,0.64
10,5,exclusive,9,246,3,6,0.76
10,5,excuse,6,247,3,3,0.64
10,5,executive,9,248,2,7,0.8
10,5,exit,4,249,2,2,0.32
10,5,expensive,9,250,2,7,0.8
10,5,experiment,10,251,4,6,0.96
10,5,expire,6,252,3,3,0.44
10,5,explicitly,10,253,3,7,0.88
10,5,explode,7,254,4,3,0.68
10,5,explosive,9,255,5,4,0.64
10,5,extensive,9,256,2,7,0.8
10,5,extent,6,257,5,1,0.48
10,5,extremist,9,258,3,6,0.76
10,5,eye,3,259,1,2,0.32
10,5,failed,6,260,0,6,0.6
10,5,fair,4,261,3,1,0.28
10,5,fairly,6,262,4,2,0.56
10,5,famous,6,263,2,4,0.52
10,5,fantastic,9,264,2,7,0.8
10,5,fantasy,7,265,6,1,0.4
10,5,fast,4,266,2,2,0.32
10,5,fasten,6,267,4,2,0.56
10,5,fee,3,268,1,2,0.28
10,5,feeding,7,269,3,4,0.56
10,5,fellow,6,270,2,4,0.52
10,5,fibre,5,271,1,4,0.6
10,5,fifty,5,272,2,3,0.4
10,5,file,4,273,2,2,0.32
10,5,firm,4,274,2,2,0.32
10,5,fix,3,275,2,1,0.24
10,5,flavour,7,276,1,6,0.64
10,5,flu,3,277,2,1,0.36
10,5,flying,6,278,2,4,0.52
10,5,folk,4,279,1,3,0.36
10,5,food,4,280,2,2,0.32
10,5,for,3,281,2,1,0.24
10,5,foreign,7,282,3,4,0.56
10,5,formation,9,283,3,6,0.88
10,5,formerly,8,284,4,4,0.6
10,5,formula,7,285,4,3,0.48
10,5,fortune,7,286,3,4,0.68
10,5,foster,6,287,2,4,0.52
10,5,fourteen,8,288,2,6,0.68
10,5,fragment,8,289,1,7,0.76
10,5,fridge,6,290,2,4,0.68
10,5,friendly,8,291,3,5,0.64
10,5,frighten,8,292,3,5,0.64
10,5,frightened,10,293,8,2,0.56
10,5,frog,4,294,2,2,0.48
10,5,full,4,295,1,3,0.36
10,5,fur,3,296,2,1,0.24
10,5,game,4,297,0,4,0.44
10,5,gene,4,298,1,3,0.44
10,5,geography,9,299,2,7,0.92
10,5,give,4,300,1,3,0.36
10,5,glass,5,301,1,4,0.48
10,5,glimpse,7,302,2,5,0.6
10,5,god,3,303,1,2,0.28
10,5,gold,4,304,2,2,0.48
10,5,golf,4,305,3,1,0.28
10,5,good,4,306,2,2,0.32
10,5,goodbye,7,307,4,3,0.48
10,5,govern,6,308,2,4,0.56
10,5,grace,5,309,1,4,0.48
10,5,gravity,7,310,3,4,0.72
10,5,green,5,311,2,3,0.44
10,5,grind,5,312,2,3,0.4
10,5,growth,6,313,2,4,0.52
10,5,guerrilla,9,314,1,8,1
10,5,guest,5,315,3,2,0.36
10,5,guidance,8,316,2,6,0.68
10,5,hair,4,317,0,4,0.44
10,5,handful,7,318,2,5,0.76
10,5,happen,6,319,2,4,0.52
10,5,harsh,5,320,2,3,0.4
10,5,harvest,7,321,3,4,0.56
10,5,hat,3,322,2,1,0.24
10,5,hate,4,323,3,1,0.4
10,5,hazard,6,324,2,4,0.52
10,5,heighten,8,325,1,7,0.76
10,5,herb,4,326,2,2,0.32
10,5,hers,4,327,3,1,0.28
10,5,hesitate,8,328,2,6,0.84
10,5,highlight,9,329,1,8,0.84
10,5,historical,10,330,2,8,0.88
10,5,holiday,7,331,1,6,0.8
10,5,horrible,8,332,2,6,0.68
10,5,horror,6,333,4,2,0.4
10,5,household,9,334,2,7,0.8
10,5,humour,6,335,1,5,0.72
10,5,hunt,4,336,2,2,0.32
10,5,hydrogen,8,337,1,7,0.76
10,5,i,1,338,0,1,0.16
10,5,ideal,5,339,1,4,0.48
10,5,ill,3,340,1,2,0.76
10,5,imaginary,9,341,1,8,1.8800000000000001
10,5,import,6,342,2,4,1.08
10,5,improve,7,343,3,4,1.8
10,5,include,7,344,1,6,1.04
10,5,inclusion,9,345,5,4,1.04
10,5,incorrect,9,346,3,6,1.28
10,5,indirect,8,347,2,6,1.72
10,5,individual,10,348,4,6,0.92
10,5,infant,6,349,2,4,0.6
10,5,inherent,8,350,2,6,0.88
10,5,initiate,8,351,2,6,0.68
10,5,inject,6,352,2,4,0.52
10,5,injury,6,353,3,3,0.44
10,5,insert,6,354,2,4,0.6
10,5,insertion,9,355,6,3,0.64
10,5,inspection,10,356,3,7,0.88
10,5,instant,7,357,3,4,0.68
10,5,instruct,8,358,4,4,0.6
10,5,intake,6,359,2,4,0.52
10,5,intense,7,360,3,4,0.56
10,5,invade,6,361,2,4,0.52
10,5,involve,7,362,3,4,0.64
10,5,island,6,363,1,5,0.56
10,5,isolated,8,364,2,6,0.8
10,5,issue,5,365,2,3,0.44
10,5,journalism,10,366,0,10,1.12
10,5,judicial,8,367,1,7,0.76
10,5,june,4,368,2,2,0.36
10,5,just,4,369,2,2,0.32
10,5,kick,4,370,0,4,0.56
10,5,kid,3,371,2,1,0.24
10,5,king,4,372,2,2,0.32
10,5,kingdom,7,373,4,3,0.4
10,5,kit,3,374,2,1,0.16
10,5,knife,5,375,1,4,0.24
10,5,know,4,376,2,2,0.2
10,5,lap,3,377,0,3,0.16
10,5,latest,6,378,2,4,0.24
10,5,law,3,379,2,1,0.12
10,5,leading,7,380,1,6,0.28
10,5,leaf,4,381,3,1,0.2
10,5,league,6,382,3,3,0.2
10,5,left,4,383,2,2,0.16
10,5,legendary,9,384,2,7,0.36
10,5,lethal,6,385,2,4,0.24
10,5,letter,6,386,3,3,0.28
10,5,lifestyle,9,387,1,8,0.4
10,5,limb,4,388,2,2,0.16
10,5,lion,4,389,2,2,0.12
10,5,literary,8,390,2,6,0.36
10,5,literature,10,391,6,4,0.28
10,5,little,6,392,3,3,0.2
10,5,live,4,393,2,2,0.16
10,5,log,3,394,1,2,0.12
10,5,lonely,6,395,2,4,0.32
10,5,look,4,396,2,2,0.16
10,5,loose,5,397,3,2,0.16
10,5,lot,3,398,2,1,0.12
10,5,low,3,399,2,1,0.12
10,5,lunch,5,400,1,4,0.2
10,5,machinery,9,401,0,9,0.44
10,5,main,4,402,2,2,0.16
10,5,mandate,7,403,2,5,0.28
10,5,mandatory,9,404,6,3,0.32
10,5,manuscript,10,405,3,7,0.36
10,5,map,3,406,2,1,0.08
10,5,mark,4,407,2,2,0.16
10,5,meal,4,408,1,3,0.16
10,5,mechanical,10,409,2,8,0.44
10,5,medication,10,410,2,8,0.4
10,5,melody,6,411,2,4,0.24
10,5,mentor,6,412,2,4,0.28
10,5,merely,6,413,2,4,0.24
10,5,merger,6,414,3,3,0.2
10,5,metre,5,415,2,3,0.2
10,5,midnight,8,416,1,7,0.32
10,5,mirror,6,417,2,4,0.28
10,5,mixed,5,418,2,3,0.16
10,5,mobilize,8,419,1,7,0.32
10,5,modify,6,420,2,4,0.24
10,5,money,5,421,2,3,0.24
10,5,monthly,7,422,3,4,0.24
10,5,most,4,423,2,2,0.12
10,5,mouth,5,424,2,3,0.2
10,5,much,4,425,1,3,0.16
10,5,multiple,8,426,2,6,0.36
10,5,museum,6,427,2,4,0.2
10,5,musician,8,428,3,5,0.28
10,5,myth,4,429,1,3,0.16
10,5,name,4,430,0,4,0.24
10,5,narrative,9,431,2,7,0.36
10,5,nasty,5,432,2,3,0.2
10,5,nation,6,433,2,4,0.24
10,5,nationwide,10,434,6,4,0.36
10,5,necessary,9,435,1,8,0.36
10,5,neutral,7,436,2,5,0.28
10,5,newly,5,437,2,3,0.16
10,5,noise,5,438,1,4,0.28
10,5,nominate,8,439,2,6,0.32
10,5,nomination,10,440,7,3,0.28
10,5,nothing,7,441,2,5,0.28
10,5,notice,6,442,3,3,0.24
10,5,notion,6,443,4,2,0.16
10,5,numerous,8,444,1,7,0.32
10,5,nut,3,445,2,1,0.08
10,5,obesity,7,446,0,7,0.4
10,5,obsess,6,447,2,4,0.24
10,5,off,3,448,1,2,0.12
10,5,offensive,9,449,3,6,0.32
10,5,official,8,450,3,5,0.36
10,5,one,3,451,1,2,0.12
10,5,online,6,452,2,4,0.2
10,5,opponent,8,453,1,7,0.36
10,5,opposed,7,454,4,3,0.2
10,5,optimistic,10,455,2,8,0.48
10,5,organic,7,456,1,6,0.28
10,5,organized,9,457,6,3,0.24
10,5,organizer,9,458,8,1,0.28
10,5,originate,9,459,2,7,0.36
10,5,other,5,460,1,4,0.2
10,5,otherwise,9,461,5,4,0.32
10,5,ought,5,462,1,4,0.2
10,5,outdoor,7,463,2,5,0.24
10,5,outfit,6,464,3,3,0.2
10,5,outlet,6,465,3,3,0.2
10,5,outlook,7,466,4,3,0.28
10,5,owe,3,467,1,2,0.12
10,5,pace,4,468,0,4,0.2
10,5,palace,6,469,2,4,0.2
10,5,pants,5,470,2,3,0.16
10,5,parade,6,471,2,4,0.28
10,5,parallel,8,472,4,4,0.24
10,5,partial,7,473,3,4,0.24
10,5,passport,8,474,2,6,0.32
10,5,patron,6,475,2,4,0.28
10,5,pause,5,476,2,3,0.2
10,5,peace,5,477,1,4,0.2
10,5,peaceful,8,478,5,3,0.24
10,5,peer,4,479,2,2,0.16
10,5,perceive,8,480,2,6,0.36
10,5,persistent,10,481,3,7,0.36
10,5,physician,9,482,1,8,0.36
10,5,picture,7,483,1,6,0.36
10,5,pig,3,484,2,1,0.08
10,5,pioneer,7,485,2,5,0.24
10,5,pipe,4,486,2,2,0.16
10,5,plan,4,487,1,3,0.16
10,5,plane,5,488,4,1,0.24
10,5,planning,8,489,4,4,0.24
10,5,plant,5,490,4,1,0.16
10,5,plead,5,491,2,3,0.2
10,5,pleased,7,492,4,3,0.28
10,5,pledge,6,493,3,3,0.2
10,5,political,9,494,1,8,0.36
10,5,pollution,9,495,3,6,0.4
10,5,portion,7,496,2,5,0.44
10,5,possess,7,497,2,5,0.28
10,5,post,4,498,3,1,0.16
10,5,prayer,6,499,1,5,0.28
10,5,precise,7,500,2,5,0.32
10,5,predict,7,501,3,4,0.24
10,5,prediction,10,502,7,3,0.28
10,5,pregnant,8,503,3,5,0.28
10,5,premier,7,504,3,4,0.32
10,5,prescribe,9,505,3,6,0.32
10,5,prevention,10,506,3,7,0.36
10,5,previously,10,507,4,6,0.4
10,5,principle,9,508,2,7,0.36
10,5,printing,8,509,4,4,0.24
10,5,process,7,510,2,5,0.36
10,5,processing,10,511,7,3,0.32
10,5,processor,9,512,7,2,0.28
10,5,product,7,513,3,4,0.28
10,5,proper,6,514,3,3,0.28
10,5,propose,7,515,4,3,0.24
10,5,prosecute,9,516,3,6,0.32
10,5,pupil,5,517,1,4,0.24
10,5,pure,4,518,2,2,0.2
10,5,purpose,7,519,3,4,0.24
10,5,pursuit,7,520,3,4,0.24
10,5,quality,7,521,0,7,0.32
10,5,quantity,8,522,3,5,0.36
10,5,query,5,523,2,3,0.16
10,5,quest,5,524,3,2,0.16
10,5,quite,5,525,2,3,0.16
10,5,radar,5,526,0,5,0.24
10,5,railway,7,527,2,5,0.32
10,5,raise,5,528,3,2,0.16
10,5,rally,5,529,2,3,0.16
10,5,rather,6,530,2,4,0.24
10,5,react,5,531,1,4,0.2
10,5,realistic,9,532,3,6,0.36
10,5,rear,4,533,3,1,0.12
10,5,rebel,5,534,2,3,0.2
10,5,recommend,9,535,2,7,0.36
10,5,recording,9,536,4,5,0.36
10,5,recount,7,537,4,3,0.24
10,5,recycle,7,538,3,4,0.24
10,5,regime,6,539,2,4,0.28
10,5,region,6,540,4,2,0.16
10,5,regional,8,541,6,2,0.2
10,5,rejection,9,542,2,7,0.36
10,5,relax,5,543,2,3,0.24
10,5,relieved,8,544,3,5,0.28
10,5,religious,9,545,4,5,0.28
10,5,remainder,9,546,2,7,0.36
10,5,remind,6,547,3,3,0.24
10,5,removal,7,548,3,4,0.24
10,5,remove,6,549,5,1,0.16
10,5,renew,5,550,2,3,0.16
10,5,repeat,6,551,2,4,0.28
10,5,republic,8,552,3,5,0.28
10,5,research,8,553,2,6,0.32
10,5,reside,6,554,3,3,0.2
10,5,residue,7,555,5,2,0.24
10,5,respective,10,556,3,7,0.36
10,5,rest,4,557,3,1,0.12
10,5,retire,6,558,2,4,0.2
10,5,retirement,10,559,6,4,0.36
10,5,reveal,6,560,2,4,0.2
10,5,revenge,7,561,4,3,0.2
10,5,revise,6,562,3,3,0.2
10,5,revision,8,563,5,3,0.28
10,5,revive,6,564,4,2,0.16
10,5,rifle,5,565,1,4,0.2
10,5,rip,3,566,2,1,0.08
10,5,rise,4,567,2,2,0.12
10,5,rival,5,568,2,3,0.2
10,5,robust,6,569,1,5,0.28
10,5,romance,7,570,2,5,0.28
10,5,roof,4,571,2,2,0.12
10,5,root,4,572,3,1,0.12
10,5,round,5,573,2,3,0.16
10,5,routine,7,574,3,4,0.32
10,5,rub,3,575,1,2,0.12
10,5,sacred,6,576,0,6,0.24
10,5,safe,4,577,2,2,0.12
10,5,salt,4,578,2,2,0.16
10,5,sample,6,579,2,4,0.28
10,5,satellite,9,580,2,7,0.36
10,5,satisfied,9,581,3,6,0.32
10,5,scan,4,582,1,3,0.16
10,5,scattered,9,583,3,6,0.4
10,5,scheme,6,584,2,4,0.2
10,5,school,6,585,3,3,0.2
10,5,scientific,10,586,2,8,0.44
10,5,scientist,9,587,7,2,0.24
10,5,seal,4,588,1,3,0.16
10,5,second,6,589,2,4,0.2
10,5,secret,6,590,3,3,0.2
10,5,secretary,9,591,6,3,0.32
10,5,seem,4,592,2,2,0.12
10,5,seminar,7,593,2,5,0.28
10,5,sensible,8,594,2,6,0.32
10,5,serious,7,595,2,5,0.32
10,5,serve,5,596,3,2,0.16
10,5,severely,8,597,2,6,0.28
10,5,sexual,6,598,2,4,0.24
10,5,sexy,4,599,3,1,0.2
10,5,shallow,7,600,1,6,0.28
10,5,shape,5,601,3,2,0.16
10,5,share,5,602,3,2,0.16
10,5,shell,5,603,2,3,0.16
10,5,shiny,5,604,2,3,0.24
10,5,ship,4,605,3,1,0.12
10,5,shoot,5,606,2,3,0.16
10,5,shore,5,607,3,2,0.16
10,5,shortly,7,608,4,3,0.2
10,5,signature,9,609,1,8,0.4
10,5,similarly,9,610,2,7,0.36
10,5,simply,6,611,3,3,0.2
10,5,sink,4,612,2,2,0.12
10,5,sister,6,613,2,4,0.28
10,5,sit,3,614,2,1,0.08
10,5,situated,8,615,3,5,0.28
10,5,ski,3,616,1,2,0.12
10,5,skull,5,617,2,3,0.16
10,5,slice,5,618,1,4,0.28
10,5,smile,5,619,1,4,0.2
10,5,snow,4,620,1,3,0.16
10,5,solar,5,621,1,4,0.24
10,5,some,4,622,2,2,0.16
10,5,someone,7,623,4,3,0.32
10,5,something,9,624,4,5,0.28
10,5,sometimes,9,625,5,4,0.28
10,5,song,4,626,2,2,0.12
10,5,south,5,627,2,3,0.24
10,5,space,5,628,1,4,0.2
10,5,specialist,10,629,2,8,0.4
10,5,specify,7,630,5,2,0.2
10,5,speech,6,631,3,3,0.24
10,5,spotlight,9,632,2,7,0.36
10,5,stab,4,633,1,3,0.16
10,5,stand,5,634,3,2,0.16
10,5,star,4,635,3,1,0.12
10,5,steer,5,636,2,3,0.24
10,5,stem,4,637,3,1,0.12
10,5,stereotype,10,638,3,7,0.36
10,5,stick,5,639,2,3,0.16
10,5,sticky,6,640,5,1,0.16
10,5,storage,7,641,2,5,0.32
10,5,story,5,642,4,1,0.12
10,5,strange,7,643,2,5,0.24
10,5,strategy,8,644,4,4,0.24
10,5,strength,8,645,3,5,0.32
10,5,stretch,7,646,4,3,0.2
10,5,strong,6,647,3,3,0.2
10,5,stumble,7,648,2,5,0.24
10,5,stun,4,649,3,1,0.16
10,5,substance,9,650,1,8,0.36
10,5,successful,10,651,2,8,0.4
10,5,such,4,652,3,1,0.12
10,5,sue,3,653,2,1,0.16
10,5,supreme,7,654,2,5,0.24
10,5,sure,4,655,2,2,0.16
10,5,swear,5,656,1,4,0.2
10,5,sweater,7,657,4,3,0.2
10,5,sweep,5,658,3,2,0.2
10,5,symbolic,8,659,1,7,0.32
10,5,sympathy,8,660,3,5,0.28
10,5,symptom,7,661,4,3,0.2
10,5,synthesis,9,662,2,7,0.4
10,5,tail,4,663,0,4,0.2
10,5,tale,4,664,2,2,0.12
10,5,talent,6,665,4,2,0.16
10,5,tank,4,666,2,2,0.12
10,5,taxi,4,667,2,2,0.2
10,5,television,10,668,1,9,0.4
10,5,tempt,5,669,2,3,0.16
10,5,tendency,8,670,2,6,0.32
10,5,tender,6,671,5,1,0.2
10,5,tension,7,672,3,4,0.24
10,5,terribly,8,673,2,6,0.32
10,5,terrific,8,674,5,3,0.24
10,5,terrify,7,675,6,1,0.24
10,5,textbook,8,676,2,6,0.32
10,5,texture,7,677,4,3,0.24
10,5,themselves,10,678,1,9,0.48
10,5,thirsty,7,679,2,5,0.24
10,5,thoughtful,10,680,2,8,0.36
10,5,ticket,6,681,1,5,0.24
10,5,tidy,4,682,2,2,0.2
10,5,till,4,683,2,2,0.12
10,5,together,8,684,1,7,0.32
10,5,tonne,5,685,2,3,0.2
10,5,too,3,686,2,1,0.12
10,5,topic,5,687,2,3,0.24
10,5,tournament,10,688,2,8,0.4
10,5,trademark,9,689,1,8,0.4
10,5,tragic,6,690,3,3,0.28
10,5,trainer,7,691,3,4,0.28
10,5,transcript,10,692,3,7,0.44
10,5,trap,4,693,3,1,0.12
10,5,tree,4,694,2,2,0.16
10,5,tribal,6,695,2,4,0.32
10,5,tribe,5,696,4,1,0.16
10,5,trio,4,697,3,1,0.12
10,5,tropical,8,698,2,6,0.32
10,5,trouble,7,699,3,4,0.32
10,5,trousers,8,700,4,4,0.28
10,5,truck,5,701,2,3,0.2
10,5,ultimate,8,702,0,8,0.36
10,5,undergo,7,703,1,6,0.36
10,5,underwear,9,704,5,4,0.68
10,5,unfair,6,705,2,4,0.52
10,5,unify,5,706,2,3,0.4
10,5,union,5,707,3,2,0.36
10,5,unique,6,708,3,3,0.56
10,5,universal,9,709,3,6,0.72
10,5,until,5,710,2,3,0.4
10,5,unusual,7,711,2,5,0.6
10,5,unveil,6,712,2,4,0.68
10,5,upgrade,7,713,1,6,0.68
10,5,urban,5,714,1,4,0.48
10,5,usage,5,715,1,4,0.48
10,5,usual,5,716,2,3,0.56
10,5,vague,5,717,0,5,0.56
10,5,validity,8,718,2,6,0.8
10,5,valuable,8,719,3,5,0.76
10,5,variety,7,720,2,5,0.72
10,5,vary,4,721,3,1,0.28
10,5,vegetable,9,722,1,8,0.84
10,5,vein,4,723,2,2,0.36
10,5,venture,7,724,2,5,0.72
10,5,verify,6,725,2,4,0.52
10,5,vessel,6,726,2,4,0.52
10,5,video,5,727,1,4,0.48
10,5,villager,8,728,2,6,0.72
10,5,virtual,7,729,2,5,0.72
10,5,visitor,7,730,2,5,0.6
10,5,vocal,5,731,1,4,0.48
10,5,voice,5,732,2,3,0.44
10,5,volunteer,9,733,2,7,0.92
10,5,warning,7,734,0,7,0.72
10,5,warrior,7,735,3,4,0.56
10,5,water,5,736,2,3,0.4
10,5,way,3,737,2,1,0.32
10,5,weapon,6,738,1,5,0.56
10,5,weird,5,739,2,3,0.44
10,5,welcome,7,740,2,5,0.6
10,5,welfare,7,741,3,4,0.68
10,5,west,4,742,2,2,0.56
10,5,whenever,8,743,1,7,0.84
10,5,whereas,7,744,3,4,0.56
10,5,which,5,745,2,3,0.44
10,5,width,5,746,1,4,0.56
10,5,willing,7,747,2,5,0.6
10,5,wind,4,748,2,2,0.32
10,5,word,4,749,1,3,0.36
10,5,work,4,750,3,1,0.28
10,5,workplace,9,751,4,5,0.92
10,5,worry,5,752,3,2,0.4
10,5,wow,3,753,2,1,0.24
10,5,wrist,5,754,1,4,0.48
10,6,a,1,0,0,1,0.16
10,6,absolutely,10,1,1,9,1.04
10,6,absurd,6,2,3,3,0.44
10,6,academic,8,3,1,7,0.76
10,6,acceptable,10,4,2,8,0.88
10,6,accident,8,5,3,5,0.76
10,6,accompany,9,6,3,6,0.72
10,6,acid,4,7,2,2,0.32
10,6,acre,4,8,2,2,0.32
10,6,actress,7,9,2,5,0.72
10,6,adaptation,10,10,1,9,0.92
10,6,adj,3,11,2,1,0.24
10,6,adjacent,8,12,3,5,0.64
10,6,adoption,8,13,2,6,0.8
10,6,adventure,9,14,2,7,0.8
10,6,aftermath,9,15,1,8,0.84
10,6,afterwards,10,16,5,5,0.84
10,6,against,7,17,1,6,0.64
10,6,aids,4,18,1,3,0.36
10,6,ally,4,19,1,3,0.36
10,6,ambulance,9,20,1,8,0.96
10,6,amendment,9,21,2,7,0.8
10,6,analysis,8,22,1,7,0.76
10,6,ancient,7,23,2,5,0.72
10,6,ankle,5,24,2,3,0.4
10,6,announce,8,25,2,6,0.68
10,6,another,7,26,2,5,0.6
10,6,anxiety,7,27,2,5,0.72
10,6,anybody,7,28,2,5,0.6
10,6,apologize,9,29,1,8,0.84
10,6,apparently,10,30,2,8,1
10,6,applaud,7,31,3,4,0.56
10,6,appreciate,10,32,3,7,0.88
10,6,approve,7,33,4,3,0.68
10,6,arguably,8,34,1,7,1.08
10,6,arms,4,35,2,2,0.48
10,6,around,6,36,2,4,0.56
10,6,arrow,5,37,2,3,0.4
10,6,assessment,10,38,1,9,1.16
10,6,assistant,9,39,3,6,0.92
10,6,atrocity,8,40,1,7,0.8
10,6,attachment,10,41,2,8,0.56
10,6,attract,7,42,3,4,0.24
10,6,auction,7,43,1,6,0.28
10,6,baby,4,44,0,4,0.2
10,6,backing,7,45,2,5,0.32
10,6,bacteria,8,46,3,5,0.28
10,6,banner,6,47,2,4,0.24
10,6,barrel,6,48,2,4,0.2
10,6,base,4,49,2,2,0.2
10,6,bath,4,50,2,2,0.12
10,6,behave,6,51,1,5,0.24
10,6,bell,4,52,2,2,0.12
10,6,best,4,53,2,2,0.16
10,6,betray,6,54,2,4,0.28
10,6,between,7,55,3,4,0.24
10,6,bill,4,56,1,3,0.16
10,6,bin,3,57,2,1,0.08
10,6,biscuit,7,58,2,5,0.24
10,6,bitter,6,59,2,4,0.28
10,6,bizarre,7,60,2,5,0.28
10,6,blade,5,61,1,4,0.2
10,6,blame,5,62,3,2,0.16
10,6,blind,5,63,2,3,0.2
10,6,blog,4,64,2,2,0.2
10,6,blow,4,65,3,1,0.12
10,6,boot,4,66,1,3,0.16
10,6,bother,6,67,2,4,0.2
10,6,bottle,6,68,3,3,0.2
10,6,boundary,8,69,2,6,0.36
10,6,boyfriend,9,70,2,7,0.32
10,6,brand,5,71,1,4,0.2
10,6,breach,6,72,2,4,0.2
10,6,break,5,73,4,1,0.24
10,6,breakdown,9,74,5,4,0.28
10,6,breathe,7,75,4,3,0.24
10,6,bridge,6,76,2,4,0.24
10,6,buddy,5,77,1,4,0.28
10,6,buffer,6,78,2,4,0.24
10,6,build,5,79,2,3,0.16
10,6,burn,4,80,2,2,0.16
10,6,business,8,81,2,6,0.28
10,6,butter,6,82,2,4,0.28
10,6,cancer,6,83,0,6,0.28
10,6,cap,3,84,2,1,0.08
10,6,capable,7,85,3,4,0.24
10,6,capitalist,10,86,3,7,0.44
10,6,carefully,9,87,2,7,0.32
10,6,carpet,6,88,3,3,0.2
10,6,cartoon,7,89,3,4,0.24
10,6,category,8,90,2,6,0.4
10,6,cave,4,91,2,2,0.12
10,6,cease,5,92,1,4,0.2
10,6,ceiling,7,93,2,5,0.28
10,6,century,7,94,2,5,0.32
10,6,ceremony,8,95,2,6,0.32
10,6,certain,7,96,3,4,0.24
10,6,challenge,9,97,1,8,0.36
10,6,chapter,7,98,3,4,0.32
10,6,charm,5,99,3,2,0.16
10,6,cheerful,8,100,2,6,0.32
10,6,childhood,9,101,2,7,0.4
10,6,choir,5,102,2,3,0.2
10,6,chronic,7,103,2,5,0.24
10,6,chunk,5,104,2,3,0.2
10,6,circuit,7,105,1,6,0.28
10,6,cite,4,106,2,2,0.2
10,6,clause,6,107,1,5,0.24
10,6,clean,5,108,2,3,0.2
10,6,clerk,5,109,3,2,0.16
10,6,clinical,8,110,2,6,0.28
10,6,closely,7,111,2,5,0.32
10,6,cluster,7,112,2,5,0.32
10,6,coffee,6,113,1,5,0.24
10,6,coincide,8,114,2,6,0.36
10,6,collection,10,115,2,8,0.36
10,6,comfort,7,116,2,5,0.24
10,6,commission,10,117,3,7,0.44
10,6,company,7,118,3,4,0.24
10,6,compensate,10,119,4,6,0.32
10,6,compete,7,120,5,2,0.2
10,6,completion,10,121,4,6,0.4
10,6,comply,6,122,5,1,0.16
10,6,component,9,123,4,5,0.28
10,6,compulsory,10,124,4,6,0.4
10,6,conceal,7,125,2,5,0.28
10,6,concept,7,126,5,2,0.2
10,6,concern,7,127,5,2,0.2
10,6,conclusion,10,128,4,6,0.4
10,6,conduct,7,129,3,4,0.24
10,6,confer,6,130,3,3,0.24
10,6,conference,10,131,6,4,0.28
10,6,confess,7,132,5,2,0.24
10,6,confused,8,133,4,4,0.28
10,6,constantly,10,134,3,7,0.36
10,6,contrast,8,135,3,5,0.36
10,6,convenient,10,136,3,7,0.36
10,6,conversion,10,137,5,5,0.32
10,6,cooker,6,138,2,4,0.28
10,6,cope,4,139,2,2,0.12
10,6,correctly,9,140,2,7,0.32
10,6,cost,4,141,2,2,0.12
10,6,cottage,7,142,2,5,0.28
10,6,counter,7,143,2,5,0.32
10,6,coup,4,144,3,1,0.12
10,6,couple,6,145,4,2,0.16
10,6,coverage,8,146,2,6,0.28
10,6,craft,5,147,1,4,0.28
10,6,create,6,148,2,4,0.2
10,6,creature,8,149,5,3,0.24
10,6,criminal,8,150,2,6,0.28
10,6,crisis,6,151,3,3,0.28
10,6,cross,5,152,2,3,0.2
10,6,crowded,7,153,3,4,0.24
10,6,crucial,7,154,2,5,0.28
10,6,crude,5,155,3,2,0.16
10,6,cruise,6,156,3,3,0.24
10,6,current,7,157,1,6,0.28
10,6,curved,6,158,3,3,0.2
10,6,cycle,5,159,1,4,0.2
10,6,dam,3,160,0,3,0.16
10,6,dare,4,161,2,2,0.2
10,6,december,8,162,1,7,0.32
10,6,decline,7,163,3,4,0.24
10,6,decrease,8,164,3,5,0.28
10,6,default,7,165,2,5,0.32
10,6,definitely,10,166,3,7,0.36
10,6,delight,7,167,2,5,0.24
10,6,deliver,7,168,4,3,0.28
10,6,democracy,9,169,2,7,0.32
10,6,demon,5,170,4,1,0.12
10,6,deposit,7,171,2,5,0.28
10,6,depression,10,172,3,7,0.44
10,6,deputy,6,173,3,3,0.2
10,6,despite,7,174,2,5,0.24
10,6,detention,9,175,2,7,0.4
10,6,diagnosis,9,176,1,8,0.36
10,6,dictator,8,177,2,6,0.28
10,6,diminish,8,178,2,6,0.36
10,6,diplomat,8,179,2,6,0.36
10,6,diplomatic,10,180,8,2,0.24
10,6,director,8,181,2,6,0.28
10,6,dirt,4,182,3,1,0.2
10,6,disastrous,10,183,2,8,0.4
10,6,discipline,10,184,3,7,0.36
10,6,disclosure,10,185,4,6,0.4
10,6,discretion,10,186,4,6,0.32
10,6,discuss,7,187,4,3,0.2
10,6,distant,7,188,3,4,0.24
10,6,distribute,10,189,4,6,0.4
10,6,divine,6,190,2,4,0.24
10,6,divorced,8,191,3,5,0.28
10,6,dominant,8,192,1,7,0.4
10,6,dot,3,193,2,1,0.12
10,6,double,6,194,2,4,0.2
10,6,download,8,195,2,6,0.32
10,6,downstairs,10,196,4,6,0.4
10,6,drama,5,197,1,4,0.2
10,6,drawing,7,198,3,4,0.24
10,6,drink,5,199,2,3,0.16
10,6,dust,4,200,1,3,0.16
10,6,ear,3,201,0,3,0.24
10,6,earth,5,202,3,2,0.16
10,6,eight,5,203,1,4,0.2
10,6,elect,5,204,1,4,0.2
10,6,eleven,6,205,3,3,0.2
10,6,eliminate,9,206,2,7,0.4
10,6,elsewhere,9,207,2,7,0.32
10,6,emotion,7,208,1,6,0.28
10,6,empirical,9,209,2,7,0.4
10,6,employer,8,210,3,5,0.28
10,6,empower,7,211,3,4,0.24
10,6,enable,6,212,1,5,0.24
10,6,endless,7,213,2,5,0.32
10,6,enemy,5,214,2,3,0.16
10,6,engineer,8,215,2,6,0.32
10,6,enjoyable,9,216,2,7,0.32
10,6,enrich,6,217,2,4,0.28
10,6,enter,5,218,2,3,0.2
10,6,enterprise,10,219,5,5,0.32
10,6,entitle,7,220,3,4,0.24
10,6,entrance,8,221,3,5,0.36
10,6,entry,5,222,4,1,0.12
10,6,erect,5,223,1,4,0.2
10,6,evaluation,10,224,1,9,0.64
10,6,event,5,225,2,3,0.2
10,6,evidence,8,226,2,6,0.28
10,6,exact,5,227,1,4,0.2
10,6,examine,7,228,3,4,0.24
10,6,exciting,8,229,2,6,0.4
10,6,exclusive,9,230,3,6,0.32
10,6,execution,9,231,2,7,0.36
10,6,exhibition,10,232,2,8,0.48
10,6,exit,4,233,2,2,0.16
10,6,experiment,10,234,2,8,0.4
10,6,expertise,9,235,5,4,0.36
10,6,explain,7,236,3,4,0.24
10,6,explicitly,10,237,4,6,0.32
10,6,explode,7,238,4,3,0.2
10,6,exploit,7,239,5,2,0.24
10,6,extent,6,240,2,4,0.24
10,6,fail,4,241,0,4,0.2
10,6,failure,7,242,4,3,0.2
10,6,fair,4,243,3,1,0.12
10,6,fall,4,244,2,2,0.2
10,6,fast,4,245,2,2,0.12
10,6,fat,3,246,2,1,0.12
10,6,fear,4,247,1,3,0.16
10,6,fibre,5,248,1,4,0.2
10,6,file,4,249,2,2,0.16
10,6,finally,7,250,2,5,0.32
10,6,financial,9,251,4,5,0.28
10,6,fine,4,252,3,1,0.12
10,6,fix,3,253,2,1,0.08
10,6,fixture,7,254,3,4,0.28
10,6,flag,4,255,1,3,0.16
10,6,flee,4,256,2,2,0.16
10,6,flexible,8,257,3,5,0.28
10,6,flourish,8,258,2,6,0.32
10,6,folk,4,259,1,3,0.24
10,6,for,3,260,2,1,0.12
10,6,foreign,7,261,3,4,0.24
10,6,foreigner,9,262,7,2,0.24
10,6,formation,9,263,3,6,0.4
10,6,former,6,264,4,2,0.16
10,6,foster,6,265,2,4,0.2
10,6,founder,7,266,2,5,0.24
10,6,fourteen,8,267,3,5,0.36
10,6,fridge,6,268,1,5,0.24
10,6,friendship,10,269,3,7,0.36
10,6,frighten,8,270,3,5,0.28
10,6,frightened,10,271,8,2,0.32
10,6,front,5,272,2,3,0.2
10,6,full,4,273,1,3,0.16
10,6,fur,3,274,2,1,0.08
10,6,game,4,275,0,4,0.2
10,6,garage,6,276,2,4,0.28
10,6,gene,4,277,1,3,0.16
10,6,general,7,278,4,3,0.2
10,6,generally,9,279,7,2,0.2
10,6,genetic,7,280,4,3,0.28
10,6,geography,9,281,2,7,0.36
10,6,give,4,282,1,3,0.16
10,6,glimpse,7,283,1,6,0.28
10,6,globe,5,284,2,3,0.24
10,6,gold,4,285,1,3,0.16
10,6,golf,4,286,3,1,0.12
10,6,goodbye,7,287,2,5,0.28
10,6,governor,8,288,2,6,0.28
10,6,grade,5,289,1,4,0.28
10,6,green,5,290,2,3,0.16
10,6,greet,5,291,4,1,0.12
10,6,grid,4,292,2,2,0.12
10,6,grin,4,293,3,1,0.12
10,6,ground,6,294,2,4,0.28
10,6,guide,5,295,1,4,0.2
10,6,guitar,6,296,3,3,0.2
10,6,hair,4,297,0,4,0.2
10,6,handful,7,298,2,5,0.24
10,6,harvest,7,299,2,5,0.32
10,6,hat,3,300,2,1,0.12
10,6,hate,4,301,3,1,0.12
10,6,hazard,6,302,2,4,0.24
10,6,headline,8,303,1,7,0.32
10,6,health,6,304,3,3,0.28
10,6,heart,5,305,3,2,0.16
10,6,heighten,8,306,2,6,0.32
10,6,her,3,307,2,1,0.08
10,6,highlight,9,308,1,8,0.44
10,6,hint,4,309,2,2,0.16
10,6,historic,8,310,2,6,0.28
10,6,holiday,7,311,1,6,0.28
10,6,honesty,7,312,2,5,0.32
10,6,hour,4,313,2,2,0.12
10,6,household,9,314,3,6,0.32
10,6,however,7,315,2,5,0.24
10,6,humour,6,316,1,5,0.32
10,6,hunger,6,317,2,4,0.2
10,6,hurricane,9,318,2,7,0.36
10,6,hydrogen,8,319,1,7,0.32
10,6,identical,9,320,0,9,0.44
10,6,identity,8,321,6,2,0.2
10,6,imagery,7,322,1,6,0.28
10,6,impatient,9,323,2,7,0.4
10,6,import,6,324,3,3,0.2
10,6,incur,5,325,1,4,0.2
10,6,inevitable,10,326,2,8,0.36
10,6,influence,9,327,2,7,0.4
10,6,info,4,328,3,1,0.12
10,6,inform,6,329,4,2,0.16
10,6,informal,8,330,6,2,0.24
10,6,inject,6,331,2,4,0.28
10,6,injure,6,332,3,3,0.2
10,6,injury,6,333,5,1,0.16
10,6,insert,6,334,2,4,0.2
10,6,inspect,7,335,3,4,0.24
10,6,inspection,10,336,7,3,0.32
10,6,instruct,8,337,3,5,0.28
10,6,instrument,10,338,6,4,0.28
10,6,intake,6,339,2,4,0.28
10,6,intense,7,340,3,4,0.24
10,6,intensify,9,341,6,3,0.24
10,6,interior,8,342,4,4,0.24
10,6,into,4,343,3,1,0.16
10,6,involve,7,344,2,5,0.24
10,6,involved,8,345,7,1,0.2
10,6,island,6,346,1,5,0.24
10,6,isolated,8,347,2,6,0.36
10,6,issue,5,348,2,3,0.16
10,6,jewellery,9,349,0,9,0.4
10,6,job,3,350,1,2,0.12
10,6,joy,3,351,2,1,0.08
10,6,june,4,352,1,3,0.24
10,6,justify,7,353,2,5,0.24
10,6,kid,3,354,0,3,0.16
10,6,kidney,6,355,3,3,0.2
10,6,king,4,356,2,2,0.16
10,6,kit,3,357,2,1,0.16
10,6,knife,5,358,1,4,0.2
10,6,lack,4,359,0,4,0.2
10,6,lad,3,360,2,1,0.08
10,6,landmark,8,361,2,6,0.56
10,6,lap,3,362,2,1,0.24
10,6,last,4,363,2,2,0.44
10,6,law,3,364,2,1,0.24
10,6,learning,8,365,1,7,0.76
10,6,left,4,366,2,2,0.32
10,6,legendary,9,367,2,7,0.8
10,6,legitimate,10,368,3,7,0.96
10,6,lesser,6,369,2,4,0.52
10,6,lethal,6,370,2,4,0.52
10,6,licence,7,371,1,6,0.8
10,6,license,7,372,5,2,0.44
10,6,lie,3,373,2,1,0.24
10,6,likelihood,10,374,2,8,0.88
10,6,limited,7,375,2,5,0.72
10,6,link,4,376,2,2,0.32
10,6,literature,10,377,2,8,0.88
10,6,little,6,378,3,3,0.44
10,6,liver,5,379,2,3,0.44
10,6,location,8,380,1,7,0.88
10,6,log,3,381,2,1,0.24
10,6,lonely,6,382,2,4,0.52
10,6,loose,5,383,2,3,0.44
10,6,lot,3,384,2,1,0.24
10,6,loudly,6,385,2,4,0.64
10,6,love,4,386,2,2,0.32
10,6,lunch,5,387,1,4,0.48
10,6,mainland,8,388,0,8,0.8
10,6,mainstream,10,389,4,6,0.92
10,6,manipulate,10,390,2,8,0.88
10,6,married,7,391,2,5,0.72
10,6,master,6,392,2,4,0.72
10,6,match,5,393,2,3,0.44
10,6,maximum,7,394,2,5,0.6
10,6,meal,4,395,1,3,0.36
10,6,mean,4,396,3,1,0.28
10,6,meanwhile,9,397,4,5,0.8
10,6,mechanical,10,398,2,8,0.88
10,6,media,5,399,2,3,0.4
10,6,medication,10,400,4,6,0.88
10,6,method,6,401,2,4,0.52
10,6,metre,5,402,3,2,0.36
10,6,midnight,8,403,1,7,0.76
10,6,militia,7,404,2,5,0.72
10,6,mind,4,405,2,2,0.32
10,6,miserable,9,406,2,7,0.8
10,6,model,5,407,1,4,0.48
10,6,modify,6,408,3,3,0.44
10,6,moment,6,409,2,4,0.64
10,6,money,5,410,2,3,0.44
10,6,monument,8,411,3,5,0.68
10,6,most,4,412,2,2,0.32
10,6,mother,6,413,2,4,0.64
10,6,mouth,5,414,2,3,0.4
10,6,mum,3,415,1,2,0.28
10,6,municipal,9,416,2,7,0.8
10,6,music,5,417,2,3,0.4
10,6,must,4,418,3,1,0.28
10,6,my,2,419,1,1,0.32
10,6,naked,5,420,0,5,0.52
10,6,name,4,421,2,2,0.44
10,6,nature,6,422,2,4,0.52
10,6,necessary,9,423,1,8,0.96
10,6,neck,4,424,3,1,0.28
10,6,negative,8,425,2,6,0.72
10,6,new,3,426,2,1,0.24
10,6,newly,5,427,3,2,0.36
10,6,night,5,428,1,4,0.48
10,6,noise,5,429,1,4,0.6
10,6,nominate,8,430,2,6,0.72
10,6,non,3,431,2,1,0.24
10,6,not,3,432,2,1,0.24
10,6,note,4,433,3,1,0.28
10,6,notion,6,434,3,3,0.56
10,6,numerous,8,435,1,7,0.76
10,6,nut,3,436,2,1,0.24
10,6,obesity,7,437,0,7,0.76
10,6,obsess,6,438,2,4,0.56
10,6,obviously,9,439,2,7,1.04
10,6,occupation,10,440,1,9,1
10,6,ocean,5,441,2,3,0.44
10,6,october,7,442,2,5,0.8
10,6,offend,6,443,1,5,0.6
10,6,offspring,9,444,3,6,0.76
10,6,once,4,445,1,3,0.4
10,6,opponent,8,446,1,7,0.92
10,6,opposed,7,447,4,3,0.52
10,6,originate,9,448,1,8,0.88
10,6,other,5,449,1,4,0.48
10,6,outdoor,7,450,1,6,0.8
10,6,outdoors,8,451,7,1,0.44
10,6,outfit,6,452,3,3,0.48
10,6,outlet,6,453,3,3,0.48
10,6,outlook,7,454,4,3,0.64
10,6,oversee,7,455,1,6,0.68
10,6,owe,3,456,1,2,0.28
10,6,pace,4,457,0,4,0.44
10,6,pad,3,458,2,1,0.24
10,6,pants,5,459,2,3,0.52
10,6,park,4,460,2,2,0.32
10,6,partial,7,461,3,4,0.56
10,6,particular,10,462,5,5,0.76
10,6,passport,8,463,2,6,0.8
10,6,password,8,464,4,4,0.6
10,6,patent,6,465,2,4,0.52
10,6,patron,6,466,3,3,0.48
10,6,pause,5,467,2,3,0.52
10,6,peculiar,8,468,1,7,0.76
10,6,perceive,8,469,2,6,0.72
10,6,persistent,10,470,3,7,0.84
10,6,personnel,9,471,4,5,0.8
10,6,philosophy,10,472,1,9,0.96
10,6,photo,5,473,2,3,0.44
10,6,physician,9,474,2,7,0.96
10,6,picture,7,475,1,6,0.68
10,6,piece,5,476,2,3,0.44
10,6,pile,4,477,2,2,0.32
10,6,pipe,4,478,2,2,0.32
10,6,plane,5,479,1,4,0.6
10,6,planning,8,480,4,4,0.6
10,6,pleased,7,481,2,5,0.6
10,6,pledge,6,482,3,3,0.88
10,6,point,5,483,1,4,0.84
10,6,pollution,9,484,2,7,0.84
10,6,pond,4,485,2,2,0.4
10,6,position,8,486,2,6,0.84
10,6,poster,6,487,3,3,0.64
10,6,pot,3,488,2,1,0.24
10,6,practical,9,489,1,8,0.88
10,6,prayer,6,490,3,3,0.44
10,6,precedent,9,491,2,7,0.92
10,6,precise,7,492,4,3,0.48
10,6,predict,7,493,3,4,0.6
10,6,prejudice,9,494,3,6,0.76
10,6,premier,7,495,3,4,0.68
10,6,premise,7,496,5,2,0.44
10,6,prescribe,9,497,3,6,0.76
10,6,presence,8,498,4,4,0.8
10,6,presently,9,499,6,3,0.6
10,6,prior,5,500,2,3,0.44
10,6,procedure,9,501,2,7,0.8
10,6,process,7,502,5,2,0.56
10,6,profound,8,503,3,5,0.64
10,6,proper,6,504,3,3,0.44
10,6,proportion,10,505,4,6,0.92
10,6,proposal,8,506,5,3,0.68
10,6,propose,7,507,6,1,0.4
10,6,prosecute,9,508,3,6,0.76
10,6,protest,7,509,3,4,0.68
10,6,publicity,9,510,1,8,0.88
10,6,pump,4,511,2,2,0.32
10,6,pupil,5,512,2,3,0.4
10,6,pursuit,7,513,2,5,0.6
10,6,push,4,514,2,2,0.44
10,6,put,3,515,2,1,0.24
10,6,quantity,8,516,0,8,0.96
10,6,query,5,517,2,3,0.48
10,6,race,4,518,0,4,0.52
10,6,racial,6,519,3,3,0.6
10,6,rating,6,520,2,4,0.52
10,6,realm,5,521,1,4,0.52
10,6,rear,4,522,3,1,0.28
10,6,reasoning,9,523,3,6,0.88
10,6,recall,6,524,2,4,0.52
10,6,recognize,9,525,3,6,0.76
10,6,recommend,9,526,4,5,0.68
10,6,recording,9,527,4,5,0.8
10,6,recount,7,528,4,3,0.52
10,6,recruit,7,529,3,4,0.56
10,6,referee,7,530,2,5,0.6
10,6,regard,6,531,2,4,0.64
10,6,regional,8,532,3,5,0.64
10,6,regulatory,10,533,3,7,0.84
10,6,reign,5,534,2,3,0.56
10,6,relaxed,7,535,2,5,0.64
10,6,relevance,9,536,3,6,0.8
10,6,relief,6,537,3,3,0.48
10,6,relieved,8,538,5,3,0.72
10,6,remainder,9,539,2,7,0.8
10,6,remark,6,540,4,2,0.44
10,6,remind,6,541,3,3,0.48
10,6,repeat,6,542,2,4,0.68
10,6,reporting,9,543,3,6,0.76
10,6,republic,8,544,3,5,0.68
10,6,reside,6,545,2,4,0.56
10,6,resolve,7,546,3,4,0.72
10,6,retail,6,547,2,4,0.52
10,6,retire,6,548,3,3,0.48
10,6,revise,6,549,2,4,0.52
10,6,right,5,550,1,4,0.6
10,6,rise,4,551,2,2,0.32
10,6,ritual,6,552,2,4,0.52
10,6,road,4,553,1,3,0.36
10,6,rob,3,554,2,1,0.24
10,6,robbery,7,555,3,4,0.56
10,6,robust,6,556,3,3,0.6
10,6,romance,7,557,2,5,0.6
10,6,round,5,558,2,3,0.4
10,6,rub,3,559,1,2,0.28
10,6,sale,4,560,0,4,0.44
10,6,satellite,9,561,2,7,0.92
10,6,satisfied,9,562,3,6,0.72
10,6,scan,4,563,1,3,0.36
10,6,scientist,9,564,2,7,0.92
10,6,score,5,565,2,3,0.44
10,6,seal,4,566,1,3,0.36
10,6,secret,6,567,2,4,0.52
10,6,secure,6,568,3,3,0.48
10,6,selective,9,569,2,7,0.92
10,6,seminar,7,570,2,5,0.6
10,6,sensible,8,571,2,6,0.44
10,6,september,9,572,2,7,0.44
10,6,serious,7,573,2,5,0.28
10,6,servant,7,574,3,4,0.24
10,6,serve,5,575,4,1,0.12
10,6,service,7,576,4,3,0.28
10,6,settlement,10,577,2,8,0.4
10,6,seven,5,578,2,3,0.16
10,6,sexual,6,579,2,4,0.24
10,6,sexy,4,580,3,1,0.12
10,6,shallow,7,581,1,6,0.36
10,6,shape,5,582,3,2,0.16
10,6,sheer,5,583,2,3,0.16
10,6,shift,5,584,2,3,0.2
10,6,shore,5,585,2,3,0.16
10,6,shortage,8,586,4,4,0.32
10,6,shortly,7,587,5,2,0.2
10,6,sibling,7,588,1,6,0.28
10,6,signature,9,589,2,7,0.4
10,6,simulation,10,590,2,8,0.36
10,6,singing,7,591,2,5,0.28
10,6,sink,4,592,3,1,0.12
10,6,sister,6,593,2,4,0.28
10,6,sit,3,594,2,1,0.08
10,6,ski,3,595,1,2,0.12
10,6,slam,4,596,1,3,0.16
10,6,slice,5,597,2,3,0.2
10,6,snow,4,598,1,3,0.16
10,6,soap,4,599,1,3,0.24
10,6,solar,5,600,2,3,0.16
10,6,solo,4,601,3,1,0.12
10,6,some,4,602,2,2,0.12
10,6,someone,7,603,4,3,0.2
10,6,something,9,604,4,5,0.36
10,6,sometimes,9,605,5,4,0.28
10,6,song,4,606,2,2,0.12
10,6,soup,4,607,2,2,0.16
10,6,south,5,608,3,2,0.16
10,6,space,5,609,1,4,0.28
10,6,spare,5,610,3,2,0.16
10,6,special,7,611,2,5,0.24
10,6,specialist,10,612,7,3,0.24
10,6,specify,7,613,5,2,0.28
10,6,sphere,6,614,2,4,0.24
10,6,spin,4,615,2,2,0.12
10,6,spokesman,9,616,2,7,0.36
10,6,spotlight,9,617,3,6,0.4
10,6,stab,4,618,1,3,0.16
10,6,staff,5,619,3,2,0.16
10,6,stall,5,620,3,2,0.16
10,6,stamp,5,621,3,2,0.16
10,6,stance,6,622,3,3,0.28
10,6,standing,8,623,4,4,0.24
10,6,star,4,624,3,1,0.12
10,6,statistic,9,625,3,6,0.32
10,6,statue,6,626,4,2,0.24
10,6,stay,4,627,3,1,0.12
10,6,steadily,8,628,2,6,0.28
10,6,steer,5,629,3,2,0.16
10,6,stick,5,630,2,3,0.16
10,6,stop,4,631,2,2,0.2
10,6,store,5,632,3,2,0.16
10,6,strange,7,633,2,5,0.28
10,6,strategic,9,634,4,5,0.28
10,6,strategy,8,635,7,1,0.24
10,6,street,6,636,3,3,0.2
10,6,stretch,7,637,4,3,0.2
10,6,strict,6,638,3,3,0.2
10,6,strike,6,639,4,2,0.16
10,6,study,5,640,2,3,0.24
10,6,stumble,7,641,3,4,0.24
10,6,stun,4,642,3,1,0.12
10,6,subject,7,643,1,6,0.28
10,6,substance,9,644,3,6,0.4
10,6,successful,10,645,2,8,0.4
10,6,such,4,646,3,1,0.12
10,6,sudden,6,647,2,4,0.2
10,6,sue,3,648,2,1,0.08
10,6,super,5,649,2,3,0.24
10,6,suppose,7,650,3,4,0.24
10,6,sure,4,651,2,2,0.16
10,6,surely,6,652,4,2,0.16
10,6,survival,8,653,3,5,0.36
10,6,swallow,7,654,1,6,0.28
10,6,swear,5,655,2,3,0.16
10,6,sweep,5,656,3,2,0.16
10,6,switch,6,657,2,4,0.2
10,6,sympathy,8,658,1,7,0.4
10,6,synthesis,9,659,2,7,0.36
10,6,tap,3,660,0,3,0.16
10,6,task,4,661,2,2,0.12
10,6,taxi,4,662,2,2,0.12
10,6,tea,3,663,1,2,0.2
10,6,television,10,664,2,8,0.36
10,6,tendency,8,665,2,6,0.32
10,6,tender,6,666,5,1,0.16
10,6,tension,7,667,3,4,0.32
10,6,terribly,8,668,2,6,0.28
10,6,terrific,8,669,5,3,0.24
10,6,texture,7,670,2,5,0.32
10,6,themselves,10,671,1,9,0.4
10,6,therapist,9,672,3,6,0.32
10,6,thereby,7,673,4,3,0.2
10,6,thesis,6,674,3,3,0.28
10,6,this,4,675,2,2,0.12
10,6,thorough,8,676,2,6,0.32
10,6,thoughtful,10,677,3,7,0.44
10,6,thrilled,8,678,2,6,0.32
10,6,thumb,5,679,2,3,0.16
10,6,tighten,7,680,1,6,0.28
10,6,together,8,681,1,7,0.4
10,6,tolerance,9,682,2,7,0.32
10,6,too,3,683,2,1,0.08
10,6,tool,4,684,3,1,0.12
10,6,topic,5,685,2,3,0.2
10,6,tour,4,686,2,2,0.2
10,6,tournament,10,687,4,6,0.32
10,6,trademark,9,688,1,8,0.36
10,6,tragic,6,689,3,3,0.2
10,6,transcript,10,690,3,7,0.44
10,6,treat,5,691,2,3,0.16
10,6,trend,5,692,3,2,0.16
10,6,trial,5,693,2,3,0.2
10,6,tribal,6,694,3,3,0.28
10,6,tribute,7,695,4,3,0.2
10,6,trio,4,696,3,1,0.12
10,6,tropical,8,697,2,6,0.32
10,6,trouble,7,698,3,4,0.32
10,6,truck,5,699,2,3,0.2
10,6,tune,4,700,1,3,0.16
10,6,twice,5,701,1,4,0.2
10,6,ultimate,8,702,0,8,0.36
10,6,unable,6,703,1,5,0.32
10,6,underlying,10,704,2,8,0.4
10,6,underwear,9,705,5,4,0.28
10,6,unfair,6,706,2,4,0.32
10,6,unique,6,707,2,4,0.2
10,6,universal,9,708,3,6,0.32
10,6,universe,8,709,7,1,0.2
10,6,until,5,710,2,3,0.24
10,6,unusual,7,711,2,5,0.28
10,6,unveil,6,712,2,4,0.2
10,6,uphold,6,713,1,5,0.24
10,6,upon,4,714,2,2,0.16
10,6,usual,5,715,1,4,0.28
10,6,vague,5,716,0,5,0.24
10,6,validity,8,717,2,6,0.32
10,6,valley,6,718,3,3,0.2
10,6,vein,4,719,1,3,0.16
10,6,venture,7,720,2,5,0.36
10,6,vessel,6,721,2,4,0.2
10,6,veteran,7,722,2,5,0.28
10,6,video,5,723,1,4,0.2
10,6,viewer,6,724,2,4,0.28
10,6,villager,8,725,2,6,0.32
10,6,virtue,6,726,2,4,0.2
10,6,visitor,7,727,2,5,0.24
10,6,visual,6,728,3,3,0.28
10,6,vocal,5,729,1,4,0.2
10,6,volunteer,9,730,2,7,0.36
10,6,wait,4,731,0,4,0.2
10,6,war,3,732,2,1,0.12
10,6,warning,7,733,3,4,0.32
10,6,water,5,734,2,3,0.16
10,6,way,3,735,2,1,0.12
10,6,weakness,8,736,1,7,0.32
10,6,wealthy,7,737,3,4,0.32
10,6,weekend,7,738,2,5,0.28
10,6,weird,5,739,2,3,0.44
10,6,welcome,7,740,2,5,0.68
10,6,whatever,8,741,1,7,0.88
10,6,which,5,742,2,3,0.4
10,6,whose,5,743,2,3,0.44
10,6,wildlife,8,744,1,7,0.76
10,6,wipe,4,745,2,2,0.32
10,6,without,7,746,2,5,0.72
10,6,word,4,747,1,3,0.36
10,6,workplace,9,748,3,6,0.72
10,6,world,5,749,3,2,0.36
10,6,worry,5,750,3,2,0.48
10,6,wow,3,751,2,1,0.24
10,6,wrap,4,752,1,3,0.36
10,6,written,7,753,2,5,0.6
10,6,youngster,9,754,0,9,0.88
10,7,absurd,6,0,0,6,0.84
10,7,accelerate,10,1,1,9,0.92
10,7,accept,6,2,4,2,0.4
10,7,acceptable,10,3,6,4,0.68
10,7,accomplish,10,4,3,7,0.92
10,7,accordance,10,5,4,6,0.8
10,7,accounting,10,6,4,6,0.76
10,7,acre,4,7,2,2,0.44
10,7,actress,7,8,2,5,0.64
10,7,adaptation,10,9,1,9,0.96
10,7,additional,10,10,2,8,1.04
10,7,adj,3,11,2,1,0.24
10,7,adolescent,10,12,2,8,0.88
10,7,adopt,5,13,3,2,0.36
10,7,advantage,9,14,2,7,0.92
10,7,advice,6,15,3,3,0.44
10,7,affordable,10,16,1,9,0.96
10,7,again,5,17,1,4,0.48
10,7,aggression,10,18,2,8,1.04
10,7,aggressive,10,19,8,2,0.64
10,7,agree,5,20,2,3,0.44
10,7,aids,4,21,1,3,0.48
10,7,alcohol,7,22,1,6,0.68
10,7,align,5,23,2,3,0.4
10,7,allocate,8,24,2,6,0.72
10,7,ally,4,25,3,1,0.28
10,7,alongside,9,26,2,7,1
10,7,ambassador,10,27,1,9,0.96
10,7,ambulance,9,28,3,6,0.8
10,7,amendment,9,29,2,7,0.96
10,7,analyse,7,30,1,6,0.64
10,7,and,3,31,2,1,0.24
10,7,animal,6,32,2,4,0.52
10,7,annoyed,7,33,2,5,0.84
10,7,another,7,34,2,5,0.76
10,7,anxiety,7,35,2,5,0.92
10,7,apologize,9,36,1,8,1.16
10,7,apology,7,37,6,1,0.52
10,7,appreciate,10,38,2,8,0.92
10,7,approach,8,39,4,4,0.6
10,7,approve,7,40,5,2,0.56
10,7,arise,5,41,1,4,0.48
10,7,arrow,5,42,2,3,0.4
10,7,artistic,8,43,2,6,0.72
10,7,ask,3,44,1,2,0.28
10,7,assault,7,45,2,5,0.76
10,7,assistant,9,46,3,6,0.76
10,7,at,2,47,1,1,0.2
10,7,atrocity,8,48,2,6,0.72
10,7,auction,7,49,1,6,0.76
10,7,automatic,9,50,2,7,0.8
10,7,backing,7,51,0,7,0.8
10,7,bacteria,8,52,3,5,0.88
10,7,bath,4,53,2,2,0.24
10,7,bay,3,54,2,1,0.12
10,7,beauty,6,55,1,5,0.28
10,7,beer,4,56,2,2,0.16
10,7,beg,3,57,2,1,0.12
10,7,behalf,6,58,2,4,0.32
10,7,belief,6,59,2,4,0.24
10,7,belong,6,60,3,3,0.2
10,7,below,5,61,4,1,0.16
10,7,benchmark,9,62,2,7,0.4
10,7,betray,6,63,2,4,0.24
10,7,between,7,64,3,4,0.24
10,7,beyond,6,65,2,4,0.2
10,7,bill,4,66,1,3,0.16
10,7,bird,4,67,2,2,0.2
10,7,birthday,8,68,3,5,0.28
10,7,biscuit,7,69,2,5,0.28
10,7,bishop,6,70,3,3,0.2
10,7,bitter,6,71,2,4,0.28
10,7,bizarre,7,72,2,5,0.28
10,7,blade,5,73,1,4,0.2
10,7,blank,5,74,3,2,0.16
10,7,blow,4,75,2,2,0.16
10,7,boil,4,76,1,3,0.24
10,7,bomb,4,77,2,2,0.12
10,7,boom,4,78,2,2,0.12
10,7,bottle,6,79,2,4,0.2
10,7,bound,5,80,2,3,0.16
10,7,breach,6,81,1,5,0.32
10,7,break,5,82,4,1,0.12
10,7,bride,5,83,2,3,0.16
10,7,bug,3,84,1,2,0.12
10,7,bunch,5,85,2,3,0.2
10,7,burden,6,86,2,4,0.2
10,7,burn,4,87,3,1,0.2
10,7,butter,6,88,2,4,0.24
10,7,cake,4,89,0,4,0.2
10,7,cap,3,90,2,1,0.08
10,7,capability,10,91,3,7,0.36
10,7,capable,7,92,5,2,0.28
10,7,card,4,93,2,2,0.12
10,7,cartoon,7,94,3,4,0.24
10,7,category,8,95,2,6,0.28
10,7,cave,4,96,2,2,0.2
10,7,celebrate,9,97,1,8,0.36
10,7,century,7,98,2,5,0.24
10,7,certain,7,99,2,5,0.28
10,7,certainty,9,100,7,2,0.28
10,7,chair,5,101,1,4,0.2
10,7,challenge,9,102,3,6,0.32
10,7,charming,8,103,3,5,0.36
10,7,cheerful,8,104,2,6,0.28
10,7,childhood,9,105,2,7,0.36
10,7,choir,5,106,2,3,0.2
10,7,chop,4,107,3,1,0.12
10,7,circle,6,108,1,5,0.32
10,7,city,4,109,2,2,0.12
10,7,clause,6,110,1,5,0.24
10,7,closely,7,111,2,5,0.28
10,7,cloud,5,112,3,2,0.24
10,7,collective,10,113,1,9,0.4
10,7,colourful,9,114,3,6,0.32
10,7,comment,7,115,2,5,0.36
10,7,commission,10,116,4,6,0.36
10,7,commodity,9,117,4,5,0.28
10,7,commonly,8,118,5,3,0.28
10,7,compassion,10,119,3,7,0.44
10,7,compensate,10,120,4,6,0.32
10,7,completion,10,121,4,6,0.32
10,7,component,9,122,4,5,0.36
10,7,compulsory,10,123,4,6,0.36
10,7,conceal,7,124,2,5,0.24
10,7,conceive,8,125,5,3,0.32
10,7,concept,7,126,5,2,0.2
10,7,concert,7,127,5,2,0.2
10,7,conclusion,10,128,4,6,0.4
10,7,confer,6,129,3,3,0.2
10,7,confused,8,130,4,4,0.24
10,7,connected,9,131,3,6,0.32
10,7,consent,7,132,3,4,0.32
10,7,constantly,10,133,4,6,0.32
10,7,constraint,10,134,5,5,0.32
10,7,consult,7,135,4,3,0.28
10,7,contrast,8,136,3,5,0.28
10,7,conversion,10,137,3,7,0.36
10,7,convey,6,138,5,1,0.16
10,7,coordinate,10,139,2,8,0.44
10,7,correct,7,140,2,5,0.24
10,7,cost,4,141,2,2,0.16
10,7,county,6,142,2,4,0.2
10,7,coup,4,143,3,1,0.2
10,7,coverage,8,144,2,6,0.28
10,7,create,6,145,1,5,0.24
10,7,creativity,10,146,5,5,0.32
10,7,creature,8,147,5,3,0.32
10,7,creep,5,148,3,2,0.16
10,7,criminal,8,149,2,6,0.28
10,7,cross,5,150,2,3,0.2
10,7,crowd,5,151,3,2,0.24
10,7,crowded,7,152,5,2,0.2
10,7,crude,5,153,2,3,0.2
10,7,cruise,6,154,3,3,0.2
10,7,cry,3,155,2,1,0.12
10,7,currency,8,156,1,7,0.4
10,7,current,7,157,6,1,0.16
10,7,cycle,5,158,1,4,0.2
10,7,dance,5,159,0,5,0.24
10,7,declare,7,160,1,6,0.28
10,7,decoration,10,161,3,7,0.44
10,7,deem,4,162,2,2,0.12
10,7,defence,7,163,2,5,0.24
10,7,definite,8,164,3,5,0.36
10,7,delighted,9,165,2,7,0.36
10,7,demon,5,166,2,3,0.2
10,7,dentist,7,167,2,5,0.28
10,7,departure,9,168,2,7,0.44
10,7,deposit,7,169,3,4,0.24
10,7,deputy,6,170,3,3,0.2
10,7,desktop,7,171,2,5,0.24
10,7,detect,6,172,2,4,0.32
10,7,devil,5,173,2,3,0.2
10,7,diagnosis,9,174,1,8,0.36
10,7,dictate,7,175,2,5,0.24
10,7,dictator,8,176,6,2,0.28
10,7,dig,3,177,2,1,0.08
10,7,digital,7,178,3,4,0.24
10,7,director,8,179,2,6,0.32
10,7,dirty,5,180,3,2,0.24
10,7,disabled,8,181,2,6,0.28
10,7,disastrous,10,182,4,6,0.36
10,7,disclosure,10,183,3,7,0.44
10,7,discount,8,184,4,4,0.28
10,7,discovery,9,185,5,4,0.28
10,7,discuss,7,186,4,3,0.24
10,7,discussion,10,187,7,3,0.32
10,7,display,7,188,3,4,0.24
10,7,distribute,10,189,3,7,0.36
10,7,divorced,8,190,2,6,0.36
10,7,dollar,6,191,1,5,0.24
10,7,domain,6,192,2,4,0.24
10,7,download,8,193,2,6,0.32
10,7,downstairs,10,194,4,6,0.44
10,7,drama,5,195,1,4,0.2
10,7,drawing,7,196,3,4,0.24
10,7,drink,5,197,2,3,0.2
10,7,earnings,8,198,0,8,0.44
10,7,editor,6,199,1,5,0.24
10,7,effort,6,200,1,5,0.24
10,7,eight,5,201,1,4,0.2
10,7,either,6,202,2,4,0.32
10,7,elect,5,203,1,4,0.2
10,7,embark,6,204,1,5,0.24
10,7,embody,6,205,3,3,0.2
10,7,emergence,9,206,2,7,0.4
10,7,emergency,9,207,8,1,0.2
10,7,emotion,7,208,2,5,0.28
10,7,empirical,9,209,2,7,0.36
10,7,empower,7,210,3,4,0.68
10,7,ending,6,211,1,5,0.56
10,7,endless,7,212,3,4,0.56
10,7,enemy,5,213,2,3,0.44
10,7,enjoyable,9,214,2,7,0.92
10,7,enrich,6,215,2,4,0.52
10,7,enter,5,216,2,3,0.44
10,7,entitle,7,217,3,4,0.56
10,7,entrance,8,218,3,5,0.76
10,7,equipment,9,219,1,8,0.92
10,7,essay,5,220,1,4,0.52
10,7,essence,7,221,3,4,0.56
10,7,evaluation,10,222,1,9,1.12
10,7,evidence,8,223,2,6,0.72
10,7,exact,5,224,1,4,0.48
10,7,exceed,6,225,2,4,0.52
10,7,excellent,9,226,4,5,0.8
10,7,exception,9,227,4,5,0.68
10,7,exciting,8,228,3,5,0.64
10,7,exclusive,9,229,3,6,0.88
10,7,excuse,6,230,3,3,0.44
10,7,executive,9,231,2,7,1.08
10,7,exhibition,10,232,2,8,1
10,7,experiment,10,233,2,8,0.88
10,7,expire,6,234,3,3,0.44
10,7,extend,6,235,2,4,0.52
10,7,extensive,9,236,5,4,0.76
10,7,faculty,7,237,0,7,0.72
10,7,failure,7,238,2,5,0.6
10,7,fair,4,239,3,1,0.28
10,7,fairly,6,240,4,2,0.52
10,7,famous,6,241,2,4,0.52
10,7,fantastic,9,242,2,7,0.8
10,7,fast,4,243,2,2,0.32
10,7,fat,3,244,2,1,0.36
10,7,fear,4,245,1,3,0.4
10,7,fee,3,246,2,1,0.24
10,7,fiction,7,247,1,6,0.64
10,7,fifty,5,248,2,3,0.4
10,7,fight,5,249,2,3,0.4
10,7,financial,9,250,2,7,0.92
10,7,fine,4,251,3,1,0.28
10,7,fix,3,252,2,1,0.24
10,7,fixture,7,253,3,4,0.56
10,7,flag,4,254,1,3,0.36
10,7,flavour,7,255,3,4,0.68
10,7,flee,4,256,2,2,0.32
10,7,flexible,8,257,3,5,0.68
10,7,floor,5,258,2,3,0.44
10,7,flourish,8,259,3,5,0.76
10,7,flower,6,260,3,3,0.48
10,7,focus,5,261,1,4,0.48
10,7,folding,7,262,2,5,0.6
10,7,folk,4,263,3,1,0.28
10,7,force,5,264,2,3,0.56
10,7,formation,9,265,3,6,0.76
10,7,formula,7,266,4,3,0.52
10,7,fortune,7,267,3,4,0.56
10,7,foundation,10,268,2,8,1.04
10,7,founder,7,269,5,2,0.44
10,7,frequent,8,270,1,7,0.76
10,7,fridge,6,271,2,4,0.64
10,7,frighten,8,272,3,5,0.64
10,7,frightened,10,273,8,2,0.56
10,7,front,5,274,2,3,0.4
10,7,fur,3,275,1,2,0.4
10,7,gallery,7,276,0,7,0.72
10,7,game,4,277,2,2,0.32
10,7,gender,6,278,1,5,0.56
10,7,gene,4,279,3,1,0.28
10,7,generally,9,280,4,5,0.8
10,7,genetic,7,281,4,3,0.52
10,7,genre,5,282,3,2,0.36
10,7,genuinely,9,283,3,6,0.72
10,7,geography,9,284,2,7,0.92
10,7,give,4,285,1,3,0.4
10,7,go,2,286,1,1,0.2
10,7,govern,6,287,2,4,0.52
10,7,governor,8,288,6,2,0.48
10,7,grace,5,289,1,4,0.6
10,7,grade,5,290,3,2,0.36
10,7,green,5,291,2,3,0.4
10,7,greet,5,292,4,1,0.32
10,7,grid,4,293,2,2,0.32
10,7,grief,5,294,3,2,0.48
10,7,grin,4,295,3,1,0.28
10,7,grind,5,296,4,1,0.32
10,7,guess,5,297,1,4,0.48
10,7,guest,5,298,4,1,0.32
10,7,guidance,8,299,2,6,0.8
10,7,gym,3,300,1,2,0.28
10,7,hair,4,301,0,4,0.44
10,7,happen,6,302,2,4,0.52
10,7,harvest,7,303,2,5,0.6
10,7,hate,4,304,2,2,0.44
10,7,hazard,6,305,2,4,0.52
10,7,headline,8,306,1,7,0.76
10,7,heart,5,307,3,2,0.36
10,7,her,3,308,2,1,0.24
10,7,highly,6,309,1,5,0.68
10,7,historical,10,310,2,8,0.88
10,7,holiday,7,311,1,6,0.64
10,7,honesty,7,312,2,5,0.6
10,7,horrible,8,313,2,6,0.84
10,7,horror,6,314,4,2,0.4
10,7,hotel,5,315,2,3,0.4
10,7,hour,4,316,2,2,0.32
10,7,household,9,317,3,6,0.88
10,7,how,3,318,2,1,0.24
10,7,humour,6,319,1,5,0.56
10,7,hurricane,9,320,2,7,0.8
10,7,hydrogen,8,321,1,7,0.88
10,7,hypothesis,10,322,2,8,0.88
10,7,i,1,323,0,1,0.16
10,7,ice,3,324,1,2,0.28
10,7,icon,4,325,2,2,0.32
10,7,identity,8,326,1,7,0.88
10,7,ignorance,9,327,1,8,0.84
10,7,ill,3,328,1,2,0.28
10,7,include,7,329,1,6,0.64
10,7,inclusion,9,330,5,4,1.8800000000000001
10,7,index,5,331,2,3,1
10,7,indirect,8,332,3,5,2.04
10,7,influence,9,333,2,7,1.84
10,7,inform,6,334,3,3,0.88
10,7,informal,8,335,6,2,0.48
10,7,inherent,8,336,2,6,0.84
10,7,initiate,8,337,2,6,0.72
10,7,injure,6,338,2,4,0.52
10,7,injury,6,339,5,1,0.36
10,7,insertion,9,340,2,7,0.92
10,7,inspection,10,341,3,7,0.84
10,7,instant,7,342,3,4,0.56
10,7,instruct,8,343,4,4,0.68
10,7,instrument,10,344,6,4,0.64
10,7,insurance,9,345,3,6,0.44
10,7,intense,7,346,2,5,0.28
10,7,intensify,9,347,6,3,0.32
10,7,interior,8,348,4,4,0.28
10,7,into,4,349,3,1,0.12
10,7,invade,6,350,2,4,0.24
10,7,invest,6,351,3,3,0.28
10,7,involve,7,352,3,4,0.24
10,7,involved,8,353,7,1,0.2
10,7,issue,5,354,1,4,0.24
10,7,jewellery,9,355,0,9,0.48
10,7,job,3,356,1,2,0.12
10,7,jump,4,357,1,3,0.16
10,7,june,4,358,2,2,0.16
10,7,just,4,359,2,2,0.16
10,7,justify,7,360,4,3,0.28
10,7,kidney,6,361,0,6,0.28
10,7,king,4,362,2,2,0.16
10,7,kingdom,7,363,4,3,0.2
10,7,kit,3,364,2,1,0.12
10,7,know,4,365,1,3,0.16
10,7,lack,4,366,0,4,0.24
10,7,lad,3,367,2,1,0.08
10,7,landmark,8,368,2,6,0.28
10,7,last,4,369,2,2,0.16
10,7,latest,6,370,2,4,0.2
10,7,lawn,4,371,2,2,0.2
10,7,leading,7,372,1,6,0.28
10,7,leaflet,7,373,3,4,0.24
10,7,league,6,374,3,3,0.2
10,7,learning,8,375,3,5,0.32
10,7,legend,6,376,2,4,0.2
10,7,legendary,9,377,6,3,0.24
10,7,lemon,5,378,2,3,0.16
10,7,lens,4,379,2,2,0.12
10,7,lesbian,7,380,2,5,0.32
10,7,licence,7,381,1,6,0.28
10,7,link,4,382,2,2,0.12
10,7,literature,10,383,2,8,0.4
10,7,litter,6,384,3,3,0.28
10,7,load,4,385,1,3,0.16
10,7,local,5,386,2,3,0.2
10,7,location,8,387,4,4,0.24
10,7,log,3,388,2,1,0.12
10,7,look,4,389,2,2,0.2
10,7,loudly,6,390,2,4,0.24
10,7,lunch,5,391,1,4,0.2
10,7,main,4,392,0,4,0.2
10,7,mandatory,9,393,2,7,0.4
10,7,map,3,394,2,1,0.08
10,7,marine,6,395,2,4,0.2
10,7,mark,4,396,3,1,0.12
10,7,mask,4,397,2,2,0.12
10,7,meal,4,398,1,3,0.16
10,7,meaningful,10,399,3,7,0.44
10,7,meanwhile,9,400,4,5,0.28
10,7,meeting,7,401,2,5,0.28
10,7,mental,6,402,2,4,0.28
10,7,mentor,6,403,4,2,0.16
10,7,mess,4,404,2,2,0.12
10,7,method,6,405,2,4,0.24
10,7,metre,5,406,3,2,0.16
10,7,midnight,8,407,1,7,0.4
10,7,militia,7,408,2,5,0.28
10,7,mirror,6,409,2,4,0.2
10,7,misleading,10,410,2,8,0.4
10,7,missing,7,411,3,4,0.32
10,7,mixed,5,412,2,3,0.2
10,7,moment,6,413,1,5,0.24
10,7,month,5,414,2,3,0.24
10,7,most,4,415,2,2,0.2
10,7,mouth,5,416,2,3,0.16
10,7,movie,5,417,2,3,0.16
10,7,mum,3,418,1,2,0.12
10,7,municipal,9,419,2,7,0.36
10,7,museum,6,420,2,4,0.28
10,7,music,5,421,3,2,0.16
10,7,must,4,422,3,1,0.12
10,7,naked,5,423,0,5,0.24
10,7,nasty,5,424,2,3,0.16
10,7,nation,6,425,2,4,0.28
10,7,nationwide,10,426,6,4,0.28
10,7,nature,6,427,3,3,0.2
10,7,neck,4,428,1,3,0.16
10,7,needle,6,429,2,4,0.24
10,7,negative,8,430,2,6,0.36
10,7,new,3,431,2,1,0.08
10,7,noise,5,432,1,4,0.2
10,7,nomination,10,433,2,8,0.36
10,7,non,3,434,2,1,0.16
10,7,normal,6,435,2,4,0.2
10,7,north,5,436,3,2,0.16
10,7,northern,8,437,5,3,0.24
10,7,not,3,438,2,1,0.12
10,7,notice,6,439,3,3,0.24
10,7,numerous,8,440,1,7,0.32
10,7,nut,3,441,2,1,0.08
10,7,oblige,6,442,0,6,0.28
10,7,obsess,6,443,2,4,0.24
10,7,occupation,10,444,1,9,0.48
10,7,ocean,5,445,2,3,0.2
10,7,offence,7,446,1,6,0.28
10,7,offend,6,447,5,1,0.2
10,7,offensive,9,448,5,4,0.28
10,7,once,4,449,1,3,0.16
10,7,online,6,450,2,4,0.2
10,7,opposed,7,451,1,6,0.36
10,7,organic,7,452,1,6,0.28
10,7,organizer,9,453,6,3,0.24
10,7,originate,9,454,2,7,0.32
10,7,other,5,455,1,4,0.28
10,7,otherwise,9,456,5,4,0.28
10,7,ought,5,457,1,4,0.2
10,7,outbreak,8,458,2,6,0.32
10,7,outdoor,7,459,3,4,0.32
10,7,outdoors,8,460,7,1,0.2
10,7,outing,6,461,3,3,0.2
10,7,outlet,6,462,3,3,0.2
10,7,oversee,7,463,1,6,0.36
10,7,owe,3,464,1,2,0.12
10,7,pad,3,465,0,3,0.16
10,7,page,4,466,2,2,0.16
10,7,painful,7,467,2,5,0.28
10,7,pants,5,468,2,3,0.2
10,7,parade,6,469,2,4,0.28
10,7,park,4,470,3,1,0.12
10,7,particular,10,471,3,7,0.36
10,7,passport,8,472,2,6,0.36
10,7,password,8,473,4,4,0.24
10,7,patent,6,474,2,4,0.2
10,7,pause,5,475,2,3,0.2
10,7,peaceful,8,476,1,7,0.4
10,7,peculiar,8,477,2,6,0.32
10,7,pepper,6,478,2,4,0.24
10,7,perceive,8,479,2,6,0.28
10,7,perfect,7,480,3,4,0.32
10,7,perhaps,7,481,3,4,0.24
10,7,persistent,10,482,3,7,0.36
10,7,personnel,9,483,4,5,0.36
10,7,physician,9,484,1,8,0.36
10,7,pick,4,485,1,3,0.16
10,7,picture,7,486,3,4,0.24
10,7,piece,5,487,2,3,0.16
10,7,pig,3,488,2,1,0.16
10,7,pile,4,489,2,2,0.12
10,7,pin,3,490,2,1,0.08
10,7,pipe,4,491,2,2,0.16
10,7,plan,4,492,1,3,0.16
10,7,plane,5,493,4,1,0.12
10,7,planning,8,494,4,4,0.32
10,7,plant,5,495,4,1,0.12
10,7,play,4,496,3,1,0.12
10,7,point,5,497,1,4,0.2
10,7,political,9,498,2,7,0.36
10,7,pond,4,499,2,2,0.2
10,7,population,10,500,2,8,0.56
10,7,portion,7,501,2,5,0.24
10,7,possess,7,502,2,5,0.32
10,7,possible,8,503,4,4,0.24
10,7,practical,9,504,1,8,0.36
10,7,praise,6,505,3,3,0.2
10,7,prayer,6,506,3,3,0.28
10,7,precedent,9,507,2,7,0.68
10,7,prejudice,9,508,3,6,0.8
10,7,premise,7,509,3,4,0.36
10,7,presence,8,510,3,5,0.68
10,7,prevention,10,511,3,7,0.84
10,7,previously,10,512,4,6,0.8
10,7,principal,9,513,2,7,0.92
10,7,principle,9,514,7,2,0.52
10,7,printing,8,515,4,4,0.6
10,7,prior,5,516,3,2,0.44
10,7,priority,8,517,5,3,0.52
10,7,procedure,9,518,2,7,0.8
10,7,processing,10,519,5,5,0.92
10,7,processor,9,520,7,2,0.52
10,7,product,7,521,3,4,0.56
10,7,profile,7,522,3,4,0.56
10,7,profound,8,523,4,4,0.68
10,7,prominent,9,524,3,6,0.76
10,7,propaganda,10,525,3,7,0.88
10,7,properly,8,526,4,4,0.68
10,7,punk,4,527,1,3,0.48
10,7,pupil,5,528,2,3,0.52
10,7,pure,4,529,2,2,0.4
10,7,pursuit,7,530,3,4,0.64
10,7,quality,7,531,0,7,0.92
10,7,quantity,8,532,3,5,0.72
10,7,query,5,533,2,3,0.4
10,7,quest,5,534,3,2,0.4
10,7,racial,6,535,0,6,0.72
10,7,racism,6,536,4,2,0.56
10,7,raise,5,537,2,3,0.44
10,7,rather,6,538,2,4,0.52
10,7,rating,6,539,3,3,0.48
10,7,realistic,9,540,1,8,1
10,7,rebel,5,541,2,3,0.4
10,7,recognize,9,542,2,7,0.8
10,7,recommend,9,543,4,5,0.68
10,7,recount,7,544,4,3,0.72
10,7,recruit,7,545,3,4,0.72
10,7,recycle,7,546,3,4,0.68
10,7,reduce,6,547,2,4,0.6
10,7,reduction,9,548,5,4,0.8
10,7,refer,5,549,2,3,0.44
10,7,referee,7,550,5,2,0.48
10,7,regard,6,551,2,4,0.64
10,7,regional,8,552,3,5,0.8
10,7,regulatory,10,553,3,7,0.84
10,7,rejection,9,554,2,7,0.92
10,7,relative,8,555,2,6,0.88
10,7,relax,5,556,4,1,0.32
10,7,relaxed,7,557,5,2,0.44
10,7,relevance,9,558,3,6,0.76
10,7,relieved,8,559,3,5,0.8
10,7,remark,6,560,2,4,0.52
10,7,remind,6,561,3,3,0.44
10,7,republic,8,562,2,6,0.72
10,7,research,8,563,2,6,0.8
10,7,reside,6,564,3,3,0.48
10,7,residence,9,565,6,3,0.6
10,7,resolve,7,566,3,4,0.68
10,7,rest,4,567,3,1,0.28
10,7,retire,6,568,2,4,0.52
10,7,retrieve,8,569,3,5,0.8
10,7,revenge,7,570,2,5,0.76
10,7,revise,6,571,3,3,0.6
10,7,revision,8,572,5,3,0.56
10,7,revive,6,573,4,2,0.4
10,7,rip,3,574,1,2,0.28
10,7,ritual,6,575,2,4,0.56
10,7,rival,5,576,2,3,0.56
10,7,road,4,577,1,3,0.4
10,7,robust,6,578,2,4,0.52
10,7,roll,4,579,2,2,0.32
10,7,romance,7,580,2,5,0.6
10,7,roof,4,581,2,2,0.44
10,7,root,4,582,3,1,0.28
10,7,rotate,6,583,2,4,0.52
10,7,round,5,584,2,3,0.52
10,7,ruin,4,585,1,3,0.48
10,7,safe,4,586,0,4,0.64
10,7,satellite,9,587,2,7,0.92
10,7,satisfied,9,588,3,6,0.84
10,7,scan,4,589,1,3,0.4
10,7,scared,6,590,3,3,0.6
10,7,scholar,7,591,2,5,0.64
10,7,score,5,592,2,3,0.4
10,7,seal,4,593,1,3,0.4
10,7,second,6,594,2,4,0.52
10,7,secret,6,595,3,3,0.56
10,7,secure,6,596,3,3,0.48
10,7,security,8,597,5,3,0.52
10,7,sensible,8,598,2,6,0.72
10,7,serve,5,599,2,3,0.52
10,7,service,7,600,4,3,0.52
10,7,settlement,10,601,2,8,0.92
10,7,settler,7,602,6,1,0.4
10,7,seven,5,603,2,3,0.6
10,7,severely,8,604,4,4,0.72
10,7,sexual,6,605,2,4,0.64
10,7,sheer,5,606,1,4,0.56
10,7,shell,5,607,3,2,0.48
10,7,shiny,5,608,2,3,0.44
10,7,shopping,8,609,2,6,0.72
10,7,shortly,7,610,3,4,0.6
10,7,sight,5,611,1,4,0.6
10,7,signature,9,612,3,6,0.88
10,7,silver,6,613,2,4,0.52
10,7,similarly,9,614,2,7,1
10,7,simulation,10,615,3,7,1.04
10,7,sin,3,616,2,1,0.24
10,7,singing,7,617,3,4,0.56
10,7,sink,4,618,3,1,0.28
10,7,sit,3,619,2,1,0.24
10,7,skip,4,620,1,3,0.52
10,7,skull,5,621,2,3,0.44
10,7,slam,4,622,1,3,0.4
10,7,snow,4,623,1,3,0.4
10,7,solid,5,624,1,4,0.48
10,7,solo,4,625,3,1,0.28
10,7,somehow,7,626,2,5,0.72
10,7,someone,7,627,4,3,0.52
10,7,soup,4,628,2,2,0.36
10,7,south,5,629,3,2,0.48
10,7,space,5,630,1,4,0.56
10,7,sphere,6,631,2,4,0.64
10,7,spotlight,9,632,2,7,0.84
10,7,staff,5,633,1,4,0.48
10,7,stall,5,634,3,2,0.36
10,7,stance,6,635,3,3,0.56
10,7,stand,5,636,4,1,0.32
10,7,star,4,637,3,1,0.28
10,7,stay,4,638,3,1,0.28
10,7,steer,5,639,2,3,0.44
10,7,stick,5,640,2,3,0.44
10,7,sticky,6,641,5,1,0.44
10,7,store,5,642,2,3,0.44
10,7,story,5,643,4,1,0.32
10,7,strange,7,644,2,5,0.6
10,7,strategic,9,645,4,5,0.8
10,7,strategy,8,646,7,1,0.44
10,7,strength,8,647,3,5,0.68
10,7,strict,6,648,3,3,0.44
10,7,strike,6,649,4,2,0.52
10,7,string,6,650,4,2,0.44
10,7,strong,6,651,3,3,0.32
10,7,studio,6,652,2,4,0.28
10,7,study,5,653,4,1,0.16
10,7,stun,4,654,3,1,0.16
10,7,subject,7,655,1,6,0.32
10,7,substance,9,656,3,6,0.32
10,7,successful,10,657,2,8,0.4
10,7,sue,3,658,2,1,0.16
10,7,sugar,5,659,2,3,0.2
10,7,suppose,7,660,2,5,0.28
10,7,sure,4,661,2,2,0.12
10,7,suspension,10,662,2,8,0.48
10,7,swallow,7,663,1,6,0.28
10,7,sweater,7,664,2,5,0.24
10,7,swim,4,665,2,2,0.16
10,7,sympathy,8,666,1,7,0.4
10,7,talk,4,667,0,4,0.2
10,7,tank,4,668,2,2,0.12
10,7,tap,3,669,2,1,0.12
10,7,tape,4,670,3,1,0.12
10,7,taxi,4,671,2,2,0.12
10,7,tea,3,672,1,2,0.12
10,7,team,4,673,3,1,0.16
10,7,television,10,674,2,8,0.4
10,7,tendency,8,675,2,6,0.28
10,7,tender,6,676,5,1,0.16
10,7,tension,7,677,3,4,0.32
10,7,terrify,7,678,2,5,0.28
10,7,terror,6,679,4,2,0.16
10,7,terrorism,9,680,6,3,0.24
10,7,therapist,9,681,1,8,0.44
10,7,thereby,7,682,4,3,0.24
10,7,thesis,6,683,3,3,0.2
10,7,this,4,684,2,2,0.12
10,7,thorough,8,685,2,6,0.36
10,7,thoughtful,10,686,3,7,0.36
10,7,tight,5,687,1,4,0.2
10,7,tighten,7,688,5,2,0.24
10,7,together,8,689,1,7,0.32
10,7,tonight,7,690,2,5,0.28
10,7,tonne,5,691,3,2,0.16
10,7,too,3,692,2,1,0.12
10,7,tool,4,693,3,1,0.16
10,7,topic,5,694,2,3,0.2
10,7,tournament,10,695,2,8,0.36
10,7,traveller,9,696,1,8,0.44
10,7,tree,4,697,2,2,0.2
10,7,trend,5,698,3,2,0.16
10,7,trial,5,699,2,3,0.2
10,7,tribute,7,700,3,4,0.24
10,7,trio,4,701,3,1,0.12
10,7,trouble,7,702,2,5,0.32
10,7,truck,5,703,2,3,0.2
10,7,ultimate,8,704,0,8,0.36
10,7,unable,6,705,1,5,0.24
10,7,underlying,10,706,2,8,0.44
10,7,unfair,6,707,2,4,0.24
10,7,universal,9,708,2,7,0.36
10,7,until,5,709,2,3,0.16
10,7,unusual,7,710,2,5,0.36
10,7,unveil,6,711,2,4,0.24
10,7,upgrade,7,712,1,6,0.28
10,7,upon,4,713,2,2,0.12
10,7,urban,5,714,1,4,0.28
10,7,urgent,6,715,2,4,0.24
10,7,usual,5,716,1,4,0.2
10,7,utility,7,717,1,6,0.28
10,7,vague,5,718,0,5,0.24
10,7,valley,6,719,2,4,0.32
10,7,valuable,8,720,3,5,0.28
10,7,variety,7,721,2,5,0.28
10,7,vegetable,9,722,1,8,0.44
10,7,vein,4,723,2,2,0.16
10,7,venture,7,724,2,5,0.24
10,7,vessel,6,725,2,4,0.24
10,7,viable,6,726,1,5,0.24
10,7,video,5,727,2,3,0.24
10,7,voice,5,728,1,4,0.2
10,7,wait,4,729,0,4,0.2
10,7,wake,4,730,2,2,0.12
10,7,walk,4,731,2,2,0.16
10,7,war,3,732,2,1,0.16
10,7,warning,7,733,3,4,0.24
10,7,washing,7,734,2,5,0.24
10,7,watch,5,735,2,3,0.2
10,7,water,5,736,3,2,0.16
10,7,weakness,8,737,1,7,0.4
10,7,wealthy,7,738,3,4,0.24
10,7,weapon,6,739,3,3,0.2
10,7,weave,5,740,3,2,0.16
10,7,whatever,8,741,1,7,0.4
10,7,whenever,8,742,2,6,0.32
10,7,whereas,7,743,3,4,0.24
10,7,whose,5,744,2,3,0.2
10,7,wildlife,8,745,1,7,0.4
10,7,win,3,746,2,1,0.12
10,7,wind,4,747,3,1,0.12
10,7,window,6,748,4,2,0.16
10,7,wine,4,749,3,1,0.12
10,7,wipe,4,750,2,2,0.2
10,7,workforce,9,751,1,8,0.36
10,7,workplace,9,752,4,5,0.28
10,7,wrap,4,753,1,3,0.16
10,7,yellow,6,754,0,6,0.32
10,8,a,1,0,0,1,0.08
10,8,absence,7,1,1,6,0.28
10,8,absolutely,10,2,3,7,0.36
10,8,absurd,6,3,3,3,0.2
10,8,accelerate,10,4,1,9,0.48
10,8,accept,6,5,4,2,0.16
10,8,accident,8,6,3,5,0.28
10,8,accompany,9,7,3,6,0.36
10,8,accordance,10,8,4,6,0.36
10,8,accurate,8,9,3,5,0.28
10,8,acid,4,10,2,2,0.16
10,8,acre,4,11,2,2,0.2
10,8,activate,8,12,2,6,0.32
10,8,actress,7,13,3,4,0.24
10,8,acute,5,14,2,3,0.16
10,8,ad,2,15,1,1,0.08
10,8,adaptation,10,16,2,8,0.44
10,8,adjacent,8,17,2,6,0.32
10,8,adolescent,10,18,2,8,0.36
10,8,adopt,5,19,3,2,0.24
10,8,adoption,8,20,5,3,0.24
10,8,advantage,9,21,2,7,0.36
10,8,advice,6,22,3,3,0.28
10,8,aftermath,9,23,1,8,0.44
10,8,again,5,24,1,4,0.24
10,8,against,7,25,5,2,0.2
10,8,aggressive,10,26,2,8,0.48
10,8,agree,5,27,2,3,0.2
10,8,alcohol,7,28,1,6,0.28
10,8,align,5,29,2,3,0.16
10,8,ally,4,30,2,2,0.16
10,8,alongside,9,31,2,7,0.4
10,8,ambulance,9,32,1,8,0.36
10,8,amendment,9,33,2,7,0.36
10,8,amusing,7,34,2,5,0.32
10,8,analyse,7,35,1,6,0.28
10,8,analysis,8,36,6,2,0.2
10,8,ancient,7,37,2,5,0.32
10,8,and,3,38,2,1,0.08
10,8,anger,5,39,2,3,0.16
10,8,animal,6,40,2,4,0.24
10,8,announce,8,41,2,6,0.28
10,8,annoyed,7,42,4,3,0.28
10,8,annoying,8,43,5,3,0.24
10,8,apologize,9,44,1,8,0.36
10,8,apology,7,45,6,1,0.16
10,8,appreciate,10,46,2,8,0.44
10,8,approve,7,47,4,3,0.2
10,8,arguably,8,48,1,7,0.32
10,8,argue,5,49,4,1,0.2
10,8,arise,5,50,2,3,0.2
10,8,around,6,51,2,4,0.24
10,8,arrest,6,52,2,4,0.2
10,8,ask,3,53,1,2,0.12
10,8,assessment,10,54,2,8,0.44
10,8,associate,9,55,3,6,0.36
10,8,at,2,56,1,1,0.08
10,8,atrocity,8,57,2,6,0.28
10,8,attract,7,58,2,5,0.32
10,8,authorize,9,59,1,8,0.36
10,8,automatic,9,60,3,6,0.32
10,8,average,7,61,1,6,0.36
10,8,backing,7,62,0,7,0.32
10,8,balance,7,63,2,5,0.28
10,8,ballet,6,64,3,3,0.2
10,8,banner,6,65,2,4,0.28
10,8,base,4,66,2,2,0.16
10,8,bat,3,67,2,1,0.08
10,8,bay,3,68,2,1,0.08
10,8,beast,5,69,1,4,0.2
10,8,beat,4,70,3,1,0.12
10,8,beg,3,71,2,1,0.08
10,8,behalf,6,72,2,4,0.28
10,8,behave,6,73,4,2,0.16
10,8,belief,6,74,2,4,0.24
10,8,bell,4,75,3,1,0.12
10,8,belong,6,76,3,3,0.2
10,8,benchmark,9,77,2,7,0.4
10,8,best,4,78,2,2,0.16
10,8,betray,6,79,2,4,0.2
10,8,between,7,80,3,4,0.24
10,8,beyond,6,81,2,4,0.28
10,8,bin,3,82,1,2,0.12
10,8,bite,4,83,2,2,0.12
10,8,bitter,6,84,3,3,0.2
10,8,bless,5,85,1,4,0.2
10,8,blind,5,86,2,3,0.24
10,8,blog,4,87,2,2,0.12
10,8,blow,4,88,3,1,0.12
10,8,boat,4,89,1,3,0.16
10,8,boil,4,90,2,2,0.12
10,8,boom,4,91,2,2,0.16
10,8,boot,4,92,3,1,0.16
10,8,bottle,6,93,2,4,0.24
10,8,bound,5,94,2,3,0.16
10,8,box,3,95,2,1,0.08
10,8,brand,5,96,1,4,0.2
10,8,breathe,7,97,2,5,0.32
10,8,breathing,9,98,6,3,0.24
10,8,bride,5,99,2,3,0.2
10,8,buddy,5,100,1,4,0.2
10,8,bug,3,101,2,1,0.08
10,8,build,5,102,2,3,0.24
10,8,bunch,5,103,2,3,0.16
10,8,burden,6,104,2,4,0.24
10,8,business,8,105,2,6,0.32
10,8,cake,4,106,0,4,0.2
10,8,can,3,107,2,1,0.16
10,8,candidate,9,108,3,6,0.32
10,8,cap,3,109,2,1,0.12
10,8,careful,7,110,2,5,0.28
10,8,carpet,6,111,3,3,0.2
10,8,category,8,112,2,6,0.36
10,8,cease,5,113,1,4,0.2
10,8,ceiling,7,114,2,5,0.24
10,8,ceremony,8,115,2,6,0.32
10,8,certain,7,116,3,4,0.32
10,8,challenge,9,117,1,8,0.4
10,8,character,9,118,3,6,0.32
10,8,charming,8,119,4,4,0.32
10,8,chart,5,120,4,1,0.16
10,8,cheerful,8,121,2,6,0.32
10,8,chicken,7,122,2,5,0.24
10,8,choir,5,123,2,3,0.24
10,8,choose,6,124,3,3,0.2
10,8,chronic,7,125,2,5,0.28
10,8,circuit,7,126,1,6,0.36
10,8,cite,4,127,2,2,0.2
10,8,city,4,128,3,1,0.12
10,8,clause,6,129,1,5,0.24
10,8,clean,5,130,2,3,0.2
10,8,clerk,5,131,3,2,0.2
10,8,clinical,8,132,2,6,0.4
10,8,cluster,7,133,2,5,0.28
10,8,coach,5,134,1,4,0.2
10,8,collection,10,135,2,8,0.4
10,8,colony,6,136,3,3,0.4
10,8,colourful,9,137,4,5,0.32
10,8,commodity,9,138,2,7,0.4
10,8,commonly,8,139,5,3,0.32
10,8,community,9,140,4,5,0.32
10,8,company,7,141,3,4,0.24
10,8,comparable,10,142,5,5,0.32
10,8,compassion,10,143,5,5,0.4
10,8,compete,7,144,4,3,0.2
10,8,comply,6,145,4,2,0.16
10,8,component,9,146,4,5,0.36
10,8,compulsory,10,147,4,6,0.32
10,8,conceal,7,148,2,5,0.24
10,8,concern,7,149,5,2,0.2
10,8,concert,7,150,6,1,0.24
10,8,conclusion,10,151,4,6,0.32
10,8,confer,6,152,3,3,0.2
10,8,confess,7,153,5,2,0.2
10,8,confidence,10,154,4,6,0.4
10,8,consent,7,155,3,4,0.24
10,8,constraint,10,156,4,6,0.32
10,8,consult,7,157,4,3,0.28
10,8,contempt,8,158,3,5,0.28
10,8,convenient,10,159,3,7,0.36
10,8,conversion,10,160,5,5,0.4
10,8,correct,7,161,2,5,0.24
10,8,could,5,162,2,3,0.2
10,8,county,6,163,3,3,0.2
10,8,couple,6,164,3,3,0.2
10,8,course,6,165,3,3,0.28
10,8,create,6,166,1,5,0.24
10,8,creativity,10,167,5,5,0.32
10,8,criminal,8,168,2,6,0.36
10,8,cross,5,169,2,3,0.2
10,8,crowd,5,170,3,2,0.16
10,8,crucial,7,171,2,5,0.24
10,8,crude,5,172,3,2,0.16
10,8,cruel,5,173,3,2,0.24
10,8,cry,3,174,2,1,0.12
10,8,current,7,175,1,6,0.28
10,8,cycle,5,176,1,4,0.2
10,8,dance,5,177,0,5,0.24
10,8,dare,4,178,2,2,0.2
10,8,deal,4,179,1,3,0.16
10,8,death,5,180,3,2,0.16
10,8,december,8,181,2,6,0.32
10,8,decline,7,182,3,4,0.24
10,8,decoration,10,183,3,7,0.44
10,8,decrease,8,184,3,5,0.28
10,8,deed,4,185,2,2,0.12
10,8,deem,4,186,3,1,0.12
10,8,default,7,187,2,5,0.72
10,8,delighted,9,188,2,7,0.8
10,8,democratic,10,189,2,8,0.92
10,8,dentist,7,190,2,5,0.72
10,8,depressing,10,191,2,8,0.92
10,8,depression,10,192,8,2,0.56
10,8,despite,7,193,2,5,0.8
10,8,detect,6,194,2,4,0.52
10,8,diagnosis,9,195,1,8,0.84
10,8,dictate,7,196,2,5,0.64
10,8,dig,3,197,2,1,0.24
10,8,dinner,6,198,2,4,0.64
10,8,diplomat,8,199,2,6,0.72
10,8,diplomatic,10,200,8,2,0.56
10,8,dirt,4,201,2,2,0.32
10,8,dirty,5,202,4,1,0.44
10,8,disclosure,10,203,2,8,0.92
10,8,discount,8,204,4,4,0.6
10,8,discretion,10,205,4,6,1
10,8,discuss,7,206,4,3,0.52
10,8,discussion,10,207,7,3,0.64
10,8,display,7,208,3,4,0.56
10,8,distant,7,209,3,4,0.68
10,8,distort,7,210,4,3,0.52
10,8,distribute,10,211,4,6,0.8
10,8,divine,6,212,2,4,0.6
10,8,divorced,8,213,3,5,0.68
10,8,dot,3,214,1,2,0.28
10,8,downstairs,10,215,2,8,0.88
10,8,drawing,7,216,1,6,0.8
10,8,duration,8,217,1,7,0.76
10,8,dust,4,218,2,2,0.32
10,8,ear,3,219,0,3,0.36
10,8,earnings,8,220,3,5,0.68
10,8,earth,5,221,3,2,0.48
10,8,edition,7,222,1,6,0.68
10,8,effective,9,223,1,8,0.88
10,8,eighty,6,224,1,5,0.56
10,8,eleven,6,225,1,5,0.68
10,8,eliminate,9,226,2,7,0.8
10,8,elsewhere,9,227,2,7,0.8
10,8,emergence,9,228,1,8,1
10,8,emission,8,229,2,6,0.72
10,8,empirical,9,230,2,7,0.8
10,8,employer,8,231,3,5,0.8
10,8,empower,7,232,3,4,0.56
10,8,engineer,8,233,1,7,0.76
10,8,enjoy,5,234,2,3,0.44
10,8,enjoyable,9,235,5,4,0.76
10,8,enormous,8,236,2,6,0.84
10,8,enter,5,237,2,3,0.52
10,8,enterprise,10,238,5,5,0.96
10,8,enthusiast,10,239,3,7,0.88
10,8,entitle,7,240,3,4,0.6
10,8,entry,5,241,3,2,0.4
10,8,equipment,9,242,1,8,1.32
10,8,erect,5,243,1,4,0.48
10,8,establish,9,244,1,8,0.88
10,8,evening,7,245,1,6,0.72
10,8,exact,5,246,1,4,0.6
10,8,exceed,6,247,2,4,0.52
10,8,excited,7,248,3,4,0.6
10,8,exciting,8,249,5,3,0.68
10,8,exclusive,9,250,3,6,0.96
10,8,excuse,6,251,3,3,0.48
10,8,execution,9,252,2,7,0.92
10,8,exercise,8,253,3,5,0.88
10,8,exhibition,10,254,2,8,0.92
10,8,existence,9,255,2,7,0.8
10,8,expensive,9,256,2,7,0.96
10,8,experiment,10,257,4,6,0.8
10,8,explode,7,258,3,4,0.56
10,8,exploit,7,259,5,2,0.44
10,8,explosive,9,260,5,4,0.76
10,8,extend,6,261,2,4,0.52
10,8,extensive,9,262,5,4,0.64
10,8,extremist,9,263,3,6,0.88
10,8,eye,3,264,1,2,0.32
10,8,fail,4,265,0,4,0.52
10,8,failed,6,266,4,2,0.48
10,8,failure,7,267,4,3,0.6
10,8,fair,4,268,3,1,0.28
10,8,famous,6,269,2,4,0.68
10,8,fantastic,9,270,2,7,0.88
10,8,fast,4,271,2,2,0.36
10,8,fasten,6,272,4,2,0.44
10,8,fat,3,273,2,1,0.36
10,8,fellow,6,274,1,5,0.6
10,8,fibre,5,275,1,4,0.52
10,8,fiction,7,276,2,5,0.64
10,8,fight,5,277,2,3,0.48
10,8,fine,4,278,2,2,0.44
10,8,fixed,5,279,2,3,0.44
10,8,flag,4,280,1,3,0.4
10,8,flexible,8,281,2,6,0.72
10,8,floor,5,282,2,3,0.44
10,8,flourish,8,283,3,5,0.76
10,8,flower,6,284,3,3,0.48
10,8,flu,3,285,2,1,0.24
10,8,flying,6,286,2,4,0.52
10,8,focus,5,287,1,4,0.48
10,8,folk,4,288,2,2,0.44
10,8,force,5,289,2,3,0.44
10,8,foreign,7,290,3,4,0.56
10,8,foreigner,9,291,7,2,0.56
10,8,founder,7,292,2,5,0.72
10,8,frequent,8,293,1,7,0.76
10,8,friday,6,294,2,4,0.52
10,8,fridge,6,295,4,2,0.4
10,8,friendly,8,296,3,5,0.8
10,8,frighten,8,297,3,5,0.76
10,8,frightened,10,298,8,2,0.68
10,8,front,5,299,2,3,0.48
10,8,full,4,300,1,3,0.52
10,8,funding,7,301,2,5,0.68
10,8,fur,3,302,2,1,0.24
10,8,garage,6,303,0,6,0.68
10,8,gender,6,304,1,5,0.6
10,8,gene,4,305,3,1,0.4
10,8,genetic,7,306,4,3,0.52
10,8,genuinely,9,307,3,6,0.76
10,8,glass,5,308,1,4,0.52
10,8,glimpse,7,309,2,5,0.72
10,8,globe,5,310,2,3,0.4
10,8,god,3,311,1,2,0.28
10,8,governor,8,312,2,6,0.68
10,8,grace,5,313,1,4,0.48
10,8,grade,5,314,3,2,0.48
10,8,grey,4,315,2,2,0.32
10,8,grin,4,316,2,2,0.32
10,8,grind,5,317,4,1,0.32
10,8,ground,6,318,2,4,0.52
10,8,guerrilla,9,319,1,8,1
10,8,guess,5,320,3,2,0.36
10,8,guest,5,321,4,1,0.32
10,8,guidance,8,322,2,6,0.72
10,8,guide,5,323,4,1,0.4
10,8,guitar,6,324,3,3,0.44
10,8,guy,3,325,2,1,0.24
10,8,gym,3,326,1,2,0.28
10,8,happen,6,327,0,6,0.64
10,8,harbour,7,328,2,5,0.6
10,8,harsh,5,329,3,2,0.48
10,8,hat,3,330,2,1,0.24
10,8,headline,8,331,1,7,0.76
10,8,heart,5,332,3,2,0.36
10,8,her,3,333,2,1,0.24
10,8,hers,4,334,3,1,0.4
10,8,hint,4,335,1,3,0.36
10,8,honesty,7,336,1,6,0.64
10,8,horror,6,337,2,4,0.52
10,8,hotel,5,338,2,3,0.44
10,8,how,3,339,2,1,0.36
10,8,humanity,8,340,1,7,0.76
10,8,humble,6,341,3,3,0.44
10,8,humour,6,342,3,3,0.44
10,8,hunger,6,343,2,4,0.52
10,8,hunt,4,344,3,1,0.36
10,8,hurricane,9,345,2,7,0.8
10,8,hydrogen,8,346,1,7,0.76
10,8,i,1,347,0,1,0.16
10,8,icon,4,348,1,3,0.48
10,8,ignorance,9,349,1,8,0.84
10,8,imaginary,9,350,1,8,0.88
10,8,impatient,9,351,2,7,0.92
10,8,improve,7,352,3,4,0.6
10,8,inclusion,9,353,1,8,0.88
10,8,incur,5,354,3,2,0.44
10,8,index,5,355,2,3,0.48
10,8,inevitable,10,356,2,8,1.04
10,8,influence,9,357,2,7,0.84
10,8,inform,6,358,3,3,0.56
10,8,informal,8,359,6,2,0.68
10,8,inherent,8,360,2,6,0.84
10,8,initiate,8,361,2,6,0.76
10,8,inject,6,362,2,4,0.56
10,8,injure,6,363,3,3,0.6
10,8,injury,6,364,5,1,0.36
10,8,insert,6,365,2,4,0.52
10,8,insertion,9,366,6,3,0.64
10,8,instant,7,367,3,4,0.68
10,8,instruct,8,368,4,4,0.6
10,8,instrument,10,369,6,4,0.68
10,8,insurance,9,370,3,6,0.88
10,8,integral,8,371,2,6,0.72
10,8,intense,7,372,4,3,0.52
10,8,invade,6,373,2,4,0.52
10,8,invest,6,374,3,3,0.56
10,8,iron,4,375,1,3,0.4
10,8,jewellery,9,376,0,9,1.08
10,8,journalism,10,377,1,9,1.04
10,8,joy,3,378,2,1,0.36
10,8,knife,5,379,0,5,0.52
10,8,lack,4,380,0,4,0.44
10,8,lad,3,381,2,1,0.24
10,8,lake,4,382,2,2,0.36
10,8,landmark,8,383,2,6,0.84
10,8,lap,3,384,2,1,0.24
10,8,laser,5,385,2,3,0.44
10,8,latest,6,386,2,4,0.52
10,8,law,3,387,2,1,0.24
10,8,lawn,4,388,3,1,0.28
10,8,leading,7,389,1,6,0.76
10,8,league,6,390,3,3,0.28
10,8,left,4,391,2,2,0.16
10,8,legitimate,10,392,2,8,0.4
10,8,lemon,5,393,2,3,0.24
10,8,lesser,6,394,2,4,0.24
10,8,lethal,6,395,2,4,0.24
10,8,letter,6,396,3,3,0.2
10,8,license,7,397,1,6,0.36
10,8,lie,3,398,2,1,0.12
10,8,lifestyle,9,399,2,7,0.36
10,8,likelihood,10,400,2,8,0.4
10,8,limited,7,401,2,5,0.32
10,8,literary,8,402,2,6,0.32
10,8,literature,10,403,6,4,0.28
10,8,litter,6,404,3,3,0.2
10,8,little,6,405,4,2,0.24
10,8,location,8,406,1,7,0.32
10,8,long,4,407,2,2,0.12
10,8,loose,5,408,2,3,0.16
10,8,lot,3,409,2,1,0.08
10,8,low,3,410,2,1,0.16
10,8,main,4,411,0,4,0.2
10,8,mainland,8,412,4,4,0.24
10,8,mainstream,10,413,4,6,0.36
10,8,map,3,414,2,1,0.08
10,8,marine,6,415,2,4,0.28
10,8,mark,4,416,3,1,0.12
10,8,mask,4,417,2,2,0.12
10,8,match,5,418,2,3,0.2
10,8,meal,4,419,1,3,0.16
10,8,meaningful,10,420,3,7,0.44
10,8,meanwhile,9,421,4,5,0.32
10,8,mechanical,10,422,2,8,0.4
10,8,meeting,7,423,2,5,0.32
10,8,melody,6,424,2,4,0.2
10,8,memory,6,425,2,4,0.24
10,8,mention,7,426,2,5,0.36
10,8,mentor,6,427,4,2,0.28
10,8,metre,5,428,2,3,0.2
10,8,minister,8,429,1,7,0.32
10,8,miserable,9,430,2,7,0.36
10,8,missing,7,431,3,4,0.32
10,8,mobilize,8,432,1,7,0.32
10,8,model,5,433,2,3,0.16
10,8,modify,6,434,3,3,0.2
10,8,moment,6,435,2,4,0.28
10,8,monument,8,436,2,6,0.32
10,8,mouth,5,437,2,3,0.16
10,8,much,4,438,1,3,0.16
10,8,mum,3,439,2,1,0.08
10,8,music,5,440,2,3,0.28
10,8,musician,8,441,5,3,0.24
10,8,my,2,442,1,1,0.08
10,8,myth,4,443,2,2,0.12
10,8,nationwide,10,444,0,10,0.44
10,8,nature,6,445,3,3,0.28
10,8,needle,6,446,1,5,0.24
10,8,neutral,7,447,2,5,0.28
10,8,newspaper,9,448,2,7,0.36
10,8,noise,5,449,1,4,0.28
10,8,noisy,5,450,4,1,0.12
10,8,norm,4,451,2,2,0.12
10,8,normal,6,452,4,2,0.2
10,8,northern,8,453,3,5,0.36
10,8,not,3,454,2,1,0.12
10,8,numerous,8,455,1,7,0.32
10,8,nut,3,456,2,1,0.08
10,8,obesity,7,457,0,7,0.32
10,8,oblige,6,458,2,4,0.28
10,8,occupation,10,459,1,9,0.4
10,8,october,7,460,2,5,0.28
10,8,off,3,461,1,2,0.12
10,8,offend,6,462,3,3,0.28
10,8,opposed,7,463,1,6,0.28
10,8,optimistic,10,464,2,8,0.4
10,8,organized,9,465,1,8,0.44
10,8,other,5,466,1,4,0.2
10,8,otherwise,9,467,5,4,0.28
10,8,outbreak,8,468,1,7,0.32
10,8,outdoors,8,469,3,5,0.36
10,8,outfit,6,470,3,3,0.2
10,8,outing,6,471,3,3,0.2
10,8,outlet,6,472,3,3,0.2
10,8,outlook,7,473,4,3,0.28
10,8,overall,7,474,1,6,0.32
10,8,oversee,7,475,4,3,0.2
10,8,pack,4,476,0,4,0.2
10,8,page,4,477,2,2,0.16
10,8,paint,5,478,2,3,0.24
10,8,palace,6,479,2,4,0.2
10,8,park,4,480,2,2,0.12
10,8,particular,10,481,3,7,0.36
10,8,partner,7,482,4,3,0.28
10,8,passenger,9,483,2,7,0.36
10,8,passport,8,484,4,4,0.24
10,8,peaceful,8,485,1,7,0.32
10,8,peculiar,8,486,2,6,0.36
10,8,pepper,6,487,2,4,0.24
10,8,perceive,8,488,2,6,0.28
10,8,perfect,7,489,3,4,0.32
10,8,personnel,9,490,3,6,0.32
10,8,philosophy,10,491,1,9,0.4
10,8,phone,5,492,2,3,0.16
10,8,photo,5,493,3,2,0.24
10,8,pile,4,494,1,3,0.16
10,8,pioneer,7,495,2,5,0.52
10,8,pipe,4,496,2,2,0.16
10,8,plan,4,497,1,3,0.16
10,8,plane,5,498,4,1,0.2
10,8,pleased,7,499,2,5,0.28
10,8,plot,4,500,2,2,0.12
10,8,point,5,501,1,4,0.2
10,8,pollution,9,502,2,7,0.36
10,8,portion,7,503,2,5,0.32
10,8,position,8,504,2,6,0.32
10,8,post,4,505,3,1,0.12
10,8,praise,6,506,1,5,0.28
10,8,prayer,6,507,3,3,0.28
10,8,precise,7,508,2,5,0.24
10,8,pregnant,8,509,3,5,0.28
10,8,prejudice,9,510,3,6,0.44
10,8,premier,7,511,3,4,0.24
10,8,presence,8,512,3,5,0.28
10,8,presently,9,513,6,3,0.24
10,8,prevention,10,514,3,7,0.44
10,8,principle,9,515,2,7,0.36
10,8,printing,8,516,4,4,0.28
10,8,prior,5,517,3,2,0.16
10,8,priority,8,518,5,3,0.32
10,8,procedure,9,519,2,7,0.36
10,8,processing,10,520,5,5,0.32
10,8,product,7,521,3,4,0.32
10,8,program,7,522,3,4,0.24
10,8,prominent,9,523,3,6,0.32
10,8,propaganda,10,524,3,7,0.44
10,8,proportion,10,525,4,6,0.32
10,8,proposal,8,526,5,3,0.24
10,8,prosperity,10,527,3,7,0.44
10,8,protest,7,528,3,4,0.24
10,8,protester,9,529,7,2,0.24
10,8,publicity,9,530,1,8,0.36
10,8,pupil,5,531,2,3,0.28
10,8,pure,4,532,2,2,0.12
10,8,push,4,533,2,2,0.16
10,8,puzzle,6,534,2,4,0.24
10,8,racial,6,535,0,6,0.28
10,8,racism,6,536,4,2,0.24
10,8,rail,4,537,2,2,0.12
10,8,rally,5,538,2,3,0.16
10,8,rational,8,539,2,6,0.28
10,8,realm,5,540,1,4,0.2
10,8,reasoning,9,541,3,6,0.4
10,8,recall,6,542,2,4,0.2
10,8,recycle,7,543,3,4,0.24
10,8,reduction,9,544,2,7,0.44
10,8,referee,7,545,2,5,0.24
10,8,reference,9,546,6,3,0.24
10,8,refuse,6,547,3,3,0.2
10,8,regard,6,548,2,4,0.28
10,8,regime,6,549,3,3,0.2
10,8,region,6,550,4,2,0.16
10,8,regional,8,551,6,2,0.2
10,8,regulatory,10,552,3,7,0.4
10,8,reign,5,553,2,3,0.16
10,8,relaxed,7,554,2,5,0.28
10,8,relevance,9,555,3,6,0.32
10,8,relieved,8,556,3,5,0.36
10,8,religious,9,557,4,5,0.28
10,8,remove,6,558,2,4,0.2
10,8,replace,7,559,2,5,0.32
10,8,research,8,560,2,6,0.28
10,8,reside,6,561,3,3,0.2
10,8,respective,10,562,3,7,0.36
10,8,rest,4,563,3,1,0.2
10,8,retail,6,564,2,4,0.24
10,8,retrieve,8,565,3,5,0.28
10,8,revenge,7,566,2,5,0.28
10,8,revise,6,567,3,3,0.28
10,8,revision,8,568,5,3,0.24
10,8,revive,6,569,4,2,0.16
10,8,right,5,570,1,4,0.2
10,8,rip,3,571,2,1,0.08
10,8,ritual,6,572,2,4,0.28
10,8,rival,5,573,2,3,0.2
10,8,road,4,574,1,3,0.16
10,8,robbery,7,575,2,5,0.28
10,8,roll,4,576,2,2,0.12
10,8,romance,7,577,2,5,0.32
10,8,rotate,6,578,2,4,0.24
10,8,rough,5,579,2,3,0.2
10,8,round,5,580,3,2,0.16
10,8,rub,3,581,1,2,0.12
10,8,rubber,6,582,3,3,0.28
10,8,rubbish,7,583,4,3,0.2
10,8,ruin,4,584,2,2,0.12
10,8,sacred,6,585,0,6,0.28
10,8,sample,6,586,2,4,0.2
10,8,sand,4,587,2,2,0.2
10,8,scan,4,588,1,3,0.16
10,8,schedule,8,589,2,6,0.28
10,8,scholar,7,590,3,4,0.24
10,8,school,6,591,4,2,0.24
10,8,score,5,592,2,3,0.2
10,8,seal,4,593,1,3,0.16
10,8,secretary,9,594,2,7,0.36
10,8,secure,6,595,3,3,0.2
10,8,seeker,6,596,2,4,0.28
10,8,segment,7,597,2,5,0.24
10,8,seminar,7,598,2,5,0.24
10,8,sensible,8,599,2,6,0.32
10,8,seriously,9,600,2,7,0.44
10,8,settlement,10,601,2,8,0.4
10,8,severely,8,602,2,6,0.28
10,8,sexual,6,603,2,4,0.32
10,8,share,5,604,1,4,0.2
10,8,sheer,5,605,2,3,0.2
10,8,shift,5,606,2,3,0.16
10,8,shiny,5,607,3,2,0.16
10,8,ship,4,608,3,1,0.2
10,8,shoot,5,609,2,3,0.2
10,8,shore,5,610,3,2,0.16
10,8,shortage,8,611,4,4,0.24
10,8,sibling,7,612,1,6,0.36
10,8,sight,5,613,2,3,0.2
10,8,signature,9,614,3,6,0.32
10,8,simply,6,615,2,4,0.2
10,8,sin,3,616,2,1,0.08
10,8,sink,4,617,3,1,0.2
10,8,sister,6,618,2,4,0.24
10,8,sit,3,619,2,1,0.12
10,8,six,3,620,2,1,0.08
10,8,skip,4,621,1,3,0.16
10,8,skirt,5,622,3,2,0.16
10,8,soap,4,623,1,3,0.24
10,8,solar,5,624,2,3,0.2
10,8,some,4,625,2,2,0.12
10,8,somehow,7,626,4,3,0.2
10,8,something,9,627,4,5,0.28
10,8,soup,4,628,2,2,0.24
10,8,south,5,629,3,2,0.16
10,8,spare,5,630,1,4,0.2
10,8,speaker,7,631,2,5,0.24
10,8,specialist,10,632,3,7,0.44
10,8,sphere,6,633,2,4,0.2
10,8,spokesman,9,634,2,7,0.36
10,8,stable,6,635,1,5,0.24
10,8,staff,5,636,3,2,0.24
10,8,stall,5,637,3,2,0.16
10,8,stance,6,638,3,3,0.2
10,8,stand,5,639,4,1,0.12
10,8,standing,8,640,5,3,0.24
10,8,star,4,641,3,1,0.2
10,8,statue,6,642,3,3,0.2
10,8,stay,4,643,3,1,0.12
10,8,stem,4,644,2,2,0.12
10,8,stick,5,645,2,3,0.2
10,8,stop,4,646,2,2,0.16
10,8,store,5,647,3,2,0.24
10,8,story,5,648,4,1,0.16
10,8,straight,8,649,2,6,0.28
10,8,striking,8,650,3,5,0.28
10,8,study,5,651,2,3,0.28
10,8,stumble,7,652,3,4,0.24
10,8,stun,4,653,3,1,0.12
10,8,substance,9,654,1,8,0.36
10,8,such,4,655,2,2,0.16
10,8,sue,3,656,2,1,0.16
10,8,sugar,5,657,2,3,0.2
10,8,sure,4,658,2,2,0.12
10,8,surgical,8,659,3,5,0.28
10,8,suspension,10,660,2,8,0.44
10,8,swear,5,661,1,4,0.2
10,8,sweater,7,662,4,3,0.2
10,8,switch,6,663,2,4,0.2
10,8,symptom,7,664,1,6,0.28
10,8,synthesis,9,665,2,7,0.44
10,8,tail,4,666,0,4,0.2
10,8,talent,6,667,2,4,0.24
10,8,tap,3,668,2,1,0.12
10,8,task,4,669,2,2,0.24
10,8,tea,3,670,1,2,0.12
10,8,television,10,671,2,8,0.4
10,8,tendency,8,672,2,6,0.32
10,8,tender,6,673,5,1,0.24
10,8,tension,7,674,3,4,0.24
10,8,terribly,8,675,2,6,0.32
10,8,terror,6,676,4,2,0.16
10,8,textbook,8,677,2,6,0.4
10,8,therapist,9,678,1,8,0.36
10,8,thesis,6,679,3,3,0.2
10,8,thorough,8,680,2,6,0.28
10,8,three,5,681,2,3,0.24
10,8,thumb,5,682,2,3,0.2
10,8,ticket,6,683,1,5,0.24
10,8,tidy,4,684,2,2,0.12
10,8,tighten,7,685,2,5,0.24
10,8,to,2,686,1,1,0.16
10,8,tolerance,9,687,2,7,0.36
10,8,tonight,7,688,2,5,0.24
10,8,tonne,5,689,3,2,0.16
10,8,tool,4,690,2,2,0.12
10,8,topic,5,691,2,3,0.24
10,8,torture,7,692,2,5,0.24
10,8,tour,4,693,2,2,0.16
10,8,trademark,9,694,1,8,0.36
10,8,tragic,6,695,3,3,0.28
10,8,trainer,7,696,3,4,0.24
10,8,transcript,10,697,3,7,0.36
10,8,tree,4,698,2,2,0.16
10,8,tribal,6,699,2,4,0.32
10,8,trio,4,700,3,1,0.12
10,8,tropical,8,701,2,6,0.32
10,8,trousers,8,702,3,5,0.28
10,8,two,3,703,1,2,0.12
10,8,unable,6,704,0,6,0.36
10,8,undergo,7,705,2,5,0.24
10,8,undermine,9,706,5,4,0.28
10,8,underwear,9,707,5,4,0.36
10,8,unfair,6,708,2,4,0.24
10,8,unique,6,709,2,4,0.24
10,8,universe,8,710,3,5,0.28
10,8,unusual,7,711,2,5,0.36
10,8,unveil,6,712,2,4,0.24
10,8,uphold,6,713,1,5,0.24
10,8,usage,5,714,1,4,0.2
10,8,utility,7,715,1,6,0.36
10,8,vague,5,716,0,5,0.52
10,8,validity,8,717,2,6,0.72
10,8,valley,6,718,3,3,0.48
10,8,valuable,8,719,3,5,0.84
10,8,variety,7,720,2,5,0.6
10,8,vein,4,721,1,3,0.4
10,8,veteran,7,722,2,5,0.64
10,8,violent,7,723,1,6,0.72
10,8,virtual,7,724,2,5,0.84
10,8,virtue,6,725,5,1,0.44
10,8,virus,5,726,3,2,0.44
10,8,visitor,7,727,2,5,0.68
10,8,wait,4,728,0,4,0.6
10,8,waiter,6,729,4,2,0.44
10,8,wake,4,730,2,2,0.36
10,8,watch,5,731,2,3,0.44
10,8,water,5,732,3,2,0.4
10,8,weakness,8,733,1,7,0.88
10,8,wealthy,7,734,3,4,0.56
10,8,weapon,6,735,3,3,0.48
10,8,weekend,7,736,2,5,0.6
10,8,weight,6,737,2,4,0.64
10,8,welcome,7,738,2,5,0.6
10,8,which,5,739,1,4,0.48
10,8,whose,5,740,2,3,0.44
10,8,willing,7,741,1,6,0.76
10,8,win,3,742,2,1,0.36
10,8,wine,4,743,3,1,0.28
10,8,woman,5,744,1,4,0.48
10,8,wonderful,9,745,2,7,0.8
10,8,word,4,746,2,2,0.32
10,8,work,4,747,3,1,0.4
10,8,workforce,9,748,4,5,0.72
10,8,workplace,9,749,4,5,0.68
10,8,worry,5,750,3,2,0.36
10,8,wow,3,751,2,1,0.32
10,8,wrap,4,752,1,3,0.4
10,8,wrist,5,753,2,3,0.4
10,8,youngster,9,754,0,9,0.92
10,9,absolutely,10,0,0,10,1.16
10,9,absurd,6,1,3,3,0.48
10,9,academic,8,2,1,7,0.84
10,9,accurate,8,3,2,6,0.72
10,9,acid,4,4,2,2,0.44
10,9,actress,7,5,2,5,0.6
10,9,adaptation,10,6,1,9,0.92
10,9,add,3,7,2,1,0.24
10,9,adequately,10,8,2,8,1
10,9,adj,3,9,2,1,0.24
10,9,adjacent,8,10,3,5,0.64
10,9,admit,5,11,2,3,0.4
10,9,adolescent,10,12,2,8,1.08
10,9,adopt,5,13,3,2,0.4
10,9,adoption,8,14,5,3,0.64
10,9,advantage,9,15,2,7,0.8
10,9,adventure,9,16,3,6,0.84
10,9,affordable,10,17,1,9,0.96
10,9,aftermath,9,18,2,7,0.8
10,9,afterwards,10,19,5,5,0.84
10,9,again,5,20,1,4,0.48
10,9,against,7,21,5,2,0.44
10,9,aggression,10,22,2,8,1
10,9,aggressive,10,23,8,2,0.56
10,9,ahead,5,24,1,4,0.48
10,9,ally,4,25,1,3,0.4
10,9,ambassador,10,26,1,9,1.08
10,9,ambulance,9,27,3,6,0.76
10,9,analyse,7,28,1,6,0.68
10,9,ancient,7,29,2,5,0.6
10,9,and,3,30,2,1,0.36
10,9,animal,6,31,2,4,0.84
10,9,ankle,5,32,2,3,0.48
10,9,annoyed,7,33,2,5,0.64
10,9,anybody,7,34,2,5,0.92
10,9,anyway,6,35,3,3,0.48
10,9,apologize,9,36,1,8,0.92
10,9,apology,7,37,6,1,0.48
10,9,appreciate,10,38,2,8,1.04
10,9,approach,8,39,4,4,0.6
10,9,approve,7,40,5,2,0.44
10,9,argue,5,41,1,4,0.48
10,9,arms,4,42,2,2,0.48
10,9,army,4,43,3,1,0.32
10,9,arrow,5,44,2,3,0.52
10,9,artist,6,45,2,4,0.56
10,9,associate,9,46,1,8,0.84
10,9,attachment,10,47,1,9,1.2
10,9,auction,7,48,1,6,0.64
10,9,average,7,49,1,6,0.4
10,9,backing,7,50,0,7,0.44
10,9,base,4,51,2,2,0.16
10,9,bath,4,52,2,2,0.16
10,9,bay,3,53,2,1,0.12
10,9,beast,5,54,1,4,0.24
10,9,beat,4,55,3,1,0.12
10,9,beg,3,56,2,1,0.2
10,9,behalf,6,57,2,4,0.24
10,9,behave,6,58,4,2,0.16
10,9,belief,6,59,2,4,0.24
10,9,bell,4,60,3,1,0.12
10,9,belong,6,61,3,3,0.28
10,9,below,5,62,4,1,0.12
10,9,benchmark,9,63,2,7,0.36
10,9,best,4,64,2,2,0.12
10,9,betray,6,65,2,4,0.28
10,9,between,7,66,3,4,0.24
10,9,beyond,6,67,2,4,0.2
10,9,bin,3,68,1,2,0.12
10,9,bird,4,69,2,2,0.16
10,9,birthday,8,70,3,5,0.36
10,9,bishop,6,71,2,4,0.2
10,9,bitter,6,72,2,4,0.2
10,9,blade,5,73,1,4,0.2
10,9,blank,5,74,3,2,0.16
10,9,bless,5,75,2,3,0.24
10,9,blind,5,76,2,3,0.16
10,9,boat,4,77,1,3,0.16
10,9,boil,4,78,2,2,0.12
10,9,bother,6,79,2,4,0.24
10,9,bound,5,80,2,3,0.24
10,9,boundary,8,81,5,3,0.24
10,9,boyfriend,9,82,2,7,0.32
10,9,breach,6,83,1,5,0.24
10,9,break,5,84,4,1,0.2
10,9,breathe,7,85,4,3,0.2
10,9,bride,5,86,2,3,0.2
10,9,buddy,5,87,1,4,0.2
10,9,buffer,6,88,2,4,0.2
10,9,bug,3,89,2,1,0.2
10,9,burden,6,90,2,4,0.2
10,9,business,8,91,2,6,0.28
10,9,butter,6,92,2,4,0.24
10,9,cafe,4,93,0,4,0.2
10,9,cake,4,94,2,2,0.2
10,9,can,3,95,2,1,0.12
10,9,cancer,6,96,3,3,0.2
10,9,cap,3,97,2,1,0.12
10,9,capability,10,98,3,7,0.36
10,9,career,6,99,2,4,0.28
10,9,careful,7,100,4,3,0.2
10,9,carefully,9,101,7,2,0.2
10,9,carpet,6,102,3,3,0.2
10,9,cartoon,7,103,3,4,0.28
10,9,category,8,104,2,6,0.28
10,9,ceiling,7,105,1,6,0.28
10,9,celebrate,9,106,2,7,0.4
10,9,cemetery,8,107,2,6,0.32
10,9,century,7,108,2,5,0.28
10,9,ceremony,8,109,2,6,0.32
10,9,certain,7,110,3,4,0.32
10,9,certainty,9,111,7,2,0.24
10,9,challenge,9,112,1,8,0.36
10,9,chapter,7,113,3,4,0.32
10,9,character,9,114,3,6,0.32
10,9,charm,5,115,4,1,0.12
10,9,charming,8,116,5,3,0.24
10,9,chart,5,117,4,1,0.16
10,9,charter,7,118,5,2,0.24
10,9,check,5,119,2,3,0.2
10,9,cheerful,8,120,3,5,0.28
10,9,chemical,8,121,3,5,0.28
10,9,childhood,9,122,2,7,0.4
10,9,choose,6,123,2,4,0.2
10,9,chop,4,124,3,1,0.12
10,9,circle,6,125,1,5,0.32
10,9,circuit,7,126,4,3,0.28
10,9,cite,4,127,2,2,0.16
10,9,city,4,128,3,1,0.12
10,9,civil,5,129,2,3,0.16
10,9,clean,5,130,1,4,0.2
10,9,club,4,131,2,2,0.2
10,9,cluster,7,132,3,4,0.24
10,9,coffee,6,133,1,5,0.24
10,9,coincide,8,134,2,6,0.32
10,9,colourful,9,135,2,7,0.4
10,9,comedy,6,136,2,4,0.24
10,9,comment,7,137,3,4,0.24
10,9,commission,10,138,4,6,0.32
10,9,commodity,9,139,4,5,0.36
10,9,commonly,8,140,5,3,0.24
10,9,compete,7,141,3,4,0.24
10,9,completion,10,142,4,6,0.44
10,9,component,9,143,4,5,0.28
10,9,concept,7,144,2,5,0.24
10,9,concert,7,145,5,2,0.2
10,9,conclusion,10,146,4,6,0.4
10,9,conduct,7,147,3,4,0.24
10,9,confer,6,148,3,3,0.2
10,9,confess,7,149,5,2,0.28
10,9,confused,8,150,4,4,0.24
10,9,connected,9,151,3,6,0.32
10,9,constraint,10,152,3,7,0.36
10,9,consult,7,153,4,3,0.28
10,9,contend,7,154,3,4,0.24
10,9,convenient,10,155,3,7,0.36
10,9,cope,4,156,2,2,0.16
10,9,cost,4,157,2,2,0.24
10,9,could,5,158,2,3,0.2
10,9,county,6,159,3,3,0.2
10,9,creep,5,160,1,4,0.2
10,9,crime,5,161,2,3,0.2
10,9,criminal,8,162,4,4,0.36
10,9,crowd,5,163,2,3,0.2
10,9,crowded,7,164,5,2,0.2
10,9,crucial,7,165,2,5,0.28
10,9,cruel,5,166,3,2,0.24
10,9,cultivate,9,167,1,8,0.4
10,9,currency,8,168,2,6,0.32
10,9,dance,5,169,0,5,0.24
10,9,dare,4,170,2,2,0.24
10,9,darkness,8,171,3,5,0.28
10,9,deal,4,172,1,3,0.16
10,9,december,8,173,2,6,0.32
10,9,declare,7,174,3,4,0.32
10,9,deed,4,175,2,2,0.16
10,9,default,7,176,2,5,0.28
10,9,delighted,9,177,2,7,0.36
10,9,democratic,10,178,2,8,0.48
10,9,dentist,7,179,2,5,0.28
10,9,depressing,10,180,2,8,0.4
10,9,desktop,7,181,2,5,0.36
10,9,detect,6,182,2,4,0.2
10,9,detention,9,183,4,5,0.28
10,9,develop,7,184,2,5,0.28
10,9,devil,5,185,3,2,0.24
10,9,diagnosis,9,186,1,8,0.36
10,9,diagram,7,187,4,3,0.2
10,9,dictator,8,188,2,6,0.28
10,9,diplomatic,10,189,2,8,0.48
10,9,director,8,190,2,6,0.28
10,9,dirt,4,191,3,1,0.12
10,9,dirty,5,192,4,1,0.12
10,9,disabled,8,193,2,6,0.4
10,9,disastrous,10,194,4,6,0.32
10,9,discipline,10,195,3,7,0.4
10,9,discount,8,196,4,4,0.32
10,9,discuss,7,197,4,3,0.24
10,9,display,7,198,3,4,0.24
10,9,distant,7,199,3,4,0.24
10,9,divine,6,200,2,4,0.28
10,9,divorced,8,201,3,5,0.28
10,9,domain,6,202,1,5,0.24
10,9,dominant,8,203,3,5,0.28
10,9,donation,8,204,2,6,0.4
10,9,dot,3,205,2,1,0.12
10,9,download,8,206,2,6,0.32
10,9,drawing,7,207,1,6,0.28
10,9,earth,5,208,0,5,0.6
10,9,edition,7,209,1,6,0.68
10,9,editor,6,210,4,2,0.44
10,9,effective,9,211,1,8,0.88
10,9,either,6,212,1,5,0.72
10,9,elect,5,213,1,4,0.48
10,9,electrical,10,214,5,5,0.76
10,9,eleven,6,215,3,3,0.44
10,9,eliminate,9,216,2,7,0.92
10,9,embark,6,217,1,5,0.6
10,9,embody,6,218,3,3,0.48
10,9,emergency,9,219,2,7,0.96
10,9,employer,8,220,2,6,0.72
10,9,ending,6,221,1,5,0.56
10,9,endless,7,222,3,4,0.56
10,9,engineer,8,223,2,6,0.84
10,9,enrich,6,224,2,4,0.52
10,9,enthusiast,10,225,2,8,0.88
10,9,entrance,8,226,3,5,0.8
10,9,equipment,9,227,1,8,0.84
10,9,essence,7,228,1,6,0.64
10,9,euro,4,229,1,3,0.4
10,9,evidence,8,230,1,7,0.88
10,9,exception,9,231,1,8,0.84
10,9,exchange,8,232,3,5,0.64
10,9,excited,7,233,3,4,0.72
10,9,exciting,8,234,5,3,0.56
10,9,excuse,6,235,3,3,0.44
10,9,executive,9,236,2,7,1.12
10,9,exercise,8,237,3,5,0.76
10,9,exhibition,10,238,2,8,0.88
10,9,existence,9,239,2,7,0.8
10,9,exit,4,240,3,1,0.28
10,9,experiment,10,241,2,8,1.04
10,9,expire,6,242,3,3,0.44
10,9,explicitly,10,243,3,7,0.84
10,9,explode,7,244,4,3,0.64
10,9,exploit,7,245,5,2,0.44
10,9,extend,6,246,2,4,0.52
10,9,extensive,9,247,5,4,0.64
10,9,extremist,9,248,3,6,0.88
10,9,faculty,7,249,0,7,0.72
10,9,fail,4,250,2,2,0.32
10,9,fair,4,251,3,1,0.28
10,9,famous,6,252,2,4,0.64
10,9,fantastic,9,253,2,7,0.8
10,9,fantasy,7,254,6,1,0.4
10,9,fast,4,255,2,2,0.32
10,9,fasten,6,256,4,2,0.4
10,9,fear,4,257,1,3,0.48
10,9,fee,3,258,2,1,0.24
10,9,feeding,7,259,3,4,0.56
10,9,fellow,6,260,2,4,0.52
10,9,fiction,7,261,1,6,0.8
10,9,fifty,5,262,2,3,0.44
10,9,fight,5,263,2,3,0.44
10,9,file,4,264,2,2,0.32
10,9,finally,7,265,2,5,0.6
10,9,fix,3,266,2,1,0.24
10,9,fixed,5,267,3,2,0.48
10,9,flee,4,268,1,3,0.36
10,9,flexible,8,269,3,5,0.68
10,9,floor,5,270,2,3,0.52
10,9,flourish,8,271,3,5,1.12
10,9,flower,6,272,3,3,0.48
10,9,flu,3,273,2,1,0.24
10,9,folk,4,274,1,3,0.36
10,9,food,4,275,2,2,0.32
10,9,force,5,276,2,3,0.4
10,9,formerly,8,277,3,5,0.8
10,9,formula,7,278,4,3,0.52
10,9,foster,6,279,2,4,0.52
10,9,fourteen,8,280,2,6,0.72
10,9,fragment,8,281,1,7,0.88
10,9,freedom,7,282,2,5,0.6
10,9,frequent,8,283,3,5,0.64
10,9,friendly,8,284,2,6,0.84
10,9,frightened,10,285,3,7,0.84
10,9,front,5,286,2,3,0.4
10,9,fulfil,6,287,1,5,0.56
10,9,full,4,288,3,1,0.4
10,9,funding,7,289,2,5,0.6
10,9,gender,6,290,0,6,0.64
10,9,generate,8,291,3,5,0.64
10,9,genetic,7,292,4,3,0.64
10,9,genuinely,9,293,3,6,0.76
10,9,geography,9,294,2,7,0.8
10,9,give,4,295,1,3,0.36
10,9,glimpse,7,296,1,6,0.8
10,9,globe,5,297,2,3,0.44
10,9,governor,8,298,1,7,0.76
10,9,grace,5,299,1,4,0.48
10,9,grade,5,300,3,2,0.52
10,9,greet,5,301,2,3,0.4
10,9,grief,5,302,2,3,0.4
10,9,ground,6,303,2,4,0.52
10,9,guerrilla,9,304,1,8,0.84
10,9,guest,5,305,3,2,0.52
10,9,guidance,8,306,2,6,0.72
10,9,guide,5,307,4,1,0.32
10,9,handful,7,308,0,7,0.72
10,9,handy,5,309,4,1,0.44
10,9,harsh,5,310,2,3,0.4
10,9,headline,8,311,1,7,0.76
10,9,heat,4,312,3,1,0.28
10,9,heighten,8,313,2,6,0.84
10,9,her,3,314,2,1,0.24
10,9,herb,4,315,3,1,0.28
10,9,hint,4,316,1,3,0.36
10,9,historical,10,317,2,8,0.88
10,9,holiday,7,318,1,6,0.8
10,9,homeland,8,319,2,6,0.72
10,9,hotel,5,320,2,3,0.4
10,9,hour,4,321,2,2,0.32
10,9,household,9,322,3,6,1.08
10,9,how,3,323,2,1,0.64
10,9,humble,6,324,1,5,1.44
10,9,humour,6,325,3,3,1.44
10,9,hunger,6,326,2,4,1.28
10,9,hunt,4,327,3,1,0.4
10,9,hydrogen,8,328,1,7,1.24
10,9,hypothesis,10,329,2,8,1.4000000000000001
10,9,icon,4,330,0,4,0.6
10,9,identity,8,331,1,7,0.76
10,9,ignorance,9,332,1,8,0.96
10,9,implement,9,333,1,8,1.04
10,9,important,9,334,3,6,0.76
10,9,improve,7,335,3,4,0.52
10,9,inclusion,9,336,1,8,0.52
10,9,incorrect,9,337,3,6,0.32
10,9,index,5,338,2,3,0.2
10,9,individual,10,339,3,7,0.36
10,9,inevitable,10,340,2,8,0.44
10,9,infant,6,341,2,4,0.24
10,9,inform,6,342,3,3,0.2
10,9,inherent,8,343,2,6,0.36
10,9,initiate,8,344,2,6,0.32
10,9,insert,6,345,2,4,0.24
10,9,insertion,9,346,6,3,0.24
10,9,inspection,10,347,3,7,0.4
10,9,instruct,8,348,3,5,0.28
10,9,instrument,10,349,6,4,0.28
10,9,intensify,9,350,2,7,0.4
10,9,interior,8,351,4,4,0.24
10,9,involved,8,352,2,6,0.32
10,9,iron,4,353,1,3,0.16
10,9,island,6,354,1,5,0.32
10,9,isolated,8,355,2,6,0.28
10,9,jewellery,9,356,0,9,0.4
10,9,journalism,10,357,1,9,0.48
10,9,jump,4,358,1,3,0.16
10,9,june,4,359,2,2,0.12
10,9,just,4,360,2,2,0.16
10,9,key,3,361,0,3,0.16
10,9,keyboard,8,362,3,5,0.36
10,9,kidney,6,363,1,5,0.24
10,9,king,4,364,2,2,0.12
10,9,knife,5,365,1,4,0.2
10,9,lad,3,366,0,3,0.16
10,9,lake,4,367,2,2,0.16
10,9,landmark,8,368,2,6,0.36
10,9,laser,5,369,2,3,0.16
10,9,last,4,370,3,1,0.12
10,9,latest,6,371,2,4,0.24
10,9,laugh,5,372,2,3,0.2
10,9,law,3,373,2,1,0.16
10,9,lawn,4,374,3,1,0.12
10,9,leadership,10,375,1,9,0.4
10,9,leading,7,376,4,3,0.2
10,9,leaf,4,377,3,1,0.16
10,9,leaflet,7,378,4,3,0.2
10,9,legend,6,379,2,4,0.2
10,9,legitimate,10,380,3,7,0.36
10,9,lens,4,381,2,2,0.2
10,9,lesbian,7,382,2,5,0.28
10,9,lethal,6,383,2,4,0.2
10,9,letter,6,384,3,3,0.2
10,9,lion,4,385,1,3,0.16
10,9,litter,6,386,2,4,0.28
10,9,liver,5,387,2,3,0.2
10,9,load,4,388,1,3,0.16
10,9,located,7,389,2,5,0.28
10,9,long,4,390,2,2,0.16
10,9,look,4,391,2,2,0.2
10,9,low,3,392,2,1,0.12
10,9,mail,4,393,0,4,0.16
10,9,mainland,8,394,3,5,0.28
10,9,mainstream,10,395,4,6,0.36
10,9,mandate,7,396,2,5,0.32
10,9,manipulate,10,397,3,7,0.36
10,9,marine,6,398,2,4,0.2
10,9,married,7,399,3,4,0.28
10,9,mask,4,400,2,2,0.12
10,9,master,6,401,3,3,0.2
10,9,maximum,7,402,2,5,0.24
10,9,meal,4,403,1,3,0.16
10,9,mean,4,404,3,1,0.16
10,9,meanwhile,9,405,4,5,0.28
10,9,medication,10,406,2,8,0.44
10,9,memory,6,407,2,4,0.24
10,9,mental,6,408,2,4,0.32
10,9,mention,7,409,4,3,0.24
10,9,mentor,6,410,4,2,0.2
10,9,merger,6,411,2,4,0.24
10,9,mess,4,412,2,2,0.16
10,9,message,7,413,4,3,0.28
10,9,metre,5,414,2,3,0.2
10,9,minister,8,415,1,7,0.32
10,9,missing,7,416,2,5,0.28
10,9,mixed,5,417,2,3,0.24
10,9,mobilize,8,418,1,7,0.32
10,9,model,5,419,2,3,0.2
10,9,modify,6,420,3,3,0.2
10,9,money,5,421,2,3,0.24
10,9,month,5,422,3,2,0.16
10,9,monthly,7,423,5,2,0.2
10,9,movie,5,424,2,3,0.16
10,9,multiple,8,425,1,7,0.32
10,9,mum,3,426,2,1,0.16
10,9,municipal,9,427,2,7,0.32
10,9,music,5,428,2,3,0.16
10,9,must,4,429,3,1,0.12
10,9,name,4,430,0,4,0.2
10,9,nasty,5,431,2,3,0.24
10,9,nation,6,432,2,4,0.24
10,9,neck,4,433,1,3,0.16
10,9,neutral,7,434,2,5,0.28
10,9,new,3,435,2,1,0.08
10,9,newly,5,436,3,2,0.2
10,9,newspaper,9,437,3,6,0.32
10,9,noise,5,438,1,4,0.2
10,9,nominate,8,439,2,6,0.32
10,9,nomination,10,440,7,3,0.32
10,9,norm,4,441,2,2,0.12
10,9,not,3,442,2,1,0.08
10,9,notice,6,443,3,3,0.2
10,9,novel,5,444,2,3,0.16
10,9,obesity,7,445,0,7,0.36
10,9,objective,9,446,2,7,0.36
10,9,occupation,10,447,1,9,0.4
10,9,ocean,5,448,2,3,0.24
10,9,october,7,449,2,5,0.28
10,9,off,3,450,1,2,0.12
10,9,official,8,451,3,5,0.28
10,9,offspring,9,452,3,6,0.4
10,9,once,4,453,1,3,0.16
10,9,one,3,454,2,1,0.08
10,9,optimistic,10,455,1,9,0.4
10,9,organic,7,456,1,6,0.36
10,9,organized,9,457,6,3,0.24
10,9,other,5,458,1,4,0.2
10,9,otherwise,9,459,5,4,0.28
10,9,ought,5,460,1,4,0.28
10,9,outbreak,8,461,2,6,0.32
10,9,oversee,7,462,1,6,0.28
10,9,pace,4,463,0,4,0.2
10,9,pack,4,464,3,1,0.12
10,9,pad,3,465,2,1,0.16
10,9,painful,7,466,2,5,0.24
10,9,paint,5,467,4,1,0.12
10,9,palace,6,468,2,4,0.2
10,9,pants,5,469,2,3,0.16
10,9,parallel,8,470,2,6,0.36
10,9,partial,7,471,3,4,0.24
10,9,particular,10,472,5,5,0.32
10,9,partner,7,473,4,3,0.28
10,9,passenger,9,474,2,7,0.36
10,9,patent,6,475,2,4,0.24
10,9,pause,5,476,2,3,0.2
10,9,peaceful,8,477,1,7,0.4
10,9,perhaps,7,478,2,5,0.24
10,9,persistent,10,479,3,7,0.36
10,9,personnel,9,480,4,5,0.36
10,9,phone,5,481,1,4,0.2
10,9,pick,4,482,1,3,0.16
10,9,piece,5,483,2,3,0.16
10,9,pig,3,484,2,1,0.16
10,9,pile,4,485,2,2,0.2
10,9,pin,3,486,2,1,0.12
10,9,pioneer,7,487,2,5,0.32
10,9,place,5,488,1,4,0.2
10,9,plane,5,489,3,2,0.16
10,9,planning,8,490,4,4,0.24
10,9,plastic,7,491,3,4,0.28
10,9,plead,5,492,2,3,0.16
10,9,pleased,7,493,4,3,0.2
10,9,pledge,6,494,3,3,0.2
10,9,plot,4,495,2,2,0.16
10,9,pollution,9,496,1,8,0.44
10,9,population,10,497,2,8,0.4
10,9,position,8,498,2,6,0.32
10,9,possess,7,499,3,4,0.32
10,9,possible,8,500,4,4,0.28
10,9,pot,3,501,2,1,0.12
10,9,practical,9,502,1,8,0.4
10,9,prayer,6,503,3,3,0.28
10,9,precedent,9,504,2,7,0.36
10,9,premier,7,505,3,4,0.24
10,9,premise,7,506,5,2,0.2
10,9,prescribe,9,507,3,6,0.4
10,9,presence,8,508,4,4,0.24
10,9,previously,10,509,3,7,0.36
10,9,principle,9,510,2,7,0.4
10,9,printer,7,511,4,3,0.2
10,9,prior,5,512,3,2,0.16
10,9,priority,8,513,5,3,0.24
10,9,procedure,9,514,2,7,0.4
10,9,process,7,515,5,2,0.2
10,9,processor,9,516,7,2,0.24
10,9,produce,7,517,3,4,0.28
10,9,product,7,518,6,1,0.16
10,9,project,7,519,3,4,0.24
10,9,prominent,9,520,3,6,0.32
10,9,proper,6,521,3,3,0.24
10,9,properly,8,522,6,2,0.2
10,9,propose,7,523,4,3,0.24
10,9,prosperity,10,524,3,7,0.36
10,9,protest,7,525,3,4,0.28
10,9,pump,4,526,1,3,0.16
10,9,punk,4,527,2,2,0.16
10,9,pure,4,528,2,2,0.16
10,9,pursuit,7,529,3,4,0.24
10,9,put,3,530,2,1,0.16
10,9,quality,7,531,0,7,0.32
10,9,query,5,532,2,3,0.16
10,9,racial,6,533,0,6,0.28
10,9,railway,7,534,2,5,0.32
10,9,rational,8,535,2,6,0.28
10,9,react,5,536,1,4,0.2
10,9,reasoning,9,537,3,6,0.32
10,9,reception,9,538,2,7,0.4
10,9,recommend,9,539,3,6,0.32
10,9,recruit,7,540,3,4,0.28
10,9,recycle,7,541,3,4,0.36
10,9,refuse,6,542,2,4,0.2
10,9,regard,6,543,2,4,0.2
10,9,regime,6,544,3,3,0.2
10,9,region,6,545,4,2,0.2
10,9,regional,8,546,6,2,0.28
10,9,rejection,9,547,2,7,0.36
10,9,relax,5,548,2,3,0.2
10,9,relevance,9,549,3,6,0.32
10,9,relief,6,550,3,3,0.24
10,9,religious,9,551,4,5,0.32
10,9,remainder,9,552,2,7,0.32
10,9,removal,7,553,3,4,0.28
10,9,remove,6,554,5,1,0.16
10,9,reporting,9,555,2,7,0.32
10,9,residence,9,556,2,7,0.32
10,9,residue,7,557,5,2,0.24
10,9,resolve,7,558,3,4,0.24
10,9,retail,6,559,2,4,0.24
10,9,reveal,6,560,2,4,0.2
10,9,revenge,7,561,4,3,0.28
10,9,revise,6,562,3,3,0.2
10,9,revive,6,563,4,2,0.16
10,9,rip,3,564,1,2,0.12
10,9,rise,4,565,2,2,0.16
10,9,ritual,6,566,2,4,0.28
10,9,rob,3,567,1,2,0.12
10,9,robbery,7,568,3,4,0.24
10,9,romance,7,569,2,5,0.28
10,9,root,4,570,2,2,0.16
10,9,rough,5,571,2,3,0.24
10,9,routine,7,572,3,4,0.24
10,9,rubber,6,573,1,5,0.24
10,9,sacred,6,574,0,6,0.24
10,9,safe,4,575,2,2,0.16
10,9,sailor,6,576,2,4,0.28
10,9,salt,4,577,2,2,0.12
10,9,sample,6,578,2,4,0.2
10,9,satisfy,7,579,2,5,0.28
10,9,scan,4,580,1,3,0.24
10,9,schedule,8,581,2,6,0.32
10,9,scheme,6,582,4,2,0.2
10,9,scientific,10,583,2,8,0.4
10,9,scientist,9,584,7,2,0.32
10,9,score,5,585,2,3,0.16
10,9,secretary,9,586,1,8,0.36
10,9,secure,6,587,3,3,0.2
10,9,september,9,588,2,7,0.4
10,9,serious,7,589,2,5,0.28
10,9,serve,5,590,3,2,0.16
10,9,service,7,591,4,3,0.24
10,9,setting,7,592,2,5,0.36
10,9,settlement,10,593,4,6,0.36
10,9,settler,7,594,6,1,0.16
10,9,seven,5,595,2,3,0.2
10,9,shape,5,596,1,4,0.28
10,9,share,5,597,3,2,0.16
10,9,shell,5,598,2,3,0.16
10,9,shift,5,599,2,3,0.16
10,9,ship,4,600,3,1,0.12
10,9,shipping,8,601,4,4,0.32
10,9,shortly,7,602,2,5,0.24
10,9,signature,9,603,1,8,0.36
10,9,silver,6,604,2,4,0.2
10,9,similarly,9,605,2,7,0.4
10,9,simply,6,606,3,3,0.2
10,9,sister,6,607,2,4,0.2
10,9,situated,8,608,2,6,0.4
10,9,six,3,609,2,1,0.08
10,9,ski,3,610,1,2,0.12
10,9,skirt,5,611,3,2,0.16
10,9,skull,5,612,2,3,0.16
10,9,slip,4,613,1,3,0.16
10,9,smile,5,614,1,4,0.24
10,9,smoking,7,615,2,5,0.28
10,9,soap,4,616,1,3,0.16
10,9,solar,5,617,2,3,0.2
10,9,solid,5,618,3,2,0.16
10,9,solo,4,619,3,1,0.12
10,9,song,4,620,2,2,0.2
10,9,spare,5,621,1,4,0.2
10,9,speak,5,622,2,3,0.2
10,9,speaker,7,623,5,2,0.2
10,9,special,7,624,3,4,0.28
10,9,specialist,10,625,7,3,0.28
10,9,specify,7,626,5,2,0.2
10,9,spectator,9,627,4,5,0.28
10,9,speech,6,628,3,3,0.24
10,9,spin,4,629,2,2,0.16
10,9,spine,5,630,4,1,0.12
10,9,spokesman,9,631,2,7,0.36
10,9,spread,6,632,2,4,0.28
10,9,stab,4,633,1,3,0.16
10,9,staff,5,634,3,2,0.16
10,9,stamp,5,635,3,2,0.16
10,9,stand,5,636,3,2,0.16
10,9,steadily,8,637,2,6,0.36
10,9,steer,5,638,3,2,0.16
10,9,stereotype,10,639,3,7,0.36
10,9,stick,5,640,2,3,0.16
10,9,stop,4,641,2,2,0.16
10,9,store,5,642,3,2,0.2
10,9,strange,7,643,2,5,0.28
10,9,strategic,9,644,4,5,0.28
10,9,strategy,8,645,7,1,0.2
10,9,street,6,646,3,3,0.28
10,9,strike,6,647,3,3,0.2
10,9,striking,8,648,5,3,0.24
10,9,string,6,649,4,2,0.16
10,9,studio,6,650,2,4,0.28
10,9,study,5,651,4,1,0.12
10,9,stun,4,652,3,1,0.12
10,9,such,4,653,1,3,0.16
10,9,sudden,6,654,2,4,0.2
10,9,sufficient,10,655,2,8,0.44
10,9,super,5,656,2,3,0.2
10,9,supreme,7,657,3,4,0.24
10,9,surely,6,658,2,4,0.24
10,9,survival,8,659,3,5,0.36
10,9,suspension,10,660,2,8,0.4
10,9,symbolic,8,661,1,7,0.32
10,9,symptom,7,662,3,4,0.28
10,9,synthesis,9,663,2,7,0.4
10,9,table,5,664,0,5,0.24
10,9,tactical,8,665,2,6,0.28
10,9,talent,6,666,2,4,0.52
10,9,talk,4,667,3,1,0.28
10,9,tank,4,668,2,2,0.32
10,9,tap,3,669,2,1,0.24
10,9,taste,5,670,2,3,0.4
10,9,tea,3,671,1,2,0.28
10,9,team,4,672,3,1,0.28
10,9,tempt,5,673,2,3,0.56
10,9,tendency,8,674,2,6,0.72
10,9,tension,7,675,3,4,0.56
10,9,textbook,8,676,2,6,0.68
10,9,themselves,10,677,1,9,1.04
10,9,therapist,9,678,3,6,0.72
10,9,thereby,7,679,4,3,0.48
10,9,thirsty,7,680,2,5,0.72
10,9,this,4,681,3,1,0.28
10,9,thoughtful,10,682,2,8,0.88
10,9,three,5,683,2,3,0.4
10,9,thumb,5,684,2,3,0.52
10,9,ticket,6,685,1,5,0.56
10,9,till,4,686,2,2,0.32
10,9,to,2,687,1,1,0.2
10,9,together,8,688,2,6,0.68
10,9,tolerance,9,689,2,7,0.92
10,9,tonight,7,690,2,5,0.6
10,9,tonne,5,691,3,2,0.36
10,9,topic,5,692,2,3,0.4
10,9,torture,7,693,2,5,0.72
10,9,tournament,10,694,2,8,0.88
10,9,trainer,7,695,1,6,0.64
10,9,transport,9,696,3,6,0.84
10,9,trap,4,697,3,1,0.28
10,9,treasure,8,698,2,6,0.72
10,9,treat,5,699,4,1,0.32
10,9,treaty,6,700,5,1,0.36
10,9,trend,5,701,3,2,0.48
10,9,tribe,5,702,2,3,0.44
10,9,tribute,7,703,4,3,0.48
10,9,tune,4,704,1,3,0.36
10,9,twice,5,705,1,4,0.48
10,9,undermine,9,706,0,9,1
10,9,underwear,9,707,5,4,0.64
10,9,unfair,6,708,2,4,0.52
10,9,unify,5,709,2,3,0.4
10,9,universal,9,710,3,6,0.84
10,9,universe,8,711,7,1,0.44
10,9,unusual,7,712,2,5,0.6
10,9,upgrade,7,713,1,6,0.76
10,9,upon,4,714,2,2,0.32
10,9,urgent,6,715,1,5,0.56
10,9,utilize,7,716,1,6,0.64
10,9,vague,5,717,0,5,0.52
10,9,validity,8,718,2,6,0.84
10,9,variety,7,719,2,5,0.64
10,9,vegetable,9,720,1,8,0.84
10,9,vein,4,721,2,2,0.32
10,9,verify,6,722,2,4,0.64
10,9,vessel,6,723,2,4,0.52
10,9,viable,6,724,1,5,0.56
10,9,viewer,6,725,2,4,0.6
10,9,violent,7,726,2,5,0.8
10,9,virtual,7,727,2,5,0.6
10,9,virus,5,728,3,2,0.36
10,9,visitor,7,729,2,5,0.6
10,9,vital,5,730,2,3,0.52
10,9,volunteer,9,731,1,8,0.84
10,9,walk,4,732,0,4,0.44
10,9,war,3,733,2,1,0.24
10,9,warrior,7,734,3,4,0.56
10,9,washing,7,735,2,5,0.72
10,9,weakness,8,736,1,7,0.76
10,9,wealthy,7,737,3,4,0.56
10,9,welcome,7,738,2,5,0.6
10,9,welfare,7,739,3,4,0.68
10,9,west,4,740,2,2,0.32
10,9,whatever,8,741,1,7,0.76
10,9,whereas,7,742,2,5,0.6
10,9,which,5,743,2,3,0.56
10,9,whose,5,744,2,3,0.44
10,9,width,5,745,1,4,0.48
10,9,wind,4,746,2,2,0.32
10,9,wine,4,747,3,1,0.28
10,9,within,6,748,2,4,0.6
10,9,woman,5,749,1,4,0.48
10,9,workplace,9,750,2,7,0.8
10,9,worry,5,751,3,2,0.36
10,9,wrap,4,752,1,3,0.36
10,9,yellow,6,753,0,6,0.72
10,9,youngster,9,754,1,8,0.84
11,0,a,1,0,0,1,0.08
11,0,absolutely,10,1,1,9,0.52
11,0,accident,8,2,1,7,0.32
11,0,accommodate,11,3,3,8,0.4
11,0,accompany,9,4,5,4,0.32
11,0,accordance,10,5,4,6,0.36
11,0,accurate,8,6,3,5,0.28
11,0,acre,4,7,2,2,0.12
11,0,activate,8,8,2,6,0.36
11,0,acute,5,9,2,3,0.16
11,0,ad,2,10,1,1,0.08
11,0,address,7,11,2,5,0.24
11,0,adequately,10,12,2,8,0.44
11,0,adj,3,13,2,1,0.08
11,0,advantage,9,14,2,7,0.32
11,0,adventure,9,15,3,6,0.32
11,0,advice,6,16,3,3,0.24
11,0,aesthetic,9,17,1,8,0.36
11,0,aftermath,9,18,1,8,0.36
11,0,afterwards,10,19,5,5,0.4
11,0,again,5,20,1,4,0.2
11,0,against,7,21,5,2,0.2
11,0,aggression,10,22,2,8,0.36
11,0,aggressive,10,23,8,2,0.32
11,0,agree,5,24,2,3,0.16
11,0,ahead,5,25,1,4,0.2
11,0,allocation,10,26,1,9,0.44
11,0,alongside,9,27,2,7,0.44
11,0,ambassador,10,28,1,9,0.4
11,0,ambulance,9,29,3,6,0.32
11,0,ancient,7,30,1,6,0.36
11,0,and,3,31,2,1,0.08
11,0,animal,6,32,2,4,0.2
11,0,ankle,5,33,2,3,0.16
11,0,anniversary,11,34,2,9,0.48
11,0,annoying,8,35,3,5,0.28
11,0,anxiety,7,36,2,5,0.24
11,0,apologize,9,37,1,8,0.44
11,0,apology,7,38,6,1,0.16
11,0,arguably,8,39,1,7,0.32
11,0,argue,5,40,4,1,0.12
11,0,arise,5,41,2,3,0.24
11,0,arms,4,42,2,2,0.16
11,0,arrangement,11,43,2,9,0.44
11,0,arrest,6,44,3,3,0.2
11,0,artist,6,45,2,4,0.2
11,0,ask,3,46,1,2,0.2
11,0,assault,7,47,2,5,0.24
11,0,at,2,48,1,1,0.08
11,0,auction,7,49,1,6,0.28
11,0,authorize,9,50,2,7,0.44
11,0,auto,4,51,3,1,0.12
11,0,average,7,52,1,6,0.32
11,0,baby,4,53,0,4,0.2
11,0,backing,7,54,2,5,0.24
11,0,banner,6,55,2,4,0.28
11,0,base,4,56,2,2,0.12
11,0,bath,4,57,2,2,0.16
11,0,battlefield,11,58,3,8,0.4
11,0,bay,3,59,2,1,0.16
11,0,beauty,6,60,1,5,0.24
11,0,beg,3,61,2,1,0.08
11,0,behalf,6,62,2,4,0.2
11,0,behave,6,63,4,2,0.2
11,0,bell,4,64,2,2,0.12
11,0,below,5,65,3,2,0.24
11,0,best,4,66,2,2,0.12
11,0,betray,6,67,2,4,0.24
11,0,between,7,68,3,4,0.24
11,0,beyond,6,69,2,4,0.28
11,0,bird,4,70,1,3,0.16
11,0,bite,4,71,2,2,0.16
11,0,bitter,6,72,3,3,0.2
11,0,bizarre,7,73,2,5,0.28
11,0,blade,5,74,1,4,0.28
11,0,blame,5,75,3,2,0.16
11,0,blank,5,76,3,2,0.16
11,0,bless,5,77,2,3,0.16
11,0,blind,5,78,2,3,0.16
11,0,blog,4,79,2,2,0.12
11,0,boat,4,80,1,3,0.2
11,0,boom,4,81,2,2,0.16
11,0,bother,6,82,2,4,0.2
11,0,bound,5,83,2,3,0.2
11,0,boundary,8,84,5,3,0.24
11,0,box,3,85,2,1,0.16
11,0,brand,5,86,1,4,0.2
11,0,breakdown,9,87,2,7,0.36
11,0,breathe,7,88,4,3,0.28
11,0,breathing,9,89,6,3,0.36
11,0,bridge,6,90,2,4,0.24
11,0,broken,6,91,2,4,0.24
11,0,buddy,5,92,1,4,0.2
11,0,bug,3,93,2,1,0.16
11,0,build,5,94,2,3,0.48
11,0,businessman,11,95,2,9,0.52
11,0,butter,6,96,2,4,0.24
11,0,cafe,4,97,0,4,0.2
11,0,cake,4,98,2,2,0.2
11,0,cancer,6,99,2,4,0.24
11,0,candidate,9,100,3,6,0.32
11,0,cap,3,101,2,1,0.08
11,0,carefully,9,102,2,7,0.44
11,0,carpet,6,103,3,3,0.2
11,0,carve,5,104,3,2,0.16
11,0,cd,2,105,1,1,0.08
11,0,ceiling,7,106,1,6,0.28
11,0,celebrate,9,107,2,7,0.44
11,0,celebrity,9,108,6,3,0.24
11,0,cemetery,8,109,2,6,0.32
11,0,central,7,110,2,5,0.24
11,0,century,7,111,4,3,0.32
11,0,chapter,7,112,1,6,0.32
11,0,charm,5,113,3,2,0.16
11,0,charming,8,114,5,3,0.24
11,0,chart,5,115,4,1,0.2
11,0,check,5,116,2,3,0.16
11,0,chemical,8,117,3,5,0.28
11,0,childhood,9,118,2,7,0.36
11,0,choir,5,119,2,3,0.28
11,0,chronic,7,120,2,5,0.28
11,0,chunk,5,121,2,3,0.16
11,0,circle,6,122,1,5,0.24
11,0,circuit,7,123,4,3,0.28
11,0,cite,4,124,2,2,0.2
11,0,civil,5,125,2,3,0.2
11,0,clause,6,126,1,5,0.24
11,0,clearly,7,127,2,5,0.28
11,0,clerk,5,128,3,2,0.24
11,0,clinical,8,129,2,6,0.32
11,0,cloud,5,130,2,3,0.16
11,0,collaborate,11,131,1,10,0.44
11,0,collective,10,132,4,6,0.4
11,0,colony,6,133,3,3,0.2
11,0,comedy,6,134,2,4,0.28
11,0,comfort,7,135,3,4,0.36
11,0,comfortable,11,136,7,4,0.28
11,0,comment,7,137,3,4,0.24
11,0,commodity,9,138,4,5,0.32
11,0,compassion,10,139,3,7,0.44
11,0,completion,10,140,4,6,0.32
11,0,comply,6,141,5,1,0.16
11,0,component,9,142,4,5,0.36
11,0,compulsory,10,143,4,6,0.32
11,0,conceive,8,144,2,6,0.28
11,0,concept,7,145,5,2,0.24
11,0,concern,7,146,5,2,0.2
11,0,concert,7,147,6,1,0.16
11,0,conclusion,10,148,4,6,0.32
11,0,confer,6,149,3,3,0.28
11,0,conference,10,150,6,4,0.28
11,0,connected,9,151,3,6,0.32
11,0,conscious,9,152,3,6,0.4
11,0,consult,7,153,4,3,0.24
11,0,contempt,8,154,3,5,0.28
11,0,contend,7,155,5,2,0.2
11,0,convenient,10,156,3,7,0.44
11,0,conversion,10,157,5,5,0.32
11,0,convey,6,158,5,1,0.16
11,0,coordinate,10,159,2,8,0.48
11,0,correctly,9,160,2,7,0.36
11,0,cottage,7,161,2,5,0.28
11,0,could,5,162,2,3,0.2
11,0,county,6,163,3,3,0.28
11,0,coup,4,164,3,1,0.12
11,0,couple,6,165,4,2,0.16
11,0,course,6,166,3,3,0.2
11,0,craft,5,167,1,4,0.2
11,0,create,6,168,2,4,0.36
11,0,creativity,10,169,5,5,0.32
11,0,credibility,11,170,3,8,0.4
11,0,credible,8,171,6,2,0.28
11,0,creep,5,172,3,2,0.16
11,0,crime,5,173,2,3,0.16
11,0,cross,5,174,2,3,0.16
11,0,crowd,5,175,3,2,0.16
11,0,crowded,7,176,5,2,0.24
11,0,cruel,5,177,2,3,0.2
11,0,cry,3,178,2,1,0.08
11,0,currency,8,179,1,7,0.32
11,0,dam,3,180,0,3,0.16
11,0,darkness,8,181,2,6,0.36
11,0,declare,7,182,1,6,0.28
11,0,decoration,10,183,3,7,0.36
11,0,deed,4,184,2,2,0.12
11,0,deem,4,185,3,1,0.2
11,0,default,7,186,2,5,0.28
11,0,defect,6,187,3,3,0.2
11,0,defence,7,188,4,3,0.2
11,0,defender,8,189,5,3,0.32
11,0,definitely,10,190,3,7,0.36
11,0,delighted,9,191,2,7,0.36
11,0,deliver,7,192,4,3,0.24
11,0,democracy,9,193,2,7,0.4
11,0,depression,10,194,2,8,0.4
11,0,deputy,6,195,3,3,0.2
11,0,desktop,7,196,2,5,0.32
11,0,detention,9,197,2,7,0.36
11,0,develop,7,198,2,5,0.24
11,0,diagnosis,9,199,1,8,0.44
11,0,dictate,7,200,2,5,0.24
11,0,dictator,8,201,6,2,0.2
11,0,digital,7,202,2,5,0.24
11,0,diminish,8,203,2,6,0.36
11,0,disabled,8,204,2,6,0.32
11,0,distant,7,205,3,4,0.24
11,0,divine,6,206,2,4,0.2
11,0,dominant,8,207,1,7,0.4
11,0,donation,8,208,2,6,0.32
11,0,dot,3,209,2,1,0.12
11,0,downstairs,10,210,2,8,0.4
11,0,drawing,7,211,1,6,0.36
11,0,drink,5,212,2,3,0.16
11,0,duration,8,213,1,7,0.32
11,0,dust,4,214,2,2,0.12
11,0,ear,3,215,0,3,0.2
11,0,earth,5,216,3,2,0.16
11,0,editor,6,217,1,5,0.24
11,0,effective,9,218,1,8,0.36
11,0,eight,5,219,1,4,0.2
11,0,electrical,10,220,1,9,0.48
11,0,electricity,11,221,8,3,0.28
11,0,embark,6,222,1,5,0.24
11,0,embody,6,223,3,3,0.28
11,0,emergence,9,224,2,7,0.36
11,0,emission,8,225,2,6,0.28
11,0,employer,8,226,2,6,0.36
11,0,enable,6,227,1,5,0.24
11,0,ending,6,228,2,4,0.2
11,0,endless,7,229,3,4,0.24
11,0,engineer,8,230,2,6,0.36
11,0,engineering,11,231,8,3,0.28
11,0,enormous,8,232,2,6,0.28
11,0,enter,5,233,2,3,0.24
11,0,enthusiast,10,234,3,7,0.4
11,0,entry,5,235,3,2,0.16
11,0,environment,11,236,2,9,0.44
11,0,erect,5,237,1,4,0.28
11,0,essence,7,238,1,6,0.4
11,0,evening,7,239,1,6,0.28
11,0,evoke,5,240,2,3,0.16
11,0,exceed,6,241,1,5,0.32
11,0,excellent,9,242,4,5,0.32
11,0,exchange,8,243,3,5,0.28
11,0,excited,7,244,3,4,0.24
11,0,exciting,8,245,5,3,0.32
11,0,executive,9,246,2,7,0.36
11,0,exercise,8,247,3,5,0.28
11,0,exhibition,10,248,2,8,0.44
11,0,expire,6,249,2,4,0.2
11,0,explain,7,250,3,4,0.24
11,0,explicitly,10,251,4,6,0.32
11,0,explode,7,252,4,3,0.28
11,0,extend,6,253,2,4,0.24
11,0,extensive,9,254,5,4,0.28
11,0,extremist,9,255,3,6,0.4
11,0,fail,4,256,0,4,0.2
11,0,failed,6,257,4,2,0.2
11,0,famous,6,258,2,4,0.24
11,0,fast,4,259,2,2,0.16
11,0,fasten,6,260,4,2,0.24
11,0,fee,3,261,1,2,0.12
11,0,fellow,6,262,2,4,0.2
11,0,file,4,263,1,3,0.16
11,0,finally,7,264,2,5,0.24
11,0,firefighter,11,265,2,9,0.48
11,0,firm,4,266,3,1,0.12
11,0,flavour,7,267,1,6,0.28
11,0,floor,5,268,2,3,0.2
11,0,flu,3,269,2,1,0.12
11,0,flying,6,270,2,4,0.28
11,0,folk,4,271,1,3,0.16
11,0,force,5,272,2,3,0.2
11,0,formation,9,273,3,6,0.32
11,0,formerly,8,274,4,4,0.32
11,0,fortunately,11,275,3,8,0.4
11,0,foster,6,276,2,4,0.24
11,0,foundation,10,277,2,8,0.48
11,0,founder,7,278,5,2,0.2
11,0,fourteen,8,279,3,5,0.28
11,0,friday,6,280,1,5,0.28
11,0,fridge,6,281,4,2,0.24
11,0,friendly,8,282,3,5,0.28
11,0,frightened,10,283,3,7,0.36
11,0,frog,4,284,2,2,0.12
11,0,fulfil,6,285,1,5,0.32
11,0,fur,3,286,2,1,0.08
11,0,gallon,6,287,0,6,0.28
11,0,game,4,288,2,2,0.12
11,0,gender,6,289,1,5,0.24
11,0,gene,4,290,3,1,0.2
11,0,generally,9,291,4,5,0.32
11,0,genetic,7,292,4,3,0.2
11,0,geography,9,293,2,7,0.32
11,0,giant,5,294,1,4,0.28
11,0,glass,5,295,1,4,0.2
11,0,go,2,296,1,1,0.08
11,0,god,3,297,2,1,0.08
11,0,golf,4,298,2,2,0.12
11,0,good,4,299,2,2,0.12
11,0,governor,8,300,2,6,0.36
11,0,grace,5,301,1,4,0.2
11,0,grade,5,302,3,2,0.16
11,0,grandfather,11,303,3,8,0.4
11,0,graphics,8,304,3,5,0.36
11,0,gravity,7,305,3,4,0.48
11,0,green,5,306,2,3,0.44
11,0,grey,4,307,3,1,0.28
11,0,grief,5,308,2,3,0.52
11,0,grin,4,309,3,1,0.28
11,0,guess,5,310,1,4,0.48
11,0,guest,5,311,4,1,0.32
11,0,guitar,6,312,2,4,0.52
11,0,guy,3,313,2,1,0.24
11,0,harbour,7,314,0,7,0.8
11,0,harsh,5,315,3,2,0.36
11,0,heighten,8,316,1,7,0.76
11,0,her,3,317,2,1,0.24
11,0,herb,4,318,3,1,0.28
11,0,hesitate,8,319,2,6,0.8
11,0,highlight,9,320,1,8,0.84
11,0,highly,6,321,5,1,0.36
11,0,hint,4,322,2,2,0.32
11,0,historic,8,323,2,6,0.8
11,0,homeland,8,324,1,7,0.84
11,0,hotel,5,325,2,3,0.52
11,0,hour,4,326,2,2,0.36
11,0,humble,6,327,1,5,0.72
11,0,humour,6,328,3,3,0.44
11,0,hunt,4,329,2,2,0.32
11,0,hurricane,9,330,2,7,0.8
11,0,hydrogen,8,331,1,7,0.88
11,0,hypothesis,10,332,2,8,0.88
11,0,icon,4,333,0,4,0.44
11,0,identical,9,334,1,8,0.84
11,0,ignorance,9,335,1,8,0.96
11,0,ill,3,336,1,2,0.28
11,0,illegal,7,337,3,4,0.56
11,0,impatient,9,338,1,8,0.96
11,0,implement,9,339,3,6,0.76
11,0,import,6,340,3,3,0.44
11,0,improve,7,341,3,4,0.56
11,0,include,7,342,1,6,0.76
11,0,inclusion,9,343,5,4,0.64
11,0,incorporate,11,344,3,8,0.92
11,0,indicate,8,345,2,6,0.84
11,0,indirect,8,346,4,4,0.6
11,0,individual,10,347,4,6,0.8
11,0,influential,11,348,2,9,1.12
11,0,information,11,349,3,8,0.92
11,0,initiate,8,350,2,6,0.68
11,0,injure,6,351,2,4,0.64
11,0,instrument,10,352,2,8,0.88
11,0,intake,6,353,2,4,0.52
11,0,intended,8,354,3,5,0.64
11,0,interior,8,355,4,4,0.72
11,0,involved,8,356,2,6,0.72
11,0,iron,4,357,1,3,0.36
11,0,isolated,8,358,1,7,0.76
11,0,january,7,359,0,7,0.84
11,0,journalism,10,360,1,9,0.96
11,0,joy,3,361,2,1,0.24
11,0,jump,4,362,1,3,0.36
11,0,june,4,363,2,2,0.44
11,0,just,4,364,2,2,0.32
11,0,justify,7,365,4,3,0.48
11,0,kid,3,366,0,3,0.32
11,0,kidney,6,367,3,3,0.48
11,0,kit,3,368,2,1,0.24
11,0,knife,5,369,1,4,0.6
11,0,lad,3,370,0,3,0.32
11,0,landscape,9,371,2,7,0.8
11,0,latest,6,372,2,4,0.52
11,0,laugh,5,373,2,3,0.52
11,0,law,3,374,2,1,0.24
11,0,lawn,4,375,3,1,0.28
11,0,layer,5,376,2,3,0.4
11,0,leading,7,377,1,6,0.64
11,0,leaf,4,378,3,1,0.28
11,0,leaflet,7,379,4,3,0.64
11,0,league,6,380,3,3,0.48
11,0,learning,8,381,3,5,0.68
11,0,legend,6,382,2,4,0.52
11,0,legendary,9,383,6,3,0.68
11,0,legislative,11,384,3,8,0.92
11,0,legitimate,10,385,4,6,0.76
11,0,lens,4,386,2,2,0.44
11,0,lesbian,7,387,2,5,0.6
11,0,letter,6,388,2,4,0.52
11,0,licence,7,389,1,6,0.64
11,0,license,7,390,5,2,0.56
11,0,lie,3,391,2,1,0.24
11,0,lifestyle,9,392,2,7,0.8
11,0,likelihood,10,393,2,8,0.88
11,0,limb,4,394,2,2,0.44
11,0,limited,7,395,3,4,0.56
11,0,link,4,396,2,2,0.32
11,0,literature,10,397,2,8,0.96
11,0,litter,6,398,3,3,0.6
11,0,little,6,399,4,2,0.4
11,0,local,5,400,1,4,0.48
11,0,long,4,401,2,2,0.32
11,0,look,4,402,2,2,0.32
11,0,lot,3,403,2,1,0.24
11,0,loudly,6,404,2,4,0.64
11,0,low,3,405,2,1,0.24
11,0,lunch,5,406,1,4,0.48
11,0,mail,4,407,0,4,0.44
11,0,mandate,7,408,2,5,0.6
11,0,mandatory,9,409,6,3,0.72
11,0,manipulate,10,410,3,7,1
11,0,manufacture,11,411,3,8,1.12
11,0,manuscript,10,412,4,6,0.96
11,0,map,3,413,2,1,0.24
11,0,marine,6,414,2,4,0.52
11,0,mark,4,415,3,1,0.28
11,0,married,7,416,3,4,0.64
11,0,master,6,417,2,4,0.52
11,0,maximum,7,418,2,5,0.6
11,0,meaningful,10,419,1,9,0.96
11,0,meanwhile,9,420,4,5,0.8
11,0,melody,6,421,2,4,0.52
11,0,mental,6,422,2,4,0.52
11,0,message,7,423,2,5,0.6
11,0,method,6,424,2,4,0.64
11,0,militia,7,425,1,6,0.64
11,0,minister,8,426,2,6,0.68
11,0,mirror,6,427,2,4,0.52
11,0,miserable,9,428,2,7,0.88
11,0,misleading,10,429,3,7,0.84
11,0,mobilize,8,430,1,7,0.76
11,0,model,5,431,2,3,0.52
11,0,modify,6,432,3,3,0.48
11,0,moment,6,433,2,4,0.52
11,0,money,5,434,2,3,0.4
11,0,month,5,435,3,2,0.36
11,0,monthly,7,436,5,2,0.56
11,0,more,4,437,2,2,0.32
11,0,mother,6,438,2,4,0.52
11,0,movie,5,439,2,3,0.4
11,0,municipal,9,440,1,8,0.96
11,0,museum,6,441,2,4,0.52
11,0,music,5,442,3,2,0.36
11,0,my,2,443,1,1,0.2
11,0,myth,4,444,2,2,0.36
11,0,naked,5,445,0,5,0.6
11,0,name,4,446,2,2,0.44
11,0,nation,6,447,2,4,0.52
11,0,negative,8,448,1,7,0.76
11,0,negotiation,11,449,3,8,1.04
11,0,neutral,7,450,2,5,0.6
11,0,newspaper,9,451,2,7,0.8
11,0,noise,5,452,1,4,0.48
11,0,nomination,10,453,2,8,1
11,0,non,3,454,2,1,0.24
11,0,norm,4,455,2,2,0.32
11,0,normal,6,456,4,2,0.4
11,0,note,4,457,2,2,0.32
11,0,nut,3,458,1,2,0.28
11,0,obesity,7,459,0,7,0.84
11,0,objective,9,460,2,7,0.8
11,0,oblige,6,461,2,4,0.52
11,0,ocean,5,462,1,4,0.48
11,0,off,3,463,1,2,0.4
11,0,offence,7,464,3,4,0.56
11,0,offend,6,465,5,1,0.36
11,0,offensive,9,466,5,4,0.64
11,0,offspring,9,467,3,6,0.84
11,0,once,4,468,1,3,0.4
11,0,opposed,7,469,1,6,0.64
11,0,optimistic,10,470,2,8,0.88
11,0,option,6,471,4,2,0.52
11,0,organic,7,472,1,6,0.68
11,0,organized,9,473,6,3,0.6
11,0,organizer,9,474,8,1,0.64
11,0,other,5,475,1,4,0.48
11,0,outbreak,8,476,1,7,0.76
11,0,outdoors,8,477,3,5,0.64
11,0,outfit,6,478,3,3,0.56
11,0,outing,6,479,3,3,0.44
11,0,outlet,6,480,3,3,0.44
11,0,outlook,7,481,4,3,0.48
11,0,overall,7,482,1,6,1.4000000000000001
11,0,pad,3,483,0,3,0.32
11,0,painful,7,484,2,5,0.6
11,0,parade,6,485,2,4,0.52
11,0,parallel,8,486,4,4,0.6
11,0,participant,11,487,3,8,1.04
11,0,partner,7,488,4,3,0.48
11,0,passenger,9,489,2,7,0.8
11,0,passport,8,490,4,4,0.72
11,0,password,8,491,4,4,0.6
11,0,patent,6,492,2,4,0.52
11,0,patience,8,493,3,5,0.64
11,0,patron,6,494,3,3,0.6
11,0,peculiar,8,495,1,7,0.76
11,0,perhaps,7,496,2,5,0.6
11,0,personality,11,497,3,8,1.04
11,0,personnel,9,498,6,3,0.56
11,0,philosopher,11,499,1,10,1.04
11,0,philosophy,10,500,9,1,0.64
11,0,pick,4,501,1,3,0.36
11,0,picture,7,502,3,4,0.56
11,0,piece,5,503,2,3,0.4
11,0,pig,3,504,2,1,0.24
11,0,pile,4,505,2,2,0.44
11,0,pin,3,506,2,1,0.24
11,0,place,5,507,1,4,0.48
11,0,plant,5,508,3,2,0.36
11,0,play,4,509,3,1,0.28
11,0,pledge,6,510,2,4,0.52
11,0,plot,4,511,2,2,0.44
11,0,point,5,512,1,4,0.48
11,0,police,6,513,2,4,0.52
11,0,pollution,9,514,3,6,0.76
11,0,position,8,515,2,6,0.68
11,0,possibility,11,516,3,8,0.48
11,0,possible,8,517,6,2,0.2
11,0,precise,7,518,1,6,0.36
11,0,predict,7,519,3,4,0.24
11,0,pregnant,8,520,3,5,0.28
11,0,preliminary,11,521,3,8,0.4
11,0,premier,7,522,3,4,0.32
11,0,premise,7,523,5,2,0.2
11,0,prescribe,9,524,3,6,0.32
11,0,presence,8,525,4,4,0.32
11,0,previously,10,526,3,7,0.36
11,0,principal,9,527,2,7,0.36
11,0,principle,9,528,7,2,0.32
11,0,printing,8,529,4,4,0.28
11,0,priority,8,530,3,5,0.28
11,0,process,7,531,2,5,0.24
11,0,profile,7,532,3,4,0.32
11,0,profound,8,533,4,4,0.24
11,0,progressive,11,534,3,8,0.44
11,0,proof,5,535,3,2,0.16
11,0,propaganda,10,536,3,7,0.44
11,0,proper,6,537,4,2,0.16
11,0,proportion,10,538,4,6,0.32
11,0,proposal,8,539,5,3,0.32
11,0,prosecute,9,540,3,6,0.32
11,0,publicity,9,541,1,8,0.36
11,0,pure,4,542,2,2,0.12
11,0,pursuit,7,543,3,4,0.32
11,0,push,4,544,2,2,0.12
11,0,put,3,545,2,1,0.08
11,0,query,5,546,0,5,0.24
11,0,quite,5,547,2,3,0.16
11,0,race,4,548,0,4,0.24
11,0,racial,6,549,3,3,0.2
11,0,racism,6,550,4,2,0.16
11,0,raise,5,551,2,3,0.16
11,0,rather,6,552,2,4,0.24
11,0,rational,8,553,3,5,0.36
11,0,react,5,554,1,4,0.2
11,0,realistic,9,555,3,6,0.32
11,0,realm,5,556,4,1,0.12
11,0,reasoning,9,557,3,6,0.4
11,0,record,6,558,2,4,0.24
11,0,recruit,7,559,3,4,0.24
11,0,recycle,7,560,3,4,0.24
11,0,reduction,9,561,2,7,0.4
11,0,referee,7,562,2,5,0.24
11,0,reference,9,563,6,3,0.24
11,0,refuse,6,564,3,3,0.28
11,0,regard,6,565,2,4,0.24
11,0,regime,6,566,3,3,0.2
11,0,region,6,567,4,2,0.16
11,0,regional,8,568,6,2,0.2
11,0,relative,8,569,2,6,0.36
11,0,relax,5,570,4,1,0.12
11,0,relaxed,7,571,5,2,0.2
11,0,relevance,9,572,3,6,0.32
11,0,relief,6,573,3,3,0.24
11,0,religious,9,574,4,5,0.28
11,0,remainder,9,575,2,7,0.36
11,0,remark,6,576,4,2,0.24
11,0,removal,7,577,3,4,0.24
11,0,remove,6,578,5,1,0.16
11,0,reporting,9,579,2,7,0.32
11,0,requirement,11,580,2,9,0.48
11,0,research,8,581,2,6,0.32
11,0,reside,6,582,3,3,0.2
11,0,residue,7,583,5,2,0.2
11,0,resolve,7,584,3,4,0.32
11,0,respective,10,585,3,7,0.36
11,0,responsible,11,586,4,7,0.4
11,0,rest,4,587,3,1,0.2
11,0,retail,6,588,2,4,0.2
11,0,revive,6,589,2,4,0.24
11,0,rifle,5,590,1,4,0.2
11,0,ritual,6,591,2,4,0.2
11,0,rival,5,592,2,3,0.28
11,0,road,4,593,1,3,0.16
11,0,rob,3,594,2,1,0.08
11,0,robbery,7,595,3,4,0.24
11,0,robust,6,596,3,3,0.2
11,0,roll,4,597,2,2,0.2
11,0,romance,7,598,2,5,0.24
11,0,root,4,599,2,2,0.16
11,0,rough,5,600,2,3,0.16
11,0,round,5,601,3,2,0.16
11,0,routine,7,602,3,4,0.32
11,0,rub,3,603,1,2,0.12
11,0,rubber,6,604,3,3,0.2
11,0,rubbish,7,605,4,3,0.2
11,0,ruin,4,606,2,2,0.16
11,0,sailor,6,607,0,6,0.32
11,0,sale,4,608,2,2,0.12
11,0,sample,6,609,2,4,0.24
11,0,sand,4,610,2,2,0.16
11,0,satellite,9,611,2,7,0.4
11,0,satisfy,7,612,3,4,0.24
11,0,scattered,9,613,1,8,0.36
11,0,scheme,6,614,2,4,0.24
11,0,scholar,7,615,3,4,0.32
11,0,scientific,10,616,2,8,0.4
11,0,scientist,9,617,7,2,0.24
11,0,score,5,618,2,3,0.16
11,0,seal,4,619,1,3,0.24
11,0,second,6,620,2,4,0.24
11,0,selective,9,621,2,7,0.36
11,0,serious,7,622,2,5,0.28
11,0,servant,7,623,3,4,0.32
11,0,serve,5,624,4,1,0.12
11,0,settler,7,625,2,5,0.28
11,0,sexy,4,626,2,2,0.16
11,0,shallow,7,627,1,6,0.36
11,0,sheer,5,628,2,3,0.2
11,0,shift,5,629,2,3,0.16
11,0,shortage,8,630,2,6,0.32
11,0,sibling,7,631,1,6,0.28
11,0,signature,9,632,2,7,0.44
11,0,silver,6,633,2,4,0.2
11,0,similarly,9,634,2,7,0.36
11,0,simply,6,635,3,3,0.28
11,0,sin,3,636,2,1,0.08
11,0,singing,7,637,3,4,0.24
11,0,sink,4,638,3,1,0.12
11,0,sister,6,639,2,4,0.24
11,0,sit,3,640,2,1,0.08
11,0,situated,8,641,3,5,0.36
11,0,ski,3,642,1,2,0.12
11,0,skirt,5,643,3,2,0.16
11,0,skull,5,644,2,3,0.16
11,0,slam,4,645,1,3,0.16
11,0,snow,4,646,1,3,0.24
11,0,solar,5,647,1,4,0.2
11,0,solo,4,648,3,1,0.12
11,0,something,9,649,2,7,0.32
11,0,song,4,650,2,2,0.12
11,0,space,5,651,1,4,0.28
11,0,speak,5,652,2,3,0.16
11,0,special,7,653,3,4,0.24
11,0,specialist,10,654,7,3,0.28
11,0,specialized,11,655,8,3,0.36
11,0,specify,7,656,5,2,0.2
11,0,spine,5,657,2,3,0.2
11,0,spokesman,9,658,2,7,0.36
11,0,stamp,5,659,1,4,0.28
11,0,stand,5,660,3,2,0.16
11,0,standing,8,661,5,3,0.24
11,0,star,4,662,3,1,0.12
11,0,statistic,9,663,3,6,0.4
11,0,statue,6,664,4,2,0.16
11,0,steer,5,665,2,3,0.2
11,0,stereotype,10,666,3,7,0.36
11,0,stick,5,667,2,3,0.24
11,0,sticky,6,668,5,1,0.16
11,0,stop,4,669,2,2,0.12
11,0,storage,7,670,3,4,0.24
11,0,store,5,671,4,1,0.12
11,0,story,5,672,4,1,0.2
11,0,straight,8,673,2,6,0.32
11,0,strategic,9,674,4,5,0.32
11,0,strategy,8,675,7,1,0.2
11,0,strength,8,676,3,5,0.36
11,0,stretch,7,677,4,3,0.48
11,0,striking,8,678,3,5,0.64
11,0,string,6,679,4,2,0.4
11,0,strong,6,680,3,3,0.56
11,0,subject,7,681,1,6,0.64
11,0,successful,10,682,2,8,0.88
11,0,sugar,5,683,2,3,0.4
11,0,super,5,684,2,3,0.52
11,0,surely,6,685,2,4,0.52
11,0,surgical,8,686,3,5,0.68
11,0,surrounding,11,687,3,8,1.04
11,0,swear,5,688,1,4,0.48
11,0,sweep,5,689,3,2,0.36
11,0,switch,6,690,2,4,0.52
11,0,sympathy,8,691,1,7,0.76
11,0,synthesis,9,692,2,7,0.92
11,0,table,5,693,0,5,0.52
11,0,tactical,8,694,2,6,0.72
11,0,tale,4,695,2,2,0.32
11,0,talent,6,696,4,2,0.56
11,0,talk,4,697,3,1,0.28
11,0,tank,4,698,2,2,0.32
11,0,taste,5,699,2,3,0.48
11,0,television,10,700,1,9,1.2
11,0,temperature,11,701,2,9,1
11,0,tension,7,702,2,5,0.64
11,0,terribly,8,703,2,6,0.76
11,0,terrific,8,704,5,3,0.68
11,0,terror,6,705,4,2,0.4
11,0,terrorism,9,706,6,3,0.56
11,0,textbook,8,707,2,6,0.8
11,0,themselves,10,708,1,9,0.92
11,0,therapist,9,709,3,6,0.72
11,0,thereby,7,710,4,3,0.48
11,0,this,4,711,2,2,0.44
11,0,thumb,5,712,2,3,0.4
11,0,ticket,6,713,1,5,0.56
11,0,tidy,4,714,2,2,0.32
11,0,tighten,7,715,2,5,0.6
11,0,timing,6,716,2,4,0.64
11,0,to,2,717,1,1,0.2
11,0,together,8,718,2,6,0.68
11,0,tonight,7,719,2,5,0.6
11,0,tonne,5,720,3,2,0.48
11,0,too,3,721,2,1,0.24
11,0,trademark,9,722,1,8,0.84
11,0,tragic,6,723,3,3,0.44
11,0,trainer,7,724,3,4,0.56
11,0,translation,11,725,3,8,1.04
11,0,transport,9,726,5,4,0.64
11,0,traveller,9,727,3,6,0.76
11,0,treaty,6,728,2,4,0.64
11,0,tribal,6,729,2,4,0.52
11,0,tribe,5,730,4,1,0.32
11,0,tribute,7,731,4,3,0.48
11,0,tropical,8,732,2,6,0.84
11,0,trouble,7,733,3,4,0.56
11,0,trousers,8,734,4,4,0.6
11,0,truck,5,735,2,3,0.4
11,0,tune,4,736,1,3,0.48
11,0,two,3,737,1,2,0.28
11,0,undergo,7,738,0,7,0.72
11,0,underground,11,739,6,5,0.76
11,0,undermine,9,740,5,4,0.76
11,0,undoubtedly,11,741,3,8,0.92
11,0,unfair,6,742,2,4,0.52
11,0,unnecessary,11,743,2,9,1.12
11,0,until,5,744,2,3,0.44
11,0,upgrade,7,745,1,6,0.68
11,0,uphold,6,746,2,4,0.52
11,0,urban,5,747,1,4,0.6
11,0,usage,5,748,1,4,0.48
11,0,utility,7,749,1,6,0.68
11,0,utilize,7,750,5,2,0.44
11,0,vague,5,751,0,5,0.52
11,0,validity,8,752,2,6,0.84
11,0,variety,7,753,2,5,0.64
11,0,vary,4,754,3,1,0.28
11,0,vegetable,9,755,1,8,0.88
11,0,vein,4,756,2,2,0.48
11,0,verify,6,757,2,4,0.52
11,0,vessel,6,758,2,4,0.52
11,0,video,5,759,1,4,0.48
11,0,villager,8,760,2,6,0.84
11,0,violent,7,761,2,5,0.64
11,0,virtue,6,762,2,4,0.56
11,0,visitor,7,763,2,5,0.72
11,0,visual,6,764,3,3,0.6
11,0,voice,5,765,1,4,0.48
11,0,wait,4,766,0,4,0.44
11,0,waiter,6,767,4,2,0.4
11,0,war,3,768,2,1,0.24
11,0,warrior,7,769,3,4,0.76
11,0,watch,5,770,2,3,0.4
11,0,way,3,771,2,1,0.24
11,0,weapon,6,772,1,5,0.56
11,0,weave,5,773,3,2,0.36
11,0,weekend,7,774,2,5,0.76
11,0,weird,5,775,2,3,0.44
11,0,welfare,7,776,2,5,0.6
11,0,whose,5,777,1,4,0.48
11,0,wildlife,8,778,1,7,0.76
11,0,win,3,779,2,1,0.36
11,0,wine,4,780,3,1,0.28
11,0,wipe,4,781,2,2,0.32
11,0,woman,5,782,1,4,0.48
11,0,work,4,783,2,2,0.32
11,0,workplace,9,784,4,5,0.84
11,0,world,5,785,3,2,0.36
11,0,wrap,4,786,1,3,0.36
11,0,wrist,5,787,2,3,0.4
11,0,written,7,788,3,4,0.56
11,1,a,1,0,0,1,0.08
11,1,accelerate,10,1,1,9,0.52
11,1,accept,6,2,4,2,0.16
11,1,accompany,9,3,3,6,0.32
11,1,accomplish,10,4,6,4,0.28
11,1,acquisition,11,5,2,9,0.48
11,1,activate,8,6,2,6,0.28
11,1,actress,7,7,3,4,0.24
11,1,add,3,8,1,2,0.2
11,1,address,7,9,3,4,0.24
11,1,adequately,10,10,2,8,0.36
11,1,adj,3,11,2,1,0.12
11,1,adjacent,8,12,3,5,0.36
11,1,adoption,8,13,2,6,0.32
11,1,aesthetic,9,14,1,8,0.36
11,1,afterwards,10,15,1,9,0.52
11,1,against,7,16,1,6,0.28
11,1,allocate,8,17,1,7,0.36
11,1,ally,4,18,3,1,0.12
11,1,alongside,9,19,2,7,0.48
11,1,ambassador,10,20,1,9,0.4
11,1,ambulance,9,21,3,6,0.32
11,1,amendment,9,22,2,7,0.44
11,1,amusing,7,23,2,5,0.28
11,1,analysis,8,24,1,7,0.32
11,1,ancient,7,25,2,5,0.24
11,1,anger,5,26,2,3,0.28
11,1,animal,6,27,2,4,0.24
11,1,ankle,5,28,2,3,0.16
11,1,anniversary,11,29,2,9,0.52
11,1,annoyed,7,30,3,4,0.24
11,1,annoying,8,31,5,3,0.24
11,1,anybody,7,32,2,5,0.24
11,1,apology,7,33,1,6,0.36
11,1,app,3,34,2,1,0.08
11,1,apparently,10,35,3,7,0.36
11,1,applaud,7,36,3,4,0.24
11,1,approve,7,37,3,4,0.32
11,1,arguably,8,38,1,7,0.32
11,1,arise,5,39,2,3,0.16
11,1,army,4,40,2,2,0.16
11,1,around,6,41,2,4,0.2
11,1,arrow,5,42,2,3,0.24
11,1,assessment,10,43,1,9,0.4
11,1,assistant,9,44,3,6,0.32
11,1,associate,9,45,3,6,0.4
11,1,assurance,9,46,3,6,0.32
11,1,at,2,47,1,1,0.08
11,1,atrocity,8,48,2,6,0.28
11,1,authorize,9,49,1,8,0.48
11,1,auto,4,50,3,1,0.12
11,1,backing,7,51,0,7,0.32
11,1,ballet,6,52,2,4,0.24
11,1,bath,4,53,2,2,0.2
11,1,battlefield,11,54,3,8,0.4
11,1,beast,5,55,1,4,0.2
11,1,beer,4,56,2,2,0.12
11,1,beg,3,57,2,1,0.08
11,1,behave,6,58,2,4,0.32
11,1,bell,4,59,2,2,0.16
11,1,belong,6,60,3,3,0.2
11,1,best,4,61,2,2,0.16
11,1,between,7,62,2,5,0.28
11,1,bin,3,63,1,2,0.2
11,1,bird,4,64,2,2,0.12
11,1,birthday,8,65,3,5,0.28
11,1,bless,5,66,1,4,0.2
11,1,blind,5,67,2,3,0.16
11,1,blog,4,68,2,2,0.24
11,1,blow,4,69,3,1,0.12
11,1,boil,4,70,1,3,0.16
11,1,boom,4,71,2,2,0.12
11,1,boot,4,72,3,1,0.12
11,1,bother,6,73,2,4,0.24
11,1,bound,5,74,2,3,0.24
11,1,boundary,8,75,5,3,0.24
11,1,box,3,76,2,1,0.08
11,1,brand,5,77,1,4,0.2
11,1,break,5,78,2,3,0.16
11,1,breakdown,9,79,5,4,0.32
11,1,breathe,7,80,4,3,0.2
11,1,breathing,9,81,6,3,0.24
11,1,bride,5,82,2,3,0.2
11,1,bright,6,83,3,3,0.28
11,1,broken,6,84,2,4,0.2
11,1,buddy,5,85,1,4,0.2
11,1,buffer,6,86,2,4,0.2
11,1,bug,3,87,2,1,0.12
11,1,burden,6,88,2,4,0.6
11,1,businessman,11,89,2,9,0.96
11,1,butter,6,90,2,4,0.52
11,1,cafe,4,91,0,4,0.44
11,1,cake,4,92,2,2,0.44
11,1,cap,3,93,2,1,0.24
11,1,capable,7,94,3,4,0.56
11,1,capitalist,10,95,3,7,0.84
11,1,career,6,96,2,4,0.64
11,1,carefully,9,97,4,5,0.68
11,1,cartoon,7,98,3,4,0.56
11,1,category,8,99,2,6,0.68
11,1,cave,4,100,2,2,0.44
11,1,cd,2,101,1,1,0.2
11,1,ceiling,7,102,1,6,0.64
11,1,celebrity,9,103,2,7,0.84
11,1,cemetery,8,104,2,6,0.96
11,1,century,7,105,2,5,0.6
11,1,ceremony,8,106,2,6,0.72
11,1,character,9,107,1,8,0.92
11,1,charming,8,108,4,4,0.72
11,1,cheat,5,109,2,3,0.44
11,1,cheerful,8,110,3,5,0.72
11,1,chicken,7,111,2,5,0.6
11,1,choose,6,112,2,4,0.64
11,1,chop,4,113,3,1,0.28
11,1,chronic,7,114,2,5,0.6
11,1,circle,6,115,1,5,0.56
11,1,citizenship,11,116,2,9,1.24
11,1,city,4,117,3,1,0.32
11,1,civil,5,118,2,3,0.4
11,1,clarity,7,119,1,6,0.68
11,1,clause,6,120,3,3,0.6
11,1,clearly,7,121,2,5,0.6
11,1,clinical,8,122,2,6,0.8
11,1,closely,7,123,2,5,0.88
11,1,coach,5,124,1,4,0.64
11,1,coincide,8,125,2,6,0.72
11,1,collective,10,126,2,8,0.88
11,1,comfort,7,127,2,5,0.6
11,1,comfortable,11,128,7,4,0.84
11,1,commission,10,129,3,7,0.84
11,1,comparable,10,130,3,7,1.04
11,1,compete,7,131,4,3,0.48
11,1,component,9,132,4,5,0.68
11,1,compulsory,10,133,4,6,0.8
11,1,concert,7,134,2,5,0.76
11,1,conclusion,10,135,4,6,0.84
11,1,confess,7,136,3,4,0.6
11,1,confused,8,137,4,4,0.72
11,1,consent,7,138,3,4,0.56
11,1,contend,7,139,3,4,0.56
11,1,convenient,10,140,3,7,0.84
11,1,conversion,10,141,5,5,0.88
11,1,cope,4,142,2,2,0.32
11,1,correct,7,143,2,5,0.6
11,1,could,5,144,2,3,0.44
11,1,counterpart,11,145,3,8,1.04
11,1,couple,6,146,3,3,0.48
11,1,court,5,147,3,2,0.44
11,1,craft,5,148,1,4,0.52
11,1,crime,5,149,2,3,0.6
11,1,criminal,8,150,4,4,0.6
11,1,cross,5,151,2,3,0.4
11,1,crowded,7,152,3,4,0.56
11,1,crucial,7,153,2,5,0.72
11,1,cruel,5,154,3,2,0.36
11,1,cultivate,9,155,1,8,0.88
11,1,currency,8,156,2,6,0.72
11,1,current,7,157,6,1,0.52
11,1,curved,6,158,3,3,0.44
11,1,cycle,5,159,1,4,0.48
11,1,dam,3,160,0,3,0.32
11,1,damage,6,161,3,3,0.44
11,1,dance,5,162,2,3,0.56
11,1,dare,4,163,2,2,0.32
11,1,deal,4,164,1,3,0.36
11,1,december,8,165,2,6,0.72
11,1,declare,7,166,3,4,0.56
11,1,decoration,10,167,3,7,0.96
11,1,decrease,8,168,3,5,0.64
11,1,deed,4,169,2,2,0.32
11,1,deem,4,170,3,1,0.28
11,1,default,7,171,2,5,0.72
11,1,defect,6,172,3,3,0.44
11,1,definite,8,173,3,5,0.64
11,1,definitely,10,174,8,2,0.68
11,1,deliver,7,175,2,5,0.6
11,1,democracy,9,176,2,7,0.8
11,1,demon,5,177,4,1,0.32
11,1,dentist,7,178,2,5,0.72
11,1,departure,9,179,2,7,0.8
11,1,deposit,7,180,3,4,0.56
11,1,deputy,6,181,3,3,0.48
11,1,despite,7,182,2,5,0.76
11,1,destruction,11,183,3,8,0.92
11,1,develop,7,184,2,5,0.6
11,1,diagnosis,9,185,1,8,0.96
11,1,dictator,8,186,2,6,0.72
11,1,digital,7,187,2,5,0.6
11,1,diminish,8,188,2,6,0.68
11,1,dinner,6,189,2,4,0.64
11,1,dirty,5,190,2,3,0.4
11,1,disabled,8,191,2,6,0.72
11,1,disastrous,10,192,4,6,0.76
11,1,discipline,10,193,3,7,0.96
11,1,discount,8,194,4,4,0.6
11,1,discovery,9,195,5,4,0.64
11,1,discuss,7,196,4,3,0.6
11,1,discussion,10,197,7,3,0.6
11,1,display,7,198,3,4,0.56
11,1,distant,7,199,3,4,0.68
11,1,distribute,10,200,4,6,0.8
11,1,disturbing,10,201,4,6,0.8
11,1,divine,6,202,2,4,0.52
11,1,domain,6,203,1,5,0.68
11,1,double,6,204,2,4,0.52
11,1,downstairs,10,205,2,8,1.2
11,1,duration,8,206,1,7,0.96
11,1,dust,4,207,2,2,0.32
11,1,effectively,11,208,0,11,1.12
11,1,eighty,6,209,1,5,0.6
11,1,either,6,210,2,4,0.64
11,1,elect,5,211,1,4,0.48
11,1,electrical,10,212,5,5,0.72
11,1,electricity,11,213,8,3,0.64
11,1,eleven,6,214,3,3,0.56
11,1,eliminate,9,215,2,7,0.44
11,1,elsewhere,9,216,2,7,0.36
11,1,embark,6,217,1,5,0.32
11,1,emergency,9,218,2,7,0.36
11,1,emission,8,219,2,6,0.32
11,1,emotion,7,220,2,5,0.28
11,1,empirical,9,221,2,7,0.44
11,1,employer,8,222,3,5,0.28
11,1,empower,7,223,3,4,0.24
11,1,enable,6,224,1,5,0.32
11,1,endless,7,225,2,5,0.24
11,1,enforcement,11,226,2,9,1
11,1,engineer,8,227,2,6,0.92
11,1,enjoy,5,228,2,3,0.64
11,1,enthusiast,10,229,2,8,0.92
11,1,entrance,8,230,3,5,0.48
11,1,essay,5,231,1,4,0.28
11,1,essence,7,232,3,4,0.32
11,1,essentially,11,233,5,6,0.4
11,1,establish,9,234,2,7,0.36
11,1,euro,4,235,1,3,0.16
11,1,event,5,236,1,4,0.24
11,1,evidence,8,237,2,6,0.32
11,1,evoke,5,238,2,3,0.2
11,1,exact,5,239,1,4,0.2
11,1,examine,7,240,3,4,0.32
11,1,exceed,6,241,2,4,0.24
11,1,exception,9,242,4,5,0.36
11,1,exclusively,11,243,3,8,0.52
11,1,excuse,6,244,3,3,0.2
11,1,executive,9,245,2,7,0.36
11,1,exercise,8,246,3,5,0.28
11,1,exhibition,10,247,2,8,0.44
11,1,existence,9,248,2,7,0.36
11,1,experiment,10,249,2,8,0.4
11,1,expire,6,250,3,3,0.28
11,1,explain,7,251,3,4,0.24
11,1,explode,7,252,4,3,0.2
11,1,exploit,7,253,5,2,0.2
11,1,exploration,11,254,5,6,0.4
11,1,explosive,9,255,5,4,0.28
11,1,extensive,9,256,2,7,0.36
11,1,eye,3,257,1,2,0.16
11,1,fail,4,258,0,4,0.2
11,1,fairly,6,259,3,3,0.2
11,1,fantasy,7,260,2,5,0.28
11,1,fast,4,261,2,2,0.12
11,1,fear,4,262,1,3,0.24
11,1,fee,3,263,2,1,0.08
11,1,feeding,7,264,3,4,0.24
11,1,fellow,6,265,2,4,0.24
11,1,fibre,5,266,1,4,0.2
11,1,fiction,7,267,2,5,0.32
11,1,fifty,5,268,2,3,0.2
11,1,fight,5,269,2,3,0.16
11,1,finally,7,270,2,5,0.28
11,1,financial,9,271,4,5,0.36
11,1,fine,4,272,3,1,0.12
11,1,firefighter,11,273,2,9,0.4
11,1,firm,4,274,3,1,0.12
11,1,fixed,5,275,2,3,0.16
11,1,fixture,7,276,3,4,0.32
11,1,flat,4,277,1,3,0.16
11,1,flavour,7,278,3,4,0.24
11,1,flee,4,279,2,2,0.12
11,1,flexibility,11,280,3,8,0.48
11,1,flourish,8,281,2,6,0.32
11,1,flower,6,282,3,3,0.2
11,1,folding,7,283,1,6,0.28
11,1,force,5,284,2,3,0.28
11,1,foreign,7,285,3,4,0.24
11,1,former,6,286,3,3,0.2
11,1,formula,7,287,4,3,0.2
11,1,forthcoming,11,288,3,8,0.48
11,1,fortunately,11,289,4,7,0.36
11,1,fortune,7,290,6,1,0.16
11,1,forward,7,291,3,4,0.28
11,1,foundation,10,292,2,8,0.4
11,1,founder,7,293,5,2,0.2
11,1,fragment,8,294,1,7,0.32
11,1,friday,6,295,2,4,0.28
11,1,frighten,8,296,3,5,0.28
11,1,front,5,297,2,3,0.2
11,1,fundamental,11,298,1,10,0.52
11,1,funding,7,299,4,3,0.2
11,1,gaming,6,300,0,6,0.28
11,1,gender,6,301,1,5,0.24
11,1,gene,4,302,3,1,0.12
11,1,generate,8,303,4,4,0.32
11,1,genetic,7,304,4,3,0.2
11,1,genuinely,9,305,3,6,0.32
11,1,giant,5,306,1,4,0.28
11,1,glass,5,307,1,4,0.2
11,1,god,3,308,1,2,0.12
11,1,gold,4,309,2,2,0.16
11,1,governor,8,310,2,6,0.28
11,1,grace,5,311,1,4,0.2
11,1,grandfather,11,312,3,8,0.48
11,1,gravity,7,313,3,4,0.24
11,1,grid,4,314,2,2,0.16
11,1,grief,5,315,3,2,0.16
11,1,grin,4,316,3,1,0.16
11,1,ground,6,317,2,4,0.2
11,1,guerrilla,9,318,1,8,0.36
11,1,guest,5,319,3,2,0.16
11,1,guidance,8,320,2,6,0.36
11,1,guide,5,321,4,1,0.12
11,1,guy,3,322,2,1,0.12
11,1,hair,4,323,0,4,0.2
11,1,handy,5,324,2,3,0.2
11,1,happen,6,325,2,4,0.28
11,1,harsh,5,326,2,3,0.16
11,1,hazard,6,327,2,4,0.2
11,1,heart,5,328,1,4,0.2
11,1,her,3,329,2,1,0.08
11,1,hers,4,330,3,1,0.12
11,1,hesitate,8,331,2,6,0.36
11,1,highly,6,332,1,5,0.24
11,1,historic,8,333,2,6,0.32
11,1,historical,10,334,8,2,0.32
11,1,horror,6,335,1,5,0.24
11,1,hour,4,336,2,2,0.16
11,1,household,9,337,3,6,0.32
11,1,how,3,338,2,1,0.08
11,1,humanity,8,339,1,7,0.4
11,1,humble,6,340,3,3,0.2
11,1,hunger,6,341,2,4,0.2
11,1,hunt,4,342,3,1,0.12
11,1,hurricane,9,343,2,7,0.4
11,1,ice,3,344,0,3,0.16
11,1,icon,4,345,2,2,0.12
11,1,ideal,5,346,1,4,0.2
11,1,identical,9,347,3,6,0.32
11,1,ignorance,9,348,1,8,0.44
11,1,illegal,7,349,1,6,0.28
11,1,imagery,7,350,1,6,0.28
11,1,important,9,351,2,7,0.4
11,1,inclusion,9,352,1,8,0.36
11,1,incorporate,11,353,3,8,0.4
11,1,incorrect,9,354,5,4,0.36
11,1,indirect,8,355,2,6,0.32
11,1,individual,10,356,4,6,0.36
11,1,influence,9,357,2,7,0.88
11,1,influential,11,358,7,4,0.72
11,1,info,4,359,3,1,0.28
11,1,inform,6,360,4,2,0.4
11,1,information,11,361,6,5,0.88
11,1,inherent,8,362,2,6,0.72
11,1,injury,6,363,2,4,0.52
11,1,insert,6,364,2,4,0.6
11,1,inspect,7,365,3,4,0.56
11,1,inspection,10,366,7,3,0.6
11,1,instruct,8,367,3,5,0.64
11,1,instrument,10,368,6,4,0.8
11,1,insurance,9,369,3,6,0.76
11,1,integral,8,370,2,6,0.72
11,1,intended,8,371,4,4,0.68
11,1,intense,7,372,5,2,0.44
11,1,interior,8,373,4,4,0.6
11,1,invade,6,374,2,4,0.52
11,1,invest,6,375,3,3,0.56
11,1,island,6,376,1,5,0.56
11,1,january,7,377,0,7,0.72
11,1,job,3,378,1,2,0.28
11,1,journalism,10,379,2,8,0.96
11,1,joy,3,380,2,1,0.24
11,1,judicial,8,381,1,7,0.76
11,1,jump,4,382,2,2,0.32
11,1,just,4,383,2,2,0.32
11,1,justify,7,384,4,3,0.6
11,1,keyboard,8,385,0,8,0.8
11,1,kick,4,386,1,3,0.36
11,1,kid,3,387,2,1,0.24
11,1,kidney,6,388,3,3,0.44
11,1,king,4,389,2,2,0.4
11,1,kingdom,7,390,4,3,0.48
11,1,kit,3,391,2,1,0.24
11,1,knife,5,392,1,4,0.48
11,1,know,4,393,2,2,0.32
11,1,lack,4,394,0,4,0.44
11,1,lake,4,395,2,2,0.44
11,1,landscape,9,396,2,7,0.8
11,1,lap,3,397,2,1,0.24
11,1,laser,5,398,2,3,0.4
11,1,laugh,5,399,2,3,0.4
11,1,law,3,400,2,1,0.32
11,1,lawn,4,401,3,1,0.28
11,1,leadership,10,402,1,9,0.96
11,1,leaf,4,403,3,1,0.28
11,1,legendary,9,404,2,7,0.88
11,1,legislative,11,405,3,8,0.96
11,1,legitimate,10,406,4,6,0.88
11,1,lens,4,407,2,2,0.36
11,1,lesser,6,408,2,4,0.6
11,1,lifestyle,9,409,1,8,0.84
11,1,likelihood,10,410,2,8,0.88
11,1,link,4,411,2,2,0.44
11,1,literature,10,412,2,8,0.92
11,1,load,4,413,1,3,0.36
11,1,location,8,414,2,6,0.68
11,1,lonely,6,415,2,4,0.64
11,1,long,4,416,3,1,0.28
11,1,loudly,6,417,2,4,0.52
11,1,lunch,5,418,1,4,0.48
11,1,machinery,9,419,0,9,0.88
11,1,mainland,8,420,2,6,0.8
11,1,mandate,7,421,2,5,0.6
11,1,manufacture,11,422,3,8,0.92
11,1,manuscript,10,423,4,6,0.92
11,1,map,3,424,2,1,0.24
11,1,marine,6,425,2,4,0.56
11,1,master,6,426,2,4,0.52
11,1,match,5,427,2,3,0.52
11,1,maximum,7,428,2,5,0.6
11,1,meal,4,429,1,3,0.36
11,1,mean,4,430,3,1,0.28
11,1,meaningful,10,431,4,6,0.92
11,1,meanwhile,9,432,4,5,0.84
11,1,medication,10,433,2,8,0.92
11,1,meeting,7,434,2,5,0.6
11,1,melody,6,435,2,4,0.6
11,1,mention,7,436,2,5,0.64
11,1,mentor,6,437,4,2,0.4
11,1,merely,6,438,2,4,0.52
11,1,mess,4,439,2,2,0.44
11,1,metre,5,440,2,3,0.44
11,1,midnight,8,441,1,7,0.76
11,1,mirror,6,442,2,4,0.52
11,1,miserable,9,443,2,7,0.88
11,1,moment,6,444,1,5,0.6
11,1,money,5,445,2,3,0.44
11,1,month,5,446,3,2,0.4
11,1,monument,8,447,3,5,0.76
11,1,more,4,448,2,2,0.44
11,1,mother,6,449,2,4,0.52
11,1,mouth,5,450,2,3,0.44
11,1,movie,5,451,2,3,0.4
11,1,much,4,452,1,3,0.4
11,1,mum,3,453,2,1,0.32
11,1,museum,6,454,2,4,0.6
11,1,must,4,455,3,1,0.32
11,1,nasty,5,456,0,5,0.6
11,1,nature,6,457,2,4,0.6
11,1,neck,4,458,1,3,0.44
11,1,needle,6,459,2,4,0.64
11,1,negative,8,460,2,6,0.72
11,1,neutral,7,461,2,5,0.72
11,1,new,3,462,2,1,0.24
11,1,night,5,463,1,4,0.6
11,1,nominate,8,464,1,7,0.76
11,1,norm,4,465,2,2,0.32
11,1,north,5,466,3,2,0.36
11,1,not,3,467,2,1,0.24
11,1,note,4,468,3,1,0.44
11,1,nothing,7,469,3,4,0.92
11,1,novel,5,470,2,3,0.52
11,1,nut,3,471,1,2,0.32
11,1,obesity,7,472,0,7,0.8
11,1,oblige,6,473,2,4,0.68
11,1,obviously,9,474,2,7,0.84
11,1,occupation,10,475,1,9,1.04
11,1,off,3,476,1,2,0.32
11,1,official,8,477,3,5,0.8
11,1,offspring,9,478,3,6,0.76
11,1,once,4,479,1,3,0.44
11,1,one,3,480,2,1,0.28
11,1,online,6,481,2,4,0.72
11,1,opportunity,11,482,1,10,1.08
11,1,optimistic,10,483,2,8,1
11,1,option,6,484,4,2,0.68
11,1,organic,7,485,1,6,0.72
11,1,otherwise,9,486,1,8,0.88
11,1,ought,5,487,1,4,0.48
11,1,outbreak,8,488,2,6,0.8
11,1,outfit,6,489,3,3,0.44
11,1,outlet,6,490,3,3,0.44
11,1,overall,7,491,1,6,0.64
11,1,oversee,7,492,4,3,0.6
11,1,paint,5,493,0,5,0.52
11,1,palace,6,494,2,4,0.52
11,1,pants,5,495,2,3,0.44
11,1,parallel,8,496,2,6,0.68
11,1,park,4,497,3,1,0.24
11,1,participate,11,498,3,8,0.48
11,1,partner,7,499,4,3,0.24
11,1,passenger,9,500,2,7,0.44
11,1,passport,8,501,4,4,0.28
11,1,password,8,502,4,4,0.28
11,1,patent,6,503,2,4,0.24
11,1,patience,8,504,3,5,0.36
11,1,pause,5,505,2,3,0.16
11,1,peace,5,506,1,4,0.2
11,1,peaceful,8,507,5,3,0.24
11,1,peculiar,8,508,2,6,0.36
11,1,peer,4,509,2,2,0.12
11,1,pepper,6,510,2,4,0.2
11,1,perfect,7,511,2,5,0.28
11,1,persistent,10,512,3,7,0.48
11,1,philosopher,11,513,1,10,0.52
11,1,philosophy,10,514,9,1,0.28
11,1,phone,5,515,2,3,0.28
11,1,physician,9,516,2,7,0.36
11,1,pick,4,517,1,3,0.16
11,1,picture,7,518,3,4,0.24
11,1,piece,5,519,2,3,0.2
11,1,pile,4,520,2,2,0.2
11,1,pioneer,7,521,2,5,0.28
11,1,pipe,4,522,2,2,0.16
11,1,place,5,523,1,4,0.2
11,1,plane,5,524,3,2,0.16
11,1,planning,8,525,4,4,0.32
11,1,plant,5,526,4,1,0.12
11,1,pleased,7,527,2,5,0.24
11,1,police,6,528,1,5,0.24
11,1,political,9,529,4,5,0.36
11,1,pollution,9,530,3,6,0.32
11,1,pond,4,531,2,2,0.12
11,1,population,10,532,2,8,0.44
11,1,possible,8,533,2,6,0.28
11,1,post,4,534,3,1,0.12
11,1,pot,3,535,2,1,0.08
11,1,prayer,6,536,1,5,0.24
11,1,precedent,9,537,2,7,0.4
11,1,precise,7,538,4,3,0.24
11,1,prediction,10,539,3,7,0.36
11,1,preliminary,11,540,3,8,0.48
11,1,premier,7,541,3,4,0.24
11,1,prescribe,9,542,3,6,0.32
11,1,presently,9,543,4,5,0.36
11,1,prevention,10,544,3,7,0.36
11,1,previously,10,545,4,6,0.36
11,1,principle,9,546,2,7,0.4
11,1,printer,7,547,4,3,0.24
11,1,prior,5,548,3,2,0.16
11,1,process,7,549,2,5,0.24
11,1,processing,10,550,7,3,0.32
11,1,program,7,551,3,4,0.24
11,1,programming,11,552,7,4,0.32
11,1,progressive,11,553,5,6,0.4
11,1,project,7,554,3,4,0.24
11,1,prominent,9,555,3,6,0.32
11,1,proof,5,556,3,2,0.16
11,1,propaganda,10,557,3,7,0.4
11,1,proper,6,558,4,2,0.16
11,1,properly,8,559,6,2,0.2
11,1,proposal,8,560,4,4,0.24
11,1,proposition,11,561,6,5,0.44
11,1,prosperity,10,562,3,7,0.44
11,1,protest,7,563,3,4,0.28
11,1,protester,9,564,7,2,0.28
11,1,publicity,9,565,1,8,0.36
11,1,pump,4,566,2,2,0.12
11,1,pupil,5,567,2,3,0.2
11,1,pursuit,7,568,2,5,0.32
11,1,put,3,569,2,1,0.12
11,1,quality,7,570,0,7,0.32
11,1,quantity,8,571,3,5,0.28
11,1,query,5,572,2,3,0.24
11,1,quest,5,573,3,2,0.16
11,1,racism,6,574,0,6,0.24
11,1,rail,4,575,2,2,0.16
11,1,railway,7,576,4,3,0.2
11,1,rally,5,577,2,3,0.24
11,1,react,5,578,1,4,0.2
11,1,reasoning,9,579,3,6,0.32
11,1,recall,6,580,2,4,0.24
11,1,reception,9,581,3,6,0.4
11,1,recognize,9,582,3,6,0.32
11,1,recommend,9,583,4,5,0.28
11,1,recount,7,584,4,3,0.28
11,1,referee,7,585,2,5,0.28
11,1,refuse,6,586,3,3,0.2
11,1,regard,6,587,2,4,0.2
11,1,region,6,588,3,3,0.2
11,1,regional,8,589,6,2,0.28
11,1,regulatory,10,590,3,7,0.36
11,1,rejection,9,591,2,7,0.36
11,1,relative,8,592,2,6,0.36
11,1,relevance,9,593,3,6,0.32
11,1,remainder,9,594,2,7,0.36
11,1,remark,6,595,4,2,0.24
11,1,remind,6,596,3,3,0.2
11,1,removal,7,597,3,4,0.24
11,1,renew,5,598,2,3,0.2
11,1,repeat,6,599,2,4,0.28
11,1,republic,8,600,3,5,0.36
11,1,requirement,11,601,2,9,0.48
11,1,research,8,602,2,6,0.36
11,1,reside,6,603,3,3,0.28
11,1,residue,7,604,5,2,0.2
11,1,resolve,7,605,3,4,0.24
11,1,rest,4,606,3,1,0.12
11,1,retirement,10,607,2,8,0.44
11,1,retrieve,8,608,3,5,0.28
11,1,reveal,6,609,2,4,0.24
11,1,revise,6,610,3,3,0.2
11,1,revival,7,611,4,3,0.28
11,1,rifle,5,612,1,4,0.2
11,1,right,5,613,2,3,0.2
11,1,rip,3,614,2,1,0.08
11,1,rob,3,615,1,2,0.12
11,1,robbery,7,616,3,4,0.24
11,1,roll,4,617,2,2,0.2
11,1,romance,7,618,2,5,0.24
11,1,root,4,619,2,2,0.16
11,1,rough,5,620,2,3,0.2
11,1,round,5,621,3,2,0.16
11,1,routine,7,622,3,4,0.32
11,1,rubbish,7,623,1,6,0.28
11,1,sale,4,624,0,4,0.2
11,1,sand,4,625,2,2,0.16
11,1,satisfy,7,626,2,5,0.32
11,1,scared,6,627,1,5,0.24
11,1,scheme,6,628,2,4,0.24
11,1,scholar,7,629,3,4,0.24
11,1,scientific,10,630,2,8,0.48
11,1,seal,4,631,1,3,0.16
11,1,second,6,632,2,4,0.24
11,1,security,8,633,3,5,0.28
11,1,seeker,6,634,2,4,0.28
11,1,segment,7,635,2,5,0.28
11,1,sensitivity,11,636,2,9,0.44
11,1,servant,7,637,2,5,0.28
11,1,setting,7,638,2,5,0.32
11,1,settlement,10,639,4,6,0.32
11,1,settler,7,640,6,1,0.16
11,1,sexual,6,641,2,4,0.28
11,1,shallow,7,642,1,6,0.32
11,1,share,5,643,3,2,0.16
11,1,shareholder,11,644,5,6,0.4
11,1,shift,5,645,2,3,0.24
11,1,shiny,5,646,3,2,0.16
11,1,shoot,5,647,2,3,0.2
11,1,sibling,7,648,1,6,0.28
11,1,sight,5,649,2,3,0.2
11,1,signature,9,650,3,6,0.4
11,1,similarly,9,651,2,7,0.36
11,1,simply,6,652,3,3,0.2
11,1,sin,3,653,2,1,0.08
11,1,six,3,654,2,1,0.12
11,1,skip,4,655,1,3,0.24
11,1,skull,5,656,2,3,0.2
11,1,slam,4,657,1,3,0.16
11,1,slice,5,658,2,3,0.2
11,1,slip,4,659,3,1,0.12
11,1,snow,4,660,1,3,0.24
11,1,soap,4,661,1,3,0.16
11,1,solar,5,662,2,3,0.16
11,1,solid,5,663,3,2,0.16
11,1,some,4,664,2,2,0.16
11,1,somehow,7,665,4,3,0.2
11,1,sometimes,9,666,4,5,0.36
11,1,soup,4,667,2,2,0.12
11,1,sovereignty,11,668,2,9,0.44
11,1,space,5,669,1,4,0.28
11,1,spare,5,670,3,2,0.16
11,1,speak,5,671,2,3,0.2
11,1,specialist,10,672,3,7,0.36
11,1,specialized,11,673,8,3,0.36
11,1,spine,5,674,2,3,0.2
11,1,spokesman,9,675,2,7,0.36
11,1,stab,4,676,1,3,0.16
11,1,stable,6,677,4,2,0.16
11,1,staff,5,678,3,2,0.24
11,1,stamp,5,679,3,2,0.16
11,1,stance,6,680,3,3,0.24
11,1,stand,5,681,4,1,0.16
11,1,star,4,682,3,1,0.12
11,1,statue,6,683,3,3,0.28
11,1,stem,4,684,2,2,0.16
11,1,stick,5,685,2,3,0.16
11,1,stop,4,686,2,2,0.12
11,1,store,5,687,3,2,0.16
11,1,story,5,688,4,1,0.12
11,1,straight,8,689,2,6,0.36
11,1,strategic,9,690,4,5,0.28
11,1,stretch,7,691,3,4,0.24
11,1,strike,6,692,3,3,0.28
11,1,strong,6,693,3,3,0.2
11,1,studio,6,694,2,4,0.24
11,1,study,5,695,4,1,0.12
11,1,stumble,7,696,3,4,0.28
11,1,stun,4,697,3,1,0.2
11,1,successful,10,698,1,9,0.48
11,1,sue,3,699,2,1,0.12
11,1,sufficient,10,700,2,8,0.44
11,1,sure,4,701,2,2,0.24
11,1,symbolic,8,702,1,7,0.32
11,1,tactical,8,703,0,8,0.36
11,1,talent,6,704,2,4,0.24
11,1,tank,4,705,2,2,0.2
11,1,tap,3,706,2,1,0.08
11,1,tape,4,707,3,1,0.12
11,1,tea,3,708,1,2,0.12
11,1,tendency,8,709,2,6,0.32
11,1,tender,6,710,5,1,0.2
11,1,tension,7,711,3,4,0.24
11,1,terrify,7,712,2,5,0.28
11,1,thereby,7,713,1,6,0.28
11,1,this,4,714,2,2,0.12
11,1,thoughtful,10,715,2,8,0.44
11,1,thrilled,8,716,2,6,0.28
11,1,ticket,6,717,1,5,0.24
11,1,tidy,4,718,2,2,0.12
11,1,tighten,7,719,2,5,0.36
11,1,timing,6,720,2,4,0.2
11,1,to,2,721,1,1,0.08
11,1,tolerance,9,722,2,7,0.32
11,1,tonne,5,723,2,3,0.28
11,1,too,3,724,2,1,0.08
11,1,tool,4,725,3,1,0.12
11,1,torture,7,726,2,5,0.24
11,1,tournament,10,727,2,8,0.4
11,1,trademark,9,728,1,8,0.44
11,1,tragic,6,729,3,3,0.2
11,1,transcript,10,730,3,7,0.36
11,1,tree,4,731,2,2,0.2
11,1,tribal,6,732,2,4,0.24
11,1,tribe,5,733,4,1,0.12
11,1,tribute,7,734,4,3,0.2
11,1,trio,4,735,3,1,0.12
11,1,tune,4,736,1,3,0.24
11,1,ultimate,8,737,0,8,0.36
11,1,undergo,7,738,1,6,0.28
11,1,underlying,10,739,5,5,0.32
11,1,underwear,9,740,5,4,0.32
11,1,unfair,6,741,2,4,0.24
11,1,union,5,742,2,3,0.2
11,1,unique,6,743,3,3,0.2
11,1,universal,9,744,3,6,0.4
11,1,until,5,745,2,3,0.2
11,1,uphold,6,746,1,5,0.24
11,1,urban,5,747,1,4,0.2
11,1,urgent,6,748,2,4,0.28
11,1,usual,5,749,1,4,0.2
11,1,utilize,7,750,1,6,0.32
11,1,validity,8,751,0,8,0.36
11,1,variety,7,752,2,5,0.32
11,1,vary,4,753,3,1,0.12
11,1,vein,4,754,1,3,0.16
11,1,venture,7,755,2,5,0.28
11,1,verify,6,756,2,4,0.2
11,1,vessel,6,757,2,4,0.28
11,1,veteran,7,758,2,5,0.28
11,1,viable,6,759,1,5,0.24
11,1,video,5,760,2,3,0.2
11,1,viewer,6,761,2,4,0.28
11,1,violent,7,762,2,5,0.24
11,1,virtue,6,763,2,4,0.24
11,1,virus,5,764,3,2,0.16
11,1,vital,5,765,2,3,0.16
11,1,vocal,5,766,1,4,0.28
11,1,wait,4,767,0,4,0.2
11,1,wake,4,768,2,2,0.16
11,1,walk,4,769,2,2,0.12
11,1,warrior,7,770,2,5,0.28
11,1,wealthy,7,771,1,6,0.4
11,1,weapon,6,772,3,3,0.2
11,1,weekend,7,773,2,5,0.28
11,1,weight,6,774,2,4,0.24
11,1,weird,5,775,3,2,0.2
11,1,welfare,7,776,2,5,0.28
11,1,west,4,777,2,2,0.16
11,1,whatever,8,778,1,7,0.32
11,1,whenever,8,779,2,6,0.36
11,1,whereas,7,780,3,4,0.24
11,1,which,5,781,2,3,0.16
11,1,whose,5,782,2,3,0.2
11,1,win,3,783,1,2,0.12
11,1,wind,4,784,3,1,0.12
11,1,window,6,785,4,2,0.24
11,1,woman,5,786,1,4,0.2
11,1,wrist,5,787,1,4,0.2
11,1,yellow,6,788,0,6,0.28
11,2,absolutely,10,0,0,10,1.12
11,2,absorb,6,1,4,2,0.4
11,2,absurd,6,2,3,3,0.44
11,2,academic,8,3,1,7,0.76
11,2,accelerate,10,4,2,8,1
11,2,accept,6,5,4,2,0.4
11,2,acceptable,10,6,6,4,0.68
11,2,accident,8,7,3,5,0.64
11,2,accommodate,11,8,3,8,1.04
11,2,accordance,10,9,4,6,0.76
11,2,actress,7,10,2,5,0.6
11,2,acute,5,11,2,3,0.52
11,2,add,3,12,1,2,0.28
11,2,additional,10,13,3,7,0.84
11,2,address,7,14,3,4,0.56
11,2,adj,3,15,2,1,0.32
11,2,adjacent,8,16,3,5,0.64
11,2,advantage,9,17,2,7,0.8
11,2,adventure,9,18,3,6,0.72
11,2,advice,6,19,3,3,0.56
11,2,afterwards,10,20,1,9,0.92
11,2,again,5,21,1,4,0.48
11,2,aggression,10,22,2,8,1
11,2,aggressive,10,23,8,2,0.56
11,2,agree,5,24,2,3,0.4
11,2,ahead,5,25,1,4,0.52
11,2,allocation,10,26,1,9,1.04
11,2,ally,4,27,3,1,0.28
11,2,alongside,9,28,2,7,0.8
11,2,ambassador,10,29,1,9,1.12
11,2,ambulance,9,30,3,6,0.8
11,2,ancient,7,31,1,6,0.68
11,2,and,3,32,2,1,0.24
11,2,anger,5,33,2,3,0.44
11,2,animal,6,34,2,4,0.68
11,2,announce,8,35,2,6,0.68
11,2,annoyed,7,36,4,3,0.52
11,2,annoying,8,37,5,3,0.64
11,2,another,7,38,2,5,0.6
11,2,anxiety,7,39,2,5,0.6
11,2,anyway,6,40,2,4,0.52
11,2,apologize,9,41,1,8,1
11,2,apology,7,42,6,1,0.4
11,2,app,3,43,2,1,0.24
11,2,applaud,7,44,3,4,0.56
11,2,approach,8,45,3,5,0.76
11,2,approve,7,46,5,2,0.44
11,2,arguably,8,47,1,7,0.76
11,2,arms,4,48,2,2,0.32
11,2,army,4,49,3,1,0.28
11,2,around,6,50,2,4,0.6
11,2,arrow,5,51,2,3,0.4
11,2,assault,7,52,1,6,0.64
11,2,associate,9,53,3,6,0.72
11,2,at,2,54,1,1,0.2
11,2,atrocity,8,55,2,6,0.88
11,2,attract,7,56,2,5,0.6
11,2,balance,7,57,0,7,0.72
11,2,ballet,6,58,3,3,0.44
11,2,banner,6,59,2,4,0.64
11,2,barrel,6,60,2,4,0.52
11,2,bat,3,61,2,1,0.24
11,2,bath,4,62,3,1,0.28
11,2,bay,3,63,2,1,0.24
11,2,beast,5,64,1,4,0.56
11,2,beat,4,65,3,1,0.28
11,2,beauty,6,66,3,3,0.48
11,2,beer,4,67,2,2,0.32
11,2,beg,3,68,2,1,0.24
11,2,behalf,6,69,2,4,0.52
11,2,behave,6,70,4,2,0.48
11,2,belief,6,71,2,4,0.52
11,2,below,5,72,3,2,0.36
11,2,benchmark,9,73,2,7,0.8
11,2,bin,3,74,1,2,0.4
11,2,birthday,8,75,2,6,0.72
11,2,bite,4,76,2,2,0.32
11,2,bitter,6,77,3,3,0.44
11,2,bizarre,7,78,2,5,0.6
11,2,blade,5,79,1,4,0.56
11,2,blank,5,80,3,2,0.36
11,2,blind,5,81,2,3,0.4
11,2,blog,4,82,2,2,0.32
11,2,blow,4,83,3,1,0.28
11,2,bomb,4,84,1,3,0.36
11,2,boom,4,85,2,2,0.4
11,2,boost,5,86,3,2,0.36
11,2,boot,4,87,3,1,0.28
11,2,bound,5,88,2,3,0.4
11,2,box,3,89,2,1,0.24
11,2,brand,5,90,1,4,0.56
11,2,breakdown,9,91,2,7,0.8
11,2,breathing,9,92,4,5,0.76
11,2,bridge,6,93,2,4,0.6
11,2,bright,6,94,3,3,0.6
11,2,broken,6,95,2,4,0.52
11,2,build,5,96,1,4,0.48
11,2,bunch,5,97,2,3,0.48
11,2,burden,6,98,2,4,0.56
11,2,business,8,99,2,6,0.8
11,2,businessman,11,100,8,3,0.64
11,2,cake,4,101,0,4,0.44
11,2,can,3,102,2,1,0.24
11,2,cancer,6,103,3,3,0.6
11,2,capability,10,104,2,8,0.96
11,2,capitalist,10,105,3,7,0.96
11,2,careful,7,106,2,5,0.76
11,2,carefully,9,107,7,2,0.52
11,2,carpet,6,108,3,3,0.44
11,2,carve,5,109,3,2,0.36
11,2,cease,5,110,1,4,0.48
11,2,celebrate,9,111,2,7,1
11,2,celebrity,9,112,6,3,0.68
11,2,cemetery,8,113,2,6,0.76
11,2,central,7,114,2,5,0.88
11,2,century,7,115,4,3,0.48
11,2,chapter,7,116,1,6,0.64
11,2,charming,8,117,3,5,0.64
11,2,cheat,5,118,2,3,0.52
11,2,check,5,119,3,2,0.36
11,2,cheerful,8,120,3,5,0.64
11,2,chemical,8,121,3,5,0.64
11,2,choose,6,122,2,4,0.44
11,2,chop,4,123,3,1,0.16
11,2,chronic,7,124,2,5,0.32
11,2,circuit,7,125,1,6,0.28
11,2,cite,4,126,2,2,0.16
11,2,citizenship,11,127,3,8,0.52
11,2,civil,5,128,2,3,0.16
11,2,clerk,5,129,1,4,0.2
11,2,clinical,8,130,2,6,0.36
11,2,cloud,5,131,2,3,0.2
11,2,collaborate,11,132,1,10,0.44
11,2,collective,10,133,4,6,0.32
11,2,colourful,9,134,3,6,0.4
11,2,community,9,135,2,7,0.32
11,2,compensate,10,136,3,7,0.36
11,2,compulsory,10,137,4,6,0.4
11,2,conceal,7,138,2,5,0.24
11,2,concern,7,139,5,2,0.2
11,2,concert,7,140,6,1,0.24
11,2,confer,6,141,3,3,0.2
11,2,conference,10,142,6,4,0.28
11,2,confess,7,143,5,2,0.2
11,2,connected,9,144,3,6,0.4
11,2,consent,7,145,3,4,0.24
11,2,constantly,10,146,4,6,0.36
11,2,consult,7,147,4,3,0.28
11,2,contempt,8,148,3,5,0.28
11,2,conversion,10,149,3,7,0.36
11,2,coordinate,10,150,2,8,0.44
11,2,could,5,151,2,3,0.16
11,2,coup,4,152,3,1,0.12
11,2,course,6,153,3,3,0.2
11,2,coverage,8,154,2,6,0.28
11,2,craft,5,155,1,4,0.28
11,2,creature,8,156,2,6,0.32
11,2,credibility,11,157,3,8,0.48
11,2,credible,8,158,6,2,0.28
11,2,criminal,8,159,2,6,0.32
11,2,cross,5,160,2,3,0.2
11,2,cruel,5,161,2,3,0.16
11,2,cruise,6,162,3,3,0.2
11,2,cry,3,163,2,1,0.16
11,2,cultivate,9,164,1,8,0.36
11,2,current,7,165,2,5,0.24
11,2,damage,6,166,0,6,0.28
11,2,dance,5,167,2,3,0.24
11,2,darkness,8,168,2,6,0.28
11,2,day,3,169,2,1,0.12
11,2,december,8,170,1,7,0.32
11,2,declare,7,171,3,4,0.32
11,2,deed,4,172,2,2,0.12
11,2,default,7,173,2,5,0.28
11,2,definitely,10,174,3,7,0.36
11,2,delight,7,175,2,5,0.32
11,2,delighted,9,176,7,2,0.24
11,2,democratic,10,177,2,8,0.36
11,2,dentist,7,178,2,5,0.32
11,2,departure,9,179,2,7,0.36
11,2,depressing,10,180,3,7,0.36
11,2,depression,10,181,8,2,0.32
11,2,deputy,6,182,3,3,0.2
11,2,destination,11,183,2,9,0.4
11,2,destruction,11,184,4,7,0.36
11,2,diagnosis,9,185,1,8,0.44
11,2,dictate,7,186,2,5,0.24
11,2,diminish,8,187,2,6,0.32
11,2,director,8,188,2,6,0.4
11,2,dirty,5,189,3,2,0.16
11,2,disabled,8,190,2,6,0.32
11,2,disastrous,10,191,4,6,0.4
11,2,disclosure,10,192,3,7,0.36
11,2,discovery,9,193,4,5,0.32
11,2,discretion,10,194,4,6,0.4
11,2,display,7,195,3,4,0.24
11,2,distant,7,196,3,4,0.24
11,2,distort,7,197,4,3,0.2
11,2,disturbing,10,198,4,6,0.4
11,2,divorced,8,199,2,6,0.28
11,2,dollar,6,200,1,5,0.24
11,2,donation,8,201,2,6,0.28
11,2,dot,3,202,2,1,0.16
11,2,double,6,203,2,4,0.24
11,2,download,8,204,2,6,0.28
11,2,drawing,7,205,1,6,0.28
11,2,drink,5,206,2,3,0.24
11,2,dust,4,207,1,3,0.16
11,2,ear,3,208,0,3,0.16
11,2,earnings,8,209,3,5,0.28
11,2,earth,5,210,3,2,0.16
11,2,edit,4,211,1,3,0.24
11,2,edition,7,212,4,3,0.2
11,2,editor,6,213,4,2,0.16
11,2,effective,9,214,1,8,0.36
11,2,effort,6,215,3,3,0.24
11,2,eight,5,216,1,4,0.2
11,2,electricity,11,217,1,10,0.44
11,2,eleven,6,218,3,3,0.2
11,2,elsewhere,9,219,2,7,0.4
11,2,embark,6,220,1,5,0.24
11,2,embody,6,221,3,3,0.2
11,2,emission,8,222,2,6,0.32
11,2,empower,7,223,2,5,0.32
11,2,enable,6,224,1,5,0.24
11,2,endless,7,225,2,5,0.28
11,2,engineering,11,226,2,9,0.48
11,2,enjoyable,9,227,2,7,0.36
11,2,enrich,6,228,2,4,0.24
11,2,enter,5,229,2,3,0.2
11,2,enterprise,10,230,5,5,0.36
11,2,enthusiast,10,231,3,7,0.36
11,2,entrance,8,232,3,5,0.4
11,2,entry,5,233,4,1,0.12
11,2,environment,11,234,2,9,0.48
11,2,equipment,9,235,1,8,0.4
11,2,erect,5,236,1,4,0.24
11,2,essay,5,237,1,4,0.28
11,2,essence,7,238,3,4,0.24
11,2,essentially,11,239,5,6,0.36
11,2,evening,7,240,1,6,0.36
11,2,event,5,241,4,1,0.16
11,2,evoke,5,242,2,3,0.16
11,2,exceed,6,243,1,5,0.24
11,2,excellent,9,244,4,5,0.28
11,2,exclusive,9,245,3,6,0.4
11,2,exclusively,11,246,9,2,0.24
11,2,excuse,6,247,3,3,0.2
11,2,execution,9,248,2,7,0.4
11,2,executive,9,249,7,2,0.24
11,2,existence,9,250,2,7,0.36
11,2,exit,4,251,3,1,0.12
11,2,expensive,9,252,2,7,0.4
11,2,experiment,10,253,4,6,0.32
11,2,expire,6,254,3,3,0.2
11,2,explicitly,10,255,3,7,0.44
11,2,exploration,11,256,4,7,0.4
11,2,explosive,9,257,5,4,0.28
11,2,extend,6,258,2,4,0.32
11,2,extent,6,259,5,1,0.16
11,2,extremist,9,260,3,6,0.32
11,2,eye,3,261,1,2,0.12
11,2,faculty,7,262,0,7,0.4
11,2,failure,7,263,2,5,0.24
11,2,famous,6,264,2,4,0.24
11,2,fantasy,7,265,2,5,0.24
11,2,fashionable,11,266,2,9,0.48
11,2,fat,3,267,2,1,0.08
11,2,feeding,7,268,1,6,0.28
11,2,fellow,6,269,2,4,0.2
11,2,fifty,5,270,1,4,0.2
11,2,financial,9,271,2,7,0.44
11,2,firefighter,11,272,2,9,0.4
11,2,fix,3,273,2,1,0.08
11,2,fixed,5,274,3,2,0.24
11,2,flee,4,275,1,3,0.16
11,2,flexibility,11,276,3,8,0.4
11,2,floor,5,277,2,3,0.16
11,2,flourish,8,278,3,5,0.36
11,2,flu,3,279,2,1,0.08
11,2,folding,7,280,1,6,0.28
11,2,food,4,281,2,2,0.16
11,2,formation,9,282,2,7,0.36
11,2,formerly,8,283,4,4,0.32
11,2,forthcoming,11,284,3,8,0.4
11,2,forward,7,285,3,4,0.24
11,2,freedom,7,286,1,6,0.36
11,2,frequent,8,287,3,5,0.28
11,2,friday,6,288,2,4,0.2
11,2,friendship,10,289,3,7,0.36
11,2,frighten,8,290,3,5,0.36
11,2,fundamental,11,291,1,10,0.44
11,2,fur,3,292,2,1,0.08
11,2,gallery,7,293,0,7,0.36
11,2,gallon,6,294,4,2,0.16
11,2,gaming,6,295,2,4,0.2
11,2,garage,6,296,2,4,0.24
11,2,gene,4,297,1,3,0.16
11,2,genetic,7,298,4,3,0.28
11,2,genuinely,9,299,3,6,0.36
11,2,geography,9,300,2,7,0.36
11,2,giant,5,301,1,4,0.28
11,2,glass,5,302,1,4,0.2
11,2,god,3,303,1,2,0.12
11,2,gold,4,304,2,2,0.16
11,2,govern,6,305,2,4,0.24
11,2,governor,8,306,6,2,0.28
11,2,grace,5,307,1,4,0.2
11,2,grade,5,308,3,2,0.16
11,2,grandfather,11,309,3,8,0.4
11,2,gravity,7,310,3,4,0.32
11,2,green,5,311,2,3,0.2
11,2,greet,5,312,4,1,0.16
11,2,grid,4,313,2,2,0.16
11,2,grin,4,314,3,1,0.12
11,2,ground,6,315,2,4,0.24
11,2,guest,5,316,1,4,0.28
11,2,guitar,6,317,2,4,0.2
11,2,hair,4,318,0,4,0.2
11,2,happen,6,319,2,4,0.24
11,2,harvest,7,320,2,5,0.28
11,2,hazard,6,321,2,4,0.32
11,2,headline,8,322,1,7,0.36
11,2,heat,4,323,3,1,0.12
11,2,herb,4,324,2,2,0.12
11,2,hers,4,325,3,1,0.12
11,2,historic,8,326,1,7,0.4
11,2,historical,10,327,8,2,0.28
11,2,holiday,7,328,1,6,0.28
11,2,honesty,7,329,2,5,0.36
11,2,horror,6,330,2,4,0.24
11,2,hotel,5,331,2,3,0.16
11,2,hour,4,332,2,2,0.12
11,2,household,9,333,3,6,0.4
11,2,how,3,334,2,1,0.12
11,2,humble,6,335,1,5,0.24
11,2,hurricane,9,336,2,7,0.32
11,2,hydrogen,8,337,1,7,0.4
11,2,hypothesis,10,338,2,8,0.48
11,2,ice,3,339,0,3,0.16
11,2,icon,4,340,2,2,0.16
11,2,identical,9,341,1,8,0.48
11,2,ignorance,9,342,1,8,0.36
11,2,ill,3,343,1,2,0.12
11,2,imagery,7,344,1,6,0.28
11,2,imaginary,9,345,4,5,0.4
11,2,impatient,9,346,2,7,0.4
11,2,implication,11,347,3,8,0.44
11,2,improve,7,348,3,4,0.32
11,2,include,7,349,1,6,0.28
11,2,incorporate,11,350,3,8,0.4
11,2,incorrect,9,351,5,4,0.36
11,2,incur,5,352,3,2,0.16
11,2,independent,11,353,2,9,0.44
11,2,index,5,354,4,1,0.12
11,2,inevitable,10,355,2,8,0.48
11,2,influence,9,356,2,7,0.36
11,2,influential,11,357,7,4,0.32
11,2,info,4,358,3,1,0.12
11,2,information,11,359,4,7,0.44
11,2,inherent,8,360,2,6,0.32
11,2,insert,6,361,2,4,0.2
11,2,inspect,7,362,3,4,0.32
11,2,instruct,8,363,3,5,0.28
11,2,intake,6,364,2,4,0.24
11,2,integral,8,365,3,5,0.28
11,2,intelligent,11,366,4,7,0.44
11,2,intended,8,367,4,4,0.24
11,2,intensify,9,368,5,4,0.28
11,2,into,4,369,3,1,0.2
11,2,invade,6,370,2,4,0.2
11,2,involve,7,371,3,4,0.24
11,2,involved,8,372,7,1,0.2
11,2,iron,4,373,1,3,0.16
11,2,issue,5,374,1,4,0.28
11,2,january,7,375,0,7,0.32
11,2,jet,3,376,1,2,0.12
11,2,jump,4,377,1,3,0.16
11,2,kid,3,378,0,3,0.16
11,2,king,4,379,2,2,0.16
11,2,knife,5,380,1,4,0.28
11,2,lack,4,381,0,4,0.2
11,2,lad,3,382,2,1,0.08
11,2,lap,3,383,2,1,0.08
11,2,laser,5,384,2,3,0.2
11,2,last,4,385,3,1,0.12
11,2,laugh,5,386,2,3,0.24
11,2,leading,7,387,1,6,0.28
11,2,leaflet,7,388,3,4,0.24
11,2,league,6,389,3,3,0.2
11,2,learning,8,390,3,5,0.36
11,2,left,4,391,2,2,0.16
11,2,lemon,5,392,2,3,0.16
11,2,lens,4,393,2,2,0.12
11,2,letter,6,394,2,4,0.24
11,2,licence,7,395,1,6,0.36
11,2,lie,3,396,2,1,0.08
11,2,lifestyle,9,397,2,7,0.36
11,2,likelihood,10,398,2,8,0.36
11,2,limb,4,399,2,2,0.2
11,2,limited,7,400,3,4,0.24
11,2,lion,4,401,2,2,0.12
11,2,literary,8,402,2,6,0.32
11,2,litter,6,403,3,3,0.28
11,2,little,6,404,4,2,0.16
11,2,live,4,405,2,2,0.12
11,2,local,5,406,1,4,0.2
11,2,location,8,407,4,4,0.24
11,2,long,4,408,2,2,0.2
11,2,look,4,409,2,2,0.16
11,2,loose,5,410,3,2,0.16
11,2,lot,3,411,2,1,0.08
11,2,low,3,412,2,1,0.12
11,2,lunch,5,413,1,4,0.2
11,2,machinery,9,414,0,9,0.44
11,2,main,4,415,2,2,0.12
11,2,mainstream,10,416,4,6,0.32
11,2,mandate,7,417,2,5,0.24
11,2,manipulate,10,418,3,7,0.44
11,2,manuscript,10,419,3,7,0.36
11,2,mark,4,420,2,2,0.16
11,2,master,6,421,2,4,0.32
11,2,match,5,422,2,3,0.4
11,2,meal,4,423,1,3,0.4
11,2,meaningful,10,424,3,7,0.84
11,2,meanwhile,9,425,4,5,0.84
11,2,media,5,426,2,3,0.4
11,2,medication,10,427,4,6,0.76
11,2,meeting,7,428,2,5,0.6
11,2,melody,6,429,2,4,0.64
11,2,mental,6,430,2,4,0.52
11,2,mentor,6,431,4,2,0.4
11,2,merger,6,432,2,4,0.52
11,2,mess,4,433,2,2,0.32
11,2,message,7,434,4,3,0.6
11,2,metre,5,435,2,3,0.4
11,2,militia,7,436,1,6,0.64
11,2,mind,4,437,2,2,0.32
11,2,ministry,8,438,3,5,0.76
11,2,miserable,9,439,2,7,0.8
11,2,model,5,440,1,4,0.48
11,2,moment,6,441,2,4,0.52
11,2,money,5,442,2,3,0.56
11,2,monthly,7,443,3,4,0.56
11,2,monument,8,444,3,5,0.64
11,2,more,4,445,2,2,0.32
11,2,mother,6,446,2,4,0.52
11,2,mouth,5,447,2,3,0.52
11,2,movie,5,448,2,3,0.44
11,2,multiple,8,449,1,7,0.76
11,2,mum,3,450,2,1,0.24
11,2,musician,8,451,2,6,0.84
11,2,must,4,452,3,1,0.28
11,2,myth,4,453,1,3,0.36
11,2,name,4,454,0,4,0.44
11,2,nasty,5,455,2,3,0.4
11,2,necessarily,11,456,1,10,1.16
11,2,necessary,9,457,8,1,0.48
11,2,needle,6,458,2,4,0.52
11,2,negotiation,11,459,2,9,1.12
11,2,neutral,7,460,2,5,0.76
11,2,newly,5,461,2,3,0.48
11,2,night,5,462,1,4,0.48
11,2,noisy,5,463,1,4,0.48
11,2,nominate,8,464,2,6,0.84
11,2,non,3,465,2,1,0.24
11,2,normal,6,466,2,4,0.52
11,2,north,5,467,3,2,0.36
11,2,northern,8,468,5,3,0.64
11,2,note,4,469,2,2,0.32
11,2,notion,6,470,3,3,0.48
11,2,novel,5,471,2,3,0.44
11,2,obesity,7,472,0,7,0.72
11,2,obviously,9,473,2,7,0.92
11,2,occupation,10,474,1,9,1.32
11,2,ocean,5,475,2,3,0.68
11,2,october,7,476,2,5,0.76
11,2,off,3,477,1,2,0.32
11,2,offence,7,478,3,4,0.68
11,2,offend,6,479,5,1,0.36
11,2,one,3,480,1,2,0.28
11,2,opponent,8,481,1,7,0.92
11,2,opportunity,11,482,4,7,0.88
11,2,opposed,7,483,4,3,0.48
11,2,optimistic,10,484,2,8,1
11,2,option,6,485,4,2,0.4
11,2,organized,9,486,1,8,0.88
11,2,ought,5,487,1,4,0.48
11,2,outdoor,7,488,2,5,0.76
11,2,outfit,6,489,3,3,0.44
11,2,outing,6,490,3,3,0.48
11,2,outlook,7,491,3,4,0.56
11,2,oversee,7,492,1,6,0.76
11,2,owe,3,493,1,2,0.28
11,2,page,4,494,0,4,0.44
11,2,park,4,495,2,2,0.32
11,2,participant,11,496,3,8,0.92
11,2,participate,11,497,9,2,0.72
11,2,peculiar,8,498,1,7,0.76
11,2,perhaps,7,499,2,5,0.6
11,2,physician,9,500,1,8,0.96
11,2,pick,4,501,1,3,0.36
11,2,pile,4,502,2,2,0.32
11,2,pin,3,503,2,1,0.24
11,2,pipe,4,504,2,2,0.32
11,2,place,5,505,1,4,0.48
11,2,plan,4,506,3,1,0.4
11,2,play,4,507,3,1,0.32
11,2,plead,5,508,2,3,0.48
11,2,pleased,7,509,4,3,0.52
11,2,pledge,6,510,3,3,0.44
11,2,plot,4,511,2,2,0.44
11,2,police,6,512,1,5,0.6
11,2,political,9,513,4,5,0.76
11,2,pollution,9,514,3,6,0.8
11,2,pond,4,515,2,2,0.44
11,2,population,10,516,2,8,0.88
11,2,portion,7,517,2,5,0.6
11,2,position,8,518,2,6,0.72
11,2,possibility,11,519,3,8,1.24
11,2,post,4,520,3,1,0.32
11,2,pot,3,521,2,1,0.28
11,2,practical,9,522,1,8,1
11,2,praise,6,523,3,3,0.6
11,2,prayer,6,524,3,3,0.48
11,2,precise,7,525,2,5,0.64
11,2,pregnant,8,526,3,5,0.76
11,2,prejudice,9,527,3,6,0.92
11,2,preliminary,11,528,3,8,0.96
11,2,premise,7,529,3,4,0.56
11,2,prescribe,9,530,3,6,0.88
11,2,presently,9,531,4,5,0.76
11,2,prestigious,11,532,4,7,0.88
11,2,previously,10,533,3,7,1
11,2,principal,9,534,2,7,0.8
11,2,principle,9,535,7,2,0.52
11,2,printer,7,536,4,3,0.64
11,2,procedure,9,537,2,7,0.8
11,2,processing,10,538,5,5,0.72
11,2,processor,9,539,7,2,0.64
11,2,produce,7,540,3,4,0.56
11,2,profile,7,541,3,4,0.56
11,2,programming,11,542,3,8,1.08
11,2,project,7,543,3,4,0.56
11,2,prominent,9,544,3,6,0.76
11,2,proof,5,545,3,2,0.36
11,2,properly,8,546,3,5,0.88
11,2,propose,7,547,4,3,0.6
11,2,proposition,11,548,6,5,0.96
11,2,prosperity,10,549,3,7,1.04
11,2,protest,7,550,3,4,0.64
11,2,protester,9,551,7,2,0.6
11,2,punk,4,552,1,3,0.44
11,2,pupil,5,553,2,3,0.44
11,2,purpose,7,554,2,5,0.76
11,2,pursuit,7,555,3,4,0.56
11,2,push,4,556,2,2,0.36
11,2,put,3,557,2,1,0.24
11,2,quality,7,558,0,7,0.76
11,2,race,4,559,0,4,0.56
11,2,racism,6,560,3,3,0.48
11,2,radiation,9,561,2,7,0.84
11,2,railway,7,562,2,5,0.64
11,2,rating,6,563,2,4,0.64
11,2,rational,8,564,4,4,0.6
11,2,record,6,565,1,5,0.56
11,2,recording,9,566,6,3,0.72
11,2,recount,7,567,4,3,0.52
11,2,reduce,6,568,2,4,0.52
11,2,refer,5,569,2,3,0.4
11,2,regime,6,570,2,4,0.52
11,2,region,6,571,4,2,0.56
11,2,relevance,9,572,2,7,0.96
11,2,relief,6,573,3,3,0.56
11,2,remainder,9,574,2,7,0.88
11,2,remark,6,575,4,2,0.56
11,2,remind,6,576,3,3,0.48
11,2,remove,6,577,3,3,0.48
11,2,republic,8,578,2,6,0.68
11,2,reside,6,579,2,4,0.64
11,2,residue,7,580,5,2,0.48
11,2,resignation,11,581,4,7,0.88
11,2,resolve,7,582,3,4,0.68
11,2,respective,10,583,3,7,0.84
11,2,responsible,11,584,4,7,0.88
11,2,rest,4,585,3,1,0.28
11,2,retire,6,586,2,4,0.64
11,2,retrieve,8,587,3,5,0.64
11,2,reveal,6,588,2,4,0.52
11,2,revise,6,589,3,3,0.48
11,2,revival,7,590,4,3,0.6
11,2,rip,3,591,1,2,0.28
11,2,rise,4,592,2,2,0.36
11,2,ritual,6,593,2,4,0.52
11,2,rival,5,594,2,3,0.4
11,2,rob,3,595,1,2,0.28
11,2,robust,6,596,3,3,0.6
11,2,roll,4,597,2,2,0.32
11,2,romance,7,598,2,5,0.6
11,2,roof,4,599,2,2,0.32
11,2,rough,5,600,2,3,0.4
11,2,routine,7,601,3,4,0.68
11,2,rub,3,602,1,2,0.28
11,2,rubber,6,603,3,3,0.48
11,2,ruin,4,604,2,2,0.32
11,2,sacred,6,605,0,6,0.64
11,2,safe,4,606,2,2,0.44
11,2,sailor,6,607,2,4,0.52
11,2,sale,4,608,2,2,0.36
11,2,sand,4,609,2,2,0.36
11,2,scattered,9,610,1,8,0.88
11,2,schedule,8,611,2,6,0.84
11,2,scheme,6,612,4,2,0.4
11,2,scholar,7,613,3,4,0.56
11,2,scholarship,11,614,7,4,0.84
11,2,school,6,615,4,2,0.4
11,2,scientific,10,616,2,8,0.92
11,2,scientist,9,617,7,2,0.52
11,2,score,5,618,2,3,0.56
11,2,seal,4,619,1,3,0.4
11,2,second,6,620,2,4,0.52
11,2,secretary,9,621,3,6,0.84
11,2,secure,6,622,3,3,0.64
11,2,security,8,623,5,3,0.56
11,2,segment,7,624,2,5,0.6
11,2,selective,9,625,2,7,0.8
11,2,sensible,8,626,2,6,1.08
11,2,september,9,627,2,7,0.92
11,2,seriously,9,628,2,7,1.08
11,2,servant,7,629,3,4,0.76
11,2,serve,5,630,4,1,0.6
11,2,seven,5,631,2,3,0.52
11,2,shallow,7,632,1,6,0.52
11,2,shape,5,633,3,2,0.16
11,2,share,5,634,3,2,0.16
11,2,shareholder,11,635,5,6,0.48
11,2,sheer,5,636,2,3,0.2
11,2,shiny,5,637,2,3,0.2
11,2,shortly,7,638,2,5,0.28
11,2,sight,5,639,1,4,0.28
11,2,signature,9,640,3,6,0.32
11,2,sin,3,641,2,1,0.12
11,2,singing,7,642,3,4,0.24
11,2,sink,4,643,3,1,0.12
11,2,sit,3,644,2,1,0.16
11,2,situated,8,645,3,5,0.28
11,2,six,3,646,2,1,0.12
11,2,skirt,5,647,1,4,0.2
11,2,slip,4,648,1,3,0.16
11,2,smile,5,649,1,4,0.28
11,2,smoking,7,650,2,5,0.28
11,2,soap,4,651,1,3,0.16
11,2,solar,5,652,2,3,0.16
11,2,something,9,653,2,7,0.36
11,2,song,4,654,2,2,0.2
11,2,sovereignty,11,655,2,9,0.44
11,2,speaker,7,656,1,6,0.32
11,2,speech,6,657,3,3,0.2
11,2,spine,5,658,2,3,0.24
11,2,spotlight,9,659,2,7,0.36
11,2,spread,6,660,2,4,0.24
11,2,stall,5,661,1,4,0.2
11,2,stamp,5,662,3,2,0.24
11,2,stance,6,663,3,3,0.2
11,2,stand,5,664,4,1,0.12
11,2,standing,8,665,5,3,0.24
11,2,star,4,666,3,1,0.12
11,2,stay,4,667,3,1,0.16
11,2,steadily,8,668,2,6,0.32
11,2,steer,5,669,3,2,0.16
11,2,stem,4,670,3,1,0.12
11,2,stick,5,671,2,3,0.2
11,2,sticky,6,672,5,1,0.2
11,2,straight,8,673,2,6,0.32
11,2,strange,7,674,4,3,0.2
11,2,strategy,8,675,4,4,0.24
11,2,strength,8,676,3,5,0.36
11,2,stretch,7,677,4,3,0.2
11,2,strike,6,678,3,3,0.2
11,2,string,6,679,4,2,0.16
11,2,strong,6,680,3,3,0.28
11,2,studio,6,681,2,4,0.24
11,2,study,5,682,4,1,0.16
11,2,successful,10,683,1,9,0.4
11,2,sudden,6,684,2,4,0.28
11,2,sue,3,685,2,1,0.08
11,2,sure,4,686,2,2,0.12
11,2,surely,6,687,4,2,0.16
11,2,surrounding,11,688,3,8,0.4
11,2,survival,8,689,3,5,0.36
11,2,swallow,7,690,1,6,0.28
11,2,swear,5,691,2,3,0.16
11,2,sweater,7,692,4,3,0.24
11,2,sweep,5,693,3,2,0.2
11,2,sympathy,8,694,1,7,0.4
11,2,tail,4,695,0,4,0.2
11,2,team,4,696,1,3,0.2
11,2,television,10,697,2,8,0.48
11,2,temperature,11,698,2,9,0.44
11,2,tendency,8,699,2,6,0.28
11,2,tension,7,700,3,4,0.32
11,2,terrific,8,701,2,6,0.28
11,2,terrify,7,702,6,1,0.16
11,2,terror,6,703,4,2,0.16
11,2,terrorism,9,704,6,3,0.32
11,2,texture,7,705,2,5,0.28
11,2,themselves,10,706,1,9,0.4
11,2,therapist,9,707,3,6,0.44
11,2,thereafter,10,708,4,6,0.36
11,2,thesis,6,709,3,3,0.2
11,2,thorough,8,710,2,6,0.32
11,2,three,5,711,2,3,0.24
11,2,thumb,5,712,2,3,0.2
11,2,tighten,7,713,1,6,0.28
11,2,till,4,714,2,2,0.16
11,2,timing,6,715,2,4,0.24
11,2,to,2,716,1,1,0.16
11,2,together,8,717,2,6,0.32
11,2,tolerance,9,718,2,7,0.36
11,2,tonight,7,719,2,5,0.28
11,2,torture,7,720,2,5,0.36
11,2,trademark,9,721,1,8,0.4
11,2,translation,11,722,3,8,0.4
11,2,traveller,9,723,3,6,0.4
11,2,treat,5,724,2,3,0.16
11,2,treaty,6,725,5,1,0.16
11,2,tree,4,726,3,1,0.12
11,2,tribe,5,727,2,3,0.24
11,2,tribute,7,728,4,3,0.2
11,2,trousers,8,729,2,6,0.28
11,2,truck,5,730,2,3,0.2
11,2,ultimate,8,731,0,8,0.4
11,2,undergo,7,732,1,6,0.28
11,2,underlying,10,733,5,5,0.32
11,2,undermine,9,734,5,4,0.28
11,2,underwear,9,735,5,4,0.36
11,2,undoubtedly,11,736,3,8,0.4
11,2,unfair,6,737,2,4,0.2
11,2,unify,5,738,2,3,0.24
11,2,union,5,739,3,2,0.16
11,2,universe,8,740,3,5,0.28
11,2,unveil,6,741,2,4,0.2
11,2,uphold,6,742,1,5,0.32
11,2,urban,5,743,1,4,0.2
11,2,vague,5,744,0,5,0.24
11,2,validity,8,745,2,6,0.28
11,2,valuable,8,746,3,5,0.36
11,2,vegetable,9,747,1,8,0.36
11,2,vein,4,748,2,2,0.12
11,2,verify,6,749,2,4,0.24
11,2,vessel,6,750,2,4,0.2
11,2,viable,6,751,1,5,0.32
11,2,villager,8,752,2,6,0.32
11,2,violent,7,753,2,5,0.24
11,2,virtual,7,754,2,5,0.32
11,2,virus,5,755,3,2,0.16
11,2,visitor,7,756,2,5,0.28
11,2,visual,6,757,3,3,0.2
11,2,vital,5,758,2,3,0.16
11,2,vocal,5,759,1,4,0.28
11,2,volunteer,9,760,2,7,0.32
11,2,wake,4,761,0,4,0.2
11,2,walk,4,762,2,2,0.16
11,2,war,3,763,2,1,0.12
11,2,washing,7,764,2,5,0.32
11,2,watch,5,765,2,3,0.2
11,2,way,3,766,2,1,0.08
11,2,weakness,8,767,1,7,0.32
11,2,wealthy,7,768,3,4,0.24
11,2,weapon,6,769,3,3,0.28
11,2,weave,5,770,3,2,0.16
11,2,weekend,7,771,2,5,0.28
11,2,welcome,7,772,2,5,0.36
11,2,welfare,7,773,3,4,0.72
11,2,west,4,774,2,2,0.32
11,2,whatever,8,775,1,7,0.76
11,2,whenever,8,776,2,6,0.72
11,2,whereas,7,777,3,4,0.68
11,2,which,5,778,2,3,0.44
11,2,willing,7,779,1,6,0.68
11,2,win,3,780,2,1,0.24
11,2,wind,4,781,3,1,0.28
11,2,work,4,782,1,3,0.48
11,2,workforce,9,783,4,5,0.72
11,2,worry,5,784,3,2,0.4
11,2,wow,3,785,2,1,0.28
11,2,wrist,5,786,1,4,0.6
11,2,young,5,787,0,5,0.72
11,2,youngster,9,788,5,4,0.64
11,3,absence,7,0,0,7,0.32
11,3,absorb,6,1,3,3,0.2
11,3,absurd,6,2,3,3,0.24
11,3,accelerate,10,3,1,9,0.4
11,3,accident,8,4,3,5,0.28
11,3,accomplish,10,5,3,7,0.44
11,3,accordance,10,6,4,6,0.32
11,3,accurate,8,7,3,5,0.28
11,3,acquisition,11,8,2,9,0.48
11,3,acre,4,9,2,2,0.16
11,3,activate,8,10,2,6,0.28
11,3,actress,7,11,3,4,0.28
11,3,acute,5,12,2,3,0.24
11,3,ad,2,13,1,1,0.08
11,3,add,3,14,2,1,0.12
11,3,additional,10,15,3,7,0.4
11,3,adequately,10,16,2,8,0.52
11,3,adoption,8,17,2,6,0.28
11,3,adventure,9,18,2,7,0.36
11,3,afterwards,10,19,1,9,0.48
11,3,again,5,20,1,4,0.2
11,3,against,7,21,5,2,0.2
11,3,agree,5,22,2,3,0.16
11,3,alcohol,7,23,1,6,0.28
11,3,align,5,24,2,3,0.24
11,3,allocation,10,25,2,8,0.48
11,3,amateur,7,26,1,6,0.32
11,3,ambassador,10,27,2,8,0.48
11,3,and,3,28,1,2,0.12
11,3,anger,5,29,2,3,0.16
11,3,animal,6,30,2,4,0.2
11,3,anniversary,11,31,2,9,0.48
11,3,announce,8,32,3,5,0.28
11,3,annoyed,7,33,4,3,0.2
11,3,annoying,8,34,5,3,0.24
11,3,anxiety,7,35,2,5,0.32
11,3,anybody,7,36,2,5,0.6
11,3,appreciate,10,37,1,9,0.96
11,3,approve,7,38,4,3,0.6
11,3,arguably,8,39,1,7,0.76
11,3,argue,5,40,4,1,0.32
11,3,arms,4,41,2,2,0.32
11,3,arrangement,11,42,2,9,1.08
11,3,arrest,6,43,3,3,0.44
11,3,artistic,8,44,2,6,0.72
11,3,assistant,9,45,1,8,0.84
11,3,atrocity,8,46,1,7,0.84
11,3,attachment,10,47,2,8,0.88
11,3,auction,7,48,1,6,0.72
11,3,auto,4,49,2,2,0.32
11,3,average,7,50,1,6,0.76
11,3,baby,4,51,0,4,0.44
11,3,backing,7,52,2,5,0.6
11,3,bath,4,53,2,2,0.32
11,3,beast,5,54,1,4,0.6
11,3,bed,3,55,2,1,0.24
11,3,behalf,6,56,2,4,0.52
11,3,behave,6,57,4,2,0.4
11,3,belief,6,58,2,4,0.52
11,3,belong,6,59,3,3,0.56
11,3,benchmark,9,60,2,7,0.8
11,3,best,4,61,2,2,0.32
11,3,beyond,6,62,2,4,0.52
11,3,bill,4,63,1,3,0.4
11,3,bin,3,64,2,1,0.32
11,3,biscuit,7,65,2,5,0.6
11,3,bishop,6,66,3,3,0.44
11,3,blade,5,67,1,4,0.48
11,3,bless,5,68,2,3,0.4
11,3,blog,4,69,2,2,0.44
11,3,boat,4,70,1,3,0.4
11,3,boom,4,71,2,2,0.32
11,3,bother,6,72,2,4,0.52
11,3,bottle,6,73,3,3,0.44
11,3,boundary,8,74,2,6,0.8
11,3,brand,5,75,1,4,0.48
11,3,breathe,7,76,2,5,0.64
11,3,breathing,9,77,6,3,0.6
11,3,bright,6,78,2,4,0.64
11,3,bunch,5,79,1,4,0.52
11,3,burden,6,80,2,4,0.52
11,3,butter,6,81,2,4,0.52
11,3,can,3,82,0,3,0.36
11,3,candidate,9,83,3,6,0.92
11,3,capitalist,10,84,2,8,1.08
11,3,card,4,85,2,2,0.32
11,3,carpet,6,86,3,3,0.6
11,3,cartoon,7,87,3,4,0.56
11,3,century,7,88,1,6,0.68
11,3,certain,7,89,2,5,0.64
11,3,challenge,9,90,1,8,1
11,3,chapter,7,91,3,4,0.56
11,3,character,9,92,3,6,0.76
11,3,charity,7,93,4,3,0.48
11,3,chart,5,94,4,1,0.4
11,3,charter,7,95,5,2,0.52
11,3,check,5,96,2,3,0.48
11,3,cheerful,8,97,3,5,0.72
11,3,childhood,9,98,2,7,0.96
11,3,chunk,5,99,2,3,0.48
11,3,circuit,7,100,1,6,0.76
11,3,cite,4,101,2,2,0.4
11,3,city,4,102,3,1,0.32
11,3,clarity,7,103,1,6,0.76
11,3,clause,6,104,3,3,0.44
11,3,clean,5,105,2,3,0.4
11,3,clearly,7,106,4,3,0.48
11,3,clinical,8,107,2,6,0.88
11,3,closely,7,108,2,5,0.72
11,3,cloud,5,109,3,2,0.44
11,3,cluster,7,110,2,5,0.72
11,3,coach,5,111,1,4,0.6
11,3,coffee,6,112,2,4,0.52
11,3,collaborate,11,113,2,9,1.04
11,3,collective,10,114,4,6,0.96
11,3,community,9,115,2,7,0.84
11,3,company,7,116,3,4,0.56
11,3,comparable,10,117,5,5,0.8
11,3,compassion,10,118,5,5,0.88
11,3,completion,10,119,4,6,0.84
11,3,comply,6,120,5,1,0.36
11,3,component,9,121,4,5,0.76
11,3,conceal,7,122,2,5,0.6
11,3,conceive,8,123,5,3,0.52
11,3,concert,7,124,5,2,0.44
11,3,conclusion,10,125,4,6,0.88
11,3,conduct,7,126,3,4,0.56
11,3,confess,7,127,3,4,0.56
11,3,connected,9,128,3,6,0.92
11,3,consent,7,129,3,4,0.68
11,3,consistency,11,130,4,7,1
11,3,constantly,10,131,4,6,0.92
11,3,consult,7,132,4,3,0.52
11,3,contempt,8,133,3,5,0.64
11,3,contend,7,134,5,2,0.44
11,3,convey,6,135,3,3,0.56
11,3,cope,4,136,2,2,0.32
11,3,correct,7,137,2,5,0.6
11,3,cost,4,138,2,2,0.32
11,3,cottage,7,139,2,5,0.6
11,3,counter,7,140,2,5,0.8
11,3,counterpart,11,141,7,4,0.72
11,3,county,6,142,5,1,0.36
11,3,coup,4,143,3,1,0.28
11,3,credibility,11,144,1,10,1.24
11,3,creep,5,145,3,2,0.36
11,3,crowd,5,146,2,3,0.44
11,3,crowded,7,147,5,2,0.44
11,3,crucial,7,148,2,5,0.72
11,3,cruel,5,149,3,2,0.36
11,3,cultivate,9,150,1,8,0.88
11,3,current,7,151,2,5,0.68
11,3,curriculum,10,152,4,6,0.92
11,3,curved,6,153,3,3,0.48
11,3,damage,6,154,0,6,0.64
11,3,dance,5,155,2,3,0.44
11,3,day,3,156,2,1,0.36
11,3,deal,4,157,1,3,0.36
11,3,death,5,158,3,2,0.36
11,3,december,8,159,2,6,0.72
11,3,declare,7,160,3,4,0.56
11,3,decline,7,161,4,3,0.64
11,3,decoration,10,162,3,7,0.92
11,3,decrease,8,163,3,5,0.68
11,3,deed,4,164,2,2,0.48
11,3,deem,4,165,3,1,0.28
11,3,defender,8,166,2,6,0.72
11,3,definite,8,167,3,5,0.64
11,3,delighted,9,168,2,7,0.92
11,3,deposit,7,169,2,5,0.6
11,3,depression,10,170,3,7,0.88
11,3,desktop,7,171,2,5,0.72
11,3,despite,7,172,3,4,0.72
11,3,destination,11,173,3,8,0.96
11,3,detect,6,174,2,4,0.52
11,3,detention,9,175,4,5,0.8
11,3,develop,7,176,2,5,0.68
11,3,diagram,7,177,1,6,0.76
11,3,dictate,7,178,2,5,0.72
11,3,diplomat,8,179,2,6,0.88
11,3,diplomatic,10,180,8,2,0.6
11,3,director,8,181,2,6,0.68
11,3,dirty,5,182,3,2,0.48
11,3,disabled,8,183,2,6,0.8
11,3,disclosure,10,184,3,7,0.92
11,3,discovery,9,185,4,5,0.68
11,3,display,7,186,3,4,0.68
11,3,distort,7,187,3,4,0.56
11,3,disturbing,10,188,4,6,0.8
11,3,divine,6,189,2,4,0.64
11,3,divorced,8,190,3,5,0.64
11,3,dominant,8,191,1,7,0.76
11,3,dot,3,192,2,1,0.24
11,3,download,8,193,2,6,0.84
11,3,downstairs,10,194,4,6,0.8
11,3,drawing,7,195,1,6,0.68
11,3,drink,5,196,2,3,0.44
11,3,dust,4,197,1,3,0.48
11,3,ear,3,198,0,3,0.36
11,3,earth,5,199,3,2,0.36
11,3,editor,6,200,1,5,0.56
11,3,effectively,11,201,1,10,1.04
11,3,eighty,6,202,1,5,0.68
11,3,either,6,203,2,4,0.52
11,3,elect,5,204,1,4,0.52
11,3,electrical,10,205,5,5,1.04
11,3,electricity,11,206,8,3,0.72
11,3,eleven,6,207,3,3,0.48
11,3,elsewhere,9,208,2,7,0.88
11,3,embody,6,209,1,5,0.68
11,3,emergence,9,210,2,7,0.8
11,3,emergency,9,211,8,1,0.48
11,3,emission,8,212,2,6,0.8
11,3,emotion,7,213,2,5,0.6
11,3,empirical,9,214,2,7,0.8
11,3,endless,7,215,1,6,0.68
11,3,enormous,8,216,2,6,0.84
11,3,enterprise,10,217,2,8,1
11,3,entitle,7,218,3,4,0.64
11,3,entrance,8,219,3,5,0.84
11,3,entry,5,220,4,1,0.32
11,3,equality,8,221,1,7,0.84
11,3,establish,9,222,1,8,0.96
11,3,evaluation,10,223,1,9,1.12
11,3,event,5,224,2,3,0.76
11,3,evoke,5,225,2,3,0.44
11,3,examination,11,226,1,10,1.2
11,3,excellent,9,227,2,7,0.72
11,3,exception,9,228,4,5,0.32
11,3,excited,7,229,3,4,0.24
11,3,exciting,8,230,5,3,0.32
11,3,exclusive,9,231,3,6,0.36
11,3,exclusively,11,232,9,2,0.28
11,3,executive,9,233,2,7,0.4
11,3,exercise,8,234,3,5,0.28
11,3,exhibition,10,235,2,8,0.36
11,3,existence,9,236,2,7,0.4
11,3,exit,4,237,3,1,0.12
11,3,expertise,9,238,2,7,0.36
11,3,explain,7,239,3,4,0.24
11,3,explode,7,240,4,3,0.28
11,3,exploit,7,241,5,2,0.2
11,3,exploration,11,242,5,6,0.36
11,3,explosive,9,243,5,4,0.32
11,3,extend,6,244,2,4,0.24
11,3,eye,3,245,1,2,0.12
11,3,faculty,7,246,0,7,0.32
11,3,fail,4,247,2,2,0.12
11,3,failure,7,248,4,3,0.28
11,3,fairly,6,249,3,3,0.2
11,3,fantastic,9,250,2,7,0.36
11,3,fantasy,7,251,6,1,0.16
11,3,fast,4,252,2,2,0.2
11,3,fat,3,253,2,1,0.12
11,3,fear,4,254,1,3,0.16
11,3,feeding,7,255,2,5,0.28
11,3,fellow,6,256,2,4,0.2
11,3,fifty,5,257,1,4,0.28
11,3,fight,5,258,2,3,0.16
11,3,file,4,259,2,2,0.16
11,3,financial,9,260,2,7,0.32
11,3,fine,4,261,3,1,0.12
11,3,firm,4,262,2,2,0.2
11,3,fix,3,263,2,1,0.08
11,3,flexibility,11,264,1,10,0.44
11,3,flying,6,265,2,4,0.2
11,3,folk,4,266,1,3,0.16
11,3,formation,9,267,2,7,0.4
11,3,fortune,7,268,3,4,0.24
11,3,forward,7,269,3,4,0.24
11,3,foster,6,270,2,4,0.32
11,3,founder,7,271,2,5,0.24
11,3,fourteen,8,272,3,5,0.28
11,3,freedom,7,273,1,6,0.28
11,3,fridge,6,274,2,4,0.28
11,3,friendship,10,275,3,7,0.36
11,3,frighten,8,276,3,5,0.28
11,3,frightened,10,277,8,2,0.32
11,3,frog,4,278,2,2,0.12
11,3,full,4,279,1,3,0.16
11,3,fundamental,11,280,2,9,0.44
11,3,gallery,7,281,0,7,0.4
11,3,gallon,6,282,4,2,0.16
11,3,game,4,283,2,2,0.12
11,3,garage,6,284,2,4,0.24
11,3,gender,6,285,1,5,0.24
11,3,gene,4,286,3,1,0.16
11,3,generate,8,287,4,4,0.28
11,3,genetic,7,288,4,3,0.2
11,3,genre,5,289,3,2,0.16
11,3,genuinely,9,290,3,6,0.4
11,3,giant,5,291,1,4,0.2
11,3,glimpse,7,292,1,6,0.28
11,3,globe,5,293,2,3,0.16
11,3,god,3,294,1,2,0.12
11,3,good,4,295,2,2,0.12
11,3,goodbye,7,296,4,3,0.28
11,3,govern,6,297,2,4,0.24
11,3,grade,5,298,1,4,0.2
11,3,grandfather,11,299,3,8,0.48
11,3,graphics,8,300,3,5,0.28
11,3,gravity,7,301,3,4,0.24
11,3,green,5,302,2,3,0.2
11,3,greet,5,303,4,1,0.12
11,3,grid,4,304,2,2,0.2
11,3,guess,5,305,1,4,0.2
11,3,guest,5,306,4,1,0.12
11,3,guidance,8,307,2,6,0.28
11,3,guide,5,308,4,1,0.12
11,3,guitar,6,309,3,3,0.24
11,3,handful,7,310,0,7,0.32
11,3,happen,6,311,2,4,0.24
11,3,harbour,7,312,2,5,0.28
11,3,harm,4,313,3,1,0.2
11,3,harvest,7,314,3,4,0.24
11,3,hat,3,315,2,1,0.12
11,3,hazard,6,316,2,4,0.24
11,3,heat,4,317,1,3,0.2
11,3,her,3,318,2,1,0.08
11,3,hers,4,319,3,1,0.2
11,3,highlight,9,320,1,8,0.36
11,3,highly,6,321,5,1,0.16
11,3,hint,4,322,2,2,0.12
11,3,historic,8,323,2,6,0.36
11,3,historical,10,324,8,2,0.24
11,3,homeland,8,325,1,7,0.32
11,3,hotel,5,326,2,3,0.16
11,3,however,7,327,2,5,0.32
11,3,humble,6,328,1,5,0.24
11,3,hydrogen,8,329,1,7,0.32
11,3,hypothesis,10,330,2,8,0.48
11,3,i,1,331,0,1,0.08
11,3,ideal,5,332,1,4,0.2
11,3,identity,8,333,3,5,0.28
11,3,ignorance,9,334,1,8,0.4
11,3,image,5,335,1,4,0.32
11,3,imaginary,9,336,4,5,0.32
11,3,implication,11,337,2,9,0.44
11,3,include,7,338,1,6,0.36
11,3,independent,11,339,2,9,0.44
11,3,index,5,340,4,1,0.12
11,3,indicate,8,341,3,5,0.36
11,3,individual,10,342,4,6,0.36
11,3,influential,11,343,2,9,0.44
11,3,information,11,344,3,8,0.48
11,3,inherent,8,345,2,6,0.28
11,3,initiate,8,346,2,6,0.32
11,3,inject,6,347,2,4,0.24
11,3,injury,6,348,3,3,0.28
11,3,insert,6,349,2,4,0.24
11,3,inspect,7,350,3,4,0.24
11,3,insurance,9,351,3,6,0.32
11,3,intake,6,352,2,4,0.28
11,3,intelligent,11,353,3,8,0.4
11,3,interesting,11,354,4,7,0.36
11,3,interior,8,355,5,3,0.32
11,3,into,4,356,3,1,0.12
11,3,invest,6,357,2,4,0.2
11,3,involve,7,358,3,4,0.24
11,3,involved,8,359,7,1,0.28
11,3,island,6,360,1,5,0.24
11,3,isolated,8,361,2,6,0.32
11,3,issue,5,362,2,3,0.2
11,3,jet,3,363,0,3,0.16
11,3,jewellery,9,364,2,7,0.44
11,3,journalism,10,365,1,9,0.4
11,3,joy,3,366,2,1,0.08
11,3,judicial,8,367,1,7,0.4
11,3,just,4,368,2,2,0.16
11,3,justify,7,369,4,3,0.2
11,3,key,3,370,0,3,0.16
11,3,kid,3,371,1,2,0.12
11,3,kidney,6,372,3,3,0.28
11,3,king,4,373,2,2,0.16
11,3,kit,3,374,2,1,0.08
11,3,lack,4,375,0,4,0.2
11,3,latest,6,376,2,4,0.24
11,3,laugh,5,377,2,3,0.2
11,3,lawn,4,378,2,2,0.2
11,3,league,6,379,1,5,0.24
11,3,learning,8,380,3,5,0.32
11,3,left,4,381,2,2,0.16
11,3,lens,4,382,2,2,0.16
11,3,lesser,6,383,2,4,0.32
11,3,lethal,6,384,2,4,0.2
11,3,licence,7,385,1,6,0.36
11,3,license,7,386,5,2,0.44
11,3,likelihood,10,387,2,8,1.04
11,3,literary,8,388,2,6,0.76
11,3,literature,10,389,6,4,0.72
11,3,litter,6,390,3,3,0.6
11,3,little,6,391,4,2,0.4
11,3,live,4,392,2,2,0.32
11,3,liver,5,393,4,1,0.32
11,3,location,8,394,1,7,0.84
11,3,log,3,395,2,1,0.36
11,3,look,4,396,2,2,0.32
11,3,loose,5,397,3,2,0.4
11,3,lot,3,398,2,1,0.28
11,3,loudly,6,399,2,4,0.6
11,3,love,4,400,2,2,0.36
11,3,mail,4,401,0,4,0.56
11,3,main,4,402,3,1,0.28
11,3,mainland,8,403,4,4,0.64
11,3,mainstream,10,404,4,6,0.84
11,3,mandate,7,405,2,5,0.76
11,3,manufacture,11,406,3,8,0.96
11,3,map,3,407,2,1,0.24
11,3,marine,6,408,2,4,0.56
11,3,married,7,409,3,4,0.76
11,3,master,6,410,2,4,0.52
11,3,match,5,411,2,3,0.4
11,3,maximum,7,412,2,5,0.6
11,3,meal,4,413,1,3,0.36
11,3,meanwhile,9,414,3,6,0.88
11,3,mechanical,10,415,2,8,0.96
11,3,media,5,416,2,3,0.48
11,3,medication,10,417,4,6,0.96
11,3,melody,6,418,2,4,0.52
11,3,memory,6,419,2,4,0.52
11,3,merely,6,420,2,4,0.6
11,3,method,6,421,2,4,0.72
11,3,metre,5,422,3,2,0.36
11,3,midnight,8,423,1,7,0.8
11,3,misleading,10,424,2,8,0.96
11,3,missing,7,425,3,4,0.72
11,3,model,5,426,1,4,0.52
11,3,modify,6,427,3,3,0.48
11,3,monthly,7,428,2,5,0.72
11,3,more,4,429,2,2,0.4
11,3,most,4,430,2,2,0.48
11,3,mother,6,431,2,4,0.52
11,3,mouth,5,432,2,3,0.44
11,3,movie,5,433,2,3,0.44
11,3,much,4,434,1,3,0.36
11,3,multiple,8,435,2,6,0.84
11,3,municipal,9,436,2,7,0.8
11,3,musician,8,437,2,6,0.72
11,3,must,4,438,3,1,0.28
11,3,my,2,439,1,1,0.32
11,3,myth,4,440,2,2,0.32
11,3,naked,5,441,0,5,0.52
11,3,narrative,9,442,2,7,0.92
11,3,nasty,5,443,2,3,0.48
11,3,nationwide,10,444,2,8,1.04
11,3,necessarily,11,445,1,10,1.04
11,3,neck,4,446,3,1,0.28
11,3,newspaper,9,447,2,7,0.96
11,3,night,5,448,1,4,0.48
11,3,noisy,5,449,1,4,0.48
11,3,norm,4,450,2,2,0.32
11,3,normal,6,451,4,2,0.4
11,3,north,5,452,3,2,0.48
11,3,not,3,453,2,1,0.24
11,3,nothing,7,454,3,4,0.6
11,3,notion,6,455,3,3,0.48
11,3,novel,5,456,2,3,0.44
11,3,objective,9,457,0,9,1.16
11,3,oblige,6,458,2,4,0.6
11,3,october,7,459,1,6,0.72
11,3,off,3,460,1,2,0.28
11,3,offence,7,461,3,4,0.68
11,3,offensive,9,462,5,4,0.64
11,3,offspring,9,463,3,6,0.76
11,3,one,3,464,1,2,0.28
11,3,optimistic,10,465,1,9,1.08
11,3,option,6,466,4,2,0.4
11,3,organic,7,467,1,6,0.68
11,3,organized,9,468,6,3,0.72
11,3,organizer,9,469,8,1,0.48
11,3,originate,9,470,2,7,0.88
11,3,other,5,471,1,4,0.52
11,3,ought,5,472,1,4,0.64
11,3,outbreak,8,473,2,6,1.44
11,3,outdoor,7,474,3,4,0.56
11,3,outfit,6,475,3,3,0.48
11,3,outing,6,476,3,3,0.56
11,3,outlet,6,477,3,3,0.44
11,3,outlook,7,478,4,3,0.48
11,3,overall,7,479,1,6,0.64
11,3,oversee,7,480,4,3,0.64
11,3,owe,3,481,1,2,0.32
11,3,pace,4,482,0,4,0.44
11,3,pack,4,483,3,1,0.28
11,3,pad,3,484,2,1,0.24
11,3,page,4,485,2,2,0.32
11,3,painful,7,486,2,5,0.72
11,3,pants,5,487,2,3,0.44
11,3,parade,6,488,2,4,0.56
11,3,parallel,8,489,4,4,0.6
11,3,participant,11,490,3,8,1.08
11,3,participate,11,491,9,2,0.6
11,3,passenger,9,492,2,7,0.84
11,3,passport,8,493,4,4,0.72
11,3,password,8,494,4,4,0.6
11,3,patent,6,495,2,4,0.52
11,3,peace,5,496,1,4,0.52
11,3,peculiar,8,497,2,6,0.92
11,3,pepper,6,498,2,4,0.6
11,3,perceive,8,499,2,6,0.84
11,3,perfect,7,500,3,4,0.6
11,3,perhaps,7,501,3,4,0.72
11,3,persistent,10,502,3,7,0.88
11,3,personality,11,503,4,7,0.88
11,3,personnel,9,504,6,3,0.72
11,3,philosopher,11,505,1,10,1.04
11,3,philosophy,10,506,9,1,0.52
11,3,picture,7,507,1,6,0.8
11,3,pig,3,508,2,1,0.24
11,3,pile,4,509,2,2,0.32
11,3,pioneer,7,510,2,5,0.64
11,3,pipe,4,511,2,2,0.32
11,3,plastic,7,512,1,6,0.8
11,3,play,4,513,3,1,0.28
11,3,plead,5,514,2,3,0.48
11,3,political,9,515,1,8,0.88
11,3,possibility,11,516,2,9,1.12
11,3,possible,8,517,6,2,0.48
11,3,poster,6,518,3,3,0.44
11,3,prayer,6,519,1,5,0.56
11,3,precise,7,520,2,5,0.76
11,3,pregnant,8,521,3,5,0.52
11,3,prejudice,9,522,3,6,0.4
11,3,preliminary,11,523,3,8,0.48
11,3,premise,7,524,3,4,0.24
11,3,prescribe,9,525,3,6,0.32
11,3,presence,8,526,4,4,0.24
11,3,presently,9,527,6,3,0.32
11,3,prevention,10,528,3,7,0.36
11,3,principal,9,529,2,7,0.36
11,3,principle,9,530,7,2,0.28
11,3,printer,7,531,4,3,0.24
11,3,procedure,9,532,2,7,0.32
11,3,process,7,533,5,2,0.24
11,3,processor,9,534,7,2,0.24
11,3,product,7,535,3,4,0.24
11,3,program,7,536,3,4,0.24
11,3,progressive,11,537,5,6,0.44
11,3,project,7,538,3,4,0.24
11,3,prominent,9,539,3,6,0.32
11,3,proof,5,540,3,2,0.16
11,3,properly,8,541,3,5,0.36
11,3,proposal,8,542,4,4,0.24
11,3,propose,7,543,6,1,0.16
11,3,proposition,11,544,6,5,0.4
11,3,protester,9,545,3,6,0.32
11,3,punk,4,546,1,3,0.16
11,3,purpose,7,547,2,5,0.24
11,3,put,3,548,2,1,0.16
11,3,puzzle,6,549,2,4,0.2
11,3,quantity,8,550,0,8,0.36
11,3,query,5,551,2,3,0.16
11,3,quest,5,552,3,2,0.16
11,3,racism,6,553,0,6,0.36
11,3,radar,5,554,2,3,0.16
11,3,rail,4,555,2,2,0.12
11,3,railway,7,556,4,3,0.2
11,3,rally,5,557,2,3,0.2
11,3,rating,6,558,2,4,0.28
11,3,reasoning,9,559,1,8,0.36
11,3,reception,9,560,2,7,0.36
11,3,recognize,9,561,3,6,0.4
11,3,recording,9,562,4,5,0.28
11,3,recycle,7,563,3,4,0.24
11,3,reduce,6,564,2,4,0.2
11,3,reduction,9,565,5,4,0.36
11,3,referee,7,566,2,5,0.28
11,3,reference,9,567,6,3,0.24
11,3,regard,6,568,2,4,0.28
11,3,region,6,569,3,3,0.2
11,3,regional,8,570,6,2,0.2
11,3,regulatory,10,571,3,7,0.36
11,3,reign,5,572,2,3,0.24
11,3,rejection,9,573,2,7,0.32
11,3,relative,8,574,2,6,0.32
11,3,relax,5,575,4,1,0.12
11,3,relaxed,7,576,5,2,0.28
11,3,religious,9,577,3,6,0.32
11,3,remark,6,578,2,4,0.2
11,3,residence,9,579,2,7,0.36
11,3,residue,7,580,5,2,0.32
11,3,resolve,7,581,3,4,0.24
11,3,rest,4,582,3,1,0.12
11,3,reveal,6,583,2,4,0.24
11,3,revival,7,584,3,4,0.32
11,3,rifle,5,585,1,4,0.2
11,3,rip,3,586,2,1,0.08
11,3,rise,4,587,2,2,0.12
11,3,road,4,588,1,3,0.16
11,3,robbery,7,589,2,5,0.32
11,3,romance,7,590,2,5,0.28
11,3,roof,4,591,2,2,0.16
11,3,root,4,592,3,1,0.12
11,3,rotate,6,593,2,4,0.2
11,3,rough,5,594,2,3,0.16
11,3,rub,3,595,1,2,0.2
11,3,rubbish,7,596,3,4,0.24
11,3,ruin,4,597,2,2,0.16
11,3,safe,4,598,0,4,0.2
11,3,sailor,6,599,2,4,0.2
11,3,salt,4,600,2,2,0.2
11,3,satellite,9,601,2,7,0.32
11,3,satisfy,7,602,3,4,0.24
11,3,scattered,9,603,1,8,0.44
11,3,scheme,6,604,2,4,0.2
11,3,scholar,7,605,3,4,0.24
11,3,scholarship,11,606,7,4,0.32
11,3,school,6,607,4,2,0.28
11,3,scientific,10,608,2,8,0.44
11,3,secret,6,609,1,5,0.28
11,3,security,8,610,3,5,0.32
11,3,seeker,6,611,2,4,0.32
11,3,seem,4,612,3,1,0.12
11,3,segment,7,613,2,5,0.24
11,3,sensible,8,614,2,6,0.32
11,3,september,9,615,2,7,0.44
11,3,serious,7,616,2,5,0.28
11,3,seriously,9,617,7,2,0.2
11,3,serve,5,618,3,2,0.16
11,3,setting,7,619,2,5,0.36
11,3,settlement,10,620,4,6,0.32
11,3,settler,7,621,6,1,0.16
11,3,severely,8,622,2,6,0.36
11,3,sexual,6,623,2,4,0.24
11,3,shape,5,624,1,4,0.2
11,3,shareholder,11,625,3,8,0.4
11,3,sheer,5,626,2,3,0.28
11,3,shiny,5,627,2,3,0.16
11,3,ship,4,628,3,1,0.12
11,3,shoot,5,629,2,3,0.16
11,3,shortage,8,630,3,5,0.28
11,3,sibling,7,631,1,6,0.36
11,3,sight,5,632,2,3,0.16
11,3,similarly,9,633,2,7,0.36
11,3,simply,6,634,3,3,0.2
11,3,sit,3,635,2,1,0.2
11,3,six,3,636,2,1,0.08
11,3,ski,3,637,1,2,0.12
11,3,skull,5,638,2,3,0.2
11,3,slice,5,639,1,4,0.2
11,3,smoking,7,640,1,6,0.28
11,3,solar,5,641,1,4,0.28
11,3,solid,5,642,3,2,0.16
11,3,some,4,643,2,2,0.16
11,3,something,9,644,4,5,0.32
11,3,song,4,645,2,2,0.16
11,3,south,5,646,2,3,0.24
11,3,space,5,647,1,4,0.2
11,3,spare,5,648,3,2,0.16
11,3,speaker,7,649,2,5,0.28
11,3,special,7,650,3,4,0.32
11,3,specialized,11,651,7,4,0.32
11,3,specify,7,652,5,2,0.2
11,3,speech,6,653,3,3,0.2
11,3,spin,4,654,2,2,0.2
11,3,spine,5,655,4,1,0.12
11,3,spokesman,9,656,2,7,0.36
11,3,stable,6,657,1,5,0.24
11,3,stall,5,658,3,2,0.16
11,3,stand,5,659,3,2,0.24
11,3,star,4,660,3,1,0.12
11,3,steer,5,661,2,3,0.16
11,3,stem,4,662,3,1,0.12
11,3,stereotype,10,663,3,7,0.36
11,3,stick,5,664,2,3,0.24
11,3,straight,8,665,2,6,0.32
11,3,strange,7,666,4,3,0.2
11,3,strategy,8,667,4,4,0.24
11,3,street,6,668,3,3,0.28
11,3,striking,8,669,3,5,0.28
11,3,studio,6,670,2,4,0.2
11,3,stumble,7,671,3,4,0.24
11,3,subject,7,672,1,6,0.36
11,3,such,4,673,2,2,0.12
11,3,sue,3,674,2,1,0.12
11,3,suppose,7,675,2,5,0.24
11,3,supreme,7,676,3,4,0.32
11,3,sure,4,677,2,2,0.12
11,3,surely,6,678,4,2,0.16
11,3,swallow,7,679,1,6,0.28
11,3,sweater,7,680,2,5,0.28
11,3,sweep,5,681,3,2,0.36
11,3,swim,4,682,2,2,0.32
11,3,switch,6,683,3,3,0.44
11,3,symbolic,8,684,1,7,0.76
11,3,sympathy,8,685,3,5,0.76
11,3,symptom,7,686,4,3,0.48
11,3,synthesis,9,687,2,7,0.8
11,3,table,5,688,0,5,0.52
11,3,tactical,8,689,2,6,0.84
11,3,tank,4,690,2,2,0.32
11,3,task,4,691,2,2,0.36
11,3,taste,5,692,3,2,0.36
11,3,taxi,4,693,2,2,0.4
11,3,tea,3,694,1,2,0.32
11,3,temperature,11,695,2,9,1.16
11,3,tendency,8,696,2,6,0.72
11,3,tender,6,697,5,1,0.36
11,3,terribly,8,698,2,6,0.84
11,3,terrific,8,699,5,3,0.56
11,3,terrify,7,700,6,1,0.4
11,3,texture,7,701,2,5,0.6
11,3,therapist,9,702,1,8,1
11,3,thereafter,10,703,4,6,0.8
11,3,thoughtful,10,704,2,8,0.96
11,3,three,5,705,2,3,0.6
11,3,ticket,6,706,1,5,0.56
11,3,tidy,4,707,2,2,0.32
11,3,tighten,7,708,2,5,0.6
11,3,till,4,709,2,2,0.4
11,3,timing,6,710,2,4,0.64
11,3,to,2,711,1,1,0.2
11,3,together,8,712,2,6,0.72
11,3,tonight,7,713,2,5,0.64
11,3,too,3,714,2,1,0.24
11,3,topic,5,715,2,3,0.52
11,3,torture,7,716,2,5,0.64
11,3,trademark,9,717,1,8,0.88
11,3,tragic,6,718,3,3,0.48
11,3,transcript,10,719,3,7,0.96
11,3,translation,11,720,5,6,0.84
11,3,transport,9,721,5,4,0.64
11,3,trap,4,722,3,1,0.4
11,3,traveller,9,723,3,6,0.72
11,3,treaty,6,724,2,4,0.6
11,3,tree,4,725,3,1,0.28
11,3,trial,5,726,2,3,0.52
11,3,tribe,5,727,3,2,0.36
11,3,tribute,7,728,4,3,0.52
11,3,trio,4,729,3,1,0.28
11,3,tropical,8,730,2,6,0.68
11,3,truck,5,731,2,3,0.52
11,3,ultimate,8,732,0,8,0.84
11,3,underground,11,733,1,10,1.16
11,3,undoubtedly,11,734,3,8,1.16
11,3,universal,9,735,2,7,0.8
11,3,universe,8,736,7,1,0.48
11,3,unnecessary,11,737,2,9,1.2
11,3,unveil,6,738,2,4,0.56
11,3,upon,4,739,1,3,0.4
11,3,urban,5,740,1,4,0.52
11,3,urgent,6,741,2,4,0.52
11,3,utility,7,742,1,6,0.8
11,3,utilize,7,743,5,2,0.44
11,3,vague,5,744,0,5,0.52
11,3,valuable,8,745,2,6,0.72
11,3,vein,4,746,1,3,0.52
11,3,venture,7,747,2,5,0.6
11,3,veteran,7,748,2,5,0.6
11,3,viable,6,749,1,5,0.6
11,3,video,5,750,2,3,0.56
11,3,viewer,6,751,2,4,0.52
11,3,villager,8,752,2,6,0.84
11,3,violent,7,753,2,5,0.72
11,3,virtual,7,754,2,5,0.76
11,3,visitor,7,755,2,5,0.6
11,3,visual,6,756,3,3,0.48
11,3,vital,5,757,2,3,0.44
11,3,voice,5,758,1,4,0.64
11,3,volunteer,9,759,2,7,0.8
11,3,wait,4,760,0,4,0.44
11,3,waiter,6,761,4,2,0.4
11,3,walk,4,762,2,2,0.32
11,3,war,3,763,2,1,0.36
11,3,washing,7,764,2,5,0.6
11,3,water,5,765,2,3,0.4
11,3,weight,6,766,1,5,0.64
11,3,welcome,7,767,2,5,0.68
11,3,welfare,7,768,3,4,0.68
11,3,whatever,8,769,1,7,0.76
11,3,whenever,8,770,2,6,0.68
11,3,whereas,7,771,3,4,0.68
11,3,which,5,772,2,3,0.4
11,3,whose,5,773,2,3,0.4
11,3,width,5,774,1,4,0.48
11,3,wildlife,8,775,2,6,0.68
11,3,willing,7,776,3,4,0.68
11,3,willingness,11,777,7,4,0.72
11,3,win,3,778,2,1,0.24
11,3,wind,4,779,3,1,0.28
11,3,wine,4,780,3,1,0.4
11,3,wipe,4,781,2,2,0.32
11,3,within,6,782,2,4,0.52
11,3,without,7,783,4,3,0.48
11,3,woman,5,784,1,4,0.48
11,3,work,4,785,2,2,0.32
11,3,workforce,9,786,4,5,0.8
11,3,wrap,4,787,1,3,0.4
11,3,young,5,788,0,5,0.52
11,4,accommodate,11,0,0,11,1.28
11,4,accompany,9,1,5,4,0.64
11,4,accomplish,10,2,6,4,1.16
11,4,accounting,10,3,4,6,1.04
11,4,accurate,8,4,3,5,0.64
11,4,acid,4,5,2,2,0.32
11,4,actress,7,6,2,5,0.76
11,4,ad,2,7,1,1,0.2
11,4,adaptation,10,8,2,8,1.08
11,4,add,3,9,2,1,0.28
11,4,additional,10,10,3,7,1.08
11,4,adjacent,8,11,2,6,0.8
11,4,admit,5,12,2,3,0.56
11,4,advantage,9,13,2,7,0.8
11,4,adventure,9,14,3,6,0.72
11,4,advice,6,15,3,3,0.6
11,4,aesthetic,9,16,1,8,0.88
11,4,again,5,17,1,4,0.48
11,4,against,7,18,5,2,0.44
11,4,aggressive,10,19,2,8,1
11,4,aids,4,20,1,3,0.4
11,4,align,5,21,1,4,0.48
11,4,allocate,8,22,2,6,0.72
11,4,ally,4,23,3,1,0.4
11,4,alongside,9,24,2,7,0.8
11,4,amateur,7,25,1,6,0.68
11,4,amusing,7,26,2,5,0.6
11,4,anger,5,27,1,4,0.6
11,4,animal,6,28,2,4,0.52
11,4,annoyed,7,29,2,5,0.6
11,4,another,7,30,2,5,0.6
11,4,anxiety,7,31,2,5,0.76
11,4,anybody,7,32,2,5,0.6
11,4,apologize,9,33,1,8,1.04
11,4,app,3,34,2,1,0.24
11,4,apparently,10,35,3,7,1.04
11,4,applaud,7,36,3,4,0.56
11,4,approve,7,37,3,4,0.56
11,4,arise,5,38,1,4,0.56
11,4,arms,4,39,2,2,0.48
11,4,army,4,40,3,1,0.32
11,4,around,6,41,2,4,0.52
11,4,arrangement,11,42,2,9,0.96
11,4,arrest,6,43,3,3,0.56
11,4,arrow,5,44,3,2,0.36
11,4,artist,6,45,2,4,0.52
11,4,artistic,8,46,6,2,0.48
11,4,assessment,10,47,1,9,1.04
11,4,associate,9,48,3,6,0.72
11,4,assurance,9,49,3,6,0.76
11,4,at,2,50,1,1,0.2
11,4,atrocity,8,51,2,6,0.84
11,4,authorize,9,52,1,8,0.88
11,4,auto,4,53,3,1,0.28
11,4,average,7,54,1,6,0.8
11,4,baby,4,55,0,4,0.6
11,4,barrel,6,56,2,4,0.52
11,4,base,4,57,2,2,0.32
11,4,bath,4,58,2,2,0.32
11,4,beast,5,59,1,4,0.48
11,4,beauty,6,60,3,3,0.64
11,4,bed,3,61,2,1,0.24
11,4,behave,6,62,2,4,0.52
11,4,belief,6,63,2,4,0.56
11,4,belong,6,64,3,3,0.68
11,4,below,5,65,4,1,0.52
11,4,benchmark,9,66,2,7,0.92
11,4,beyond,6,67,2,4,0.52
11,4,blank,5,68,1,4,0.48
11,4,blog,4,69,2,2,0.32
11,4,blow,4,70,3,1,0.36
11,4,boil,4,71,1,3,0.36
11,4,bomb,4,72,2,2,0.32
11,4,boom,4,73,2,2,0.32
11,4,boost,5,74,3,2,0.4
11,4,bother,6,75,2,4,0.56
11,4,bottle,6,76,3,3,0.6
11,4,bound,5,77,2,3,0.4
11,4,box,3,78,2,1,0.24
11,4,boyfriend,9,79,2,7,0.8
11,4,bride,5,80,1,4,0.48
11,4,bridge,6,81,4,2,0.52
11,4,buddy,5,82,1,4,0.48
11,4,build,5,83,2,3,0.4
11,4,business,8,84,2,6,0.68
11,4,businessman,11,85,8,3,0.76
11,4,butter,6,86,2,4,0.52
11,4,cafe,4,87,0,4,0.44
11,4,cake,4,88,2,2,0.32
11,4,can,3,89,2,1,0.24
11,4,cancer,6,90,3,3,0.56
11,4,cap,3,91,2,1,0.24
11,4,capable,7,92,3,4,0.56
11,4,card,4,93,2,2,0.32
11,4,career,6,94,3,3,0.44
11,4,carefully,9,95,4,5,0.8
11,4,carpet,6,96,3,3,0.44
11,4,cartoon,7,97,3,4,0.56
11,4,carve,5,98,3,2,0.36
11,4,cd,2,99,1,1,0.2
11,4,celebrate,9,100,1,8,0.96
11,4,cemetery,8,101,2,6,0.68
11,4,ceremony,8,102,2,6,0.68
11,4,chair,5,103,1,4,0.6
11,4,chapter,7,104,3,4,0.56
11,4,charity,7,105,3,4,0.56
11,4,charm,5,106,4,1,0.32
11,4,charming,8,107,5,3,0.64
11,4,cheat,5,108,2,3,0.44
11,4,cheerful,8,109,3,5,0.64
11,4,chemical,8,110,3,5,0.64
11,4,chop,4,111,2,2,0.32
11,4,civil,5,112,1,4,0.6
11,4,clean,5,113,1,4,0.48
11,4,clearly,7,114,4,3,0.52
11,4,clinical,8,115,2,6,0.72
11,4,closely,7,116,2,5,0.72
11,4,cloud,5,117,3,2,0.36
11,4,cluster,7,118,2,5,0.6
11,4,coach,5,119,1,4,0.48
11,4,coincide,8,120,2,6,0.84
11,4,collaborate,11,121,2,9,1
11,4,colourful,9,122,3,6,0.72
11,4,comedy,6,123,2,4,0.64
11,4,comment,7,124,3,4,0.56
11,4,commission,10,125,4,6,0.92
11,4,commodity,9,126,4,5,0.68
11,4,commonly,8,127,5,3,0.64
11,4,compete,7,128,3,4,0.56
11,4,comply,6,129,4,2,0.4
11,4,compulsory,10,130,4,6,1.04
11,4,conceal,7,131,2,5,0.6
11,4,conceive,8,132,5,3,0.56
11,4,concert,7,133,5,2,0.44
11,4,conclusion,10,134,4,6,0.88
11,4,conduct,7,135,3,4,0.56
11,4,confer,6,136,3,3,0.44
11,4,conference,10,137,6,4,0.68
11,4,confused,8,138,4,4,0.72
11,4,connected,9,139,3,6,0.72
11,4,consistency,11,140,3,8,0.92
11,4,constraint,10,141,4,6,0.92
11,4,contend,7,142,3,4,0.56
11,4,contrast,8,143,4,4,0.6
11,4,conversion,10,144,3,7,0.96
11,4,coordinate,10,145,2,8,0.88
11,4,cope,4,146,2,2,0.32
11,4,correctly,9,147,2,7,0.92
11,4,cottage,7,148,2,5,0.6
11,4,counter,7,149,2,5,0.68
11,4,counterpart,11,150,7,4,0.44
11,4,couple,6,151,3,3,0.28
11,4,craft,5,152,1,4,0.2
11,4,creature,8,153,2,6,0.32
11,4,credibility,11,154,3,8,0.52
11,4,creep,5,155,3,2,0.16
11,4,criminal,8,156,2,6,0.28
11,4,cross,5,157,2,3,0.2
11,4,crowd,5,158,3,2,0.16
11,4,crowded,7,159,5,2,0.28
11,4,crucial,7,160,2,5,0.28
11,4,crude,5,161,3,2,0.16
11,4,current,7,162,1,6,0.28
11,4,curved,6,163,3,3,0.28
11,4,cycle,5,164,1,4,0.2
11,4,damage,6,165,0,6,0.28
11,4,day,3,166,2,1,0.08
11,4,death,5,167,1,4,0.2
11,4,declare,7,168,2,5,0.36
11,4,decrease,8,169,3,5,0.28
11,4,default,7,170,2,5,0.28
11,4,defect,6,171,3,3,0.2
11,4,definite,8,172,3,5,0.36
11,4,delight,7,173,2,5,0.28
11,4,demon,5,174,2,3,0.16
11,4,departure,9,175,2,7,0.36
11,4,deposit,7,176,3,4,0.32
11,4,depressing,10,177,3,7,0.4
11,4,despite,7,178,2,5,0.28
11,4,destination,11,179,3,8,0.48
11,4,detect,6,180,2,4,0.2
11,4,detention,9,181,4,5,0.28
11,4,develop,7,182,2,5,0.28
11,4,devil,5,183,3,2,0.24
11,4,diagram,7,184,1,6,0.28
11,4,diminish,8,185,2,6,0.28
11,4,dinner,6,186,2,4,0.24
11,4,diplomat,8,187,2,6,0.4
11,4,dirt,4,188,2,2,0.16
11,4,dirty,5,189,4,1,0.12
11,4,disabled,8,190,2,6,0.32
11,4,discuss,7,191,3,4,0.32
11,4,discussion,10,192,7,3,0.28
11,4,display,7,193,3,4,0.24
11,4,distant,7,194,3,4,0.28
11,4,distort,7,195,4,3,0.28
11,4,distribute,10,196,4,6,0.32
11,4,disturbing,10,197,4,6,0.32
11,4,divine,6,198,2,4,0.28
11,4,dollar,6,199,1,5,0.24
11,4,domain,6,200,2,4,0.24
11,4,dominant,8,201,3,5,0.28
11,4,download,8,202,2,6,0.4
11,4,drama,5,203,1,4,0.2
11,4,drink,5,204,2,3,0.16
11,4,ear,3,205,0,3,0.16
11,4,earnings,8,206,3,5,0.28
11,4,editor,6,207,1,5,0.32
11,4,effective,9,208,1,8,0.36
11,4,effort,6,209,3,3,0.2
11,4,eight,5,210,1,4,0.2
11,4,elect,5,211,1,4,0.28
11,4,eliminate,9,212,2,7,0.36
11,4,elsewhere,9,213,2,7,0.56
11,4,embark,6,214,1,5,0.8
11,4,emergence,9,215,2,7,0.6
11,4,emission,8,216,2,6,0.36
11,4,emotion,7,217,2,5,0.28
11,4,enable,6,218,1,5,0.32
11,4,ending,6,219,2,4,0.2
11,4,endless,7,220,3,4,0.24
11,4,enemy,5,221,2,3,0.16
11,4,enjoyable,9,222,2,7,0.44
11,4,enormous,8,223,2,6,0.32
11,4,enrich,6,224,2,4,0.2
11,4,enter,5,225,2,3,0.16
11,4,enterprise,10,226,5,5,0.4
11,4,entitle,7,227,3,4,0.24
11,4,environment,11,228,2,9,0.44
11,4,erect,5,229,1,4,0.28
11,4,essay,5,230,1,4,0.2
11,4,essentially,11,231,3,8,0.4
11,4,establish,9,232,2,7,0.36
11,4,euro,4,233,1,3,0.24
11,4,evaluation,10,234,1,9,0.52
11,4,event,5,235,2,3,0.16
11,4,evidence,8,236,2,6,0.4
11,4,evoke,5,237,2,3,0.16
11,4,exact,5,238,1,4,0.2
11,4,exceed,6,239,2,4,0.24
11,4,excellent,9,240,4,5,0.28
11,4,exception,9,241,4,5,0.4
11,4,exciting,8,242,3,5,0.28
11,4,exclusive,9,243,3,6,0.32
11,4,exclusively,11,244,9,2,0.36
11,4,exercise,8,245,2,6,0.32
11,4,exhibition,10,246,2,8,0.4
11,4,existence,9,247,2,7,0.44
11,4,exit,4,248,3,1,0.12
11,4,expire,6,249,2,4,0.2
11,4,explain,7,250,3,4,0.24
11,4,explode,7,251,4,3,0.28
11,4,explosive,9,252,5,4,0.28
11,4,extent,6,253,2,4,0.24
11,4,extremist,9,254,3,6,0.32
11,4,faculty,7,255,0,7,0.36
11,4,fail,4,256,2,2,0.16
11,4,failed,6,257,4,2,0.2
11,4,fairly,6,258,3,3,0.2
11,4,fall,4,259,2,2,0.12
11,4,fantasy,7,260,2,5,0.32
11,4,fear,4,261,1,3,0.16
11,4,fee,3,262,2,1,0.08
11,4,feeding,7,263,3,4,0.24
11,4,fellow,6,264,2,4,0.2
11,4,few,3,265,2,1,0.2
11,4,fiction,7,266,1,6,0.28
11,4,financial,9,267,2,7,0.32
11,4,fine,4,268,3,1,0.12
11,4,flag,4,269,1,3,0.24
11,4,flavour,7,270,3,4,0.24
11,4,flee,4,271,2,2,0.12
11,4,flexibility,11,272,3,8,0.4
11,4,flower,6,273,2,4,0.28
11,4,flu,3,274,2,1,0.12
11,4,focus,5,275,1,4,0.2
11,4,foreign,7,276,2,5,0.28
11,4,formula,7,277,3,4,0.24
11,4,fortune,7,278,3,4,0.32
11,4,forward,7,279,3,4,0.24
11,4,foster,6,280,2,4,0.2
11,4,foundation,10,281,2,8,0.4
11,4,founder,7,282,5,2,0.28
11,4,freedom,7,283,1,6,0.28
11,4,friendly,8,284,2,6,0.28
11,4,friendship,10,285,6,4,0.36
11,4,frighten,8,286,3,5,0.28
11,4,frightened,10,287,8,2,0.24
11,4,fundamental,11,288,1,10,0.52
11,4,funding,7,289,4,3,0.2
11,4,fur,3,290,2,1,0.12
11,4,gallery,7,291,0,7,0.28
11,4,gallon,6,292,4,2,0.16
11,4,garage,6,293,2,4,0.28
11,4,gene,4,294,1,3,0.16
11,4,generate,8,295,4,4,0.24
11,4,genetic,7,296,4,3,0.2
11,4,genre,5,297,3,2,0.24
11,4,geography,9,298,2,7,0.32
11,4,give,4,299,1,3,0.16
11,4,glass,5,300,1,4,0.2
11,4,god,3,301,1,2,0.12
11,4,good,4,302,2,2,0.2
11,4,govern,6,303,2,4,0.2
11,4,grade,5,304,1,4,0.2
11,4,grid,4,305,2,2,0.12
11,4,grin,4,306,3,1,0.12
11,4,ground,6,307,2,4,0.28
11,4,guerrilla,9,308,1,8,0.36
11,4,guidance,8,309,2,6,0.32
11,4,guitar,6,310,3,3,0.2
11,4,guy,3,311,2,1,0.12
11,4,handy,5,312,0,5,0.32
11,4,harbour,7,313,2,5,0.28
11,4,harsh,5,314,3,2,0.16
11,4,hate,4,315,2,2,0.12
11,4,hazard,6,316,2,4,0.32
11,4,headline,8,317,1,7,0.32
11,4,heart,5,318,3,2,0.16
11,4,heat,4,319,3,1,0.12
11,4,heighten,8,320,2,6,0.32
11,4,her,3,321,2,1,0.2
11,4,herb,4,322,3,1,0.12
11,4,hers,4,323,3,1,0.12
11,4,highlight,9,324,1,8,0.36
11,4,highly,6,325,5,1,0.16
11,4,hint,4,326,2,2,0.2
11,4,historic,8,327,2,6,0.32
11,4,holiday,7,328,1,6,0.28
11,4,homeland,8,329,2,6,0.28
11,4,honesty,7,330,2,5,0.36
11,4,hour,4,331,2,2,0.12
11,4,household,9,332,3,6,0.32
11,4,how,3,333,2,1,0.08
11,4,humanity,8,334,1,7,0.44
11,4,humble,6,335,3,3,0.2
11,4,humour,6,336,3,3,0.2
11,4,hunger,6,337,2,4,0.2
11,4,hunt,4,338,3,1,0.12
11,4,hydrogen,8,339,1,7,0.4
11,4,ideal,5,340,0,5,0.24
11,4,identity,8,341,3,5,0.28
11,4,illegal,7,342,1,6,0.28
11,4,image,5,343,1,4,0.28
11,4,imagery,7,344,5,2,0.2
11,4,implication,11,345,2,9,0.4
11,4,independent,11,346,1,10,0.52
11,4,index,5,347,4,1,0.12
11,4,individual,10,348,3,7,0.36
11,4,inevitable,10,349,2,8,0.48
11,4,infant,6,350,2,4,0.24
11,4,influence,9,351,3,6,0.32
11,4,inform,6,352,3,3,0.2
11,4,informal,8,353,6,2,0.28
11,4,inherent,8,354,2,6,0.28
11,4,inject,6,355,2,4,0.2
11,4,injure,6,356,3,3,0.2
11,4,insert,6,357,2,4,0.28
11,4,inspection,10,358,3,7,0.36
11,4,instant,7,359,3,4,0.24
11,4,instrument,10,360,4,6,0.4
11,4,integral,8,361,2,6,0.32
11,4,intelligent,11,362,4,7,0.36
11,4,interesting,11,363,4,7,0.44
11,4,interior,8,364,5,3,0.24
11,4,invest,6,365,2,4,0.24
11,4,isolated,8,366,1,7,0.32
11,4,january,7,367,0,7,0.4
11,4,jewellery,9,368,1,8,0.36
11,4,job,3,369,1,2,0.12
11,4,joy,3,370,2,1,0.12
11,4,judicial,8,371,1,7,0.44
11,4,jump,4,372,2,2,0.12
11,4,june,4,373,2,2,0.12
11,4,key,3,374,0,3,0.16
11,4,keyboard,8,375,3,5,0.28
11,4,kick,4,376,1,3,0.24
11,4,kid,3,377,2,1,0.12
11,4,kidney,6,378,3,3,0.2
11,4,kit,3,379,2,1,0.08
11,4,know,4,380,1,3,0.16
11,4,lad,3,381,0,3,0.16
11,4,landscape,9,382,2,7,0.44
11,4,laser,5,383,2,3,0.16
11,4,laugh,5,384,2,3,0.2
11,4,leadership,10,385,1,9,0.44
11,4,leading,7,386,4,3,0.28
11,4,leaf,4,387,3,1,0.12
11,4,leaflet,7,388,4,3,0.2
11,4,legend,6,389,2,4,0.2
11,4,legendary,9,390,6,3,0.32
11,4,lens,4,391,2,2,0.12
11,4,lie,3,392,1,2,0.12
11,4,lifestyle,9,393,2,7,0.36
11,4,likelihood,10,394,2,8,0.36
11,4,limb,4,395,2,2,0.24
11,4,limited,7,396,3,4,0.24
11,4,literary,8,397,2,6,0.32
11,4,literature,10,398,6,4,0.36
11,4,litter,6,399,3,3,0.2
11,4,little,6,400,4,2,0.16
11,4,live,4,401,2,2,0.12
11,4,local,5,402,1,4,0.2
11,4,located,7,403,4,3,0.28
11,4,log,3,404,2,1,0.08
11,4,look,4,405,2,2,0.12
11,4,loose,5,406,3,2,0.16
11,4,lot,3,407,2,1,0.12
11,4,loudly,6,408,2,4,0.2
11,4,love,4,409,2,2,0.2
11,4,low,3,410,2,1,0.08
11,4,machinery,9,411,0,9,0.4
11,4,mainland,8,412,2,6,0.32
11,4,manuscript,10,413,2,8,0.48
11,4,mark,4,414,2,2,0.12
11,4,master,6,415,2,4,0.2
11,4,meaningful,10,416,1,9,0.4
11,4,mechanical,10,417,2,8,0.48
11,4,meeting,7,418,2,5,0.28
11,4,melody,6,419,2,4,0.24
11,4,memory,6,420,2,4,0.24
11,4,mental,6,421,2,4,0.32
11,4,mentor,6,422,4,2,0.2
11,4,merely,6,423,2,4,0.24
11,4,mess,4,424,2,2,0.16
11,4,midnight,8,425,1,7,0.4
11,4,militia,7,426,2,5,0.28
11,4,mind,4,427,2,2,0.16
11,4,mirror,6,428,2,4,0.24
11,4,misleading,10,429,2,8,0.48
11,4,missing,7,430,3,4,0.24
11,4,mobilize,8,431,1,7,0.32
11,4,model,5,432,2,3,0.2
11,4,month,5,433,2,3,0.28
11,4,mouth,5,434,2,3,0.16
11,4,movie,5,435,2,3,0.16
11,4,multiple,8,436,1,7,0.32
11,4,mum,3,437,2,1,0.08
11,4,musician,8,438,2,6,0.4
11,4,must,4,439,3,1,0.12
11,4,my,2,440,1,1,0.08
11,4,naked,5,441,0,5,0.24
11,4,name,4,442,2,2,0.16
11,4,narrative,9,443,2,7,0.44
11,4,nature,6,444,2,4,0.24
11,4,necessary,9,445,1,8,0.36
11,4,negative,8,446,2,6,0.32
11,4,newly,5,447,2,3,0.28
11,4,newspaper,9,448,3,6,0.32
11,4,night,5,449,1,4,0.2
11,4,noise,5,450,1,4,0.2
11,4,noisy,5,451,4,1,0.2
11,4,nomination,10,452,2,8,0.4
11,4,norm,4,453,2,2,0.12
11,4,north,5,454,3,2,0.16
11,4,note,4,455,2,2,0.16
11,4,notice,6,456,3,3,0.28
11,4,novel,5,457,2,3,0.2
11,4,nut,3,458,1,2,0.12
11,4,obsess,6,459,0,6,0.28
11,4,occupation,10,460,1,9,1.04
11,4,offence,7,461,1,6,0.68
11,4,official,8,462,3,5,0.64
11,4,one,3,463,1,2,0.28
11,4,online,6,464,2,4,0.64
11,4,opportunity,11,465,1,10,1.04
11,4,opposed,7,466,4,3,0.48
11,4,optimistic,10,467,2,8,1.04
11,4,originate,9,468,1,8,0.88
11,4,outbreak,8,469,1,7,0.76
11,4,outfit,6,470,3,3,0.44
11,4,outlet,6,471,3,3,0.6
11,4,outlook,7,472,4,3,0.52
11,4,overall,7,473,1,6,0.68
11,4,pad,3,474,0,3,0.32
11,4,pants,5,475,2,3,0.44
11,4,parade,6,476,2,4,0.64
11,4,participate,11,477,3,8,1.04
11,4,partner,7,478,4,3,0.6
11,4,passport,8,479,2,6,1.52
11,4,patent,6,480,2,4,0.52
11,4,patience,8,481,3,5,0.76
11,4,peace,5,482,1,4,0.52
11,4,peculiar,8,483,2,6,0.88
11,4,pepper,6,484,2,4,0.52
11,4,perceive,8,485,2,6,0.76
11,4,perhaps,7,486,3,4,0.6
11,4,personality,11,487,3,8,1.08
11,4,personnel,9,488,6,3,0.6
11,4,philosopher,11,489,1,10,1.04
11,4,photo,5,490,2,3,0.56
11,4,pick,4,491,1,3,0.36
11,4,pig,3,492,2,1,0.24
11,4,pile,4,493,2,2,0.36
11,4,pin,3,494,2,1,0.28
11,4,pipe,4,495,2,2,0.36
11,4,plane,5,496,1,4,0.6
11,4,plastic,7,497,3,4,0.56
11,4,plead,5,498,2,3,0.44
11,4,pleased,7,499,4,3,0.48
11,4,pledge,6,500,3,3,0.6
11,4,plot,4,501,2,2,0.32
11,4,point,5,502,1,4,0.48
11,4,pond,4,503,2,2,0.32
11,4,position,8,504,2,6,0.8
11,4,possess,7,505,3,4,0.72
11,4,possibility,11,506,4,7,0.88
11,4,possible,8,507,6,2,0.52
11,4,post,4,508,3,1,0.28
11,4,poster,6,509,4,2,0.56
11,4,precedent,9,510,1,8,0.84
11,4,precise,7,511,4,3,0.48
11,4,predict,7,512,3,4,0.56
11,4,pregnant,8,513,3,5,0.76
11,4,prejudice,9,514,3,6,0.72
11,4,preliminary,11,515,3,8,0.92
11,4,premise,7,516,3,4,0.68
11,4,prescribe,9,517,3,6,0.72
11,4,presence,8,518,4,4,0.6
11,4,presently,9,519,6,3,0.68
11,4,prevention,10,520,3,7,0.84
11,4,previously,10,521,4,6,0.76
11,4,principal,9,522,2,7,0.92
11,4,printer,7,523,4,3,0.48
11,4,printing,8,524,5,3,0.52
11,4,priority,8,525,3,5,0.68
11,4,processing,10,526,2,8,1
11,4,processor,9,527,7,2,0.6
11,4,product,7,528,3,4,0.56
11,4,program,7,529,3,4,0.68
11,4,project,7,530,3,4,0.56
11,4,proof,5,531,3,2,0.36
11,4,proper,6,532,3,3,0.44
11,4,properly,8,533,6,2,0.48
11,4,pump,4,534,1,3,0.48
11,4,pursuit,7,535,2,5,0.6
11,4,put,3,536,2,1,0.24
11,4,quality,7,537,0,7,0.72
11,4,query,5,538,2,3,0.44
11,4,quite,5,539,2,3,0.56
11,4,race,4,540,0,4,0.44
11,4,racial,6,541,3,3,0.44
11,4,racism,6,542,4,2,0.4
11,4,radar,5,543,2,3,0.4
11,4,rail,4,544,2,2,0.44
11,4,rally,5,545,2,3,0.4
11,4,rational,8,546,2,6,0.68
11,4,react,5,547,1,4,0.48
11,4,realistic,9,548,3,6,0.88
11,4,realm,5,549,4,1,0.32
11,4,rear,4,550,3,1,0.28
11,4,rebel,5,551,2,3,0.4
11,4,record,6,552,2,4,0.52
11,4,recording,9,553,6,3,0.68
11,4,recount,7,554,4,3,0.48
11,4,recruit,7,555,3,4,0.56
11,4,reduce,6,556,2,4,0.52
11,4,reduction,9,557,5,4,0.76
11,4,refer,5,558,2,3,0.4
11,4,referee,7,559,5,2,0.44
11,4,region,6,560,2,4,0.52
11,4,regulatory,10,561,3,7,0.96
11,4,relaxed,7,562,2,5,0.6
11,4,relevance,9,563,3,6,0.72
11,4,relief,6,564,3,3,0.6
11,4,religious,9,565,4,5,0.8
11,4,remainder,9,566,2,7,0.84
11,4,remark,6,567,4,2,0.4
11,4,remind,6,568,3,3,0.6
11,4,removal,7,569,3,4,0.56
11,4,repeat,6,570,2,4,0.52
11,4,reportedly,10,571,3,7,0.84
11,4,reporting,9,572,6,3,0.72
11,4,republic,8,573,3,5,0.64
11,4,requirement,11,574,2,9,1.16
11,4,research,8,575,2,6,0.84
11,4,residue,7,576,3,4,0.56
11,4,resolve,7,577,3,4,0.64
11,4,responsible,11,578,3,8,1.2
11,4,retrieve,8,579,2,6,0.72
11,4,revision,8,580,2,6,0.68
11,4,revive,6,581,4,2,0.4
11,4,rifle,5,582,1,4,0.6
11,4,right,5,583,2,3,0.4
11,4,rip,3,584,2,1,0.24
11,4,road,4,585,1,3,0.4
11,4,rob,3,586,2,1,0.28
11,4,robust,6,587,3,3,0.48
11,4,roll,4,588,2,2,0.44
11,4,romance,7,589,2,5,0.6
11,4,roof,4,590,2,2,0.32
11,4,rotate,6,591,2,4,0.52
11,4,ruin,4,592,1,3,0.4
11,4,sacred,6,593,0,6,0.76
11,4,sand,4,594,2,2,0.24
11,4,satisfied,9,595,2,7,0.44
11,4,scan,4,596,1,3,0.2
11,4,scared,6,597,3,3,0.24
11,4,schedule,8,598,2,6,0.4
11,4,scheme,6,599,4,2,0.2
11,4,scholar,7,600,3,4,0.24
11,4,school,6,601,4,2,0.16
11,4,scientific,10,602,2,8,0.48
11,4,secure,6,603,1,5,0.24
11,4,seeker,6,604,2,4,0.2
11,4,segment,7,605,2,5,0.36
11,4,selective,9,606,2,7,0.36
11,4,sensible,8,607,2,6,0.32
11,4,sensitivity,11,608,5,6,0.44
11,4,september,9,609,2,7,0.32
11,4,serious,7,610,2,5,0.24
11,4,service,7,611,3,4,0.24
11,4,settlement,10,612,2,8,0.48
11,4,settler,7,613,6,1,0.16
11,4,seven,5,614,2,3,0.16
11,4,severely,8,615,4,4,0.24
11,4,sexual,6,616,2,4,0.32
11,4,sexy,4,617,3,1,0.12
11,4,shallow,7,618,1,6,0.28
11,4,share,5,619,3,2,0.16
11,4,sheer,5,620,2,3,0.16
11,4,ship,4,621,2,2,0.24
11,4,shipping,8,622,4,4,0.24
11,4,shore,5,623,2,3,0.16
11,4,shortage,8,624,4,4,0.24
11,4,shortly,7,625,5,2,0.28
11,4,sight,5,626,1,4,0.2
11,4,silver,6,627,2,4,0.2
11,4,simply,6,628,2,4,0.24
11,4,sit,3,629,2,1,0.08
11,4,situated,8,630,3,5,0.36
11,4,skip,4,631,1,3,0.16
11,4,skirt,5,632,3,2,0.16
11,4,skull,5,633,2,3,0.16
11,4,smoking,7,634,1,6,0.28
11,4,snow,4,635,1,3,0.24
11,4,soap,4,636,1,3,0.16
11,4,solid,5,637,2,3,0.16
11,4,somehow,7,638,2,5,0.28
11,4,someone,7,639,4,3,0.28
11,4,something,9,640,4,5,0.32
11,4,song,4,641,2,2,0.12
11,4,soup,4,642,2,2,0.12
11,4,sovereignty,11,643,2,9,0.52
11,4,spare,5,644,1,4,0.2
11,4,speak,5,645,2,3,0.2
11,4,special,7,646,3,4,0.24
11,4,specify,7,647,5,2,0.2
11,4,speech,6,648,3,3,0.28
11,4,spine,5,649,2,3,0.2
11,4,spokesman,9,650,2,7,0.32
11,4,spread,6,651,2,4,0.24
11,4,stab,4,652,1,3,0.24
11,4,stable,6,653,4,2,0.16
11,4,staff,5,654,3,2,0.16
11,4,stall,5,655,3,2,0.16
11,4,star,4,656,3,1,0.12
11,4,statue,6,657,3,3,0.2
11,4,stay,4,658,3,1,0.2
11,4,steadily,8,659,2,6,0.28
11,4,stem,4,660,3,1,0.12
11,4,stop,4,661,2,2,0.16
11,4,story,5,662,3,2,0.16
11,4,strange,7,663,2,5,0.32
11,4,strategic,9,664,4,5,0.28
11,4,strength,8,665,3,5,0.28
11,4,stretch,7,666,4,3,0.28
11,4,strike,6,667,3,3,0.2
11,4,striking,8,668,5,3,0.24
11,4,string,6,669,4,2,0.16
11,4,strong,6,670,3,3,0.2
11,4,study,5,671,2,3,0.28
11,4,stumble,7,672,3,4,0.24
11,4,stun,4,673,3,1,0.12
11,4,subject,7,674,1,6,0.28
11,4,substance,9,675,3,6,0.4
11,4,such,4,676,2,2,0.16
11,4,sugar,5,677,2,3,0.16
11,4,suppose,7,678,2,5,0.24
11,4,supreme,7,679,3,4,0.24
11,4,sure,4,680,2,2,0.24
11,4,surely,6,681,4,2,0.16
11,4,surgical,8,682,3,5,0.28
11,4,surrounding,11,683,3,8,0.48
11,4,survival,8,684,3,5,0.28
11,4,suspension,10,685,2,8,0.4
11,4,sweater,7,686,1,6,0.28
11,4,switch,6,687,2,4,0.28
11,4,sympathy,8,688,1,7,0.32
11,4,symptom,7,689,4,3,0.2
11,4,synthesis,9,690,2,7,0.44
11,4,table,5,691,0,5,0.2
11,4,tactical,8,692,2,6,0.32
11,4,tale,4,693,2,2,0.12
11,4,talk,4,694,3,1,0.12
11,4,tap,3,695,2,1,0.08
11,4,taste,5,696,2,3,0.28
11,4,tea,3,697,1,2,0.12
11,4,team,4,698,3,1,0.12
11,4,television,10,699,2,8,0.4
11,4,temperature,11,700,2,9,0.52
11,4,tempt,5,701,4,1,0.12
11,4,tendency,8,702,2,6,0.28
11,4,tender,6,703,5,1,0.16
11,4,tension,7,704,3,4,0.32
11,4,terribly,8,705,2,6,0.32
11,4,terrific,8,706,5,3,0.24
11,4,terrify,7,707,6,1,0.16
11,4,terrorism,9,708,4,5,0.4
11,4,textbook,8,709,2,6,0.28
11,4,themselves,10,710,1,9,0.44
11,4,thereby,7,711,3,4,0.32
11,4,thirsty,7,712,2,5,0.28
11,4,thoughtful,10,713,2,8,0.4
11,4,three,5,714,2,3,0.2
11,4,thumb,5,715,2,3,0.28
11,4,ticket,6,716,1,5,0.24
11,4,tidy,4,717,2,2,0.16
11,4,till,4,718,2,2,0.12
11,4,tolerance,9,719,1,8,0.44
11,4,too,3,720,2,1,0.08
11,4,tool,4,721,3,1,0.12
11,4,topic,5,722,2,3,0.16
11,4,tour,4,723,2,2,0.12
11,4,trainer,7,724,1,6,0.28
11,4,translation,11,725,3,8,0.48
11,4,treat,5,726,2,3,0.2
11,4,trend,5,727,3,2,0.16
11,4,trousers,8,728,2,6,0.4
11,4,truck,5,729,2,3,0.2
11,4,twice,5,730,1,4,0.2
11,4,two,3,731,2,1,0.12
11,4,ultimate,8,732,0,8,0.36
11,4,unable,6,733,1,5,0.32
11,4,undergo,7,734,2,5,0.28
11,4,underground,11,735,6,5,0.32
11,4,undermine,9,736,5,4,0.36
11,4,underwear,9,737,5,4,0.28
11,4,undoubtedly,11,738,3,8,0.4
11,4,unfair,6,739,2,4,0.24
11,4,unify,5,740,2,3,0.28
11,4,union,5,741,3,2,0.16
11,4,unique,6,742,3,3,0.2
11,4,universal,9,743,3,6,0.32
11,4,unusual,7,744,2,5,0.36
11,4,upgrade,7,745,1,6,0.32
11,4,urban,5,746,1,4,0.2
11,4,urgent,6,747,2,4,0.24
11,4,utility,7,748,1,6,0.36
11,4,vague,5,749,0,5,0.24
11,4,validity,8,750,2,6,0.28
11,4,variety,7,751,2,5,0.24
11,4,vein,4,752,1,3,0.16
11,4,verify,6,753,2,4,0.4
11,4,video,5,754,1,4,0.48
11,4,viewer,6,755,2,4,0.52
11,4,violent,7,756,2,5,0.6
11,4,virtual,7,757,2,5,0.76
11,4,virtue,6,758,5,1,0.36
11,4,virus,5,759,3,2,0.36
11,4,visitor,7,760,2,5,0.6
11,4,vital,5,761,2,3,0.64
11,4,volunteer,9,762,1,8,0.84
11,4,wait,4,763,0,4,0.44
11,4,wake,4,764,2,2,0.32
11,4,war,3,765,2,1,0.24
11,4,warning,7,766,3,4,0.72
11,4,warrior,7,767,3,4,0.56
11,4,water,5,768,2,3,0.4
11,4,weapon,6,769,1,5,0.56
11,4,weave,5,770,3,2,0.36
11,4,weekend,7,771,2,5,0.76
11,4,weird,5,772,2,3,0.4
11,4,welcome,7,773,2,5,0.64
11,4,whatever,8,774,1,7,0.8
11,4,willingness,11,775,1,10,1.32
11,4,window,6,776,2,4,0.56
11,4,wipe,4,777,2,2,0.32
11,4,within,6,778,2,4,0.52
11,4,without,7,779,4,3,0.64
11,4,woman,5,780,1,4,0.48
11,4,wonderful,9,781,2,7,0.8
11,4,word,4,782,2,2,0.32
11,4,workforce,9,783,3,6,0.96
11,4,workplace,9,784,4,5,0.84
11,4,world,5,785,3,2,0.44
11,4,written,7,786,1,6,0.76
11,4,yellow,6,787,0,6,0.8
11,4,youngster,9,788,1,8,0.84
11,5,academic,8,0,0,8,0.76
11,5,accelerate,10,1,2,8,0.56
11,5,acceptable,10,2,4,6,0.36
11,5,accident,8,3,3,5,0.28
11,5,accommodate,11,4,3,8,0.48
11,5,accomplish,10,5,5,5,0.32
11,5,accordance,10,6,4,6,0.32
11,5,acre,4,7,2,2,0.24
11,5,activate,8,8,2,6,0.28
11,5,additional,10,9,1,9,0.4
11,5,adequately,10,10,2,8,0.48
11,5,adj,3,11,2,1,0.08
11,5,adjacent,8,12,3,5,0.28
11,5,admit,5,13,2,3,0.16
11,5,adopt,5,14,2,3,0.16
11,5,affordable,10,15,1,9,0.48
11,5,against,7,16,1,6,0.28
11,5,aggression,10,17,2,8,0.36
11,5,aids,4,18,1,3,0.28
11,5,align,5,19,1,4,0.2
11,5,alongside,9,20,2,7,0.32
11,5,analyse,7,21,1,6,0.28
11,5,ancient,7,22,2,5,0.36
11,5,annoyed,7,23,2,5,0.24
11,5,annoying,8,24,5,3,0.24
11,5,anxiety,7,25,2,5,0.28
11,5,anybody,7,26,2,5,0.36
11,5,anyway,6,27,3,3,0.2
11,5,apology,7,28,1,6,0.28
11,5,app,3,29,2,1,0.12
11,5,appreciate,10,30,3,7,0.48
11,5,approach,8,31,4,4,0.24
11,5,approve,7,32,5,2,0.2
11,5,arguably,8,33,1,7,0.4
11,5,argue,5,34,4,1,0.12
11,5,army,4,35,2,2,0.12
11,5,arrangement,11,36,2,9,0.4
11,5,arrest,6,37,3,3,0.2
11,5,arrow,5,38,3,2,0.24
11,5,ask,3,39,1,2,0.12
11,5,associate,9,40,2,7,0.32
11,5,atrocity,8,41,1,7,0.32
11,5,attachment,10,42,2,8,0.52
11,5,auction,7,43,1,6,0.32
11,5,average,7,44,1,6,0.32
11,5,baby,4,45,0,4,0.2
11,5,backing,7,46,2,5,0.36
11,5,ballet,6,47,2,4,0.24
11,5,banner,6,48,2,4,0.24
11,5,bat,3,49,2,1,0.12
11,5,bath,4,50,3,1,0.24
11,5,beast,5,51,1,4,0.24
11,5,beauty,6,52,3,3,0.2
11,5,behave,6,53,2,4,0.2
11,5,bell,4,54,2,2,0.12
11,5,benchmark,9,55,2,7,0.44
11,5,best,4,56,2,2,0.12
11,5,betray,6,57,2,4,0.24
11,5,beyond,6,58,2,4,0.2
11,5,birthday,8,59,1,7,0.4
11,5,biscuit,7,60,2,5,0.28
11,5,bishop,6,61,3,3,0.2
11,5,bite,4,62,2,2,0.12
11,5,blame,5,63,1,4,0.2
11,5,blank,5,64,3,2,0.24
11,5,blog,4,65,2,2,0.16
11,5,boat,4,66,1,3,0.16
11,5,boil,4,67,2,2,0.12
11,5,bomb,4,68,2,2,0.16
11,5,boost,5,69,2,3,0.16
11,5,boot,4,70,3,1,0.2
11,5,bother,6,71,2,4,0.2
11,5,bottle,6,72,3,3,0.2
11,5,bound,5,73,2,3,0.16
11,5,boundary,8,74,5,3,0.24
11,5,boyfriend,9,75,2,7,0.44
11,5,brand,5,76,1,4,0.2
11,5,break,5,77,2,3,0.2
11,5,breathing,9,78,4,5,0.32
11,5,buffer,6,79,1,5,0.44
11,5,bunch,5,80,2,3,0.2
11,5,burden,6,81,2,4,0.24
11,5,business,8,82,2,6,0.36
11,5,businessman,11,83,8,3,0.4
11,5,cake,4,84,0,4,0.28
11,5,can,3,85,2,1,0.12
11,5,cap,3,86,2,1,0.12
11,5,capitalist,10,87,3,7,0.52
11,5,card,4,88,2,2,0.12
11,5,careful,7,89,3,4,0.28
11,5,carpet,6,90,3,3,0.2
11,5,cease,5,91,1,4,0.2
11,5,celebrity,9,92,2,7,0.44
11,5,cemetery,8,93,2,6,0.32
11,5,century,7,94,2,5,0.24
11,5,ceremony,8,95,2,6,0.4
11,5,chapter,7,96,1,6,0.28
11,5,character,9,97,3,6,0.32
11,5,charity,7,98,4,3,0.2
11,5,charm,5,99,4,1,0.24
11,5,charming,8,100,5,3,0.24
11,5,charter,7,101,4,3,0.2
11,5,cheat,5,102,2,3,0.16
11,5,cheerful,8,103,3,5,0.36
11,5,chemical,8,104,3,5,0.28
11,5,chicken,7,105,2,5,0.28
11,5,chronic,7,106,2,5,0.28
11,5,chunk,5,107,2,3,0.28
11,5,circuit,7,108,1,6,0.28
11,5,cite,4,109,2,2,0.12
11,5,city,4,110,3,1,0.12
11,5,civil,5,111,2,3,0.16
11,5,clarity,7,112,1,6,0.36
11,5,clause,6,113,3,3,0.2
11,5,clean,5,114,2,3,0.2
11,5,clinical,8,115,2,6,0.28
11,5,closely,7,116,2,5,0.36
11,5,coincide,8,117,1,7,0.32
11,5,collection,10,118,2,8,0.44
11,5,comedy,6,119,2,4,0.24
11,5,comfortable,11,120,3,8,0.48
11,5,commonly,8,121,3,5,0.28
11,5,community,9,122,4,5,0.28
11,5,comparable,10,123,3,7,0.44
11,5,compensate,10,124,4,6,0.32
11,5,compete,7,125,5,2,0.2
11,5,completion,10,126,4,6,0.44
11,5,comply,6,127,5,1,0.16
11,5,conceal,7,128,2,5,0.24
11,5,concept,7,129,5,2,0.2
11,5,concern,7,130,5,2,0.32
11,5,concert,7,131,6,1,0.2
11,5,conclusion,10,132,4,6,0.4
11,5,confess,7,133,3,4,0.32
11,5,confidence,10,134,4,6,0.36
11,5,confused,8,135,4,4,0.24
11,5,conscious,9,136,3,6,0.32
11,5,consistency,11,137,4,7,0.44
11,5,constraint,10,138,4,6,0.32
11,5,contend,7,139,3,4,0.24
11,5,controversy,11,140,4,7,0.52
11,5,convenient,10,141,3,7,0.4
11,5,conversion,10,142,5,5,0.44
11,5,cooker,6,143,2,4,0.2
11,5,coordinate,10,144,3,7,0.36
11,5,cope,4,145,2,2,0.16
11,5,correct,7,146,2,5,0.36
11,5,cost,4,147,2,2,0.16
11,5,could,5,148,2,3,0.2
11,5,counter,7,149,3,4,0.24
11,5,county,6,150,5,1,0.16
11,5,coup,4,151,3,1,0.12
11,5,couple,6,152,4,2,0.28
11,5,court,5,153,3,2,0.16
11,5,coverage,8,154,2,6,0.32
11,5,craft,5,155,1,4,0.2
11,5,credible,8,156,2,6,0.4
11,5,criminal,8,157,2,6,0.32
11,5,crisis,6,158,3,3,0.2
11,5,crowded,7,159,2,5,0.28
11,5,crude,5,160,2,3,0.28
11,5,cruise,6,161,3,3,0.2
11,5,cultivate,9,162,1,8,0.36
11,5,currency,8,163,2,6,0.32
11,5,current,7,164,6,1,0.24
11,5,curriculum,10,165,4,6,0.32
11,5,cycle,5,166,1,4,0.2
11,5,dance,5,167,0,5,0.2
11,5,dare,4,168,2,2,0.24
11,5,day,3,169,2,1,0.12
11,5,deal,4,170,1,3,0.16
11,5,declare,7,171,2,5,0.24
11,5,decoration,10,172,3,7,0.48
11,5,deed,4,173,2,2,0.12
11,5,deem,4,174,3,1,0.12
11,5,defect,6,175,2,4,0.2
11,5,defence,7,176,4,3,0.2
11,5,definite,8,177,3,5,0.36
11,5,definitely,10,178,8,2,0.24
11,5,delight,7,179,2,5,0.28
11,5,delighted,9,180,7,2,0.24
11,5,deliver,7,181,4,3,0.28
11,5,democratic,10,182,2,8,0.4
11,5,dentist,7,183,2,5,0.28
11,5,departure,9,184,2,7,0.44
11,5,depressing,10,185,3,7,0.36
11,5,desktop,7,186,2,5,0.28
11,5,despite,7,187,3,4,0.32
11,5,destination,11,188,3,8,0.4
11,5,destruction,11,189,4,7,0.4
11,5,devil,5,190,2,3,0.16
11,5,diagram,7,191,1,6,0.4
11,5,dictate,7,192,2,5,0.28
11,5,dictator,8,193,6,2,0.2
11,5,diminish,8,194,2,6,0.4
11,5,dirt,4,195,2,2,0.12
11,5,dirty,5,196,4,1,0.12
11,5,discipline,10,197,2,8,0.36
11,5,disclosure,10,198,4,6,0.4
11,5,discretion,10,199,4,6,0.32
11,5,discussion,10,200,4,6,0.32
11,5,distort,7,201,3,4,0.32
11,5,distribute,10,202,4,6,0.32
11,5,dollar,6,203,1,5,0.24
11,5,domain,6,204,2,4,0.24
11,5,dominant,8,205,3,5,0.36
11,5,donation,8,206,2,6,0.32
11,5,dot,3,207,2,1,0.08
11,5,double,6,208,2,4,0.24
11,5,download,8,209,2,6,0.4
11,5,downstairs,10,210,4,6,0.36
11,5,drink,5,211,1,4,0.2
11,5,earnings,8,212,0,8,0.32
11,5,earth,5,213,3,2,0.28
11,5,eighty,6,214,1,5,0.24
11,5,elect,5,215,1,4,0.2
11,5,electrical,10,216,5,5,0.32
11,5,electricity,11,217,8,3,0.4
11,5,eleven,6,218,3,3,0.2
11,5,elsewhere,9,219,2,7,0.32
11,5,embark,6,220,1,5,0.32
11,5,embody,6,221,3,3,0.2
11,5,emergence,9,222,2,7,0.36
11,5,emission,8,223,2,6,0.28
11,5,employer,8,224,2,6,0.4
11,5,ending,6,225,1,5,0.24
11,5,endless,7,226,3,4,0.24
11,5,enjoy,5,227,2,3,0.2
11,5,enormous,8,228,2,6,0.4
11,5,enrich,6,229,2,4,0.24
11,5,enterprise,10,230,2,8,0.52
11,5,entrance,8,231,3,5,0.44
11,5,entry,5,232,4,1,0.12
11,5,environment,11,233,2,9,0.4
11,5,equality,8,234,1,7,0.32
11,5,equipment,9,235,3,6,0.44
11,5,essay,5,236,1,4,0.2
11,5,essence,7,237,3,4,0.24
11,5,establish,9,238,2,7,0.48
11,5,evening,7,239,1,6,0.28
11,5,evoke,5,240,2,3,0.16
11,5,examination,11,241,1,10,0.44
11,5,examine,7,242,6,1,0.28
11,5,excited,7,243,2,5,0.28
11,5,exciting,8,244,5,3,0.24
11,5,exclusive,9,245,3,6,0.32
11,5,excuse,6,246,3,3,0.28
11,5,execution,9,247,2,7,0.32
11,5,expertise,9,248,2,7,0.36
11,5,expire,6,249,3,3,0.28
11,5,explicitly,10,250,3,7,0.36
11,5,explode,7,251,4,3,0.2
11,5,exploration,11,252,5,6,0.44
11,5,explosive,9,253,5,4,0.28
11,5,extend,6,254,2,4,0.24
11,5,extensive,9,255,5,4,0.28
11,5,extent,6,256,5,1,0.24
11,5,faculty,7,257,0,7,0.32
11,5,fair,4,258,2,2,0.12
11,5,fall,4,259,2,2,0.12
11,5,fantastic,9,260,2,7,0.36
11,5,fat,3,261,2,1,0.16
11,5,fear,4,262,1,3,0.16
11,5,feeding,7,263,2,5,0.28
11,5,fellow,6,264,2,4,0.24
11,5,fiction,7,265,1,6,0.36
11,5,fifty,5,266,2,3,0.16
11,5,file,4,267,2,2,0.12
11,5,firefighter,11,268,2,9,0.48
11,5,fix,3,269,2,1,0.12
11,5,fixture,7,270,3,4,0.36
11,5,flavour,7,271,1,6,0.28
11,5,flexible,8,272,2,6,0.28
11,5,floor,5,273,2,3,0.2
11,5,flourish,8,274,3,5,0.36
11,5,flu,3,275,2,1,0.12
11,5,folding,7,276,1,6,0.28
11,5,folk,4,277,3,1,0.12
11,5,food,4,278,2,2,0.12
11,5,for,3,279,2,1,0.2
11,5,foreign,7,280,3,4,0.24
11,5,foreigner,9,281,7,2,0.24
11,5,formation,9,282,3,6,0.32
11,5,former,6,283,4,2,0.24
11,5,fortunately,11,284,3,8,0.4
11,5,foster,6,285,2,4,0.24
11,5,founder,7,286,2,5,0.24
11,5,fragment,8,287,1,7,0.4
11,5,frequent,8,288,2,6,0.32
11,5,friday,6,289,2,4,0.2
11,5,fridge,6,290,4,2,0.28
11,5,frighten,8,291,3,5,0.28
11,5,frightened,10,292,8,2,0.56
11,5,front,5,293,2,3,0.4
11,5,fundamental,11,294,1,10,1.28
11,5,funding,7,295,4,3,0.6
11,5,gallery,7,296,0,7,0.88
11,5,gallon,6,297,4,2,0.48
11,5,game,4,298,2,2,0.48
11,5,gene,4,299,1,3,0.4
11,5,generate,8,300,4,4,0.64
11,5,genuinely,9,301,3,6,0.84
11,5,geography,9,302,2,7,1
11,5,giant,5,303,1,4,0.52
11,5,glass,5,304,1,4,0.48
11,5,globe,5,305,2,3,0.44
11,5,gold,4,306,1,3,0.4
11,5,governor,8,307,2,6,0.84
11,5,grade,5,308,1,4,0.48
11,5,gravity,7,309,3,4,0.56
11,5,greet,5,310,2,3,0.4
11,5,grid,4,311,2,2,0.48
11,5,grin,4,312,3,1,0.28
11,5,grind,5,313,4,1,0.32
11,5,ground,6,314,2,4,0.52
11,5,guerrilla,9,315,1,8,0.84
11,5,guess,5,316,3,2,0.52
11,5,guidance,8,317,2,6,0.72
11,5,guide,5,318,4,1,0.32
11,5,guy,3,319,2,1,0.24
11,5,gym,3,320,1,2,0.28
11,5,hair,4,321,0,4,0.56
11,5,handful,7,322,2,5,0.64
11,5,handy,5,323,4,1,0.32
11,5,happen,6,324,2,4,0.52
11,5,harbour,7,325,2,5,0.76
11,5,harm,4,326,3,1,0.44
11,5,harsh,5,327,3,2,0.36
11,5,hate,4,328,2,2,0.32
11,5,hazard,6,329,2,4,0.52
11,5,health,6,330,1,5,0.56
11,5,heart,5,331,3,2,0.52
11,5,heat,4,332,3,1,0.32
11,5,her,3,333,2,1,0.28
11,5,hers,4,334,3,1,0.32
11,5,hesitate,8,335,2,6,0.84
11,5,highlight,9,336,1,8,1.08
11,5,historical,10,337,2,8,0.96
11,5,holiday,7,338,1,6,0.68
11,5,homeland,8,339,2,6,0.84
11,5,horrible,8,340,2,6,0.72
11,5,horror,6,341,4,2,0.4
11,5,hotel,5,342,2,3,0.4
11,5,how,3,343,2,1,0.24
11,5,however,7,344,3,4,0.72
11,5,humanity,8,345,1,7,0.76
11,5,humble,6,346,3,3,0.48
11,5,humour,6,347,3,3,0.48
11,5,hunger,6,348,2,4,0.64
11,5,hunt,4,349,3,1,0.28
11,5,ice,3,350,0,3,0.32
11,5,identity,8,351,1,7,0.8
11,5,illegal,7,352,1,6,0.68
11,5,imagery,7,353,1,6,0.8
11,5,impatient,9,354,2,7,0.8
11,5,implement,9,355,3,6,0.76
11,5,implication,11,356,4,7,1.04
11,5,import,6,357,3,3,0.44
11,5,important,9,358,6,3,0.56
11,5,improve,7,359,3,4,0.68
11,5,include,7,360,1,6,0.68
11,5,inclusion,9,361,5,4,0.64
11,5,incorporate,11,362,3,8,0.96
11,5,infant,6,363,2,4,0.64
11,5,influential,11,364,3,8,0.96
11,5,info,4,365,3,1,0.28
11,5,inform,6,366,4,2,0.4
11,5,informal,8,367,6,2,0.64
11,5,information,11,368,7,4,0.72
11,5,inherent,8,369,2,6,0.72
11,5,inject,6,370,2,4,0.64
11,5,injury,6,371,3,3,0.48
11,5,insertion,9,372,2,7,0.84
11,5,inspection,10,373,3,7,0.84
11,5,instruct,8,374,3,5,0.8
11,5,instrument,10,375,6,4,0.68
11,5,intelligent,11,376,2,9,1.16
11,5,intense,7,377,4,3,0.48
11,5,intensify,9,378,6,3,0.56
11,5,interesting,11,379,4,7,0.88
11,5,interior,8,380,5,3,0.68
11,5,invade,6,381,2,4,0.52
11,5,involve,7,382,3,4,0.56
11,5,involved,8,383,7,1,0.44
11,5,issue,5,384,1,4,0.6
11,5,job,3,385,0,3,0.36
11,5,journalism,10,386,2,8,0.92
11,5,judicial,8,387,1,7,0.76
11,5,june,4,388,2,2,0.44
11,5,justify,7,389,2,5,0.6
11,5,king,4,390,0,4,0.44
11,5,knife,5,391,1,4,0.48
11,5,lack,4,392,0,4,0.44
11,5,lad,3,393,2,1,0.4
11,5,lake,4,394,2,2,0.32
11,5,lap,3,395,2,1,0.24
11,5,latest,6,396,2,4,0.52
11,5,law,3,397,2,1,0.24
11,5,lawn,4,398,3,1,0.28
11,5,layer,5,399,2,3,0.56
11,5,leadership,10,400,1,9,0.96
11,5,leading,7,401,4,3,0.52
11,5,leaf,4,402,3,1,0.28
11,5,league,6,403,3,3,0.48
11,5,learning,8,404,3,5,0.88
11,5,left,4,405,2,2,0.32
11,5,legitimate,10,406,2,8,0.88
11,5,lethal,6,407,2,4,0.64
11,5,letter,6,408,3,3,0.48
11,5,licence,7,409,1,6,0.68
11,5,lifestyle,9,410,2,7,0.8
11,5,likelihood,10,411,2,8,1.04
11,5,limb,4,412,2,2,0.32
11,5,lion,4,413,2,2,0.32
11,5,literary,8,414,2,6,0.72
11,5,literature,10,415,6,4,0.84
11,5,live,4,416,2,2,0.36
11,5,liver,5,417,4,1,0.32
11,5,load,4,418,1,3,0.4
11,5,located,7,419,2,5,0.64
11,5,look,4,420,2,2,0.48
11,5,loose,5,421,3,2,0.36
11,5,lot,3,422,2,1,0.24
11,5,low,3,423,2,1,0.24
11,5,lunch,5,424,1,4,0.48
11,5,main,4,425,0,4,0.44
11,5,mainstream,10,426,4,6,0.92
11,5,mandate,7,427,2,5,0.64
11,5,mandatory,9,428,6,3,0.56
11,5,manipulate,10,429,3,7,1.08
11,5,manufacture,11,430,3,8,0.92
11,5,manuscript,10,431,4,6,0.8
11,5,map,3,432,2,1,0.24
11,5,marine,6,433,2,4,0.68
11,5,married,7,434,3,4,0.56
11,5,master,6,435,2,4,0.52
11,5,mean,4,436,1,3,0.36
11,5,media,5,437,2,3,0.56
11,5,melody,6,438,2,4,0.52
11,5,memory,6,439,2,4,0.52
11,5,mentor,6,440,2,4,0.56
11,5,merely,6,441,2,4,0.52
11,5,merger,6,442,3,3,0.64
11,5,message,7,443,2,5,0.64
11,5,midnight,8,444,1,7,0.76
11,5,militia,7,445,2,5,0.8
11,5,mind,4,446,2,2,0.32
11,5,mirror,6,447,2,4,0.52
11,5,missing,7,448,2,5,0.64
11,5,mobilize,8,449,1,7,0.76
11,5,modify,6,450,2,4,0.68
11,5,moment,6,451,2,4,0.52
11,5,month,5,452,2,3,0.4
11,5,more,4,453,2,2,0.32
11,5,most,4,454,2,2,0.32
11,5,multiple,8,455,1,7,0.92
11,5,mum,3,456,2,1,0.24
11,5,museum,6,457,2,4,0.52
11,5,music,5,458,3,2,0.36
11,5,musician,8,459,5,3,0.68
11,5,must,4,460,3,1,0.28
11,5,myth,4,461,1,3,0.4
11,5,name,4,462,0,4,0.44
11,5,nasty,5,463,2,3,0.44
11,5,nation,6,464,2,4,0.52
11,5,nationwide,10,465,6,4,0.84
11,5,nature,6,466,3,3,0.48
11,5,necessarily,11,467,1,10,1.04
11,5,neck,4,468,3,1,0.4
11,5,needle,6,469,2,4,0.52
11,5,negative,8,470,2,6,0.72
11,5,negotiation,11,471,3,8,0.96
11,5,neutral,7,472,2,5,0.76
11,5,noisy,5,473,1,4,0.48
11,5,nomination,10,474,2,8,0.96
11,5,non,3,475,2,1,0.24
11,5,norm,4,476,2,2,0.52
11,5,note,4,477,2,2,0.36
11,5,numerous,8,478,1,7,0.76
11,5,nut,3,479,2,1,0.24
11,5,obesity,7,480,0,7,1.36
11,5,oblige,6,481,2,4,0.68
11,5,obviously,9,482,2,7,0.8
11,5,occupation,10,483,1,9,0.96
11,5,october,7,484,2,5,0.76
11,5,offence,7,485,1,6,0.68
11,5,offensive,9,486,5,4,0.64
11,5,offspring,9,487,3,6,0.88
11,5,one,3,488,1,2,0.28
11,5,opponent,8,489,1,7,0.76
11,5,opportunity,11,490,4,7,1
11,5,opposed,7,491,4,3,0.76
11,5,optimistic,10,492,2,8,0.88
11,5,organic,7,493,1,6,0.68
11,5,organized,9,494,6,3,0.6
11,5,organizer,9,495,8,1,0.6
11,5,originate,9,496,2,7,0.8
11,5,other,5,497,1,4,0.4
11,5,otherwise,9,498,5,4,0.44
11,5,outlet,6,499,1,5,0.24
11,5,painful,7,500,0,7,0.32
11,5,paint,5,501,4,1,0.12
11,5,palace,6,502,2,4,0.32
11,5,pants,5,503,2,3,0.16
11,5,parade,6,504,2,4,0.24
11,5,park,4,505,3,1,0.12
11,5,participate,11,506,3,8,0.4
11,5,partner,7,507,4,3,0.32
11,5,passenger,9,508,2,7,0.32
11,5,password,8,509,4,4,0.24
11,5,patron,6,510,2,4,0.32
11,5,peace,5,511,1,4,0.2
11,5,peaceful,8,512,5,3,0.24
11,5,peculiar,8,513,2,6,0.28
11,5,peer,4,514,2,2,0.16
11,5,perceive,8,515,2,6,0.4
11,5,personality,11,516,3,8,0.4
11,5,pick,4,517,1,3,0.16
11,5,picture,7,518,3,4,0.36
11,5,pioneer,7,519,2,5,0.24
11,5,pipe,4,520,2,2,0.12
11,5,place,5,521,1,4,0.2
11,5,plant,5,522,3,2,0.16
11,5,play,4,523,3,1,0.2
11,5,pledge,6,524,2,4,0.24
11,5,political,9,525,1,8,0.36
11,5,pond,4,526,2,2,0.12
11,5,portion,7,527,2,5,0.36
11,5,position,8,528,2,6,0.32
11,5,possess,7,529,3,4,0.24
11,5,pot,3,530,2,1,0.08
11,5,prayer,6,531,1,5,0.24
11,5,predict,7,532,2,5,0.36
11,5,prejudice,9,533,3,6,0.32
11,5,prescribe,9,534,3,6,0.32
11,5,presence,8,535,4,4,0.36
11,5,previously,10,536,3,7,0.4
11,5,principal,9,537,2,7,0.36
11,5,printer,7,538,4,3,0.32
11,5,printing,8,539,5,3,0.24
11,5,procedure,9,540,2,7,0.36
11,5,process,7,541,5,2,0.2
11,5,prominent,9,542,3,6,0.44
11,5,propaganda,10,543,3,7,0.36
11,5,proportion,10,544,4,6,0.32
11,5,proposition,11,545,5,6,0.44
11,5,protester,9,546,3,6,0.32
11,5,pupil,5,547,1,4,0.2
11,5,pure,4,548,2,2,0.12
11,5,pursuit,7,549,3,4,0.36
11,5,quite,5,550,0,5,0.24
11,5,race,4,551,0,4,0.2
11,5,racial,6,552,3,3,0.2
11,5,radiation,9,553,2,7,0.44
11,5,rather,6,554,2,4,0.24
11,5,rational,8,555,3,5,0.28
11,5,react,5,556,1,4,0.2
11,5,rear,4,557,3,1,0.24
11,5,rebel,5,558,2,3,0.2
11,5,reception,9,559,2,7,0.36
11,5,recommend,9,560,3,6,0.32
11,5,record,6,561,4,2,0.28
11,5,reduce,6,562,2,4,0.24
11,5,reduction,9,563,5,4,0.28
11,5,refer,5,564,2,3,0.16
11,5,refuse,6,565,3,3,0.28
11,5,regime,6,566,2,4,0.24
11,5,region,6,567,4,2,0.16
11,5,regulatory,10,568,3,7,0.36
11,5,reign,5,569,2,3,0.16
11,5,rejection,9,570,2,7,0.44
11,5,relaxed,7,571,2,5,0.24
11,5,relieved,8,572,3,5,0.28
11,5,religious,9,573,4,5,0.4
11,5,remark,6,574,2,4,0.24
11,5,remove,6,575,3,3,0.24
11,5,renew,5,576,2,3,0.2
11,5,repeat,6,577,2,4,0.36
11,5,replace,7,578,3,4,0.24
11,5,reportedly,10,579,3,7,0.36
11,5,republic,8,580,3,5,0.28
11,5,requirement,11,581,2,9,0.52
11,5,research,8,582,2,6,0.32
11,5,reside,6,583,3,3,0.2
11,5,resignation,11,584,4,7,0.48
11,5,resolve,7,585,3,4,0.24
11,5,respective,10,586,3,7,0.36
11,5,retail,6,587,2,4,0.52
11,5,retire,6,588,3,3,0.64
11,5,retirement,10,589,6,4,0.84
11,5,retrieve,8,590,3,5,0.92
11,5,reveal,6,591,2,4,1.2
11,5,revenge,7,592,4,3,0.44
11,5,rip,3,593,1,2,0.28
11,5,rise,4,594,2,2,0.48
11,5,rival,5,595,2,3,0.48
11,5,rob,3,596,1,2,0.24
11,5,robust,6,597,3,3,0.56
11,5,rotate,6,598,2,4,0.36
11,5,rough,5,599,2,3,0.2
11,5,routine,7,600,3,4,0.28
11,5,rubber,6,601,1,5,0.28
11,5,ruin,4,602,2,2,0.24
11,5,sacred,6,603,0,6,0.32
11,5,sample,6,604,2,4,0.28
11,5,satellite,9,605,2,7,0.4
11,5,satisfied,9,606,3,6,0.44
11,5,satisfy,7,607,6,1,0.2
11,5,schedule,8,608,1,7,0.32
11,5,scholarship,11,609,3,8,0.48
11,5,school,6,610,4,2,0.16
11,5,scientific,10,611,2,8,0.4
11,5,security,8,612,1,7,0.32
11,5,segment,7,613,2,5,0.32
11,5,selective,9,614,2,7,0.36
11,5,seminar,7,615,2,5,0.28
11,5,sensible,8,616,2,6,0.4
11,5,sensitivity,11,617,5,6,0.4
11,5,september,9,618,2,7,0.4
11,5,service,7,619,2,5,0.36
11,5,settlement,10,620,2,8,0.36
11,5,seven,5,621,2,3,0.16
11,5,sheer,5,622,1,4,0.2
11,5,shift,5,623,2,3,0.24
11,5,ship,4,624,3,1,0.12
11,5,shipping,8,625,4,4,0.24
11,5,shopping,8,626,2,6,0.48
11,5,shortly,7,627,3,4,0.68
11,5,sight,5,628,1,4,0.52
11,5,simulation,10,629,2,8,1.08
11,5,sit,3,630,2,1,0.28
11,5,skull,5,631,1,4,0.56
11,5,slam,4,632,1,3,0.52
11,5,slice,5,633,2,3,0.44
11,5,slip,4,634,3,1,0.28
11,5,smoking,7,635,1,6,0.68
11,5,snow,4,636,1,3,0.36
11,5,soap,4,637,1,3,0.48
11,5,solar,5,638,2,3,0.44
11,5,solo,4,639,3,1,0.28
11,5,somehow,7,640,2,5,0.64
11,5,someone,7,641,4,3,0.52
11,5,soup,4,642,2,2,0.44
11,5,south,5,643,3,2,0.36
11,5,speak,5,644,1,4,0.48
11,5,speaker,7,645,5,2,0.44
11,5,special,7,646,3,4,0.56
11,5,specialist,10,647,7,3,0.8
11,5,speech,6,648,3,3,0.56
11,5,spin,4,649,2,2,0.4
11,5,spine,5,650,4,1,0.4
11,5,spotlight,9,651,2,7,0.96
11,5,spread,6,652,2,4,0.52
11,5,stable,6,653,1,5,0.64
11,5,stand,5,654,3,2,0.4
11,5,standing,8,655,5,3,0.68
11,5,star,4,656,3,1,0.28
11,5,statistic,9,657,3,6,0.72
11,5,statue,6,658,4,2,0.4
11,5,steadily,8,659,2,6,0.68
11,5,stem,4,660,3,1,0.4
11,5,stop,4,661,2,2,0.32
11,5,story,5,662,3,2,0.36
11,5,street,6,663,2,4,0.52
11,5,strength,8,664,4,4,0.64
11,5,stretch,7,665,4,3,0.6
11,5,string,6,666,3,3,0.44
11,5,strong,6,667,3,3,0.44
11,5,studio,6,668,2,4,0.52
11,5,subject,7,669,1,6,0.76
11,5,substance,9,670,3,6,0.76
11,5,successful,10,671,2,8,0.88
11,5,such,4,672,3,1,0.28
11,5,sue,3,673,2,1,0.32
11,5,sugar,5,674,2,3,0.4
11,5,super,5,675,2,3,0.48
11,5,suppose,7,676,3,4,0.6
11,5,supreme,7,677,3,4,0.68
11,5,sure,4,678,2,2,0.44
11,5,surgical,8,679,3,5,0.64
11,5,suspension,10,680,2,8,0.96
11,5,swear,5,681,1,4,0.48
11,5,sweater,7,682,4,3,0.6
11,5,sweep,5,683,3,2,0.36
11,5,swim,4,684,2,2,0.32
11,5,switch,6,685,3,3,0.44
11,5,symbolic,8,686,1,7,0.88
11,5,table,5,687,0,5,0.52
11,5,tail,4,688,2,2,0.32
11,5,tank,4,689,2,2,0.32
11,5,tap,3,690,2,1,0.24
11,5,tape,4,691,3,1,0.28
11,5,taste,5,692,2,3,0.52
11,5,tea,3,693,1,2,0.28
11,5,television,10,694,2,8,0.88
11,5,temperature,11,695,2,9,0.96
11,5,tendency,8,696,2,6,0.8
11,5,tender,6,697,5,1,0.36
11,5,tension,7,698,3,4,0.56
11,5,terrify,7,699,2,5,0.64
11,5,textbook,8,700,2,6,0.8
11,5,themselves,10,701,1,9,0.96
11,5,therapist,9,702,3,6,0.72
11,5,thesis,6,703,3,3,0.56
11,5,thirsty,7,704,2,5,0.6
11,5,thoughtful,10,705,2,8,0.88
11,5,three,5,706,2,3,0.52
11,5,thrilled,8,707,3,5,0.68
11,5,ticket,6,708,1,5,0.56
11,5,tight,5,709,2,3,0.44
11,5,tighten,7,710,5,2,0.44
11,5,together,8,711,1,7,0.88
11,5,tolerance,9,712,2,7,0.8
11,5,tonight,7,713,2,5,0.6
11,5,too,3,714,2,1,0.24
11,5,tool,4,715,3,1,0.4
11,5,topic,5,716,2,3,0.48
11,5,tour,4,717,2,2,0.36
11,5,tournament,10,718,4,6,0.88
11,5,tragic,6,719,1,5,0.8
11,5,trainer,7,720,3,4,0.56
11,5,translation,11,721,3,8,1.08
11,5,traveller,9,722,3,6,1
11,5,treasure,8,723,2,6,0.68
11,5,treat,5,724,4,1,0.32
11,5,tree,4,725,3,1,0.28
11,5,trend,5,726,3,2,0.44
11,5,tribal,6,727,2,4,0.72
11,5,tribe,5,728,4,1,0.32
11,5,trouble,7,729,2,5,0.6
11,5,truck,5,730,2,3,0.4
11,5,two,3,731,1,2,0.28
11,5,ultimate,8,732,0,8,0.92
11,5,underground,11,733,1,10,1.04
11,5,underlying,10,734,5,5,0.72
11,5,undermine,9,735,5,4,0.76
11,5,unfair,6,736,2,4,0.52
11,5,unify,5,737,2,3,0.4
11,5,union,5,738,3,2,0.36
11,5,unique,6,739,3,3,0.56
11,5,universe,8,740,3,5,0.68
11,5,unnecessary,11,741,2,9,1.04
11,5,uphold,6,742,1,5,0.56
11,5,urgent,6,743,1,5,0.68
11,5,usual,5,744,1,4,0.48
11,5,utility,7,745,1,6,0.68
11,5,vague,5,746,0,5,0.52
11,5,validity,8,747,2,6,0.8
11,5,valuable,8,748,3,5,0.64
11,5,vary,4,749,2,2,0.36
11,5,vein,4,750,1,3,0.4
11,5,verify,6,751,2,4,0.52
11,5,vessel,6,752,2,4,0.64
11,5,veteran,7,753,2,5,0.6
11,5,viable,6,754,1,5,0.56
11,5,video,5,755,2,3,0.44
11,5,viewer,6,756,2,4,0.64
11,5,villager,8,757,2,6,0.72
11,5,virtue,6,758,2,4,0.52
11,5,visual,6,759,2,4,0.52
11,5,vital,5,760,2,3,0.52
11,5,vocal,5,761,1,4,0.48
11,5,voice,5,762,2,3,0.4
11,5,wait,4,763,0,4,0.44
11,5,walk,4,764,2,2,0.32
11,5,warning,7,765,2,5,0.72
11,5,water,5,766,2,3,0.4
11,5,weakness,8,767,1,7,0.76
11,5,welcome,7,768,2,5,0.76
11,5,welfare,7,769,3,4,0.76
11,5,west,4,770,2,2,0.24
11,5,whatever,8,771,1,7,0.4
11,5,whenever,8,772,2,6,0.32
11,5,which,5,773,2,3,0.2
11,5,whose,5,774,2,3,0.24
11,5,width,5,775,1,4,0.2
11,5,willingness,11,776,2,9,0.44
11,5,window,6,777,2,4,0.24
11,5,wine,4,778,3,1,0.2
11,5,wipe,4,779,2,2,0.16
11,5,wisdom,6,780,2,4,0.2
11,5,within,6,781,2,4,0.24
11,5,without,7,782,4,3,0.28
11,5,woman,5,783,1,4,0.2
11,5,word,4,784,2,2,0.16
11,5,work,4,785,3,1,0.12
11,5,workplace,9,786,4,5,0.32
11,5,wrap,4,787,1,3,0.16
11,5,young,5,788,0,5,0.28
11,6,absence,7,0,0,7,0.76
11,6,absurd,6,1,3,3,0.44
11,6,accelerate,10,2,1,9,1.08
11,6,accept,6,3,4,2,0.52
11,6,accident,8,4,3,5,0.8
11,6,accommodate,11,5,3,8,1.12
11,6,accompany,9,6,5,4,0.8
11,6,accordance,10,7,4,6,0.8
11,6,accounting,10,8,4,6,0.96
11,6,acquisition,11,9,2,9,1.12
11,6,actress,7,10,2,5,0.64
11,6,acute,5,11,2,3,0.48
11,6,ad,2,12,1,1,0.2
11,6,add,3,13,2,1,0.36
11,6,additional,10,14,3,7,0.88
11,6,address,7,15,3,4,0.56
11,6,adequately,10,16,2,8,1.04
11,6,adj,3,17,2,1,0.24
11,6,admit,5,18,2,3,0.4
11,6,adoption,8,19,2,6,0.72
11,6,advantage,9,20,2,7,0.92
11,6,adventure,9,21,3,6,0.88
11,6,advice,6,22,3,3,0.48
11,6,aesthetic,9,23,1,8,0.88
11,6,aggression,10,24,1,9,1.08
11,6,agree,5,25,2,3,0.44
11,6,ahead,5,26,1,4,0.48
11,6,aids,4,27,1,3,0.4
11,6,align,5,28,1,4,0.48
11,6,allocation,10,29,2,8,0.88
11,6,ally,4,30,3,1,0.12
11,6,ambassador,10,31,1,9,0.44
11,6,ambulance,9,32,3,6,0.4
11,6,amusing,7,33,2,5,0.28
11,6,analysis,8,34,1,7,0.32
11,6,ancient,7,35,2,5,0.36
11,6,anniversary,11,36,2,9,0.56
11,6,announce,8,37,3,5,0.32
11,6,annoying,8,38,4,4,0.28
11,6,another,7,39,2,5,0.32
11,6,anxiety,7,40,2,5,0.28
11,6,apologize,9,41,1,8,0.4
11,6,apology,7,42,6,1,0.24
11,6,applaud,7,43,2,5,0.28
11,6,arguably,8,44,1,7,0.32
11,6,arms,4,45,2,2,0.16
11,6,arrangement,11,46,2,9,0.48
11,6,artistic,8,47,2,6,0.28
11,6,assessment,10,48,1,9,0.44
11,6,assistant,9,49,3,6,0.4
11,6,assurance,9,50,3,6,0.32
11,6,at,2,51,1,1,0.08
11,6,atrocity,8,52,2,6,0.28
11,6,attachment,10,53,2,8,0.44
11,6,attract,7,54,3,4,0.24
11,6,auto,4,55,1,3,0.16
11,6,average,7,56,1,6,0.28
11,6,backing,7,57,0,7,0.4
11,6,bacteria,8,58,3,5,0.28
11,6,barrel,6,59,2,4,0.2
11,6,base,4,60,2,2,0.12
11,6,bat,3,61,2,1,0.16
11,6,bay,3,62,2,1,0.08
11,6,beast,5,63,1,4,0.2
11,6,bed,3,64,2,1,0.08
11,6,beer,4,65,2,2,0.12
11,6,beg,3,66,2,1,0.08
11,6,behalf,6,67,2,4,0.2
11,6,belief,6,68,2,4,0.28
11,6,bell,4,69,3,1,0.12
11,6,below,5,70,3,2,0.16
11,6,beyond,6,71,2,4,0.24
11,6,bin,3,72,1,2,0.16
11,6,bird,4,73,2,2,0.2
11,6,bite,4,74,2,2,0.12
11,6,blame,5,75,1,4,0.2
11,6,bless,5,76,2,3,0.2
11,6,blind,5,77,2,3,0.16
11,6,blog,4,78,2,2,0.12
11,6,blow,4,79,3,1,0.2
11,6,boat,4,80,1,3,0.16
11,6,boil,4,81,2,2,0.16
11,6,bomb,4,82,2,2,0.12
11,6,boom,4,83,2,2,0.12
11,6,boost,5,84,3,2,0.16
11,6,box,3,85,2,1,0.16
11,6,breach,6,86,1,5,0.24
11,6,breathe,7,87,4,3,0.24
11,6,bright,6,88,2,4,0.2
11,6,buffer,6,89,1,5,0.24
11,6,bug,3,90,2,1,0.16
11,6,build,5,91,2,3,0.16
11,6,bunch,5,92,2,3,0.2
11,6,business,8,93,2,6,0.32
11,6,butter,6,94,2,4,0.28
11,6,cafe,4,95,0,4,0.2
11,6,cake,4,96,2,2,0.16
11,6,can,3,97,2,1,0.12
11,6,candidate,9,98,3,6,0.32
11,6,capable,7,99,2,5,0.32
11,6,card,4,100,2,2,0.12
11,6,career,6,101,3,3,0.2
11,6,carpet,6,102,3,3,0.2
11,6,cemetery,8,103,1,7,0.32
11,6,central,7,104,2,5,0.36
11,6,century,7,105,4,3,0.24
11,6,chair,5,106,1,4,0.24
11,6,charm,5,107,3,2,0.16
11,6,charming,8,108,5,3,0.32
11,6,chart,5,109,4,1,0.12
11,6,charter,7,110,5,2,0.2
11,6,cheat,5,111,2,3,0.2
11,6,check,5,112,3,2,0.16
11,6,chemical,8,113,3,5,0.32
11,6,chicken,7,114,2,5,0.28
11,6,chronic,7,115,2,5,0.24
11,6,chunk,5,116,2,3,0.2
11,6,cite,4,117,1,3,0.24
11,6,citizenship,11,118,3,8,0.4
11,6,clean,5,119,1,4,0.2
11,6,clerk,5,120,3,2,0.16
11,6,closely,7,121,2,5,0.32
11,6,cloud,5,122,3,2,0.16
11,6,club,4,123,2,2,0.16
11,6,cluster,7,124,3,4,0.28
11,6,coach,5,125,1,4,0.2
11,6,coincide,8,126,2,6,0.4
11,6,colony,6,127,2,4,0.2
11,6,colourful,9,128,4,5,0.32
11,6,comfort,7,129,2,5,0.28
11,6,comfortable,11,130,7,4,0.4
11,6,comment,7,131,3,4,0.24
11,6,commodity,9,132,4,5,0.28
11,6,community,9,133,4,5,0.36
11,6,compassion,10,134,3,7,0.36
11,6,compensate,10,135,4,6,0.32
11,6,compete,7,136,5,2,0.28
11,6,completion,10,137,4,6,0.32
11,6,component,9,138,4,5,0.28
11,6,conceive,8,139,2,6,0.4
11,6,conclusion,10,140,4,6,0.32
11,6,conduct,7,141,3,4,0.24
11,6,confer,6,142,3,3,0.2
11,6,connected,9,143,3,6,0.4
11,6,consistency,11,144,3,8,0.4
11,6,constantly,10,145,4,6,0.36
11,6,constraint,10,146,5,5,0.36
11,6,consult,7,147,4,3,0.2
11,6,contempt,8,148,3,5,0.28
11,6,contend,7,149,5,2,0.24
11,6,controversy,11,150,4,7,0.36
11,6,convenient,10,151,3,7,0.36
11,6,convey,6,152,5,1,0.24
11,6,cooker,6,153,2,4,0.24
11,6,coordinate,10,154,3,7,0.36
11,6,correct,7,155,2,5,0.28
11,6,correctly,9,156,7,2,0.32
11,6,cottage,7,157,2,5,0.28
11,6,county,6,158,2,4,0.24
11,6,couple,6,159,3,3,0.2
11,6,course,6,160,3,3,0.28
11,6,court,5,161,4,1,0.12
11,6,craft,5,162,1,4,0.2
11,6,create,6,163,2,4,0.24
11,6,credible,8,164,3,5,0.28
11,6,creep,5,165,3,2,0.24
11,6,crime,5,166,2,3,0.2
11,6,criminal,8,167,4,4,0.24
11,6,crisis,6,168,3,3,0.2
11,6,crowd,5,169,2,3,0.24
11,6,crowded,7,170,5,2,0.2
11,6,cruise,6,171,2,4,0.2
11,6,currency,8,172,1,7,0.36
11,6,damage,6,173,0,6,0.32
11,6,dare,4,174,2,2,0.16
11,6,deal,4,175,1,3,0.16
11,6,death,5,176,3,2,0.16
11,6,december,8,177,2,6,0.32
11,6,declare,7,178,3,4,0.32
11,6,decline,7,179,4,3,0.2
11,6,decrease,8,180,3,5,0.28
11,6,deed,4,181,2,2,0.12
11,6,defender,8,182,2,6,0.36
11,6,delight,7,183,2,5,0.24
11,6,delighted,9,184,7,2,0.24
11,6,deliver,7,185,4,3,0.2
11,6,democratic,10,186,2,8,0.44
11,6,demon,5,187,4,1,0.12
11,6,dentist,7,188,2,5,0.24
11,6,deposit,7,189,2,5,0.28
11,6,depressing,10,190,3,7,0.44
11,6,deputy,6,191,3,3,0.2
11,6,desktop,7,192,2,5,0.24
11,6,destruction,11,193,3,8,0.48
11,6,detect,6,194,2,4,0.2
11,6,detention,9,195,4,5,0.28
11,6,develop,7,196,2,5,0.24
11,6,devil,5,197,3,2,0.24
11,6,dictator,8,198,1,7,0.32
11,6,diminish,8,199,2,6,0.32
11,6,diplomatic,10,200,2,8,0.48
11,6,discount,8,201,2,6,0.32
11,6,discovery,9,202,5,4,0.28
11,6,discuss,7,203,4,3,0.2
11,6,divine,6,204,2,4,0.28
11,6,divorced,8,205,3,5,0.28
11,6,dollar,6,206,1,5,0.24
11,6,domain,6,207,2,4,0.2
11,6,double,6,208,2,4,0.28
11,6,downstairs,10,209,2,8,0.4
11,6,drama,5,210,1,4,0.2
11,6,earth,5,211,0,5,0.24
11,6,edit,4,212,1,3,0.24
11,6,edition,7,213,4,3,0.2
11,6,editor,6,214,4,2,0.16
11,6,effective,9,215,1,8,0.36
11,6,effectively,11,216,9,2,0.32
11,6,effort,6,217,3,3,0.2
11,6,eight,5,218,1,4,0.2
11,6,either,6,219,2,4,0.24
11,6,electrical,10,220,1,9,0.48
11,6,eliminate,9,221,2,7,0.36
11,6,emergence,9,222,1,8,0.36
11,6,emission,8,223,2,6,0.4
11,6,employer,8,224,2,6,0.32
11,6,endless,7,225,1,6,0.32
11,6,enforcement,11,226,2,9,0.52
11,6,engineer,8,227,2,6,0.32
11,6,enjoy,5,228,2,3,0.2
11,6,enormous,8,229,2,6,0.36
11,6,enrich,6,230,2,4,0.32
11,6,enterprise,10,231,2,8,0.4
11,6,entitle,7,232,3,4,0.28
11,6,equality,8,233,1,7,0.56
11,6,essay,5,234,1,4,0.2
11,6,essence,7,235,3,4,0.24
11,6,evening,7,236,1,6,0.32
11,6,evidence,8,237,2,6,0.4
11,6,evoke,5,238,2,3,0.2
11,6,examination,11,239,1,10,0.6
11,6,examine,7,240,6,1,0.2
11,6,excellent,9,241,2,7,0.6
11,6,exception,9,242,4,5,0.36
11,6,exciting,8,243,3,5,0.36
11,6,exclusive,9,244,3,6,0.48
11,6,excuse,6,245,3,3,0.24
11,6,executive,9,246,2,7,0.36
11,6,exercise,8,247,3,5,0.4
11,6,expensive,9,248,2,7,0.48
11,6,experiment,10,249,4,6,0.44
11,6,explain,7,250,3,4,0.36
11,6,explicitly,10,251,4,6,0.48
11,6,explode,7,252,4,3,0.36
11,6,extensive,9,253,2,7,0.52
11,6,extremist,9,254,3,6,0.48
11,6,eye,3,255,1,2,0.12
11,6,failed,6,256,0,6,0.28
11,6,failure,7,257,4,3,0.24
11,6,fair,4,258,3,1,0.16
11,6,fairly,6,259,4,2,0.28
11,6,famous,6,260,2,4,0.28
11,6,fantastic,9,261,2,7,0.36
11,6,fast,4,262,2,2,0.16
11,6,fee,3,263,1,2,0.2
11,6,feeding,7,264,3,4,0.24
11,6,few,3,265,2,1,0.12
11,6,fibre,5,266,1,4,0.2
11,6,fiction,7,267,2,5,0.28
11,6,fifty,5,268,2,3,0.24
11,6,finally,7,269,2,5,0.28
11,6,financial,9,270,4,5,0.32
11,6,fine,4,271,3,1,0.12
11,6,firm,4,272,2,2,0.12
11,6,flag,4,273,1,3,0.24
11,6,flavour,7,274,3,4,0.24
11,6,flexibility,11,275,2,9,0.44
11,6,flexible,8,276,6,2,0.28
11,6,flu,3,277,2,1,0.08
11,6,focus,5,278,1,4,0.2
11,6,food,4,279,2,2,0.16
11,6,force,5,280,2,3,0.16
11,6,foreigner,9,281,3,6,0.4
11,6,formerly,8,282,3,5,0.28
11,6,foster,6,283,2,4,0.2
11,6,foundation,10,284,2,8,0.4
11,6,fourteen,8,285,3,5,0.36
11,6,freedom,7,286,1,6,0.28
11,6,frequent,8,287,3,5,0.28
11,6,friday,6,288,2,4,0.2
11,6,fridge,6,289,4,2,0.24
11,6,friendly,8,290,3,5,0.28
11,6,friendship,10,291,6,4,0.28
11,6,frog,4,292,2,2,0.12
11,6,fulfil,6,293,1,5,0.36
11,6,full,4,294,3,1,0.12
11,6,funding,7,295,2,5,0.28
11,6,fur,3,296,2,1,0.12
11,6,gaming,6,297,0,6,0.28
11,6,genre,5,298,1,4,0.36
11,6,genuinely,9,299,3,6,0.52
11,6,geography,9,300,2,7,0.36
11,6,glimpse,7,301,1,6,0.36
11,6,globe,5,302,2,3,0.16
11,6,go,2,303,1,1,0.08
11,6,god,3,304,2,1,0.08
11,6,gold,4,305,2,2,0.12
11,6,govern,6,306,2,4,0.24
11,6,governor,8,307,6,2,0.28
11,6,graphics,8,308,1,7,0.32
11,6,green,5,309,2,3,0.16
11,6,greet,5,310,4,1,0.12
11,6,grief,5,311,2,3,0.24
11,6,grin,4,312,3,1,0.12
11,6,grind,5,313,4,1,0.12
11,6,ground,6,314,2,4,0.24
11,6,guerrilla,9,315,1,8,0.36
11,6,guidance,8,316,2,6,0.4
11,6,guide,5,317,4,1,0.12
11,6,guy,3,318,2,1,0.08
11,6,gym,3,319,1,2,0.12
11,6,hair,4,320,0,4,0.2
11,6,handful,7,321,2,5,0.32
11,6,handy,5,322,4,1,0.12
11,6,harm,4,323,2,2,0.12
11,6,harsh,5,324,3,2,0.16
11,6,hat,3,325,2,1,0.08
11,6,hate,4,326,3,1,0.12
11,6,hazard,6,327,2,4,0.28
11,6,health,6,328,1,5,0.24
11,6,heart,5,329,3,2,0.16
11,6,heighten,8,330,2,6,0.32
11,6,her,3,331,2,1,0.12
11,6,hers,4,332,3,1,0.16
11,6,highly,6,333,1,5,0.24
11,6,hint,4,334,2,2,0.2
11,6,honesty,7,335,1,6,0.72
11,6,horror,6,336,2,4,0.56
11,6,hotel,5,337,2,3,0.56
11,6,hour,4,338,2,2,0.32
11,6,household,9,339,3,6,0.72
11,6,how,3,340,2,1,0.24
11,6,humour,6,341,1,5,0.64
11,6,hurricane,9,342,2,7,0.96
11,6,hydrogen,8,343,1,7,0.76
11,6,hypothesis,10,344,2,8,0.88
11,6,i,1,345,0,1,0.28
11,6,ice,3,346,1,2,0.28
11,6,icon,4,347,2,2,0.32
11,6,identical,9,348,1,8,0.84
11,6,identity,8,349,6,2,0.48
11,6,ignorance,9,350,1,8,0.96
11,6,ill,3,351,1,2,0.28
11,6,illegal,7,352,3,4,0.56
11,6,imagery,7,353,1,6,0.68
11,6,impatient,9,354,2,7,0.96
11,6,implement,9,355,3,6,0.8
11,6,implication,11,356,4,7,0.88
11,6,important,9,357,3,6,0.92
11,6,include,7,358,1,6,0.68
11,6,inclusion,9,359,5,4,0.64
11,6,incorporate,11,360,3,8,1.08
11,6,independent,11,361,2,9,1
11,6,indicate,8,362,3,5,0.68
11,6,indirect,8,363,4,4,0.72
11,6,individual,10,364,4,6,0.8
11,6,inevitable,10,365,2,8,0.92
11,6,inform,6,366,2,4,0.64
11,6,injure,6,367,2,4,0.56
11,6,insert,6,368,2,4,0.52
11,6,instant,7,369,3,4,0.6
11,6,intelligent,11,370,2,9,1.2
11,6,intended,8,371,4,4,0.6
11,6,intense,7,372,5,2,0.44
11,6,intensify,9,373,6,3,0.68
11,6,invest,6,374,2,4,0.52
11,6,involve,7,375,3,4,0.56
11,6,involved,8,376,7,1,0.44
11,6,issue,5,377,1,4,0.48
11,6,january,7,378,0,7,0.84
11,6,jet,3,379,1,2,0.28
11,6,journalism,10,380,1,9,1
11,6,joy,3,381,2,1,0.24
11,6,just,4,382,1,3,0.48
11,6,kick,4,383,0,4,0.44
11,6,kid,3,384,2,1,0.24
11,6,kidney,6,385,3,3,0.44
11,6,kingdom,7,386,2,5,0.6
11,6,kit,3,387,2,1,0.24
11,6,know,4,388,1,3,0.52
11,6,lack,4,389,0,4,0.44
11,6,lad,3,390,2,1,0.24
11,6,lake,4,391,2,2,0.32
11,6,laser,5,392,2,3,0.44
11,6,laugh,5,393,2,3,0.4
11,6,law,3,394,2,1,0.36
11,6,lawn,4,395,3,1,0.28
11,6,leaf,4,396,1,3,0.36
11,6,leaflet,7,397,4,3,0.48
11,6,left,4,398,2,2,0.32
11,6,legendary,9,399,2,7,0.92
11,6,legislative,11,400,3,8,0.92
11,6,lemon,5,401,2,3,0.44
11,6,lesbian,7,402,2,5,0.6
11,6,lesser,6,403,3,3,0.6
11,6,letter,6,404,2,4,0.52
11,6,licence,7,405,1,6,0.68
11,6,likelihood,10,406,2,8,1
11,6,lion,4,407,2,2,0.32
11,6,literary,8,408,2,6,0.68
11,6,literature,10,409,6,4,0.68
11,6,live,4,410,2,2,0.32
11,6,local,5,411,1,4,0.6
11,6,location,8,412,4,4,0.6
11,6,lonely,6,413,2,4,0.52
11,6,look,4,414,2,2,0.32
11,6,lot,3,415,2,1,0.24
11,6,loudly,6,416,2,4,0.64
11,6,love,4,417,2,2,0.32
11,6,low,3,418,2,1,0.24
11,6,lunch,5,419,1,4,0.48
11,6,mail,4,420,0,4,0.44
11,6,main,4,421,3,1,0.28
11,6,mainland,8,422,4,4,0.72
11,6,mainstream,10,423,4,6,0.76
11,6,mandate,7,424,2,5,0.6
11,6,manipulate,10,425,3,7,0.96
11,6,mark,4,426,2,2,0.32
11,6,married,7,427,3,4,0.6
11,6,mask,4,428,2,2,0.52
11,6,maximum,7,429,2,5,0.84
11,6,meal,4,430,1,3,0.4
11,6,mean,4,431,3,1,0.28
11,6,medication,10,432,2,8,0.88
11,6,memory,6,433,2,4,0.52
11,6,mentor,6,434,2,4,0.64
11,6,merely,6,435,2,4,0.52
11,6,mess,4,436,2,2,0.32
11,6,message,7,437,4,3,0.48
11,6,method,6,438,2,4,0.64
11,6,militia,7,439,1,6,0.68
11,6,mind,4,440,2,2,0.32
11,6,ministry,8,441,3,5,0.64
11,6,mirror,6,442,2,4,0.52
11,6,missing,7,443,2,5,0.72
11,6,mixed,5,444,2,3,0.44
11,6,model,5,445,1,4,0.48
11,6,moment,6,446,2,4,0.52
11,6,month,5,447,2,3,0.52
11,6,monthly,7,448,5,2,0.44
11,6,monument,8,449,3,5,0.68
11,6,mother,6,450,2,4,0.52
11,6,movie,5,451,2,3,0.52
11,6,much,4,452,1,3,0.4
11,6,multiple,8,453,2,6,0.72
11,6,mum,3,454,2,1,0.24
11,6,musician,8,455,2,6,0.68
11,6,my,2,456,1,1,0.2
11,6,myth,4,457,2,2,0.44
11,6,naked,5,458,0,5,0.52
11,6,nation,6,459,2,4,0.52
11,6,nature,6,460,3,3,0.44
11,6,necessary,9,461,1,8,1
11,6,neck,4,462,3,1,0.28
11,6,needle,6,463,2,4,0.52
11,6,negative,8,464,2,6,0.68
11,6,newly,5,465,2,3,0.4
11,6,newspaper,9,466,3,6,0.84
11,6,noise,5,467,1,4,0.48
11,6,noisy,5,468,4,1,0.32
11,6,nomination,10,469,2,8,1
11,6,non,3,470,2,1,0.24
11,6,normal,6,471,2,4,0.52
11,6,northern,8,472,3,5,0.64
11,6,note,4,473,2,2,0.32
11,6,novel,5,474,2,3,0.52
11,6,numerous,8,475,1,7,0.84
11,6,nut,3,476,2,1,0.24
11,6,oblige,6,477,0,6,0.6
11,6,obsess,6,478,2,4,0.52
11,6,obviously,9,479,2,7,0.92
11,6,offend,6,480,1,5,0.56
11,6,offensive,9,481,5,4,0.64
11,6,official,8,482,3,5,0.76
11,6,offspring,9,483,3,6,0.72
11,6,once,4,484,1,3,0.36
11,6,option,6,485,1,5,0.56
11,6,originate,9,486,1,8,0.96
11,6,other,5,487,1,4,0.48
11,6,ought,5,488,1,4,0.48
11,6,outdoor,7,489,2,5,1.24
11,6,outfit,6,490,3,3,0.6
11,6,outing,6,491,3,3,0.44
11,6,overall,7,492,1,6,0.64
11,6,owe,3,493,1,2,0.28
11,6,pace,4,494,0,4,0.44
11,6,pad,3,495,2,1,0.24
11,6,paint,5,496,2,3,0.56
11,6,pants,5,497,2,3,0.44
11,6,participant,11,498,2,9,1
11,6,participate,11,499,9,2,0.72
11,6,partner,7,500,4,3,0.48
11,6,passport,8,501,2,6,0.72
11,6,patience,8,502,2,6,0.72
11,6,patron,6,503,3,3,0.6
11,6,peaceful,8,504,1,7,0.76
11,6,peer,4,505,2,2,0.32
11,6,pepper,6,506,2,4,0.52
11,6,persistent,10,507,2,8,1
11,6,personality,11,508,4,7,0.92
11,6,philosophy,10,509,1,9,0.92
11,6,phone,5,510,2,3,0.52
11,6,piece,5,511,1,4,0.48
11,6,pig,3,512,2,1,0.24
11,6,pipe,4,513,2,2,0.32
11,6,place,5,514,1,4,0.48
11,6,plan,4,515,3,1,0.28
11,6,pleased,7,516,2,5,0.72
11,6,pledge,6,517,3,3,0.44
11,6,police,6,518,1,5,0.56
11,6,political,9,519,4,5,0.72
11,6,pollution,9,520,3,6,0.88
11,6,pond,4,521,2,2,0.32
11,6,population,10,522,2,8,0.88
11,6,position,8,523,2,6,0.84
11,6,possess,7,524,3,4,0.56
11,6,possibility,11,525,4,7,0.92
11,6,poster,6,526,3,3,0.52
11,6,praise,6,527,1,5,0.68
11,6,prayer,6,528,3,3,0.44
11,6,precedent,9,529,2,7,0.8
11,6,prediction,10,530,3,7,0.96
11,6,preliminary,11,531,3,8,0.92
11,6,premier,7,532,3,4,0.56
11,6,prestigious,11,533,3,8,1.08
11,6,previously,10,534,3,7,0.84
11,6,printer,7,535,2,5,0.6
11,6,prior,5,536,3,2,0.36
11,6,priority,8,537,5,3,0.68
11,6,procedure,9,538,2,7,0.8
11,6,produce,7,539,3,4,0.56
11,6,profile,7,540,3,4,0.68
11,6,program,7,541,3,4,0.56
11,6,programming,11,542,7,4,0.64
11,6,progressive,11,543,5,6,0.52
11,6,project,7,544,3,4,0.24
11,6,proof,5,545,3,2,0.2
11,6,propaganda,10,546,3,7,0.4
11,6,proportion,10,547,4,6,0.44
11,6,prosecute,9,548,3,6,0.32
11,6,publicity,9,549,1,8,0.36
11,6,punk,4,550,2,2,0.16
11,6,pure,4,551,2,2,0.2
11,6,push,4,552,2,2,0.16
11,6,quest,5,553,0,5,0.24
11,6,quite,5,554,2,3,0.2
11,6,race,4,555,0,4,0.2
11,6,racial,6,556,3,3,0.28
11,6,racism,6,557,4,2,0.16
11,6,rail,4,558,2,2,0.16
11,6,rational,8,559,2,6,0.28
11,6,react,5,560,1,4,0.2
11,6,realistic,9,561,3,6,0.4
11,6,realm,5,562,4,1,0.12
11,6,rear,4,563,3,1,0.12
11,6,reasoning,9,564,3,6,0.32
11,6,reception,9,565,2,7,0.4
11,6,record,6,566,3,3,0.2
11,6,recording,9,567,6,3,0.24
11,6,recount,7,568,4,3,0.32
11,6,recruit,7,569,3,4,0.24
11,6,referee,7,570,2,5,0.24
11,6,refuse,6,571,3,3,0.2
11,6,regard,6,572,2,4,0.2
11,6,regime,6,573,3,3,0.28
11,6,region,6,574,4,2,0.16
11,6,rejection,9,575,2,7,0.32
11,6,relax,5,576,2,3,0.16
11,6,relaxed,7,577,5,2,0.28
11,6,relevance,9,578,3,6,0.32
11,6,relief,6,579,3,3,0.2
11,6,religious,9,580,4,5,0.36
11,6,remainder,9,581,2,7,0.36
11,6,remark,6,582,4,2,0.2
11,6,removal,7,583,3,4,0.24
11,6,renew,5,584,2,3,0.16
11,6,reportedly,10,585,2,8,0.48
11,6,reporting,9,586,6,3,0.24
11,6,research,8,587,2,6,0.32
11,6,reside,6,588,3,3,0.28
11,6,respective,10,589,3,7,0.36
11,6,rest,4,590,3,1,0.12
11,6,retrieve,8,591,2,6,0.28
11,6,revive,6,592,2,4,0.28
11,6,rifle,5,593,1,4,0.2
11,6,right,5,594,2,3,0.16
11,6,ritual,6,595,2,4,0.24
11,6,rob,3,596,1,2,0.12
11,6,robust,6,597,3,3,0.28
11,6,roll,4,598,2,2,0.12
11,6,romance,7,599,2,5,0.24
11,6,rough,5,600,2,3,0.16
11,6,round,5,601,3,2,0.16
11,6,routine,7,602,3,4,0.32
11,6,rubber,6,603,1,5,0.24
11,6,ruin,4,604,2,2,0.12
11,6,sacred,6,605,0,6,0.28
11,6,sailor,6,606,2,4,0.28
11,6,sale,4,607,2,2,0.16
11,6,satellite,9,608,2,7,0.36
11,6,satisfy,7,609,3,4,0.24
11,6,scared,6,610,1,5,0.32
11,6,scattered,9,611,3,6,0.32
11,6,schedule,8,612,2,6,0.32
11,6,scholar,7,613,3,4,0.24
11,6,school,6,614,4,2,0.28
11,6,second,6,615,1,5,0.24
11,6,secure,6,616,3,3,0.2
11,6,security,8,617,5,3,0.24
11,6,segment,7,618,2,5,0.32
11,6,september,9,619,2,7,0.36
11,6,serious,7,620,2,5,0.24
11,6,seriously,9,621,7,2,0.24
11,6,service,7,622,3,4,0.32
11,6,seven,5,623,2,3,0.2
11,6,sexual,6,624,2,4,0.2
11,6,sexy,4,625,3,1,0.12
11,6,shape,5,626,1,4,0.28
11,6,share,5,627,3,2,0.16
11,6,shoot,5,628,2,3,0.16
11,6,shore,5,629,3,2,0.16
11,6,shortly,7,630,4,3,0.2
11,6,signature,9,631,1,8,0.44
11,6,silver,6,632,2,4,0.2
11,6,simulation,10,633,2,8,0.4
11,6,sin,3,634,2,1,0.08
11,6,ski,3,635,1,2,0.12
11,6,skull,5,636,2,3,0.24
11,6,slam,4,637,1,3,0.16
11,6,slice,5,638,2,3,0.16
11,6,smoking,7,639,1,6,0.28
11,6,soap,4,640,1,3,0.16
11,6,some,4,641,2,2,0.24
11,6,somehow,7,642,4,3,0.28
11,6,someone,7,643,4,3,0.2
11,6,something,9,644,4,5,0.28
11,6,sometimes,9,645,5,4,0.36
11,6,soup,4,646,2,2,0.12
11,6,space,5,647,1,4,0.2
11,6,spare,5,648,3,2,0.16
11,6,speaker,7,649,2,5,0.32
11,6,specify,7,650,3,4,0.24
11,6,speech,6,651,3,3,0.2
11,6,sphere,6,652,2,4,0.24
11,6,spine,5,653,2,3,0.16
11,6,spokesman,9,654,2,7,0.4
11,6,spotlight,9,655,3,6,0.32
11,6,stab,4,656,1,3,0.16
11,6,stable,6,657,4,2,0.16
11,6,staff,5,658,3,2,0.24
11,6,stall,5,659,3,2,0.16
11,6,stamp,5,660,3,2,0.16
11,6,stand,5,661,3,2,0.16
11,6,star,4,662,3,1,0.12
11,6,statue,6,663,3,3,0.28
11,6,steadily,8,664,2,6,0.32
11,6,stem,4,665,3,1,0.12
11,6,stereotype,10,666,3,7,0.36
11,6,stick,5,667,2,3,0.24
11,6,sticky,6,668,5,1,0.16
11,6,stop,4,669,2,2,0.16
11,6,storage,7,670,3,4,0.24
11,6,store,5,671,4,1,0.12
11,6,story,5,672,4,1,0.2
11,6,straight,8,673,2,6,0.28
11,6,strange,7,674,4,3,0.24
11,6,strategic,9,675,4,5,0.32
11,6,street,6,676,3,3,0.28
11,6,strict,6,677,3,3,0.2
11,6,string,6,678,4,2,0.16
11,6,stun,4,679,2,2,0.12
11,6,sue,3,680,1,2,0.12
11,6,sufficient,10,681,2,8,0.44
11,6,super,5,682,2,3,0.2
11,6,supreme,7,683,3,4,0.24
11,6,sure,4,684,2,2,0.12
11,6,surrounding,11,685,3,8,0.48
11,6,survival,8,686,3,5,0.28
11,6,swallow,7,687,1,6,0.28
11,6,swear,5,688,2,3,0.16
11,6,sweep,5,689,3,2,0.24
11,6,swim,4,690,2,2,0.12
11,6,sympathy,8,691,1,7,0.32
11,6,symptom,7,692,4,3,0.2
11,6,synthesis,9,693,2,7,0.44
11,6,table,5,694,0,5,0.24
11,6,tail,4,695,2,2,0.16
11,6,talent,6,696,2,4,0.24
11,6,talk,4,697,3,1,0.12
11,6,tap,3,698,2,1,0.08
11,6,temperature,11,699,1,10,0.52
11,6,tendency,8,700,2,6,0.32
11,6,tension,7,701,3,4,0.24
11,6,terror,6,702,2,4,0.32
11,6,themselves,10,703,1,9,0.4
11,6,thereafter,10,704,3,7,0.36
11,6,thesis,6,705,3,3,0.28
11,6,this,4,706,2,2,0.12
11,6,thrilled,8,707,2,6,0.32
11,6,thumb,5,708,2,3,0.2
11,6,tidy,4,709,1,3,0.16
11,6,tighten,7,710,2,5,0.36
11,6,timing,6,711,2,4,0.2
11,6,tolerance,9,712,1,8,0.36
11,6,tonne,5,713,2,3,0.2
11,6,too,3,714,2,1,0.16
11,6,tool,4,715,3,1,0.12
11,6,topic,5,716,2,3,0.2
11,6,torture,7,717,2,5,0.28
11,6,trademark,9,718,1,8,0.36
11,6,trainer,7,719,3,4,0.32
11,6,transport,9,720,3,6,0.32
11,6,trap,4,721,3,1,0.12
11,6,treasure,8,722,2,6,0.36
11,6,treaty,6,723,4,2,0.16
11,6,tribal,6,724,2,4,0.24
11,6,tribe,5,725,4,1,0.12
11,6,tribute,7,726,4,3,0.2
11,6,trio,4,727,3,1,0.2
11,6,tropical,8,728,2,6,0.32
11,6,trouble,7,729,3,4,0.24
11,6,trousers,8,730,4,4,0.28
11,6,truck,5,731,2,3,0.24
11,6,twice,5,732,1,4,0.2
11,6,two,3,733,2,1,0.08
11,6,ultimate,8,734,0,8,0.36
11,6,unable,6,735,1,5,0.24
11,6,underlying,10,736,2,8,0.48
11,6,undoubtedly,11,737,3,8,0.4
11,6,unify,5,738,2,3,0.16
11,6,universal,9,739,3,6,0.4
11,6,until,5,740,2,3,0.2
11,6,upgrade,7,741,1,6,0.28
11,6,uphold,6,742,2,4,0.24
11,6,urban,5,743,1,4,0.28
11,6,urgent,6,744,2,4,0.2
11,6,usage,5,745,1,4,0.2
11,6,usual,5,746,2,3,0.16
11,6,utilize,7,747,1,6,0.28
11,6,variety,7,748,0,7,0.4
11,6,vegetable,9,749,1,8,0.36
11,6,vein,4,750,2,2,0.12
11,6,venture,7,751,2,5,0.28
11,6,verify,6,752,2,4,0.32
11,6,veteran,7,753,2,5,0.28
11,6,villager,8,754,1,7,0.32
11,6,virtual,7,755,2,5,0.32
11,6,voice,5,756,1,4,0.2
11,6,volunteer,9,757,2,7,0.36
11,6,waiter,6,758,0,6,0.28
11,6,walk,4,759,2,2,0.12
11,6,warning,7,760,2,5,0.36
11,6,warrior,7,761,3,4,0.24
11,6,washing,7,762,2,5,0.28
11,6,weakness,8,763,1,7,0.48
11,6,wealthy,7,764,3,4,0.24
11,6,weave,5,765,3,2,0.16
11,6,weird,5,766,2,3,0.2
11,6,welfare,7,767,2,5,0.28
11,6,west,4,768,2,2,0.2
11,6,whenever,8,769,1,7,0.32
11,6,which,5,770,2,3,0.2
11,6,whose,5,771,2,3,0.16
11,6,willing,7,772,1,6,0.36
11,6,win,3,773,2,1,0.08
11,6,wind,4,774,3,1,0.12
11,6,window,6,775,4,2,0.16
11,6,wine,4,776,3,1,0.12
11,6,wipe,4,777,2,2,0.16
11,6,wisdom,6,778,2,4,0.28
11,6,without,7,779,2,5,0.28
11,6,woman,5,780,1,4,0.24
11,6,work,4,781,2,2,0.12
11,6,workforce,9,782,4,5,0.32
11,6,workplace,9,783,4,5,0.36
11,6,wow,3,784,2,1,0.08
11,6,wrap,4,785,1,3,0.16
11,6,yellow,6,786,0,6,0.28
11,6,young,5,787,1,4,0.28
11,6,youngster,9,788,5,4,0.28
11,7,a,1,0,0,1,0.16
11,7,absorb,6,1,1,5,0.6
11,7,accelerate,10,2,1,9,1.08
11,7,acceptable,10,3,4,6,0.76
11,7,accident,8,4,3,5,0.64
11,7,accommodate,11,5,3,8,1.04
11,7,accomplish,10,6,5,5,0.72
11,7,accounting,10,7,4,6,0.76
11,7,accurate,8,8,3,5,0.76
11,7,acquisition,11,9,2,9,0.96
11,7,actress,7,10,2,5,0.64
11,7,add,3,11,1,2,0.28
11,7,additional,10,12,3,7,0.96
11,7,address,7,13,3,4,0.56
11,7,adequately,10,14,2,8,0.88
11,7,admit,5,15,2,3,0.4
11,7,adopt,5,16,2,3,0.56
11,7,advantage,9,17,2,7,0.8
11,7,adventure,9,18,3,6,0.72
11,7,aesthetic,9,19,1,8,0.96
11,7,aftermath,9,20,1,8,0.84
11,7,afterwards,10,21,5,5,0.72
11,7,aggression,10,22,1,9,1.12
11,7,aggressive,10,23,8,2,0.56
11,7,agree,5,24,2,3,0.4
11,7,ahead,5,25,1,4,0.48
11,7,aids,4,26,1,3,0.48
11,7,alcohol,7,27,1,6,0.64
11,7,align,5,28,2,3,0.4
11,7,allocate,8,29,2,6,0.72
11,7,alongside,9,30,2,7,0.92
11,7,ambassador,10,31,1,9,0.92
11,7,anger,5,32,1,4,0.48
11,7,animal,6,33,2,4,0.52
11,7,anniversary,11,34,2,9,1.12
11,7,another,7,35,2,5,0.6
11,7,anxiety,7,36,2,5,0.6
11,7,anyway,6,37,2,4,0.64
11,7,apologize,9,38,1,8,0.84
11,7,apology,7,39,6,1,0.4
11,7,app,3,40,2,1,0.24
11,7,arguably,8,41,1,7,0.88
11,7,argue,5,42,4,1,0.32
11,7,arise,5,43,2,3,0.4
11,7,arrangement,11,44,2,9,1.04
11,7,arrest,6,45,3,3,0.56
11,7,arrow,5,46,3,2,0.4
11,7,artist,6,47,2,4,0.52
11,7,artistic,8,48,6,2,0.6
11,7,assessment,10,49,1,9,1.16
11,7,associate,9,50,3,6,0.76
11,7,atrocity,8,51,1,7,0.76
11,7,auto,4,52,1,3,0.36
11,7,automatic,9,53,4,5,0.84
11,7,average,7,54,1,6,0.68
11,7,baby,4,55,0,4,0.44
11,7,bacteria,8,56,2,6,0.84
11,7,balance,7,57,2,5,0.64
11,7,banner,6,58,2,4,0.52
11,7,barrel,6,59,2,4,0.52
11,7,bat,3,60,2,1,0.24
11,7,battlefield,11,61,3,8,1.04
11,7,bay,3,62,2,1,0.24
11,7,beat,4,63,1,3,0.36
11,7,beauty,6,64,3,3,0.44
11,7,bed,3,65,2,1,0.24
11,7,behalf,6,66,2,4,0.64
11,7,belief,6,67,2,4,0.52
11,7,bell,4,68,3,1,0.28
11,7,belong,6,69,3,3,0.52
11,7,benchmark,9,70,2,7,1.08
11,7,best,4,71,2,2,0.4
11,7,betray,6,72,2,4,0.64
11,7,bill,4,73,1,3,0.44
11,7,bin,3,74,2,1,0.24
11,7,bird,4,75,2,2,0.4
11,7,birthday,8,76,3,5,0.84
11,7,bite,4,77,2,2,0.32
11,7,blog,4,78,1,3,0.36
11,7,blow,4,79,3,1,0.28
11,7,bomb,4,80,1,3,0.36
11,7,boost,5,81,2,3,0.4
11,7,bound,5,82,2,3,0.6
11,7,boyfriend,9,83,2,7,0.8
11,7,brand,5,84,1,4,0.48
11,7,breakdown,9,85,2,7,0.96
11,7,breathe,7,86,4,3,0.48
11,7,breathing,9,87,6,3,0.56
11,7,broken,6,88,2,4,0.52
11,7,buddy,5,89,1,4,0.6
11,7,build,5,90,2,3,0.44
11,7,business,8,91,2,6,0.68
11,7,businessman,11,92,8,3,0.64
11,7,can,3,93,0,3,0.32
11,7,cancer,6,94,3,3,0.56
11,7,cap,3,95,2,1,0.24
11,7,capable,7,96,3,4,0.56
11,7,capitalist,10,97,3,7,0.84
11,7,card,4,98,2,2,0.48
11,7,careful,7,99,3,4,0.68
11,7,carefully,9,100,7,2,0.64
11,7,cave,4,101,2,2,0.36
11,7,cd,2,102,1,1,0.2
11,7,ceiling,7,103,1,6,0.8
11,7,central,7,104,2,5,0.6
11,7,century,7,105,4,3,0.48
11,7,ceremony,8,106,2,6,0.72
11,7,certain,7,107,3,4,0.68
11,7,certainty,9,108,7,2,0.52
11,7,chapter,7,109,1,6,0.64
11,7,character,9,110,3,6,0.84
11,7,charity,7,111,4,3,0.48
11,7,charming,8,112,4,4,0.6
11,7,charter,7,113,4,3,0.48
11,7,cheat,5,114,2,3,0.52
11,7,childhood,9,115,2,7,0.8
11,7,choir,5,116,2,3,0.4
11,7,choose,6,117,3,3,0.6
11,7,chronic,7,118,2,5,0.72
11,7,circle,6,119,1,5,0.56
11,7,circuit,7,120,4,3,0.52
11,7,cite,4,121,2,2,0.32
11,7,citizenship,11,122,3,8,1.04
11,7,clause,6,123,1,5,0.56
11,7,clearly,7,124,2,5,0.72
11,7,clerk,5,125,3,2,0.44
11,7,cloud,5,126,2,3,0.48
11,7,coffee,6,127,1,5,0.76
11,7,coincide,8,128,2,6,0.76
11,7,collaborate,11,129,2,9,1.08
11,7,collection,10,130,4,6,0.88
11,7,colourful,9,131,3,6,0.72
11,7,comfort,7,132,2,5,0.6
11,7,comfortable,11,133,7,4,0.8
11,7,comment,7,134,3,4,0.6
11,7,commission,10,135,4,6,0.76
11,7,commonly,8,136,4,4,0.68
11,7,community,9,137,4,5,0.68
11,7,company,7,138,3,4,0.56
11,7,comparable,10,139,5,5,0.76
11,7,compassion,10,140,5,5,0.84
11,7,compensate,10,141,4,6,0.8
11,7,component,9,142,4,5,0.68
11,7,conceal,7,143,2,5,0.72
11,7,concept,7,144,5,2,0.44
11,7,conclusion,10,145,4,6,0.76
11,7,confer,6,146,3,3,0.56
11,7,confess,7,147,5,2,0.44
11,7,conscious,9,148,3,6,0.72
11,7,consent,7,149,4,3,0.52
11,7,consistency,11,150,4,7,1
11,7,constantly,10,151,4,6,0.76
11,7,constraint,10,152,5,5,0.72
11,7,consult,7,153,4,3,0.64
11,7,contempt,8,154,3,5,0.64
11,7,convey,6,155,3,3,0.44
11,7,cooker,6,156,2,4,0.52
11,7,correct,7,157,2,5,0.72
11,7,cost,4,158,2,2,0.32
11,7,could,5,159,2,3,0.4
11,7,county,6,160,3,3,0.48
11,7,course,6,161,3,3,0.48
11,7,court,5,162,4,1,0.44
11,7,craft,5,163,1,4,0.48
11,7,create,6,164,2,4,0.52
11,7,creativity,10,165,5,5,0.84
11,7,creature,8,166,5,3,0.72
11,7,credibility,11,167,3,8,0.92
11,7,creep,5,168,3,2,0.44
11,7,criminal,8,169,2,6,0.8
11,7,crisis,6,170,3,3,0.68
11,7,cross,5,171,2,3,0.48
11,7,crowded,7,172,3,4,0.6
11,7,crude,5,173,2,3,0.48
11,7,cruise,6,174,3,3,0.64
11,7,current,7,175,1,6,0.64
11,7,curved,6,176,3,3,0.44
11,7,cycle,5,177,1,4,0.48
11,7,dam,3,178,0,3,0.36
11,7,damage,6,179,3,3,0.6
11,7,day,3,180,2,1,0.24
11,7,deal,4,181,1,3,0.36
11,7,death,5,182,3,2,0.36
11,7,declare,7,183,2,5,0.6
11,7,deem,4,184,2,2,0.32
11,7,default,7,185,2,5,0.72
11,7,defence,7,186,3,4,0.64
11,7,deliver,7,187,2,5,0.68
11,7,dentist,7,188,2,5,0.68
11,7,departure,9,189,2,7,0.92
11,7,depression,10,190,3,7,0.84
11,7,deputy,6,191,3,3,0.4
11,7,destination,11,192,2,9,0.6
11,7,destruction,11,193,4,7,0.4
11,7,detect,6,194,2,4,0.2
11,7,detention,9,195,4,5,0.4
11,7,develop,7,196,2,5,0.28
11,7,diagram,7,197,1,6,0.28
11,7,dictate,7,198,2,5,0.36
11,7,digital,7,199,2,5,0.24
11,7,diminish,8,200,2,6,0.32
11,7,dinner,6,201,2,4,0.2
11,7,diplomat,8,202,2,6,0.4
11,7,diplomatic,10,203,8,2,0.24
11,7,dirt,4,204,2,2,0.12
11,7,dirty,5,205,4,1,0.12
11,7,disabled,8,206,2,6,0.36
11,7,discipline,10,207,3,7,0.36
11,7,discretion,10,208,4,6,0.32
11,7,discussion,10,209,4,6,0.4
11,7,distant,7,210,3,4,0.24
11,7,distort,7,211,4,3,0.2
11,7,double,6,212,1,5,0.24
11,7,downstairs,10,213,2,8,0.48
11,7,drama,5,214,1,4,0.2
11,7,drink,5,215,2,3,0.16
11,7,dust,4,216,1,3,0.16
11,7,edit,4,217,0,4,0.2
11,7,effort,6,218,1,5,0.32
11,7,eleven,6,219,1,5,0.24
11,7,eliminate,9,220,2,7,0.36
11,7,elsewhere,9,221,2,7,0.44
11,7,embark,6,222,1,5,0.24
11,7,empirical,9,223,2,7,0.36
11,7,enemy,5,224,1,4,0.2
11,7,engineer,8,225,2,6,0.4
11,7,enormous,8,226,2,6,0.28
11,7,enter,5,227,2,3,0.16
11,7,enterprise,10,228,5,5,0.32
11,7,enthusiast,10,229,3,7,0.44
11,7,entrance,8,230,3,5,0.4
11,7,environment,11,231,2,9,0.4
11,7,equipment,9,232,1,8,0.44
11,7,essay,5,233,1,4,0.2
11,7,essence,7,234,3,4,0.24
11,7,euro,4,235,1,3,0.16
11,7,evaluation,10,236,1,9,0.48
11,7,evening,7,237,2,5,0.28
11,7,event,5,238,4,1,0.16
11,7,evidence,8,239,2,6,0.4
11,7,exact,5,240,1,4,0.2
11,7,excited,7,241,2,5,0.28
11,7,excuse,6,242,3,3,0.2
11,7,execution,9,243,2,7,0.44
11,7,exercise,8,244,3,5,0.28
11,7,expensive,9,245,2,7,0.36
11,7,experiment,10,246,4,6,0.4
11,7,expertise,9,247,5,4,0.28
11,7,expire,6,248,3,3,0.2
11,7,explain,7,249,3,4,0.24
11,7,explicitly,10,250,4,6,0.44
11,7,exploration,11,251,4,7,0.36
11,7,extensive,9,252,2,7,0.36
11,7,extent,6,253,5,1,0.24
11,7,extremist,9,254,3,6,0.32
11,7,fail,4,255,0,4,0.2
11,7,failure,7,256,4,3,0.2
11,7,fair,4,257,3,1,0.12
11,7,fall,4,258,2,2,0.2
11,7,famous,6,259,2,4,0.24
11,7,fantastic,9,260,2,7,0.36
11,7,fantasy,7,261,6,1,0.2
11,7,fast,4,262,2,2,0.2
11,7,fee,3,263,1,2,0.12
11,7,feeding,7,264,3,4,0.24
11,7,few,3,265,2,1,0.08
11,7,fibre,5,266,1,4,0.2
11,7,fifty,5,267,2,3,0.16
11,7,financial,9,268,2,7,0.4
11,7,fine,4,269,3,1,0.12
11,7,firefighter,11,270,2,9,0.44
11,7,flag,4,271,1,3,0.16
11,7,flat,4,272,3,1,0.2
11,7,flavour,7,273,3,4,0.24
11,7,flee,4,274,2,2,0.12
11,7,flexibility,11,275,3,8,0.4
11,7,flying,6,276,2,4,0.28
11,7,focus,5,277,1,4,0.2
11,7,folding,7,278,2,5,0.24
11,7,folk,4,279,3,1,0.12
11,7,foreign,7,280,2,5,0.36
11,7,foreigner,9,281,7,2,0.24
11,7,formation,9,282,3,6,0.32
11,7,former,6,283,4,2,0.16
11,7,formerly,8,284,6,2,0.28
11,7,formula,7,285,4,3,0.2
11,7,fragment,8,286,1,7,0.32
11,7,freedom,7,287,2,5,0.28
11,7,frequent,8,288,3,5,0.36
11,7,fridge,6,289,2,4,0.24
11,7,friendship,10,290,3,7,0.36
11,7,frighten,8,291,3,5,0.36
11,7,frightened,10,292,8,2,0.24
11,7,frog,4,293,2,2,0.12
11,7,front,5,294,3,2,0.16
11,7,fulfil,6,295,1,5,0.24
11,7,fundamental,11,296,2,9,0.52
11,7,funding,7,297,4,3,0.2
11,7,fur,3,298,2,1,0.08
11,7,game,4,299,0,4,0.2
11,7,garage,6,300,2,4,0.28
11,7,gender,6,301,1,5,0.24
11,7,gene,4,302,3,1,0.12
11,7,general,7,303,4,3,0.2
11,7,generally,9,304,7,2,0.28
11,7,generate,8,305,6,2,0.2
11,7,genre,5,306,3,2,0.16
11,7,genuinely,9,307,3,6,0.32
11,7,giant,5,308,1,4,0.28
11,7,give,4,309,2,2,0.12
11,7,glass,5,310,1,4,0.2
11,7,glimpse,7,311,2,5,0.28
11,7,globe,5,312,2,3,0.16
11,7,go,2,313,1,1,0.08
11,7,golf,4,314,2,2,0.2
11,7,goodbye,7,315,2,5,0.24
11,7,gravity,7,316,1,6,0.28
11,7,green,5,317,2,3,0.2
11,7,greet,5,318,4,1,0.12
11,7,grid,4,319,2,2,0.2
11,7,grief,5,320,3,2,0.16
11,7,guerrilla,9,321,1,8,0.36
11,7,guidance,8,322,2,6,0.28
11,7,guitar,6,323,3,3,0.28
11,7,guy,3,324,2,1,0.12
11,7,gym,3,325,1,2,0.12
11,7,hair,4,326,0,4,0.2
11,7,harbour,7,327,2,5,0.28
11,7,harsh,5,328,3,2,0.24
11,7,hazard,6,329,2,4,0.24
11,7,health,6,330,1,5,0.24
11,7,heart,5,331,3,2,0.16
11,7,heat,4,332,3,1,0.12
11,7,herb,4,333,2,2,0.16
11,7,highlight,9,334,1,8,0.44
11,7,historic,8,335,2,6,0.28
11,7,historical,10,336,8,2,0.24
11,7,holiday,7,337,1,6,0.36
11,7,horrible,8,338,2,6,0.28
11,7,horror,6,339,4,2,0.16
11,7,household,9,340,2,7,0.44
11,7,how,3,341,2,1,0.12
11,7,humanity,8,342,1,7,0.32
11,7,humour,6,343,3,3,0.2
11,7,hunger,6,344,2,4,0.2
11,7,hydrogen,8,345,1,7,0.4
11,7,hypothesis,10,346,2,8,0.4
11,7,icon,4,347,0,4,0.2
11,7,ideal,5,348,1,4,0.2
11,7,identical,9,349,3,6,0.4
11,7,identity,8,350,6,2,0.2
11,7,ill,3,351,1,2,0.12
11,7,illegal,7,352,3,4,0.24
11,7,imagery,7,353,1,6,0.36
11,7,impatient,9,354,2,7,0.36
11,7,important,9,355,3,6,0.32
11,7,improve,7,356,3,4,0.32
11,7,index,5,357,1,4,0.2
11,7,indicate,8,358,3,5,0.28
11,7,indirect,8,359,4,4,0.24
11,7,individual,10,360,4,6,0.4
11,7,inevitable,10,361,2,8,0.4
11,7,initiate,8,362,2,6,0.28
11,7,injury,6,363,2,4,0.32
11,7,insert,6,364,2,4,0.24
11,7,inspect,7,365,3,4,0.24
11,7,instrument,10,366,3,7,0.36
11,7,insurance,9,367,3,6,0.4
11,7,intelligent,11,368,2,9,0.44
11,7,intensify,9,369,4,5,0.32
11,7,interesting,11,370,4,7,0.44
11,7,interior,8,371,5,3,0.24
11,7,involve,7,372,2,5,0.24
11,7,involved,8,373,7,1,0.28
11,7,iron,4,374,1,3,0.16
11,7,island,6,375,1,5,0.24
11,7,isolated,8,376,2,6,0.32
11,7,jet,3,377,0,3,0.16
11,7,job,3,378,1,2,0.2
11,7,journalism,10,379,2,8,0.36
11,7,joy,3,380,2,1,0.08
11,7,jump,4,381,1,3,0.16
11,7,just,4,382,2,2,0.12
11,7,justify,7,383,4,3,0.28
11,7,knife,5,384,0,5,0.24
11,7,know,4,385,2,2,0.12
11,7,lack,4,386,0,4,0.2
11,7,landmark,8,387,2,6,0.32
11,7,laser,5,388,2,3,0.24
11,7,latest,6,389,2,4,0.24
11,7,leaf,4,390,1,3,0.16
11,7,leaflet,7,391,4,3,0.2
11,7,learning,8,392,3,5,0.36
11,7,left,4,393,2,2,0.12
11,7,legendary,9,394,2,7,0.36
11,7,legislative,11,395,3,8,0.4
11,7,legitimate,10,396,4,6,0.44
11,7,lemon,5,397,2,3,0.16
11,7,lens,4,398,2,2,0.12
11,7,lethal,6,399,2,4,0.24
11,7,letter,6,400,3,3,0.28
11,7,licence,7,401,1,6,0.28
11,7,license,7,402,5,2,0.2
11,7,lie,3,403,2,1,0.08
11,7,likelihood,10,404,2,8,0.44
11,7,limited,7,405,2,5,0.24
11,7,link,4,406,2,2,0.16
11,7,literary,8,407,2,6,0.32
11,7,little,6,408,3,3,0.28
11,7,live,4,409,2,2,0.16
11,7,load,4,410,1,3,0.16
11,7,location,8,411,2,6,0.32
11,7,lonely,6,412,2,4,0.24
11,7,long,4,413,3,1,0.2
11,7,look,4,414,2,2,0.12
11,7,lot,3,415,2,1,0.08
11,7,loudly,6,416,2,4,0.24
11,7,machinery,9,417,0,9,0.4
11,7,mail,4,418,2,2,0.2
11,7,mainland,8,419,3,5,0.28
11,7,mainstream,10,420,4,6,0.32
11,7,mandate,7,421,2,5,0.28
11,7,mandatory,9,422,6,3,0.32
11,7,manipulate,10,423,3,7,0.36
11,7,map,3,424,2,1,0.12
11,7,married,7,425,2,5,0.28
11,7,mask,4,426,2,2,0.24
11,7,match,5,427,2,3,0.2
11,7,meal,4,428,1,3,0.16
11,7,melody,6,429,2,4,0.2
11,7,mentor,6,430,2,4,0.24
11,7,merely,6,431,2,4,0.28
11,7,merger,6,432,3,3,0.2
11,7,message,7,433,2,5,0.28
11,7,metre,5,434,2,3,0.16
11,7,militia,7,435,1,6,0.36
11,7,mind,4,436,2,2,0.16
11,7,minister,8,437,3,5,0.28
11,7,mirror,6,438,2,4,0.24
11,7,misleading,10,439,2,8,0.48
11,7,model,5,440,1,4,0.2
11,7,month,5,441,2,3,0.2
11,7,monthly,7,442,5,2,0.2
11,7,mother,6,443,2,4,0.32
11,7,movie,5,444,2,3,0.2
11,7,much,4,445,1,3,0.16
11,7,multiple,8,446,2,6,0.32
11,7,mum,3,447,2,1,0.08
11,7,municipal,9,448,2,7,0.44
11,7,museum,6,449,2,4,0.24
11,7,music,5,450,3,2,0.16
11,7,musician,8,451,5,3,0.24
11,7,must,4,452,3,1,0.12
11,7,narrative,9,453,0,9,0.48
11,7,nature,6,454,2,4,0.24
11,7,negative,8,455,1,7,0.32
11,7,negotiation,11,456,3,8,0.48
11,7,neutral,7,457,2,5,0.24
11,7,new,3,458,2,1,0.08
11,7,noisy,5,459,1,4,0.2
11,7,nomination,10,460,2,8,0.48
11,7,norm,4,461,2,2,0.12
11,7,normal,6,462,4,2,0.16
11,7,north,5,463,3,2,0.16
11,7,northern,8,464,5,3,0.32
11,7,not,3,465,2,1,0.08
11,7,nothing,7,466,3,4,0.24
11,7,notice,6,467,3,3,0.2
11,7,notion,6,468,4,2,0.16
11,7,novel,5,469,2,3,0.16
11,7,nut,3,470,1,2,0.2
11,7,obesity,7,471,0,7,0.32
11,7,october,7,472,1,6,0.28
11,7,off,3,473,1,2,0.12
11,7,offence,7,474,3,4,0.32
11,7,offend,6,475,5,1,0.16
11,7,offspring,9,476,3,6,0.32
11,7,online,6,477,1,5,0.24
11,7,opposed,7,478,1,6,0.36
11,7,organic,7,479,1,6,0.28
11,7,organized,9,480,6,3,0.52
11,7,organizer,9,481,8,1,0.2
11,7,originate,9,482,2,7,0.44
11,7,other,5,483,1,4,0.2
11,7,ought,5,484,1,4,0.2
11,7,outbreak,8,485,2,6,0.32
11,7,outdoor,7,486,3,4,0.32
11,7,outfit,6,487,3,3,0.2
11,7,overall,7,488,1,6,0.28
11,7,oversee,7,489,4,3,0.2
11,7,pace,4,490,0,4,0.28
11,7,pack,4,491,3,1,0.12
11,7,painful,7,492,2,5,0.28
11,7,palace,6,493,2,4,0.2
11,7,parade,6,494,2,4,0.24
11,7,park,4,495,3,1,0.2
11,7,partner,7,496,3,4,0.24
11,7,password,8,497,2,6,0.32
11,7,patent,6,498,2,4,0.2
11,7,patience,8,499,3,5,0.36
11,7,peculiar,8,500,1,7,0.32
11,7,personality,11,501,2,9,0.44
11,7,philosophy,10,502,1,9,0.64
11,7,picture,7,503,1,6,0.68
11,7,pile,4,504,2,2,0.32
11,7,pioneer,7,505,2,5,0.6
11,7,pipe,4,506,2,2,0.48
11,7,plane,5,507,1,4,0.48
11,7,planning,8,508,4,4,0.6
11,7,plant,5,509,4,1,0.32
11,7,play,4,510,3,1,0.28
11,7,pleased,7,511,2,5,0.76
11,7,police,6,512,1,5,0.56
11,7,political,9,513,4,5,0.68
11,7,pollution,9,514,3,6,0.84
11,7,position,8,515,2,6,0.72
11,7,possibility,11,516,3,8,0.92
11,7,poster,6,517,3,3,0.44
11,7,praise,6,518,1,5,0.72
11,7,precedent,9,519,2,7,0.84
11,7,precise,7,520,4,3,0.56
11,7,prediction,10,521,3,7,1.04
11,7,prejudice,9,522,3,6,0.76
11,7,premier,7,523,3,4,0.64
11,7,premise,7,524,5,2,0.52
11,7,presence,8,525,3,5,0.8
11,7,presently,9,526,6,3,0.56
11,7,prestigious,11,527,4,7,0.88
11,7,previously,10,528,3,7,1
11,7,principle,9,529,2,7,0.84
11,7,printing,8,530,4,4,0.6
11,7,prior,5,531,3,2,0.48
11,7,process,7,532,2,5,0.6
11,7,processor,9,533,7,2,0.52
11,7,product,7,534,3,4,0.56
11,7,profile,7,535,3,4,0.68
11,7,project,7,536,3,4,0.56
11,7,prominent,9,537,3,6,0.72
11,7,proof,5,538,3,2,0.36
11,7,propaganda,10,539,3,7,0.96
11,7,properly,8,540,4,4,0.6
11,7,proposal,8,541,4,4,0.6
11,7,propose,7,542,6,1,0.4
11,7,prosecute,9,543,3,6,0.88
11,7,pump,4,544,1,3,0.4
11,7,punk,4,545,2,2,0.32
11,7,pupil,5,546,2,3,0.44
11,7,pursuit,7,547,2,5,0.76
11,7,push,4,548,2,2,0.32
11,7,puzzle,6,549,2,4,0.52
11,7,quality,7,550,0,7,0.72
11,7,quest,5,551,2,3,0.44
11,7,race,4,552,0,4,0.56
11,7,racial,6,553,3,3,0.48
11,7,rail,4,554,2,2,0.32
11,7,railway,7,555,4,3,0.48
11,7,raise,5,556,3,2,0.36
11,7,rally,5,557,2,3,0.56
11,7,rather,6,558,2,4,0.52
11,7,rating,6,559,3,3,0.44
11,7,realistic,9,560,1,8,0.84
11,7,rear,4,561,3,1,0.4
11,7,reasoning,9,562,3,6,0.72
11,7,recommend,9,563,2,7,0.8
11,7,recruit,7,564,3,4,0.56
11,7,recycle,7,565,3,4,0.68
11,7,reduce,6,566,2,4,0.52
11,7,reduction,9,567,5,4,0.64
11,7,referee,7,568,2,5,0.6
11,7,regime,6,569,2,4,0.68
11,7,regional,8,570,4,4,0.6
11,7,regulatory,10,571,3,7,0.88
11,7,rejection,9,572,2,7,0.96
11,7,relevance,9,573,2,7,0.8
11,7,remainder,9,574,2,7,0.8
11,7,remark,6,575,4,2,0.56
11,7,reportedly,10,576,2,8,0.88
11,7,reporting,9,577,6,3,0.56
11,7,republic,8,578,3,5,0.64
11,7,requirement,11,579,2,9,1.12
11,7,reside,6,580,2,4,0.52
11,7,resignation,11,581,4,7,0.88
11,7,resolve,7,582,3,4,0.72
11,7,responsible,11,583,3,8,0.92
11,7,rest,4,584,3,1,0.28
11,7,reveal,6,585,2,4,0.52
11,7,revise,6,586,3,3,0.6
11,7,right,5,587,1,4,0.56
11,7,rip,3,588,2,1,0.4
11,7,rise,4,589,2,2,0.32
11,7,ritual,6,590,2,4,0.56
11,7,rob,3,591,1,2,0.44
11,7,robust,6,592,3,3,0.48
11,7,roll,4,593,2,2,0.36
11,7,romance,7,594,2,5,0.6
11,7,roof,4,595,2,2,0.32
11,7,root,4,596,3,1,0.28
11,7,round,5,597,2,3,0.6
11,7,rub,3,598,1,2,0.36
11,7,ruin,4,599,2,2,0.36
11,7,sacred,6,600,0,6,0.76
11,7,safe,4,601,2,2,0.36
11,7,sailor,6,602,2,4,0.64
11,7,sale,4,603,2,2,0.36
11,7,sample,6,604,2,4,0.52
11,7,sand,4,605,2,2,0.36
11,7,satellite,9,606,2,7,0.84
11,7,satisfy,7,607,3,4,0.72
11,7,scan,4,608,1,3,0.36
11,7,scholar,7,609,2,5,0.6
11,7,score,5,610,2,3,0.44
11,7,secure,6,611,1,5,0.72
11,7,security,8,612,5,3,0.56
11,7,seeker,6,613,2,4,0.52
11,7,seem,4,614,3,1,0.28
11,7,segment,7,615,2,5,0.6
11,7,sensible,8,616,2,6,0.84
11,7,serious,7,617,2,5,0.64
11,7,servant,7,618,3,4,0.68
11,7,setting,7,619,2,5,0.84
11,7,settlement,10,620,4,6,0.8
11,7,sexual,6,621,2,4,0.6
11,7,sexy,4,622,3,1,0.32
11,7,shallow,7,623,1,6,0.92
11,7,share,5,624,3,2,0.4
11,7,shareholder,11,625,5,6,0.84
11,7,sheer,5,626,2,3,0.44
11,7,shiny,5,627,2,3,0.44
11,7,shipping,8,628,3,5,0.8
11,7,shopping,8,629,2,6,0.68
11,7,shortly,7,630,3,4,0.56
11,7,sibling,7,631,1,6,0.84
11,7,signature,9,632,2,7,0.96
11,7,similarly,9,633,2,7,0.96
11,7,sin,3,634,2,1,0.28
11,7,singing,7,635,3,4,0.72
11,7,sink,4,636,3,1,0.28
11,7,sister,6,637,2,4,0.52
11,7,six,3,638,2,1,0.24
11,7,ski,3,639,1,2,0.32
11,7,skull,5,640,2,3,0.44
11,7,slam,4,641,1,3,0.52
11,7,slip,4,642,2,2,0.32
11,7,smile,5,643,1,4,0.48
11,7,soap,4,644,1,3,0.36
11,7,solar,5,645,2,3,0.44
11,7,some,4,646,2,2,0.4
11,7,somehow,7,647,4,3,0.64
11,7,someone,7,648,4,3,0.52
11,7,song,4,649,2,2,0.32
11,7,soup,4,650,2,2,0.32
11,7,south,5,651,3,2,0.4
11,7,sovereignty,11,652,2,9,1.12
11,7,speaker,7,653,1,6,0.68
11,7,special,7,654,3,4,0.56
11,7,specify,7,655,5,2,0.56
11,7,speech,6,656,3,3,0.44
11,7,sphere,6,657,2,4,0.52
11,7,spokesman,9,658,2,7,0.84
11,7,stab,4,659,1,3,0.56
11,7,staff,5,660,3,2,0.36
11,7,stall,5,661,3,2,0.36
11,7,star,4,662,3,1,0.4
11,7,stay,4,663,3,1,0.44
11,7,stereotype,10,664,2,8,1.2
11,7,stop,4,665,2,2,0.32
11,7,storage,7,666,3,4,0.6
11,7,store,5,667,4,1,0.32
11,7,straight,8,668,2,6,0.72
11,7,strange,7,669,4,3,0.64
11,7,strategy,8,670,4,4,0.6
11,7,strength,8,671,3,5,0.64
11,7,stretch,7,672,4,3,0.64
11,7,strike,6,673,3,3,0.48
11,7,strong,6,674,3,3,0.48
11,7,stumble,7,675,2,5,0.6
11,7,such,4,676,1,3,0.4
11,7,sudden,6,677,2,4,0.68
11,7,sugar,5,678,2,3,0.44
11,7,super,5,679,2,3,0.44
11,7,supreme,7,680,3,4,0.68
11,7,sure,4,681,2,2,0.36
11,7,surgical,8,682,3,5,0.84
11,7,surrounding,11,683,3,8,1
11,7,survival,8,684,3,5,0.72
11,7,swear,5,685,1,4,0.72
11,7,sweep,5,686,3,2,0.36
11,7,switch,6,687,2,4,0.52
11,7,symbolic,8,688,1,7,0.76
11,7,sympathy,8,689,3,5,0.8
11,7,synthesis,9,690,2,7,0.8
11,7,table,5,691,0,5,0.52
11,7,tactical,8,692,2,6,0.72
11,7,tail,4,693,2,2,0.48
11,7,tap,3,694,2,1,0.24
11,7,taste,5,695,2,3,0.44
11,7,tea,3,696,1,2,0.28
11,7,television,10,697,2,8,0.92
11,7,temperature,11,698,2,9,1.12
11,7,tendency,8,699,2,6,0.76
11,7,tension,7,700,3,4,0.68
11,7,terrify,7,701,2,5,0.84
11,7,texture,7,702,2,5,0.6
11,7,themselves,10,703,1,9,0.96
11,7,thereby,7,704,3,4,0.56
11,7,thorough,8,705,2,6,0.84
11,7,thoughtful,10,706,3,7,0.88
11,7,tidy,4,707,1,3,0.24
11,7,tight,5,708,2,3,0.24
11,7,timing,6,709,2,4,0.32
11,7,together,8,710,1,7,0.36
11,7,tolerance,9,711,2,7,0.36
11,7,tonight,7,712,2,5,0.36
11,7,tonne,5,713,3,2,0.16
11,7,tool,4,714,2,2,0.16
11,7,topic,5,715,2,3,0.2
11,7,torture,7,716,2,5,0.28
11,7,tour,4,717,2,2,0.2
11,7,trademark,9,718,1,8,0.36
11,7,tragic,6,719,3,3,0.2
11,7,translation,11,720,3,8,0.4
11,7,trap,4,721,3,1,0.2
11,7,traveller,9,722,3,6,0.32
11,7,treasure,8,723,2,6,0.32
11,7,treat,5,724,4,1,0.12
11,7,treaty,6,725,5,1,0.24
11,7,tribal,6,726,2,4,0.24
11,7,tribute,7,727,4,3,0.2
11,7,trio,4,728,3,1,0.12
11,7,trouble,7,729,2,5,0.32
11,7,trousers,8,730,4,4,0.24
11,7,truck,5,731,2,3,0.16
11,7,tune,4,732,1,3,0.16
11,7,twice,5,733,1,4,0.2
11,7,ultimate,8,734,0,8,0.44
11,7,undergo,7,735,1,6,0.28
11,7,underlying,10,736,5,5,0.32
11,7,undermine,9,737,5,4,0.36
11,7,underwear,9,738,5,4,0.28
11,7,unfair,6,739,2,4,0.24
11,7,union,5,740,2,3,0.16
11,7,unique,6,741,3,3,0.28
11,7,universal,9,742,3,6,0.32
11,7,unnecessary,11,743,2,9,0.4
11,7,unusual,7,744,2,5,0.24
11,7,upgrade,7,745,1,6,0.36
11,7,uphold,6,746,2,4,0.24
11,7,upon,4,747,2,2,0.12
11,7,usual,5,748,1,4,0.2
11,7,utility,7,749,1,6,0.36
11,7,validity,8,750,0,8,0.36
11,7,valley,6,751,3,3,0.2
11,7,valuable,8,752,3,5,0.28
11,7,venture,7,753,1,6,0.4
11,7,vessel,6,754,2,4,0.24
11,7,viewer,6,755,1,5,0.24
11,7,villager,8,756,2,6,0.32
11,7,virtual,7,757,2,5,0.36
11,7,virtue,6,758,5,1,0.16
11,7,visitor,7,759,2,5,0.28
11,7,volunteer,9,760,1,8,0.44
11,7,walk,4,761,0,4,0.2
11,7,war,3,762,2,1,0.08
11,7,water,5,763,2,3,0.2
11,7,wealthy,7,764,1,6,0.28
11,7,weapon,6,765,3,3,0.2
11,7,weave,5,766,3,2,0.28
11,7,weird,5,767,2,3,0.2
11,7,welcome,7,768,2,5,0.28
11,7,welfare,7,769,3,4,0.28
11,7,whatever,8,770,1,7,0.4
11,7,whenever,8,771,2,6,0.32
11,7,whereas,7,772,3,4,0.24
11,7,which,5,773,2,3,0.2
11,7,whose,5,774,2,3,0.28
11,7,width,5,775,1,4,0.2
11,7,wildlife,8,776,2,6,0.32
11,7,wind,4,777,2,2,0.16
11,7,window,6,778,4,2,0.16
11,7,wipe,4,779,2,2,0.24
11,7,within,6,780,2,4,0.2
11,7,woman,5,781,1,4,0.2
11,7,wonderful,9,782,2,7,0.36
11,7,work,4,783,2,2,0.24
11,7,workforce,9,784,4,5,0.32
11,7,workplace,9,785,4,5,0.32
11,7,wrap,4,786,1,3,0.2
11,7,written,7,787,2,5,0.4
11,7,young,5,788,0,5,0.28
11,8,a,1,0,0,1,0.08
11,8,absence,7,1,1,6,0.28
11,8,absolutely,10,2,3,7,0.44
11,8,absorb,6,3,4,2,0.16
11,8,academic,8,4,1,7,0.32
11,8,accelerate,10,5,2,8,0.4
11,8,accept,6,6,4,2,0.28
11,8,acceptable,10,7,6,4,0.28
11,8,accommodate,11,8,3,8,0.4
11,8,accompany,9,9,5,4,0.36
11,8,accordance,10,10,4,6,0.32
11,8,accurate,8,11,3,5,0.28
11,8,acid,4,12,2,2,0.16
11,8,ad,2,13,1,1,0.16
11,8,adaptation,10,14,2,8,0.4
11,8,adj,3,15,2,1,0.08
11,8,adoption,8,16,2,6,0.28
11,8,advantage,9,17,2,7,0.44
11,8,adventure,9,18,3,6,0.32
11,8,aftermath,9,19,1,8,0.36
11,8,afterwards,10,20,5,5,0.4
11,8,again,5,21,1,4,0.2
11,8,aggressive,10,22,2,8,0.4
11,8,aids,4,23,1,3,0.16
11,8,align,5,24,1,4,0.28
11,8,allocate,8,25,2,6,0.32
11,8,alongside,9,26,2,7,0.36
11,8,amateur,7,27,1,6,0.28
11,8,amendment,9,28,2,7,0.44
11,8,analyse,7,29,1,6,0.28
11,8,and,3,30,2,1,0.08
11,8,anger,5,31,2,3,0.2
11,8,anybody,7,32,2,5,0.36
11,8,apparently,10,33,1,9,0.4
11,8,applaud,7,34,3,4,0.24
11,8,appreciate,10,35,3,7,0.48
11,8,approve,7,36,4,3,0.2
11,8,arguably,8,37,1,7,0.32
11,8,argue,5,38,4,1,0.12
11,8,arise,5,39,2,3,0.28
11,8,around,6,40,2,4,0.2
11,8,artist,6,41,2,4,0.24
11,8,assessment,10,42,1,9,0.4
11,8,assistant,9,43,3,6,0.4
11,8,associate,9,44,3,6,0.32
11,8,assurance,9,45,3,6,0.32
11,8,atrocity,8,46,1,7,0.4
11,8,auction,7,47,1,6,0.28
11,8,automatic,9,48,2,7,0.44
11,8,baby,4,49,0,4,0.52
11,8,backing,7,50,2,5,0.76
11,8,balance,7,51,2,5,0.6
11,8,ballet,6,52,3,3,0.48
11,8,banner,6,53,2,4,0.52
11,8,bay,3,54,2,1,0.36
11,8,beast,5,55,1,4,0.48
11,8,behalf,6,56,2,4,0.52
11,8,belief,6,57,2,4,0.52
11,8,below,5,58,3,2,0.4
11,8,betray,6,59,2,4,0.72
11,8,between,7,60,3,4,0.56
11,8,beyond,6,61,2,4,0.6
11,8,bird,4,62,1,3,0.4
11,8,birthday,8,63,3,5,0.88
11,8,biscuit,7,64,2,5,0.64
11,8,bishop,6,65,3,3,0.48
11,8,bite,4,66,2,2,0.36
11,8,bitter,6,67,3,3,0.48
11,8,bless,5,68,1,4,0.64
11,8,blind,5,69,2,3,0.44
11,8,blog,4,70,2,2,0.32
11,8,blow,4,71,3,1,0.28
11,8,boat,4,72,1,3,0.36
11,8,boil,4,73,2,2,0.32
11,8,boom,4,74,2,2,0.44
11,8,boost,5,75,3,2,0.36
11,8,boot,4,76,3,1,0.28
11,8,bother,6,77,2,4,0.52
11,8,bottle,6,78,3,3,0.48
11,8,bound,5,79,2,3,0.6
11,8,box,3,80,2,1,0.24
11,8,brand,5,81,1,4,0.48
11,8,breach,6,82,2,4,0.52
11,8,breakdown,9,83,4,5,0.76
11,8,breathe,7,84,4,3,0.68
11,8,buddy,5,85,1,4,0.52
11,8,bunch,5,86,2,3,0.52
11,8,burn,4,87,2,2,0.48
11,8,cafe,4,88,0,4,0.48
11,8,cancer,6,89,2,4,0.68
11,8,card,4,90,2,2,0.4
11,8,career,6,91,3,3,0.52
11,8,careful,7,92,4,3,0.52
11,8,carefully,9,93,7,2,0.68
11,8,carpet,6,94,3,3,0.8
11,8,category,8,95,2,6,0.72
11,8,cave,4,96,2,2,0.32
11,8,cease,5,97,1,4,0.48
11,8,cemetery,8,98,2,6,0.84
11,8,central,7,99,2,5,0.6
11,8,certain,7,100,2,5,0.6
11,8,character,9,101,1,8,1.04
11,8,charter,7,102,4,3,0.48
11,8,cheerful,8,103,2,6,0.68
11,8,chemical,8,104,3,5,0.64
11,8,chicken,7,105,2,5,0.76
11,8,childhood,9,106,3,6,0.72
11,8,choose,6,107,2,4,0.52
11,8,chop,4,108,3,1,0.28
11,8,chronic,7,109,2,5,0.76
11,8,circle,6,110,1,5,0.56
11,8,circuit,7,111,4,3,0.56
11,8,city,4,112,2,2,0.32
11,8,civil,5,113,2,3,0.44
11,8,clarity,7,114,1,6,0.84
11,8,clause,6,115,3,3,0.44
11,8,clean,5,116,2,3,0.44
11,8,clerk,5,117,3,2,0.4
11,8,closely,7,118,2,5,0.72
11,8,club,4,119,2,2,0.32
11,8,coincide,8,120,1,7,0.84
11,8,collective,10,121,2,8,0.96
11,8,colony,6,122,3,3,0.6
11,8,colourful,9,123,4,5,0.68
11,8,comfort,7,124,2,5,0.6
11,8,comfortable,11,125,7,4,0.72
11,8,comment,7,126,3,4,0.68
11,8,commission,10,127,4,6,0.8
11,8,commodity,9,128,4,5,0.68
11,8,community,9,129,4,5,0.8
11,8,compensate,10,130,3,7,0.84
11,8,compete,7,131,5,2,0.44
11,8,completion,10,132,4,6,0.92
11,8,component,9,133,4,5,0.68
11,8,conceal,7,134,2,5,0.6
11,8,conceive,8,135,5,3,0.68
11,8,concept,7,136,5,2,0.44
11,8,concern,7,137,5,2,0.44
11,8,conduct,7,138,3,4,0.56
11,8,conference,10,139,3,7,0.96
11,8,confess,7,140,5,2,0.44
11,8,confidence,10,141,4,6,0.76
11,8,confused,8,142,4,4,0.6
11,8,consent,7,143,3,4,0.68
11,8,consistency,11,144,4,7,0.96
11,8,constraint,10,145,4,6,0.88
11,8,consult,7,146,4,3,0.64
11,8,controversy,11,147,3,8,0.92
11,8,coordinate,10,148,2,8,0.92
11,8,cope,4,149,2,2,0.48
11,8,cost,4,150,2,2,0.32
11,8,could,5,151,2,3,0.44
11,8,counterpart,11,152,3,8,1.12
11,8,coup,4,153,3,1,0.28
11,8,court,5,154,3,2,0.52
11,8,coverage,8,155,2,6,0.72
11,8,craft,5,156,1,4,0.48
11,8,create,6,157,2,4,0.52
11,8,creature,8,158,5,3,0.68
11,8,credibility,11,159,3,8,0.92
11,8,credible,8,160,6,2,0.48
11,8,creep,5,161,3,2,0.36
11,8,crime,5,162,2,3,0.56
11,8,cross,5,163,2,3,0.4
11,8,crowd,5,164,3,2,0.36
11,8,crowded,7,165,5,2,0.44
11,8,crucial,7,166,2,5,0.76
11,8,crude,5,167,3,2,0.4
11,8,cruel,5,168,3,2,0.36
11,8,cruise,6,169,3,3,0.52
11,8,cultivate,9,170,1,8,0.96
11,8,current,7,171,2,5,0.8
11,8,cycle,5,172,1,4,0.52
11,8,dam,3,173,0,3,0.36
11,8,damage,6,174,3,3,0.52
11,8,dance,5,175,2,3,0.44
11,8,dare,4,176,2,2,0.48
11,8,day,3,177,2,1,0.24
11,8,deal,4,178,1,3,0.4
11,8,december,8,179,2,6,0.8
11,8,declare,7,180,3,4,0.88
11,8,decoration,10,181,3,7,1.12
11,8,deed,4,182,2,2,0.32
11,8,defect,6,183,2,4,0.56
11,8,definite,8,184,3,5,0.64
11,8,definitely,10,185,8,2,0.72
11,8,delight,7,186,2,5,0.6
11,8,deliver,7,187,4,3,0.48
11,8,democratic,10,188,2,8,1.04
11,8,depression,10,189,2,8,0.92
11,8,deputy,6,190,3,3,0.48
11,8,detention,9,191,2,7,0.96
11,8,develop,7,192,2,5,0.76
11,8,devil,5,193,3,2,0.44
11,8,diagnosis,9,194,1,8,1
11,8,dictate,7,195,2,5,0.84
11,8,disclosure,10,196,2,8,0.92
11,8,discuss,7,197,4,3,0.52
11,8,discussion,10,198,7,3,0.76
11,8,display,7,199,3,4,0.6
11,8,distant,7,200,3,4,0.56
11,8,distort,7,201,4,3,0.48
11,8,distribute,10,202,4,6,0.92
11,8,divine,6,203,2,4,0.52
11,8,divorced,8,204,3,5,0.64
11,8,double,6,205,1,5,0.64
11,8,downstairs,10,206,2,8,1.08
11,8,drawing,7,207,1,6,0.68
11,8,duration,8,208,1,7,0.76
11,8,dust,4,209,2,2,0.32
11,8,earnings,8,210,0,8,0.96
11,8,edit,4,211,1,3,0.36
11,8,effectively,11,212,1,10,1.04
11,8,effort,6,213,3,3,0.6
11,8,eighty,6,214,1,5,0.56
11,8,elect,5,215,1,4,0.48
11,8,elsewhere,9,216,2,7,0.8
11,8,embark,6,217,1,5,0.72
11,8,empirical,9,218,2,7,0.84
11,8,employer,8,219,3,5,0.68
11,8,ending,6,220,1,5,0.56
11,8,enforcement,11,221,2,9,1.12
11,8,engineer,8,222,2,6,0.72
11,8,engineering,11,223,8,3,0.88
11,8,enormous,8,224,2,6,0.76
11,8,enthusiast,10,225,2,8,0.96
11,8,entitle,7,226,3,4,0.64
11,8,entrance,8,227,3,5,0.92
11,8,environment,11,228,2,9,1.04
11,8,equipment,9,229,1,8,0.88
11,8,essay,5,230,1,4,0.96
11,8,essence,7,231,3,4,0.56
11,8,evidence,8,232,1,7,0.76
11,8,exact,5,233,1,4,0.48
11,8,exceed,6,234,2,4,0.68
11,8,excellent,9,235,4,5,0.68
11,8,exciting,8,236,3,5,0.64
11,8,exclusive,9,237,3,6,0.92
11,8,exclusively,11,238,9,2,0.64
11,8,excuse,6,239,3,3,0.48
11,8,executive,9,240,2,7,0.8
11,8,expensive,9,241,2,7,0.96
11,8,experiment,10,242,4,6,0.8
11,8,explain,7,243,3,4,0.32
11,8,explicitly,10,244,4,6,0.44
11,8,exploit,7,245,4,3,0.24
11,8,extend,6,246,2,4,0.24
11,8,extensive,9,247,5,4,0.28
11,8,extremist,9,248,3,6,0.48
11,8,eye,3,249,1,2,0.16
11,8,faculty,7,250,0,7,0.36
11,8,failed,6,251,2,4,0.24
11,8,failure,7,252,4,3,0.32
11,8,famous,6,253,2,4,0.2
11,8,fantastic,9,254,2,7,0.36
11,8,fashionable,11,255,2,9,0.52
11,8,fasten,6,256,3,3,0.2
11,8,fat,3,257,2,1,0.08
11,8,fibre,5,258,1,4,0.2
11,8,fiction,7,259,2,5,0.28
11,8,fifty,5,260,2,3,0.28
11,8,file,4,261,2,2,0.12
11,8,firm,4,262,2,2,0.16
11,8,fixed,5,263,2,3,0.16
11,8,flat,4,264,1,3,0.16
11,8,flee,4,265,2,2,0.12
11,8,flourish,8,266,2,6,0.4
11,8,flu,3,267,2,1,0.08
11,8,folk,4,268,1,3,0.16
11,8,force,5,269,2,3,0.16
11,8,foreign,7,270,3,4,0.24
11,8,former,6,271,3,3,0.28
11,8,formula,7,272,4,3,0.2
11,8,forthcoming,11,273,3,8,0.4
11,8,fortune,7,274,4,3,0.32
11,8,forward,7,275,3,4,0.24
11,8,foster,6,276,2,4,0.2
11,8,founder,7,277,2,5,0.28
11,8,fourteen,8,278,3,5,0.36
11,8,frequent,8,279,1,7,0.32
11,8,friendly,8,280,2,6,0.32
11,8,front,5,281,2,3,0.2
11,8,fulfil,6,282,1,5,0.36
11,8,full,4,283,3,1,0.12
11,8,fundamental,11,284,2,9,0.44
11,8,funding,7,285,4,3,0.24
11,8,gallery,7,286,0,7,0.44
11,8,gene,4,287,1,3,0.16
11,8,generally,9,288,4,5,0.32
11,8,genuinely,9,289,3,6,0.4
11,8,giant,5,290,1,4,0.2
11,8,glass,5,291,1,4,0.2
11,8,glimpse,7,292,2,5,0.24
11,8,good,4,293,1,3,0.16
11,8,grace,5,294,1,4,0.28
11,8,grandfather,11,295,3,8,0.4
11,8,gravity,7,296,3,4,0.24
11,8,green,5,297,2,3,0.2
11,8,grey,4,298,3,1,0.24
11,8,grid,4,299,2,2,0.12
11,8,grief,5,300,3,2,0.16
11,8,grind,5,301,3,2,0.16
11,8,guerrilla,9,302,1,8,0.36
11,8,guidance,8,303,2,6,0.4
11,8,guitar,6,304,3,3,0.2
11,8,happen,6,305,0,6,0.28
11,8,harm,4,306,2,2,0.12
11,8,harsh,5,307,3,2,0.16
11,8,headline,8,308,1,7,0.4
11,8,heat,4,309,3,1,0.12
11,8,heighten,8,310,2,6,0.28
11,8,hers,4,311,2,2,0.16
11,8,highlight,9,312,1,8,0.48
11,8,highly,6,313,5,1,0.16
11,8,holiday,7,314,1,6,0.28
11,8,homeland,8,315,2,6,0.28
11,8,horror,6,316,2,4,0.32
11,8,hotel,5,317,2,3,0.2
11,8,household,9,318,2,7,0.36
11,8,humanity,8,319,1,7,0.44
11,8,humble,6,320,3,3,0.2
11,8,hunger,6,321,2,4,0.24
11,8,hunt,4,322,3,1,0.12
11,8,hurricane,9,323,2,7,0.36
11,8,hydrogen,8,324,1,7,0.4
11,8,hypothesis,10,325,2,8,0.4
11,8,i,1,326,0,1,0.08
11,8,icon,4,327,1,3,0.16
11,8,identical,9,328,1,8,0.48
11,8,identity,8,329,6,2,0.2
11,8,ignorance,9,330,1,8,0.36
11,8,ill,3,331,1,2,0.12
11,8,image,5,332,1,4,0.32
11,8,impatient,9,333,2,7,0.36
11,8,important,9,334,3,6,0.32
11,8,incorporate,11,335,1,10,0.56
11,8,incur,5,336,3,2,0.16
11,8,independent,11,337,2,9,0.44
11,8,indirect,8,338,3,5,0.4
11,8,individual,10,339,4,6,0.32
11,8,inevitable,10,340,2,8,0.36
11,8,influence,9,341,2,7,0.44
11,8,influential,11,342,7,4,0.32
11,8,inform,6,343,3,3,0.2
11,8,inherent,8,344,2,6,0.28
11,8,initiate,8,345,2,6,0.4
11,8,inject,6,346,2,4,0.24
11,8,injure,6,347,3,3,0.2
11,8,injury,6,348,5,1,0.16
11,8,insertion,9,349,2,7,0.44
11,8,inspect,7,350,3,4,0.24
11,8,inspection,10,351,7,3,0.28
11,8,instruct,8,352,3,5,0.36
11,8,instrument,10,353,6,4,0.28
11,8,intake,6,354,2,4,0.24
11,8,integral,8,355,3,5,0.28
11,8,intelligent,11,356,4,7,0.48
11,8,intense,7,357,4,3,0.2
11,8,intensify,9,358,6,3,0.24
11,8,interior,8,359,4,4,0.36
11,8,involved,8,360,2,6,0.28
11,8,iron,4,361,1,3,0.16
11,8,island,6,362,1,5,0.24
11,8,isolated,8,363,2,6,0.4
11,8,issue,5,364,2,3,0.16
11,8,jet,3,365,0,3,0.16
11,8,jewellery,9,366,2,7,0.4
11,8,job,3,367,1,2,0.12
11,8,journalism,10,368,2,8,0.48
11,8,judicial,8,369,1,7,0.32
11,8,jump,4,370,2,2,0.12
11,8,june,4,371,2,2,0.12
11,8,justify,7,372,2,5,0.36
11,8,key,3,373,0,3,0.16
11,8,keyboard,8,374,3,5,0.28
11,8,kick,4,375,1,3,0.16
11,8,kidney,6,376,2,4,0.32
11,8,king,4,377,2,2,0.16
11,8,kingdom,7,378,4,3,0.2
11,8,knife,5,379,1,4,0.2
11,8,landscape,9,380,0,9,0.4
11,8,lap,3,381,2,1,0.2
11,8,laser,5,382,2,3,0.2
11,8,laugh,5,383,2,3,0.16
11,8,lawn,4,384,2,2,0.16
11,8,layer,5,385,2,3,0.16
11,8,leaf,4,386,1,3,0.16
11,8,leaflet,7,387,4,3,0.32
11,8,league,6,388,3,3,0.2
11,8,learning,8,389,3,5,0.28
11,8,legislative,11,390,2,9,0.52
11,8,legitimate,10,391,4,6,0.48
11,8,lemon,5,392,2,3,0.2
11,8,lens,4,393,2,2,0.16
11,8,lesbian,7,394,2,5,0.4
11,8,lesser,6,395,3,3,0.2
11,8,lethal,6,396,2,4,0.28
11,8,letter,6,397,3,3,0.32
11,8,lie,3,398,1,2,0.16
11,8,lifestyle,9,399,2,7,0.56
11,8,likelihood,10,400,2,8,0.48
11,8,limited,7,401,2,5,0.28
11,8,link,4,402,2,2,0.16
11,8,little,6,403,2,4,0.36
11,8,location,8,404,1,7,0.36
11,8,log,3,405,2,1,0.12
11,8,lonely,6,406,2,4,0.24
11,8,long,4,407,3,1,0.32
11,8,loose,5,408,2,3,0.2
11,8,loudly,6,409,2,4,0.24
11,8,love,4,410,2,2,0.28
11,8,machinery,9,411,0,9,0.64
11,8,mail,4,412,2,2,0.32
11,8,main,4,413,3,1,0.24
11,8,mainland,8,414,4,4,0.48
11,8,mandate,7,415,2,5,0.56
11,8,manipulate,10,416,3,7,0.84
11,8,manuscript,10,417,3,7,0.48
11,8,map,3,418,2,1,0.12
11,8,mark,4,419,2,2,0.16
11,8,master,6,420,2,4,0.32
11,8,match,5,421,2,3,0.44
11,8,maximum,7,422,2,5,0.4
11,8,meal,4,423,1,3,0.28
11,8,meaningful,10,424,3,7,0.44
11,8,meanwhile,9,425,4,5,0.6
11,8,mechanical,10,426,2,8,1.08
11,8,meeting,7,427,2,5,0.72
11,8,mental,6,428,2,4,0.72
11,8,mention,7,429,4,3,0.52
11,8,method,6,430,2,4,0.6
11,8,midnight,8,431,1,7,1.12
11,8,militia,7,432,2,5,1.12
11,8,minister,8,433,2,6,1
11,8,modify,6,434,1,5,0.64
11,8,moment,6,435,2,4,0.76
11,8,money,5,436,2,3,0.6
11,8,monthly,7,437,3,4,0.56
11,8,monument,8,438,3,5,0.68
11,8,mother,6,439,2,4,0.6
11,8,mouth,5,440,2,3,0.64
11,8,movie,5,441,2,3,0.44
11,8,multiple,8,442,1,7,0.92
11,8,mum,3,443,2,1,0.24
11,8,music,5,444,2,3,0.52
11,8,musician,8,445,5,3,0.8
11,8,must,4,446,3,1,0.28
11,8,my,2,447,1,1,0.24
11,8,myth,4,448,2,2,0.36
11,8,name,4,449,0,4,0.44
11,8,narrative,9,450,2,7,1
11,8,nation,6,451,2,4,0.56
11,8,necessarily,11,452,1,10,1.16
11,8,necessary,9,453,8,1,0.52
11,8,negotiation,11,454,2,9,1.16
11,8,neutral,7,455,2,5,0.64
11,8,newly,5,456,2,3,0.44
11,8,night,5,457,1,4,0.64
11,8,noise,5,458,1,4,0.48
11,8,nominate,8,459,2,6,0.72
11,8,nomination,10,460,7,3,0.6
11,8,norm,4,461,2,2,0.48
11,8,normal,6,462,4,2,0.4
11,8,northern,8,463,3,5,0.64
11,8,not,3,464,2,1,0.24
11,8,note,4,465,3,1,0.28
11,8,notion,6,466,3,3,0.6
11,8,numerous,8,467,1,7,0.8
11,8,nut,3,468,2,1,0.24
11,8,obesity,7,469,0,7,3.24
11,8,oblige,6,470,2,4,1.48
11,8,october,7,471,1,6,2.36
11,8,offence,7,472,1,6,1.76
11,8,offend,6,473,5,1,0.72
11,8,offensive,9,474,5,4,1.44
11,8,offspring,9,475,3,6,1.68
11,8,once,4,476,1,3,0.44
11,8,online,6,477,2,4,0.56
11,8,opponent,8,478,1,7,0.8
11,8,optimistic,10,479,2,8,1.04
11,8,option,6,480,4,2,0.44
11,8,organic,7,481,1,6,0.68
11,8,organized,9,482,6,3,0.6
11,8,originate,9,483,2,7,0.92
11,8,outdoors,8,484,1,7,0.92
11,8,outing,6,485,3,3,0.48
11,8,overall,7,486,1,6,0.8
11,8,pack,4,487,0,4,0.44
11,8,participate,11,488,2,9,1
11,8,particular,10,489,6,4,0.68
11,8,partner,7,490,4,3,0.64
11,8,passenger,9,491,2,7,0.84
11,8,passport,8,492,4,4,0.6
11,8,password,8,493,4,4,0.68
11,8,patent,6,494,2,4,0.52
11,8,peaceful,8,495,1,7,0.76
11,8,perceive,8,496,2,6,0.72
11,8,perhaps,7,497,3,4,0.68
11,8,personality,11,498,3,8,0.92
11,8,personnel,9,499,6,3,0.56
11,8,phone,5,500,1,4,0.6
11,8,physician,9,501,2,7,0.8
11,8,pick,4,502,1,3,0.36
11,8,pig,3,503,2,1,0.24
11,8,pile,4,504,2,2,0.36
11,8,pin,3,505,2,1,0.28
11,8,planning,8,506,1,7,0.88
11,8,plastic,7,507,3,4,0.56
11,8,point,5,508,1,4,0.56
11,8,pollution,9,509,2,7,0.96
11,8,population,10,510,2,8,0.96
11,8,possess,7,511,2,5,0.64
11,8,possible,8,512,4,4,0.68
11,8,post,4,513,3,1,0.4
11,8,practical,9,514,1,8,0.84
11,8,prayer,6,515,3,3,0.44
11,8,predict,7,516,2,5,0.6
11,8,prejudice,9,517,3,6,0.84
11,8,preliminary,11,518,3,8,0.92
11,8,premier,7,519,3,4,0.56
11,8,premise,7,520,5,2,0.56
11,8,presence,8,521,3,5,0.96
11,8,prevention,10,522,3,7,1.6
11,8,previously,10,523,4,6,1.68
11,8,principle,9,524,2,7,0.96
11,8,printer,7,525,4,3,0.64
11,8,printing,8,526,5,3,0.64
11,8,process,7,527,2,5,0.76
11,8,processing,10,528,7,3,0.68
11,8,processor,9,529,7,2,0.56
11,8,profile,7,530,3,4,0.68
11,8,program,7,531,3,4,0.6
11,8,programming,11,532,7,4,0.76
11,8,project,7,533,3,4,0.56
11,8,proof,5,534,3,2,0.48
11,8,proportion,10,535,3,7,0.84
11,8,proposal,8,536,5,3,0.56
11,8,publicity,9,537,1,8,0.96
11,8,punk,4,538,2,2,0.32
11,8,pupil,5,539,2,3,0.44
11,8,push,4,540,2,2,0.32
11,8,put,3,541,2,1,0.24
11,8,puzzle,6,542,2,4,0.52
11,8,quantity,8,543,0,8,0.96
11,8,quest,5,544,2,3,0.44
11,8,quite,5,545,2,3,0.44
11,8,racism,6,546,0,6,0.68
11,8,radar,5,547,2,3,0.6
11,8,radiation,9,548,3,6,0.76
11,8,rail,4,549,2,2,0.36
11,8,railway,7,550,4,3,0.48
11,8,rally,5,551,2,3,0.56
11,8,rather,6,552,2,4,0.52
11,8,rating,6,553,3,3,0.48
11,8,rational,8,554,4,4,0.6
11,8,realm,5,555,1,4,0.48
11,8,rebel,5,556,2,3,0.56
11,8,recall,6,557,2,4,0.52
11,8,reception,9,558,3,6,0.76
11,8,recommend,9,559,3,6,0.84
11,8,record,6,560,4,2,0.52
11,8,recruit,7,561,3,4,0.56
11,8,recycle,7,562,3,4,0.6
11,8,reduction,9,563,2,7,0.96
11,8,referee,7,564,2,5,0.6
11,8,reference,9,565,6,3,0.56
11,8,refuse,6,566,3,3,0.48
11,8,regime,6,567,2,4,0.64
11,8,regional,8,568,4,4,0.76
11,8,regulatory,10,569,3,7,1
11,8,reign,5,570,2,3,0.52
11,8,rejection,9,571,2,7,0.96
11,8,relative,8,572,2,6,0.72
11,8,relax,5,573,4,1,0.32
11,8,relaxed,7,574,5,2,0.56
11,8,relief,6,575,3,3,0.64
11,8,religious,9,576,4,5,0.72
11,8,remainder,9,577,2,7,0.84
11,8,remind,6,578,3,3,0.48
11,8,repeat,6,579,2,4,0.64
11,8,republic,8,580,3,5,0.64
11,8,requirement,11,581,2,9,1.24
11,8,respective,10,582,2,8,0.56
11,8,responsible,11,583,4,7,0.4
11,8,rest,4,584,3,1,0.12
11,8,retail,6,585,2,4,0.28
11,8,retire,6,586,3,3,0.2
11,8,revise,6,587,2,4,0.24
11,8,revision,8,588,5,3,0.24
11,8,revive,6,589,4,2,0.2
11,8,right,5,590,1,4,0.28
11,8,rival,5,591,2,3,0.2
11,8,road,4,592,1,3,0.16
11,8,roll,4,593,2,2,0.16
11,8,roof,4,594,2,2,0.12
11,8,root,4,595,3,1,0.12
11,8,rough,5,596,2,3,0.24
11,8,rubbish,7,597,1,6,0.32
11,8,ruin,4,598,2,2,0.16
11,8,sacred,6,599,0,6,0.28
11,8,sailor,6,600,2,4,0.28
11,8,sale,4,601,2,2,0.16
11,8,salt,4,602,3,1,0.12
11,8,sample,6,603,2,4,0.24
11,8,sand,4,604,2,2,0.12
11,8,satellite,9,605,2,7,0.44
11,8,satisfy,7,606,3,4,0.24
11,8,scan,4,607,1,3,0.16
11,8,scattered,9,608,3,6,0.32
11,8,schedule,8,609,2,6,0.36
11,8,scholar,7,610,3,4,0.24
11,8,scholarship,11,611,7,4,0.32
11,8,school,6,612,4,2,0.16
11,8,scientist,9,613,2,7,0.4
11,8,score,5,614,2,3,0.2
11,8,secretary,9,615,1,8,0.36
11,8,sensible,8,616,2,6,0.36
11,8,sensitivity,11,617,5,6,0.36
11,8,serious,7,618,2,5,0.28
11,8,serve,5,619,3,2,0.16
11,8,severely,8,620,2,6,0.36
11,8,sexual,6,621,2,4,0.24
11,8,shallow,7,622,1,6,0.28
11,8,shape,5,623,3,2,0.16
11,8,share,5,624,3,2,0.2
11,8,shift,5,625,2,3,0.2
11,8,shiny,5,626,3,2,0.16
11,8,shipping,8,627,3,5,0.28
11,8,shopping,8,628,2,6,0.36
11,8,shortage,8,629,3,5,0.28
11,8,shortly,7,630,5,2,0.2
11,8,sibling,7,631,1,6,0.28
11,8,silver,6,632,2,4,0.28
11,8,similarly,9,633,2,7,0.36
11,8,sin,3,634,2,1,0.08
11,8,sit,3,635,2,1,0.12
11,8,situated,8,636,3,5,0.28
11,8,six,3,637,2,1,0.16
11,8,skip,4,638,1,3,0.16
11,8,skirt,5,639,3,2,0.16
11,8,skull,5,640,2,3,0.2
11,8,smile,5,641,1,4,0.2
11,8,soap,4,642,1,3,0.16
11,8,solar,5,643,2,3,0.24
11,8,solo,4,644,3,1,0.12
11,8,someone,7,645,2,5,0.24
11,8,sometimes,9,646,4,5,0.28
11,8,song,4,647,2,2,0.16
11,8,soup,4,648,2,2,0.2
11,8,south,5,649,3,2,0.16
11,8,sovereignty,11,650,2,9,0.44
11,8,space,5,651,1,4,0.2
11,8,speaker,7,652,2,5,0.32
11,8,specialist,10,653,3,7,0.36
11,8,specialized,11,654,8,3,0.28
11,8,speech,6,655,3,3,0.28
11,8,spine,5,656,2,3,0.2
11,8,spokesman,9,657,2,7,0.36
11,8,spread,6,658,2,4,0.24
11,8,stab,4,659,1,3,0.24
11,8,stable,6,660,4,2,0.16
11,8,stamp,5,661,3,2,0.16
11,8,stand,5,662,3,2,0.16
11,8,statistic,9,663,3,6,0.32
11,8,statue,6,664,4,2,0.24
11,8,steadily,8,665,2,6,0.28
11,8,stereotype,10,666,3,7,0.36
11,8,stick,5,667,2,3,0.2
11,8,sticky,6,668,5,1,0.2
11,8,stop,4,669,2,2,0.16
11,8,store,5,670,3,2,0.16
11,8,straight,8,671,2,6,0.32
11,8,strategic,9,672,4,5,0.36
11,8,strategy,8,673,7,1,0.2
11,8,stretch,7,674,3,4,0.28
11,8,strong,6,675,3,3,0.2
11,8,studio,6,676,2,4,0.28
11,8,stumble,7,677,3,4,0.24
11,8,subject,7,678,1,6,0.28
11,8,successful,10,679,2,8,0.44
11,8,such,4,680,3,1,0.16
11,8,super,5,681,2,3,0.2
11,8,suppose,7,682,3,4,0.24
11,8,sure,4,683,2,2,0.12
11,8,surely,6,684,4,2,0.16
11,8,suspension,10,685,2,8,0.44
11,8,sweep,5,686,1,4,0.2
11,8,swim,4,687,2,2,0.16
11,8,sympathy,8,688,1,7,0.32
11,8,symptom,7,689,4,3,0.28
11,8,synthesis,9,690,2,7,0.36
11,8,tactical,8,691,0,8,0.4
11,8,tale,4,692,2,2,0.16
11,8,talent,6,693,4,2,0.24
11,8,talk,4,694,3,1,0.12
11,8,tape,4,695,2,2,0.16
11,8,task,4,696,2,2,0.16
11,8,taxi,4,697,2,2,0.16
11,8,tea,3,698,1,2,0.12
11,8,team,4,699,3,1,0.2
11,8,temperature,11,700,2,9,0.44
11,8,tendency,8,701,2,6,0.32
11,8,terribly,8,702,2,6,0.36
11,8,texture,7,703,2,5,0.28
11,8,themselves,10,704,1,9,0.4
11,8,thereafter,10,705,3,7,0.44
11,8,thereby,7,706,5,2,0.2
11,8,thesis,6,707,3,3,0.2
11,8,thirsty,7,708,2,5,0.28
11,8,thrilled,8,709,2,6,0.4
11,8,thumb,5,710,2,3,0.2
11,8,tidy,4,711,1,3,0.16
11,8,tight,5,712,2,3,0.2
11,8,tighten,7,713,5,2,0.2
11,8,till,4,714,2,2,0.2
11,8,tonight,7,715,1,6,0.28
11,8,tool,4,716,2,2,0.16
11,8,tour,4,717,2,2,0.16
11,8,tournament,10,718,4,6,0.36
11,8,trademark,9,719,1,8,0.44
11,8,tragic,6,720,3,3,0.2
11,8,trainer,7,721,3,4,0.24
11,8,transcript,10,722,3,7,0.44
11,8,transport,9,723,5,4,0.28
11,8,treaty,6,724,2,4,0.24
11,8,trend,5,725,3,2,0.16
11,8,trial,5,726,2,3,0.24
11,8,tribal,6,727,3,3,0.2
11,8,tribe,5,728,4,1,0.12
11,8,tribute,7,729,4,3,0.24
11,8,trio,4,730,3,1,0.12
11,8,trousers,8,731,2,6,0.4
11,8,tune,4,732,1,3,0.2
11,8,two,3,733,1,2,0.12
11,8,unable,6,734,0,6,0.28
11,8,undergo,7,735,2,5,0.28
11,8,underground,11,736,6,5,0.44
11,8,underwear,9,737,5,4,0.28
11,8,unfair,6,738,2,4,0.24
11,8,union,5,739,2,3,0.28
11,8,unique,6,740,3,3,0.2
11,8,universal,9,741,3,6,0.36
11,8,universe,8,742,7,1,0.2
11,8,until,5,743,2,3,0.16
11,8,unusual,7,744,2,5,0.32
11,8,uphold,6,745,1,5,0.28
11,8,upon,4,746,2,2,0.16
11,8,urban,5,747,1,4,0.24
11,8,urgent,6,748,2,4,0.32
11,8,usual,5,749,1,4,0.2
11,8,utility,7,750,1,6,0.28
11,8,valley,6,751,0,6,0.28
11,8,vary,4,752,2,2,0.12
11,8,vegetable,9,753,1,8,0.44
11,8,vein,4,754,2,2,0.16
11,8,vessel,6,755,2,4,0.24
11,8,veteran,7,756,2,5,0.28
11,8,viable,6,757,1,5,0.32
11,8,video,5,758,2,3,0.2
11,8,violent,7,759,2,5,0.28
11,8,virtual,7,760,2,5,0.28
11,8,virtue,6,761,5,1,0.24
11,8,virus,5,762,3,2,0.16
11,8,visitor,7,763,2,5,0.28
11,8,vocal,5,764,1,4,0.24
11,8,voice,5,765,2,3,0.2
11,8,warning,7,766,0,7,0.4
11,8,warrior,7,767,3,4,0.24
11,8,weakness,8,768,1,7,0.32
11,8,wealthy,7,769,3,4,0.24
11,8,weapon,6,770,3,3,0.28
11,8,weekend,7,771,2,5,0.28
11,8,weird,5,772,2,3,0.2
11,8,whenever,8,773,1,7,0.32
11,8,whereas,7,774,3,4,0.32
11,8,which,5,775,2,3,0.2
11,8,wildlife,8,776,1,7,0.32
11,8,willingness,11,777,3,8,0.52
11,8,win,3,778,2,1,0.08
11,8,wind,4,779,3,1,0.12
11,8,window,6,780,4,2,0.2
11,8,wipe,4,781,2,2,0.16
11,8,within,6,782,2,4,0.2
11,8,wonderful,9,783,1,8,0.44
11,8,workforce,9,784,2,7,0.36
11,8,workplace,9,785,4,5,0.32
11,8,wrap,4,786,1,3,0.24
11,8,wrist,5,787,2,3,0.2
11,8,young,5,788,0,5,0.24
11,9,absence,7,0,0,7,0.76
11,9,absolutely,10,1,3,7,1.2
11,9,absorb,6,2,4,2,0.48
11,9,academic,8,3,1,7,0.8
11,9,acceptable,10,4,2,8,1.08
11,9,accident,8,5,3,5,0.68
11,9,accompany,9,6,3,6,0.92
11,9,accordance,10,7,4,6,0.84
11,9,actress,7,8,2,5,0.76
11,9,acute,5,9,2,3,0.4
11,9,ad,2,10,1,1,0.2
11,9,add,3,11,2,1,0.24
11,9,adj,3,12,2,1,0.24
11,9,adjacent,8,13,3,5,0.76
11,9,admit,5,14,2,3,0.44
11,9,adopt,5,15,2,3,0.44
11,9,adoption,8,16,5,3,0.56
11,9,advantage,9,17,2,7,0.88
11,9,advice,6,18,3,3,0.48
11,9,aesthetic,9,19,1,8,0.88
11,9,aftermath,9,20,1,8,0.84
11,9,afterwards,10,21,5,5,0.84
11,9,aggression,10,22,1,9,0.92
11,9,agree,5,23,2,3,0.4
11,9,aids,4,24,1,3,0.48
11,9,alcohol,7,25,1,6,0.64
11,9,align,5,26,2,3,0.44
11,9,allocate,8,27,2,6,0.68
11,9,allocation,10,28,7,3,0.72
11,9,amendment,9,29,1,8,0.84
11,9,analysis,8,30,1,7,0.76
11,9,anger,5,31,2,3,0.4
11,9,animal,6,32,2,4,0.6
11,9,anniversary,11,33,2,9,0.96
11,9,announce,8,34,3,5,0.68
11,9,anybody,7,35,2,5,0.72
11,9,apology,7,36,1,6,0.64
11,9,apparently,10,37,2,8,0.92
11,9,approach,8,38,3,5,1.12
11,9,argue,5,39,1,4,0.56
11,9,arise,5,40,2,3,0.44
11,9,arms,4,41,2,2,0.36
11,9,arrow,5,42,2,3,0.44
11,9,ask,3,43,1,2,0.36
11,9,assault,7,44,2,5,0.84
11,9,assistant,9,45,3,6,0.76
11,9,associate,9,46,3,6,0.84
11,9,assurance,9,47,3,6,1
11,9,auction,7,48,1,6,0.68
11,9,automatic,9,49,2,7,0.8
11,9,average,7,50,1,6,0.88
11,9,balance,7,51,0,7,0.92
11,9,ballet,6,52,3,3,0.48
11,9,barrel,6,53,2,4,0.64
11,9,base,4,54,2,2,0.44
11,9,bath,4,55,2,2,0.52
11,9,bay,3,56,2,1,0.24
11,9,beast,5,57,1,4,0.48
11,9,beat,4,58,3,1,0.28
11,9,bed,3,59,2,1,0.24
11,9,beer,4,60,2,2,0.36
11,9,beg,3,61,2,1,0.24
11,9,belief,6,62,2,4,0.6
11,9,benchmark,9,63,2,7,0.8
11,9,best,4,64,2,2,0.36
11,9,between,7,65,2,5,0.64
11,9,beyond,6,66,2,4,0.6
11,9,bin,3,67,1,2,0.28
11,9,birthday,8,68,2,6,0.72
11,9,bizarre,7,69,2,5,0.6
11,9,blank,5,70,1,4,0.6
11,9,blog,4,71,2,2,0.36
11,9,blow,4,72,3,1,0.28
11,9,bomb,4,73,1,3,0.4
11,9,bottle,6,74,2,4,0.52
11,9,box,3,75,2,1,0.24
11,9,boyfriend,9,76,2,7,0.92
11,9,brand,5,77,1,4,0.52
11,9,breathing,9,78,2,7,0.8
11,9,bride,5,79,2,3,0.44
11,9,bridge,6,80,4,2,0.52
11,9,buddy,5,81,1,4,0.48
11,9,bunch,5,82,2,3,0.44
11,9,burden,6,83,2,4,0.52
11,9,business,8,84,2,6,0.84
11,9,butter,6,85,2,4,0.52
11,9,cafe,4,86,0,4,0.44
11,9,cake,4,87,2,2,0.32
11,9,candidate,9,88,2,7,0.8
11,9,cap,3,89,2,1,0.36
11,9,capability,10,90,3,7,0.84
11,9,career,6,91,2,4,0.52
11,9,careful,7,92,4,3,0.48
11,9,carefully,9,93,7,2,0.64
11,9,carpet,6,94,3,3,0.48
11,9,cartoon,7,95,3,4,0.6
11,9,category,8,96,2,6,0.72
11,9,cave,4,97,2,2,0.44
11,9,cease,5,98,1,4,0.48
11,9,celebrity,9,99,2,7,0.84
11,9,cemetery,8,100,2,6,0.76
11,9,certain,7,101,2,5,0.76
11,9,certainty,9,102,7,2,0.52
11,9,chair,5,103,1,4,0.48
11,9,challenge,9,104,3,6,0.76
11,9,chapter,7,105,3,4,0.72
11,9,character,9,106,3,6,0.76
11,9,charity,7,107,4,3,0.52
11,9,charm,5,108,4,1,0.32
11,9,cheat,5,109,2,3,0.52
11,9,chicken,7,110,2,5,0.6
11,9,childhood,9,111,3,6,0.72
11,9,choir,5,112,2,3,0.4
11,9,chop,4,113,3,1,0.36
11,9,chronic,7,114,2,5,0.64
11,9,chunk,5,115,2,3,0.44
11,9,circle,6,116,1,5,0.68
11,9,circuit,7,117,4,3,0.72
11,9,cite,4,118,2,2,0.32
11,9,civil,5,119,2,3,0.4
11,9,clause,6,120,1,5,0.4
11,9,clerk,5,121,2,3,0.2
11,9,clinical,8,122,2,6,0.36
11,9,closely,7,123,2,5,0.28
11,9,cloud,5,124,3,2,0.16
11,9,cluster,7,125,2,5,0.28
11,9,coffee,6,126,1,5,0.32
11,9,coincide,8,127,2,6,0.32
11,9,collaborate,11,128,2,9,0.44
11,9,colony,6,129,3,3,0.2
11,9,colourful,9,130,4,5,0.48
11,9,comedy,6,131,2,4,0.2
11,9,comfort,7,132,3,4,0.24
11,9,commodity,9,133,3,6,0.4
11,9,company,7,134,3,4,0.24
11,9,comparable,10,135,5,5,0.32
11,9,comply,6,136,4,2,0.2
11,9,compulsory,10,137,4,6,0.4
11,9,conceal,7,138,2,5,0.24
11,9,concern,7,139,5,2,0.2
11,9,conference,10,140,3,7,0.4
11,9,confused,8,141,4,4,0.24
11,9,constantly,10,142,3,7,0.36
11,9,contempt,8,143,3,5,0.28
11,9,contend,7,144,5,2,0.28
11,9,convenient,10,145,3,7,0.36
11,9,conversion,10,146,5,5,0.32
11,9,convey,6,147,5,1,0.2
11,9,cooker,6,148,2,4,0.24
11,9,coordinate,10,149,3,7,0.36
11,9,correct,7,150,2,5,0.24
11,9,correctly,9,151,7,2,0.28
11,9,cost,4,152,2,2,0.12
11,9,cottage,7,153,2,5,0.28
11,9,counterpart,11,154,2,9,0.48
11,9,county,6,155,5,1,0.16
11,9,course,6,156,3,3,0.2
11,9,court,5,157,4,1,0.12
11,9,create,6,158,1,5,0.24
11,9,creature,8,159,5,3,0.28
11,9,credible,8,160,3,5,0.28
11,9,criminal,8,161,2,6,0.36
11,9,crowd,5,162,2,3,0.32
11,9,crucial,7,163,2,5,0.52
11,9,cruel,5,164,3,2,0.2
11,9,cruise,6,165,3,3,0.28
11,9,cry,3,166,2,1,0.12
11,9,cultivate,9,167,1,8,0.56
11,9,dam,3,168,0,3,0.16
11,9,dance,5,169,2,3,0.2
11,9,dare,4,170,2,2,0.16
11,9,darkness,8,171,3,5,0.28
11,9,day,3,172,2,1,0.12
11,9,death,5,173,1,4,0.28
11,9,declare,7,174,2,5,0.24
11,9,decrease,8,175,3,5,0.28
11,9,deed,4,176,2,2,0.16
11,9,deem,4,177,3,1,0.16
11,9,default,7,178,2,5,0.28
11,9,defect,6,179,3,3,0.2
11,9,defence,7,180,4,3,0.2
11,9,definite,8,181,3,5,0.36
11,9,definitely,10,182,8,2,0.24
11,9,delight,7,183,2,5,0.28
11,9,delighted,9,184,7,2,0.24
11,9,democracy,9,185,2,7,0.4
11,9,departure,9,186,2,7,0.36
11,9,deposit,7,187,3,4,0.24
11,9,depressing,10,188,3,7,0.44
11,9,depression,10,189,8,2,0.24
11,9,despite,7,190,2,5,0.24
11,9,destination,11,191,3,8,0.48
11,9,detect,6,192,2,4,0.2
11,9,diagram,7,193,1,6,0.28
11,9,dictate,7,194,2,5,0.24
11,9,dig,3,195,2,1,0.12
11,9,diplomat,8,196,2,6,0.36
11,9,diplomatic,10,197,8,2,0.24
11,9,director,8,198,2,6,0.28
11,9,disastrous,10,199,2,8,0.44
11,9,discretion,10,200,3,7,0.36
11,9,distant,7,201,3,4,0.24
11,9,distribute,10,202,4,6,0.4
11,9,divine,6,203,2,4,0.2
11,9,divorced,8,204,3,5,0.28
11,9,donation,8,205,1,7,0.4
11,9,dot,3,206,2,1,0.12
11,9,downstairs,10,207,2,8,0.36
11,9,drama,5,208,1,4,0.2
11,9,drawing,7,209,3,4,0.24
11,9,ear,3,210,0,3,0.2
11,9,earnings,8,211,3,5,0.28
11,9,edit,4,212,1,3,0.16
11,9,edition,7,213,4,3,0.2
11,9,effective,9,214,1,8,0.44
11,9,eighty,6,215,1,5,0.24
11,9,either,6,216,2,4,0.24
11,9,elect,5,217,1,4,0.2
11,9,electrical,10,218,5,5,0.4
11,9,electricity,11,219,8,3,0.28
11,9,eleven,6,220,3,3,0.2
11,9,eliminate,9,221,2,7,0.44
11,9,elsewhere,9,222,2,7,0.36
11,9,emergence,9,223,1,8,0.36
11,9,ending,6,224,1,5,0.24
11,9,endless,7,225,3,4,0.32
11,9,enforcement,11,226,2,9,0.44
11,9,engineer,8,227,2,6,0.32
11,9,engineering,11,228,8,3,0.36
11,9,enjoy,5,229,2,3,0.16
11,9,enjoyable,9,230,5,4,0.28
11,9,enormous,8,231,2,6,0.36
11,9,enrich,6,232,2,4,0.24
11,9,entrance,8,233,2,6,0.32
11,9,environment,11,234,2,9,0.56
11,9,equipment,9,235,1,8,0.44
11,9,erect,5,236,1,4,0.2
11,9,essay,5,237,1,4,0.2
11,9,euro,4,238,1,3,0.16
11,9,evaluation,10,239,1,9,0.48
11,9,evening,7,240,2,5,0.28
11,9,event,5,241,4,1,0.12
11,9,evidence,8,242,2,6,0.28
11,9,examination,11,243,1,10,0.52
11,9,excited,7,244,2,5,0.24
11,9,exclusively,11,245,3,8,0.48
11,9,expensive,9,246,2,7,0.36
11,9,experiment,10,247,4,6,0.32
11,9,expertise,9,248,5,4,0.36
11,9,expire,6,249,3,3,0.2
11,9,explain,7,250,3,4,0.24
11,9,explicitly,10,251,4,6,0.36
11,9,explode,7,252,4,3,0.28
11,9,exploit,7,253,5,2,0.2
11,9,explosive,9,254,5,4,0.28
11,9,extensive,9,255,2,7,0.36
11,9,extremist,9,256,3,6,0.4
11,9,fail,4,257,0,4,0.2
11,9,failure,7,258,4,3,0.2
11,9,fall,4,259,2,2,0.16
11,9,fashionable,11,260,2,9,0.52
11,9,fast,4,261,3,1,0.12
11,9,fasten,6,262,4,2,0.28
11,9,fat,3,263,2,1,0.28
11,9,fear,4,264,1,3,0.44
11,9,fellow,6,265,2,4,0.56
11,9,fiction,7,266,1,6,0.4
11,9,fight,5,267,2,3,0.2
11,9,firefighter,11,268,2,9,0.44
11,9,firm,4,269,3,1,0.2
11,9,fixture,7,270,2,5,0.28
11,9,flat,4,271,1,3,0.16
11,9,flavour,7,272,3,4,0.24
11,9,flexibility,11,273,2,9,0.52
11,9,floor,5,274,2,3,0.2
11,9,flourish,8,275,3,5,0.28
11,9,flower,6,276,3,3,0.2
11,9,flying,6,277,2,4,0.32
11,9,focus,5,278,1,4,0.24
11,9,folding,7,279,2,5,0.28
11,9,folk,4,280,3,1,0.12
11,9,food,4,281,2,2,0.16
11,9,force,5,282,2,3,0.28
11,9,foreign,7,283,3,4,0.24
11,9,foreigner,9,284,7,2,0.24
11,9,former,6,285,3,3,0.2
11,9,formula,7,286,4,3,0.28
11,9,fortune,7,287,3,4,0.24
11,9,forward,7,288,3,4,0.24
11,9,foster,6,289,2,4,0.24
11,9,foundation,10,290,2,8,0.44
11,9,fragment,8,291,1,7,0.32
11,9,frequent,8,292,2,6,0.32
11,9,fridge,6,293,2,4,0.24
11,9,friendly,8,294,3,5,0.44
11,9,front,5,295,2,3,0.2
11,9,funding,7,296,1,6,0.32
11,9,fur,3,297,2,1,0.12
11,9,gallery,7,298,0,7,0.4
11,9,game,4,299,2,2,0.12
11,9,garage,6,300,2,4,0.24
11,9,gender,6,301,1,5,0.32
11,9,genuinely,9,302,3,6,0.4
11,9,give,4,303,1,3,0.16
11,9,glimpse,7,304,1,6,0.32
11,9,go,2,305,1,1,0.08
11,9,gold,4,306,2,2,0.16
11,9,golf,4,307,3,1,0.12
11,9,govern,6,308,2,4,0.28
11,9,governor,8,309,6,2,0.2
11,9,grace,5,310,1,4,0.2
11,9,grade,5,311,3,2,0.16
11,9,grandfather,11,312,3,8,0.52
11,9,graphics,8,313,3,5,0.32
11,9,green,5,314,2,3,0.2
11,9,grey,4,315,3,1,0.12
11,9,grid,4,316,2,2,0.16
11,9,grin,4,317,3,1,0.16
11,9,grind,5,318,4,1,0.16
11,9,ground,6,319,2,4,0.24
11,9,guess,5,320,1,4,0.2
11,9,guide,5,321,2,3,0.16
11,9,guy,3,322,2,1,0.16
11,9,gym,3,323,1,2,0.12
11,9,happen,6,324,0,6,0.28
11,9,harvest,7,325,2,5,0.32
11,9,hate,4,326,2,2,0.16
11,9,health,6,327,1,5,0.36
11,9,heart,5,328,3,2,0.16
11,9,herb,4,329,2,2,0.12
11,9,hers,4,330,3,1,0.12
11,9,hesitate,8,331,2,6,0.32
11,9,highlight,9,332,1,8,0.44
11,9,hint,4,333,2,2,0.2
11,9,historical,10,334,2,8,0.64
11,9,holiday,7,335,1,6,0.4
11,9,horrible,8,336,2,6,0.44
11,9,horror,6,337,4,2,0.2
11,9,hour,4,338,2,2,0.16
11,9,household,9,339,3,6,0.4
11,9,how,3,340,2,1,0.2
11,9,however,7,341,3,4,0.24
11,9,hunger,6,342,1,5,0.28
11,9,hypothesis,10,343,1,9,0.4
11,9,icon,4,344,0,4,0.32
11,9,ideal,5,345,1,4,0.24
11,9,identical,9,346,3,6,0.4
11,9,identity,8,347,6,2,0.24
11,9,ignorance,9,348,1,8,0.52
11,9,illegal,7,349,1,6,0.32
11,9,imaginary,9,350,1,8,0.4
11,9,implication,11,351,2,9,0.6
11,9,include,7,352,1,6,0.36
11,9,incorrect,9,353,3,6,0.36
11,9,incur,5,354,3,2,0.24
11,9,independent,11,355,2,9,0.44
11,9,indirect,8,356,3,5,0.28
11,9,infant,6,357,2,4,0.24
11,9,influential,11,358,3,8,0.48
11,9,inform,6,359,3,3,0.2
11,9,inherent,8,360,2,6,0.32
11,9,inject,6,361,2,4,0.32
11,9,inspect,7,362,2,5,0.24
11,9,instant,7,363,3,4,0.24
11,9,insurance,9,364,3,6,0.32
11,9,intelligent,11,365,2,9,0.52
11,9,intended,8,366,4,4,0.24
11,9,into,4,367,3,1,0.12
11,9,involve,7,368,2,5,0.24
11,9,involved,8,369,7,1,0.28
11,9,isolated,8,370,1,7,0.32
11,9,issue,5,371,2,3,0.16
11,9,jump,4,372,0,4,0.2
11,9,june,4,373,2,2,0.2
11,9,key,3,374,0,3,0.16
11,9,kidney,6,375,1,5,0.24
11,9,king,4,376,2,2,0.12
11,9,kingdom,7,377,4,3,0.2
11,9,kit,3,378,2,1,0.08
11,9,know,4,379,1,3,0.24
11,9,lack,4,380,0,4,0.2
11,9,lap,3,381,2,1,0.08
11,9,law,3,382,2,1,0.08
11,9,leadership,10,383,1,9,0.4
11,9,leading,7,384,4,3,0.28
11,9,leaf,4,385,3,1,0.12
11,9,leaflet,7,386,4,3,0.2
11,9,league,6,387,3,3,0.2
11,9,left,4,388,2,2,0.12
11,9,legendary,9,389,2,7,0.4
11,9,legislative,11,390,3,8,0.4
11,9,lemon,5,391,2,3,0.2
11,9,lethal,6,392,2,4,0.28
11,9,licence,7,393,1,6,0.28
11,9,license,7,394,5,2,0.2
11,9,lie,3,395,2,1,0.08
11,9,limited,7,396,2,5,0.28
11,9,literature,10,397,2,8,0.44
11,9,litter,6,398,3,3,0.2
11,9,live,4,399,2,2,0.12
11,9,liver,5,400,4,1,0.12
11,9,load,4,401,1,3,0.24
11,9,located,7,402,2,5,0.24
11,9,lonely,6,403,2,4,0.24
11,9,long,4,404,3,1,0.12
11,9,look,4,405,2,2,0.12
11,9,loose,5,406,3,2,0.24
11,9,loudly,6,407,2,4,0.24
11,9,love,4,408,2,2,0.16
11,9,lunch,5,409,1,4,0.2
11,9,mail,4,410,0,4,0.2
11,9,main,4,411,3,1,0.12
11,9,mainland,8,412,4,4,0.32
11,9,mandate,7,413,2,5,0.24
11,9,manipulate,10,414,3,7,0.64
11,9,manufacture,11,415,3,8,1.12
11,9,manuscript,10,416,4,6,0.96
11,9,map,3,417,2,1,0.24
11,9,married,7,418,2,5,0.6
11,9,mask,4,419,2,2,0.44
11,9,master,6,420,3,3,0.44
11,9,maximum,7,421,2,5,0.6
11,9,mean,4,422,1,3,0.4
11,9,mechanical,10,423,2,8,1
11,9,meeting,7,424,2,5,0.64
11,9,memory,6,425,2,4,0.52
11,9,mental,6,426,2,4,0.52
11,9,mention,7,427,4,3,0.64
11,9,merger,6,428,2,4,0.52
11,9,message,7,429,2,5,0.6
11,9,method,6,430,2,4,0.52
11,9,metre,5,431,3,2,0.36
11,9,midnight,8,432,1,7,0.84
11,9,mind,4,433,2,2,0.32
11,9,ministry,8,434,3,5,0.64
11,9,mirror,6,435,2,4,0.52
11,9,missing,7,436,2,5,0.72
11,9,money,5,437,1,4,0.48
11,9,mouth,5,438,2,3,0.4
11,9,movie,5,439,2,3,0.4
11,9,music,5,440,1,4,0.48
11,9,musician,8,441,5,3,0.68
11,9,must,4,442,3,1,0.28
11,9,myth,4,443,1,3,0.4
11,9,name,4,444,0,4,0.44
11,9,narrative,9,445,2,7,0.92
11,9,nation,6,446,2,4,0.52
11,9,nationwide,10,447,6,4,0.68
11,9,nature,6,448,3,3,0.44
11,9,necessary,9,449,1,8,0.96
11,9,neck,4,450,3,1,0.28
11,9,negative,8,451,2,6,0.72
11,9,neutral,7,452,2,5,0.64
11,9,newly,5,453,2,3,0.6
11,9,newspaper,9,454,3,6,0.76
11,9,non,3,455,1,2,0.28
11,9,normal,6,456,2,4,0.52
11,9,northern,8,457,3,5,0.76
11,9,note,4,458,2,2,0.32
11,9,notion,6,459,3,3,0.44
11,9,numerous,8,460,1,7,0.76
11,9,objective,9,461,0,9,1
11,9,obviously,9,462,2,7,0.8
11,9,occupation,10,463,1,9,0.96
11,9,off,3,464,1,2,0.28
11,9,offence,7,465,3,4,0.68
11,9,offensive,9,466,5,4,0.64
11,9,offspring,9,467,3,6,0.76
11,9,once,4,468,1,3,0.4
11,9,opponent,8,469,1,7,0.88
11,9,opposed,7,470,4,3,0.48
11,9,optimistic,10,471,2,8,0.88
11,9,option,6,472,4,2,0.52
11,9,organized,9,473,1,8,0.92
11,9,organizer,9,474,8,1,0.48
11,9,originate,9,475,2,7,0.92
11,9,otherwise,9,476,1,8,1.44
11,9,outbreak,8,477,1,7,0.76
11,9,outdoors,8,478,3,5,0.64
11,9,outfit,6,479,3,3,0.6
11,9,overall,7,480,1,6,0.64
11,9,oversee,7,481,4,3,0.52
11,9,owe,3,482,1,2,0.28
11,9,pace,4,483,0,4,0.44
11,9,pack,4,484,3,1,0.44
11,9,page,4,485,2,2,0.32
11,9,painful,7,486,2,5,0.64
11,9,pants,5,487,2,3,0.48
11,9,park,4,488,2,2,0.4
11,9,partial,7,489,3,4,0.68
11,9,participant,11,490,5,6,0.84
11,9,particular,10,491,6,4,0.72
11,9,partner,7,492,4,3,0.64
11,9,password,8,493,2,6,0.68
11,9,patience,8,494,2,6,0.84
11,9,patron,6,495,3,3,0.56
11,9,perceive,8,496,1,7,0.92
11,9,perfect,7,497,3,4,0.56
11,9,persistent,10,498,3,7,0.84
11,9,philosopher,11,499,1,10,1.16
11,9,phone,5,500,2,3,0.4
11,9,piece,5,501,1,4,0.52
11,9,pile,4,502,2,2,0.36
11,9,pin,3,503,2,1,0.24
11,9,pioneer,7,504,2,5,0.8
11,9,place,5,505,1,4,0.52
11,9,plan,4,506,3,1,0.28
11,9,planning,8,507,4,4,0.64
11,9,plant,5,508,4,1,0.36
11,9,plastic,7,509,3,4,0.68
11,9,plead,5,510,2,3,0.4
11,9,pleased,7,511,4,3,0.52
11,9,point,5,512,1,4,0.48
11,9,political,9,513,2,7,0.88
11,9,pollution,9,514,3,6,0.76
11,9,portion,7,515,2,5,0.72
11,9,position,8,516,2,6,0.88
11,9,possess,7,517,3,4,0.56
11,9,possibility,11,518,4,7,0.88
11,9,post,4,519,3,1,0.28
11,9,poster,6,520,4,2,0.52
11,9,practical,9,521,1,8,0.84
11,9,precedent,9,522,2,7,0.8
11,9,predict,7,523,3,4,0.56
11,9,prediction,10,524,7,3,0.72
11,9,pregnant,8,525,3,5,0.64
11,9,prejudice,9,526,3,6,0.76
11,9,prescribe,9,527,3,6,0.88
11,9,previously,10,528,3,7,0.84
11,9,principle,9,529,2,7,0.8
11,9,printer,7,530,4,3,0.6
11,9,printing,8,531,5,3,0.52
11,9,prior,5,532,3,2,0.36
11,9,priority,8,533,5,3,0.56
11,9,process,7,534,2,5,0.76
11,9,processor,9,535,7,2,0.52
11,9,program,7,536,3,4,0.56
11,9,project,7,537,3,4,0.56
11,9,proof,5,538,3,2,0.48
11,9,propaganda,10,539,3,7,0.96
11,9,proposal,8,540,4,4,0.68
11,9,prosecute,9,541,3,6,0.88
11,9,prosperity,10,542,4,6,0.8
11,9,protest,7,543,3,4,0.56
11,9,pump,4,544,1,3,0.36
11,9,punk,4,545,2,2,0.44
11,9,pupil,5,546,2,3,0.48
11,9,purpose,7,547,2,5,0.68
11,9,put,3,548,2,1,0.24
11,9,puzzle,6,549,2,4,0.56
11,9,quality,7,550,0,7,0.88
11,9,query,5,551,2,3,0.4
11,9,quite,5,552,2,3,0.4
11,9,race,4,553,0,4,0.44
11,9,racial,6,554,3,3,0.44
11,9,radar,5,555,2,3,0.56
11,9,radiation,9,556,3,6,0.76
11,9,rally,5,557,2,3,0.44
11,9,rational,8,558,2,6,0.72
11,9,realistic,9,559,1,8,0.96
11,9,realm,5,560,4,1,0.32
11,9,reasoning,9,561,3,6,0.72
11,9,rebel,5,562,2,3,0.52
11,9,recall,6,563,2,4,0.64
11,9,reception,9,564,3,6,0.72
11,9,recommend,9,565,3,6,0.76
11,9,record,6,566,4,2,0.4
11,9,recruit,7,567,3,4,0.68
11,9,reduce,6,568,2,4,0.52
11,9,refer,5,569,2,3,0.4
11,9,referee,7,570,5,2,0.44
11,9,regime,6,571,2,4,0.64
11,9,regional,8,572,4,4,0.6
11,9,regulatory,10,573,3,7,0.84
11,9,relative,8,574,2,6,0.8
11,9,relaxed,7,575,4,3,0.52
11,9,relief,6,576,3,3,0.44
11,9,remainder,9,577,2,7,0.8
11,9,remark,6,578,4,2,0.52
11,9,remind,6,579,3,3,0.44
11,9,removal,7,580,3,4,0.56
11,9,remove,6,581,5,1,0.36
11,9,reportedly,10,582,2,8,1
11,9,requirement,11,583,2,9,1
11,9,research,8,584,2,6,0.68
11,9,reside,6,585,3,3,0.44
11,9,residence,9,586,6,3,0.68
11,9,respective,10,587,3,7,0.84
11,9,rest,4,588,3,1,0.28
11,9,retail,6,589,2,4,0.64
11,9,retire,6,590,3,3,0.44
11,9,retirement,10,591,6,4,0.68
11,9,revision,8,592,2,6,0.68
11,9,revival,7,593,4,3,0.64
11,9,rifle,5,594,1,4,0.48
11,9,right,5,595,2,3,0.4
11,9,rip,3,596,2,1,0.24
11,9,ritual,6,597,2,4,0.52
11,9,rival,5,598,2,3,0.52
11,9,roll,4,599,1,3,0.36
11,9,root,4,600,2,2,0.32
11,9,round,5,601,2,3,0.4
11,9,rub,3,602,1,2,0.28
11,9,rubber,6,603,3,3,0.48
11,9,ruin,4,604,2,2,0.44
11,9,sacred,6,605,0,6,0.6
11,9,safe,4,606,2,2,0.32
11,9,sale,4,607,2,2,0.32
11,9,sand,4,608,2,2,0.32
11,9,satisfied,9,609,2,7,0.92
11,9,satisfy,7,610,6,1,0.4
11,9,scared,6,611,1,5,0.56
11,9,scheme,6,612,2,4,0.52
11,9,school,6,613,3,3,0.44
11,9,second,6,614,1,5,0.68
11,9,secret,6,615,3,3,0.44
11,9,secretary,9,616,6,3,0.56
11,9,seem,4,617,2,2,0.32
11,9,sensible,8,618,2,6,0.72
11,9,september,9,619,2,7,0.44
11,9,servant,7,620,2,5,0.28
11,9,service,7,621,4,3,0.28
11,9,seven,5,622,2,3,0.2
11,9,severely,8,623,4,4,0.28
11,9,sexy,4,624,2,2,0.12
11,9,shape,5,625,1,4,0.2
11,9,share,5,626,3,2,0.24
11,9,shareholder,11,627,5,6,0.36
11,9,sheer,5,628,2,3,0.2
11,9,shell,5,629,3,2,0.16
11,9,shift,5,630,2,3,0.2
11,9,shiny,5,631,3,2,0.24
11,9,ship,4,632,3,1,0.12
11,9,shoot,5,633,2,3,0.2
11,9,shore,5,634,3,2,0.16
11,9,sight,5,635,1,4,0.2
11,9,silver,6,636,2,4,0.28
11,9,similarly,9,637,2,7,0.32
11,9,simulation,10,638,3,7,0.36
11,9,sin,3,639,2,1,0.08
11,9,singing,7,640,3,4,0.32
11,9,sit,3,641,2,1,0.08
11,9,skirt,5,642,1,4,0.2
11,9,skull,5,643,2,3,0.16
11,9,slice,5,644,1,4,0.2
11,9,smile,5,645,1,4,0.28
11,9,snow,4,646,1,3,0.16
11,9,soap,4,647,1,3,0.16
11,9,solo,4,648,2,2,0.16
11,9,somehow,7,649,2,5,0.24
11,9,something,9,650,4,5,0.4
11,9,sometimes,9,651,5,4,0.28
11,9,song,4,652,2,2,0.16
11,9,south,5,653,2,3,0.16
11,9,sovereignty,11,654,2,9,0.52
11,9,space,5,655,1,4,0.2
11,9,spare,5,656,3,2,0.16
11,9,special,7,657,2,5,0.28
11,9,speech,6,658,3,3,0.28
11,9,sphere,6,659,2,4,0.24
11,9,spine,5,660,2,3,0.2
11,9,spokesman,9,661,2,7,0.36
11,9,spotlight,9,662,3,6,0.4
11,9,stable,6,663,1,5,0.24
11,9,staff,5,664,3,2,0.16
11,9,stand,5,665,3,2,0.16
11,9,standing,8,666,5,3,0.28
11,9,statistic,9,667,3,6,0.32
11,9,statue,6,668,4,2,0.2
11,9,stay,4,669,3,1,0.12
11,9,stereotype,10,670,2,8,0.44
11,9,stick,5,671,2,3,0.2
11,9,stop,4,672,2,2,0.16
11,9,storage,7,673,3,4,0.24
11,9,strange,7,674,2,5,0.28
11,9,street,6,675,3,3,0.28
11,9,strike,6,676,3,3,0.2
11,9,striking,8,677,5,3,0.24
11,9,string,6,678,4,2,0.2
11,9,study,5,679,2,3,0.24
11,9,stun,4,680,3,1,0.12
11,9,substance,9,681,1,8,0.36
11,9,such,4,682,2,2,0.16
11,9,sue,3,683,2,1,0.08
11,9,sugar,5,684,2,3,0.24
11,9,super,5,685,2,3,0.24
11,9,suppose,7,686,3,4,0.24
11,9,surgical,8,687,2,6,0.32
11,9,surrounding,11,688,3,8,0.48
11,9,sweater,7,689,1,6,0.28
11,9,sweep,5,690,3,2,0.16
11,9,swim,4,691,2,2,0.16
11,9,switch,6,692,3,3,0.2
11,9,sympathy,8,693,1,7,0.44
11,9,table,5,694,0,5,0.24
11,9,tail,4,695,2,2,0.12
11,9,talk,4,696,2,2,0.16
11,9,tank,4,697,2,2,0.16
11,9,tape,4,698,2,2,0.24
11,9,task,4,699,2,2,0.16
11,9,taxi,4,700,2,2,0.16
11,9,tea,3,701,1,2,0.12
11,9,team,4,702,3,1,0.12
11,9,television,10,703,2,8,0.48
11,9,tempt,5,704,2,3,0.16
11,9,terrify,7,705,2,5,0.28
11,9,texture,7,706,2,5,0.28
11,9,thereby,7,707,1,6,0.36
11,9,thesis,6,708,3,3,0.2
11,9,this,4,709,2,2,0.12
11,9,thorough,8,710,2,6,0.32
11,9,thoughtful,10,711,3,7,0.44
11,9,ticket,6,712,1,5,0.24
11,9,timing,6,713,2,4,0.24
11,9,too,3,714,1,2,0.12
11,9,tool,4,715,3,1,0.12
11,9,tournament,10,716,2,8,0.44
11,9,trademark,9,717,1,8,0.36
11,9,tragic,6,718,3,3,0.2
11,9,trainer,7,719,3,4,0.24
11,9,transcript,10,720,3,7,0.44
11,9,translation,11,721,5,6,0.36
11,9,tree,4,722,2,2,0.12
11,9,trend,5,723,3,2,0.24
11,9,trial,5,724,2,3,0.16
11,9,tribal,6,725,3,3,0.2
11,9,tribe,5,726,4,1,0.12
11,9,tribute,7,727,4,3,0.24
11,9,trousers,8,728,2,6,0.4
11,9,truck,5,729,2,3,0.16
11,9,tune,4,730,1,3,0.16
11,9,ultimate,8,731,0,8,0.36
11,9,undergo,7,732,1,6,0.36
11,9,underground,11,733,6,5,0.36
11,9,underlying,10,734,5,5,0.32
11,9,underwear,9,735,5,4,0.36
11,9,unfair,6,736,2,4,0.2
11,9,unify,5,737,2,3,0.2
11,9,unique,6,738,3,3,0.2
11,9,universal,9,739,3,6,0.4
11,9,unnecessary,11,740,2,9,0.44
11,9,until,5,741,2,3,0.16
11,9,unveil,6,742,2,4,0.24
11,9,upgrade,7,743,1,6,0.36
11,9,uphold,6,744,2,4,0.24
11,9,upon,4,745,2,2,0.16
11,9,usage,5,746,1,4,0.2
11,9,valley,6,747,0,6,0.28
11,9,valuable,8,748,3,5,0.36
11,9,variety,7,749,2,5,0.24
11,9,vary,4,750,3,1,0.12
11,9,venture,7,751,1,6,0.28
11,9,verify,6,752,2,4,0.28
11,9,veteran,7,753,2,5,0.28
11,9,viable,6,754,1,5,0.24
11,9,villager,8,755,2,6,0.32
11,9,virtual,7,756,2,5,0.36
11,9,virtue,6,757,5,1,0.16
11,9,virus,5,758,3,2,0.16
11,9,visual,6,759,2,4,0.2
11,9,waiter,6,760,0,6,0.36
11,9,wake,4,761,2,2,0.12
11,9,war,3,762,2,1,0.08
11,9,warning,7,763,3,4,0.24
11,9,warrior,7,764,3,4,0.24
11,9,washing,7,765,2,5,0.36
11,9,watch,5,766,2,3,0.2
11,9,water,5,767,3,2,0.16
11,9,weakness,8,768,1,7,0.32
11,9,wealthy,7,769,3,4,0.32
11,9,weapon,6,770,3,3,0.2
11,9,weight,6,771,2,4,0.2
11,9,welcome,7,772,2,5,0.24
11,9,whatever,8,773,1,7,0.4
11,9,whenever,8,774,2,6,0.28
11,9,whereas,7,775,3,4,0.24
11,9,width,5,776,1,4,0.2
11,9,wine,4,777,2,2,0.12
11,9,wipe,4,778,2,2,0.24
11,9,wisdom,6,779,2,4,0.2
11,9,within,6,780,2,4,0.2
11,9,woman,5,781,1,4,0.2
11,9,word,4,782,2,2,0.12
11,9,work,4,783,3,1,0.2
11,9,workplace,9,784,4,5,0.36
11,9,wow,3,785,2,1,0.24
11,9,written,7,786,1,6,0.68
11,9,yellow,6,787,0,6,0.76
11,9,youngster,9,788,1,8,0.88
3,0,a,1,0,0,1,1
3,0,ad,2,1,1,1,0.44
3,0,adj,3,2,2,1,0.64
3,0,app,3,3,1,2,0.52
3,0,ask,3,4,1,2,0.52
3,0,bed,3,5,0,3,0.48
3,0,beg,3,6,2,1,0.32
3,0,bin,3,7,1,2,0.44
3,0,bug,3,8,1,2,0.4
3,0,can,3,9,0,3,0.44
3,0,cd,2,10,1,1,0.24
3,0,cry,3,11,1,2,0.4
3,0,ear,3,12,0,3,0.52
3,0,eye,3,13,1,2,0.36
3,0,fee,3,14,0,3,0.4
3,0,fix,3,15,1,2,0.56
3,0,flu,3,16,1,2,0.36
3,0,god,3,17,0,3,0.4
3,0,guy,3,18,1,2,0.36
3,0,gym,3,19,1,2,0.44
3,0,hat,3,20,0,3,0.4
3,0,i,1,21,0,1,0.16
3,0,ill,3,22,1,2,0.44
3,0,key,3,23,0,3,0.4
3,0,kit,3,24,1,2,0.36
3,0,low,3,25,0,3,0.4
3,0,my,2,26,0,2,0.32
3,0,nut,3,27,0,3,0.4
3,0,pad,3,28,0,3,0.4
3,0,pin,3,29,1,2,0.52
3,0,pot,3,30,1,2,0.32
3,0,put,3,31,1,2,0.32
3,0,rob,3,32,0,3,0.48
3,0,sin,3,33,0,3,0.4
3,0,ski,3,34,1,2,0.2
3,0,sue,3,35,1,2,0.2
3,0,tea,3,36,0,3,0.32
3,0,to,2,37,1,1,0.12
3,0,too,3,38,2,1,0.16
3,0,two,3,39,1,2,0.32
3,0,war,3,40,0,3,0.2
3,0,way,3,41,2,1,0.12
3,0,win,3,42,1,2,0.16
3,1,ad,2,0,0,2,0.16
3,1,add,3,1,2,1,0.12
3,1,adj,3,2,2,1,0.24
3,1,app,3,3,1,2,0.16
3,1,at,2,4,1,1,0.08
3,1,bay,3,5,0,3,0.16
3,1,bin,3,6,1,2,0.12
3,1,box,3,7,1,2,0.24
3,1,bug,3,8,1,2,0.16
3,1,can,3,9,0,3,0.16
3,1,cry,3,10,1,2,0.2
3,1,dig,3,11,0,3,0.2
3,1,dot,3,12,1,2,0.16
3,1,ear,3,13,0,3,0.16
3,1,fat,3,14,0,3,0.16
3,1,few,3,15,1,2,0.12
3,1,fix,3,16,1,2,0.12
3,1,flu,3,17,1,2,0.2
3,1,for,3,18,1,2,0.12
3,1,go,2,19,0,2,0.12
3,1,god,3,20,2,1,0.12
3,1,guy,3,21,1,2,0.16
3,1,her,3,22,0,3,0.2
3,1,how,3,23,1,2,0.16
3,1,ill,3,24,0,3,0.24
3,1,key,3,25,0,3,0.16
3,1,kit,3,26,1,2,0.2
3,1,law,3,27,0,3,0.16
3,1,log,3,28,1,2,0.16
3,1,lot,3,29,2,1,0.16
3,1,map,3,30,0,3,0.16
3,1,non,3,31,0,3,0.16
3,1,nut,3,32,1,2,0.2
3,1,off,3,33,0,3,0.16
3,1,pad,3,34,0,3,0.16
3,1,pig,3,35,1,2,0.16
3,1,put,3,36,1,2,0.16
3,1,rip,3,37,0,3,0.16
3,1,too,3,38,0,3,0.24
3,1,two,3,39,1,2,0.24
3,1,war,3,40,0,3,0.16
3,1,way,3,41,2,1,0.12
3,1,win,3,42,1,2,0.12
3,2,a,1,0,0,1,0.08
3,2,ad,2,1,1,1,0.12
3,2,adj,3,2,2,1,0.16
3,2,at,2,3,1,1,0.12
3,2,bed,3,4,0,3,0.2
3,2,beg,3,5,2,1,0.2
3,2,bin,3,6,1,2,0.36
3,2,box,3,7,1,2,0.16
3,2,can,3,8,0,3,0.2
3,2,cap,3,9,2,1,0.16
3,2,cry,3,10,1,2,0.16
3,2,dig,3,11,0,3,0.2
3,2,ear,3,12,0,3,0.2
3,2,flu,3,13,0,3,0.28
3,2,for,3,14,1,2,0.32
3,2,fur,3,15,1,2,0.36
3,2,how,3,16,0,3,0.36
3,2,i,1,17,0,1,0.16
3,2,ice,3,18,1,2,0.32
3,2,ill,3,19,1,2,0.16
3,2,joy,3,20,0,3,0.2
3,2,lap,3,21,0,3,0.24
3,2,law,3,22,2,1,0.12
3,2,lie,3,23,1,2,0.12
3,2,lot,3,24,1,2,0.16
3,2,low,3,25,2,1,0.12
3,2,new,3,26,0,3,0.16
3,2,off,3,27,0,3,0.24
3,2,one,3,28,1,2,0.2
3,2,pig,3,29,0,3,0.16
3,2,pot,3,30,1,2,0.16
3,2,rob,3,31,0,3,0.16
3,2,rub,3,32,1,2,0.12
3,2,sin,3,33,0,3,0.16
3,2,six,3,34,2,1,0.12
3,2,ski,3,35,1,2,0.28
3,2,sue,3,36,1,2,0.36
3,2,tea,3,37,0,3,0.2
3,2,two,3,38,1,2,0.12
3,2,war,3,39,0,3,0.16
3,2,way,3,40,2,1,0.12
3,2,win,3,41,1,2,0.12
3,2,wow,3,42,1,2,0.12
3,3,a,1,0,0,1,0.08
3,3,ad,2,1,1,1,0.12
3,3,ask,3,2,1,2,0.16
3,3,at,2,3,1,1,0.16
3,3,bat,3,4,0,3,0.16
3,3,bed,3,5,1,2,0.16
3,3,beg,3,6,2,1,0.16
3,3,bin,3,7,1,2,0.16
3,3,cap,3,8,0,3,0.28
3,3,cd,2,9,1,1,0.2
3,3,dam,3,10,0,3,0.32
3,3,day,3,11,2,1,0.2
3,3,dot,3,12,1,2,0.2
3,3,eye,3,13,0,3,0.2
3,3,fat,3,14,0,3,0.16
3,3,few,3,15,1,2,0.2
3,3,fix,3,16,1,2,0.2
3,3,fur,3,17,1,2,0.2
3,3,go,2,18,0,2,0.24
3,3,god,3,19,2,1,0.12
3,3,guy,3,20,1,2,0.16
3,3,her,3,21,0,3,0.36
3,3,i,1,22,0,1,0.16
3,3,ice,3,23,1,2,0.16
3,3,joy,3,24,0,3,0.2
3,3,lad,3,25,0,3,0.36
3,3,lap,3,26,2,1,0.24
3,3,law,3,27,2,1,0.12
3,3,lie,3,28,1,2,0.16
3,3,lot,3,29,1,2,0.16
3,3,mum,3,30,0,3,0.2
3,3,non,3,31,0,3,0.2
3,3,nut,3,32,1,2,0.16
3,3,one,3,33,0,3,0.2
3,3,pot,3,34,0,3,0.36
3,3,rip,3,35,0,3,0.24
3,3,sin,3,36,0,3,0.28
3,3,sit,3,37,2,1,0.12
3,3,tap,3,38,0,3,0.16
3,3,tea,3,39,1,2,0.12
3,3,to,2,40,1,1,0.08
3,3,war,3,41,0,3,0.24
3,3,way,3,42,2,1,0.12
3,4,ad,2,0,0,2,0.12
3,4,add,3,1,2,1,0.12
3,4,adj,3,2,2,1,0.12
3,4,and,3,3,1,2,0.12
3,4,ask,3,4,1,2,0.12
3,4,bat,3,5,0,3,0.16
3,4,bay,3,6,2,1,0.12
3,4,bed,3,7,1,2,0.2
3,4,beg,3,8,2,1,0.12
3,4,bin,3,9,1,2,0.12
3,4,box,3,10,1,2,0.12
3,4,cap,3,11,0,3,0.2
3,4,dam,3,12,0,3,0.16
3,4,day,3,13,2,1,0.12
3,4,dig,3,14,1,2,0.16
3,4,eye,3,15,0,3,0.24
3,4,fee,3,16,0,3,0.16
3,4,fix,3,17,1,2,0.12
3,4,go,2,18,0,2,0.12
3,4,god,3,19,2,1,0.12
3,4,gym,3,20,1,2,0.16
3,4,hat,3,21,0,3,0.16
3,4,her,3,22,1,2,0.16
3,4,how,3,23,1,2,0.2
3,4,i,1,24,0,1,0.08
3,4,jet,3,25,0,3,0.16
3,4,job,3,26,1,2,0.12
3,4,kit,3,27,0,3,0.16
3,4,lad,3,28,0,3,0.16
3,4,lap,3,29,2,1,0.12
3,4,lie,3,30,1,2,0.2
3,4,lot,3,31,1,2,0.12
3,4,map,3,32,0,3,0.16
3,4,my,2,33,1,1,0.08
3,4,nut,3,34,0,3,0.16
3,4,off,3,35,0,3,0.2
3,4,pad,3,36,0,3,0.2
3,4,pig,3,37,1,2,0.16
3,4,sin,3,38,0,3,0.24
3,4,ski,3,39,1,2,0.12
3,4,way,3,40,0,3,0.16
3,4,win,3,41,1,2,0.12
3,4,wow,3,42,1,2,0.12
3,5,and,3,0,0,3,0.16
3,5,ask,3,1,1,2,0.24
3,5,bat,3,2,0,3,0.32
3,5,bay,3,3,2,1,0.2
3,5,bed,3,4,1,2,0.16
3,5,bug,3,5,1,2,0.12
3,5,cd,2,6,0,2,0.12
3,5,cry,3,7,1,2,0.16
3,5,dam,3,8,0,3,0.2
3,5,day,3,9,2,1,0.12
3,5,ear,3,10,0,3,0.2
3,5,eye,3,11,1,2,0.2
3,5,few,3,12,0,3,0.16
3,5,guy,3,13,0,3,0.16
3,5,gym,3,14,1,2,0.12
3,5,hat,3,15,0,3,0.16
3,5,i,1,16,0,1,0.08
3,5,ill,3,17,1,2,0.12
3,5,jet,3,18,0,3,0.16
3,5,key,3,19,0,3,0.24
3,5,kid,3,20,1,2,0.16
3,5,kit,3,21,2,1,0.12
3,5,lap,3,22,0,3,0.16
3,5,law,3,23,2,1,0.12
3,5,log,3,24,1,2,0.12
3,5,lot,3,25,2,1,0.12
3,5,low,3,26,2,1,0.16
3,5,map,3,27,0,3,0.16
3,5,new,3,28,0,3,0.16
3,5,non,3,29,1,2,0.12
3,5,not,3,30,2,1,0.12
3,5,off,3,31,0,3,0.16
3,5,pin,3,32,0,3,0.16
3,5,pot,3,33,1,2,0.16
3,5,sit,3,34,0,3,0.24
3,5,six,3,35,2,1,0.12
3,5,ski,3,36,1,2,0.12
3,5,tap,3,37,0,3,0.16
3,5,tea,3,38,1,2,0.12
3,5,to,2,39,1,1,0.08
3,5,too,3,40,2,1,0.12
3,5,two,3,41,1,2,0.12
3,5,wow,3,42,0,3,0.24
3,6,a,1,0,0,1,0.08
3,6,adj,3,1,1,2,0.12
3,6,and,3,2,1,2,0.12
3,6,app,3,3,1,2,0.12
3,6,at,2,4,1,1,0.08
3,6,bin,3,5,0,3,0.16
3,6,box,3,6,1,2,0.12
3,6,bug,3,7,1,2,0.12
3,6,cap,3,8,0,3,0.24
3,6,dam,3,9,0,3,0.16
3,6,dot,3,10,1,2,0.12
3,6,few,3,11,0,3,0.16
3,6,fix,3,12,1,2,0.12
3,6,for,3,13,1,2,0.16
3,6,fur,3,14,1,2,0.12
3,6,god,3,15,0,3,0.24
3,6,guy,3,16,1,2,0.12
3,6,gym,3,17,1,2,0.12
3,6,ill,3,18,0,3,0.16
3,6,key,3,19,0,3,0.16
3,6,kid,3,20,1,2,0.12
3,6,kit,3,21,2,1,0.12
3,6,law,3,22,0,3,0.16
3,6,low,3,23,1,2,0.2
3,6,map,3,24,0,3,0.16
3,6,mum,3,25,1,2,0.12
3,6,non,3,26,0,3,0.16
3,6,nut,3,27,1,2,0.12
3,6,off,3,28,0,3,0.16
3,6,one,3,29,1,2,0.12
3,6,owe,3,30,1,2,0.2
3,6,pad,3,31,0,3,0.16
3,6,pig,3,32,1,2,0.12
3,6,pin,3,33,2,1,0.12
3,6,put,3,34,1,2,0.12
3,6,rip,3,35,0,3,0.16
3,6,rob,3,36,1,2,0.12
3,6,rub,3,37,1,2,0.12
3,6,six,3,38,0,3,0.24
3,6,tap,3,39,0,3,0.16
3,6,tea,3,40,1,2,0.12
3,6,to,2,41,1,1,0.08
3,6,war,3,42,0,3,0.16
3,7,a,1,0,0,1,0.08
3,7,app,3,1,1,2,0.16
3,7,ask,3,2,1,2,0.12
3,7,bat,3,3,0,3,0.24
3,7,bed,3,4,1,2,0.12
3,7,bin,3,5,1,2,0.12
3,7,box,3,6,1,2,0.12
3,7,bug,3,7,1,2,0.12
3,7,can,3,8,0,3,0.16
3,7,cap,3,9,2,1,0.12
3,7,dig,3,10,0,3,0.16
3,7,fee,3,11,0,3,0.24
3,7,fix,3,12,1,2,0.12
3,7,for,3,13,1,2,0.12
3,7,go,2,14,0,2,0.12
3,7,god,3,15,2,1,0.12
3,7,hat,3,16,0,3,0.16
3,7,how,3,17,1,2,0.12
3,7,i,1,18,0,1,0.08
3,7,jet,3,19,0,3,0.24
3,7,job,3,20,1,2,0.12
3,7,joy,3,21,2,1,0.12
3,7,lot,3,22,0,3,0.16
3,7,low,3,23,2,1,0.12
3,7,not,3,24,0,3,0.16
3,7,owe,3,25,0,3,0.16
3,7,pad,3,26,0,3,0.16
3,7,pig,3,27,1,2,0.2
3,7,pot,3,28,1,2,0.12
3,7,rip,3,29,0,3,0.16
3,7,rob,3,30,1,2,0.12
3,7,rub,3,31,1,2,0.12
3,7,sit,3,32,0,3,0.16
3,7,six,3,33,2,1,0.12
3,7,ski,3,34,1,2,0.2
3,7,sue,3,35,1,2,0.12
3,7,tap,3,36,0,3,0.16
3,7,tea,3,37,1,2,0.12
3,7,to,2,38,1,1,0.08
3,7,too,3,39,2,1,0.12
3,7,two,3,40,1,2,0.12
3,7,war,3,41,0,3,0.16
3,7,way,3,42,2,1,0.16
3,8,a,1,0,0,1,0.08
3,8,ad,2,1,1,1,0.12
3,8,add,3,2,2,1,0.24
3,8,app,3,3,1,2,0.2
3,8,ask,3,4,1,2,0.28
3,8,bin,3,5,0,3,0.28
3,8,can,3,6,0,3,0.28
3,8,cap,3,7,2,1,0.12
3,8,cry,3,8,1,2,0.16
3,8,dam,3,9,0,3,0.2
3,8,day,3,10,2,1,0.36
3,8,dig,3,11,1,2,0.32
3,8,dot,3,12,1,2,0.32
3,8,ear,3,13,0,3,0.52
3,8,fat,3,14,0,3,0.32
3,8,fee,3,15,1,2,0.48
3,8,few,3,16,2,1,0.56
3,8,fur,3,17,1,2,0.72
3,8,go,2,18,0,2,0.52
3,8,guy,3,19,1,2,0.44
3,8,her,3,20,0,3,0.36
3,8,how,3,21,1,2,0.32
3,8,i,1,22,0,1,0.16
3,8,joy,3,23,0,3,0.36
3,8,key,3,24,0,3,0.36
3,8,kid,3,25,1,2,0.4
3,8,kit,3,26,2,1,0.56
3,8,map,3,27,0,3,0.4
3,8,my,2,28,1,1,0.2
3,8,new,3,29,0,3,0.36
3,8,not,3,30,1,2,0.36
3,8,nut,3,31,1,2,0.32
3,8,pad,3,32,0,3,0.36
3,8,pig,3,33,1,2,0.44
3,8,pin,3,34,2,1,0.24
3,8,rub,3,35,0,3,0.36
3,8,sin,3,36,0,3,0.36
3,8,six,3,37,2,1,0.24
3,8,sue,3,38,1,2,0.32
3,8,tap,3,39,0,3,0.4
3,8,too,3,40,1,2,0.44
3,8,way,3,41,0,3,0.36
3,8,wow,3,42,1,2,0.28
3,9,app,3,0,0,3,0.36
3,9,bat,3,1,0,3,0.36
3,9,bed,3,2,1,2,0.28
3,9,can,3,3,0,3,0.36
3,9,cd,2,4,1,1,0.2
3,9,cry,3,5,1,2,0.28
3,9,day,3,6,0,3,0.48
3,9,dig,3,7,1,2,0.32
3,9,ear,3,8,0,3,0.4
3,9,fat,3,9,0,3,0.36
3,9,fix,3,10,1,2,0.32
3,9,flu,3,11,1,2,0.28
3,9,for,3,12,1,2,0.28
3,9,fur,3,13,1,2,0.4
3,9,hat,3,14,0,3,0.36
3,9,her,3,15,1,2,0.28
3,9,i,1,16,0,1,0.16
3,9,ice,3,17,1,2,0.28
3,9,ill,3,18,1,2,0.32
3,9,jet,3,19,0,3,0.4
3,9,key,3,20,0,3,0.4
3,9,kit,3,21,1,2,0.44
3,9,lad,3,22,0,3,0.36
3,9,lap,3,23,2,1,0.24
3,9,low,3,24,1,2,0.28
3,9,map,3,25,0,3,0.32
3,9,mum,3,26,1,2,0.28
3,9,off,3,27,0,3,0.4
3,9,one,3,28,1,2,0.64
3,9,owe,3,29,1,2,0.48
3,9,pad,3,30,0,3,0.36
3,9,pin,3,31,1,2,0.28
3,9,rip,3,32,0,3,0.32
3,9,rob,3,33,1,2,0.28
3,9,rub,3,34,1,2,0.28
3,9,sin,3,35,0,3,0.36
3,9,six,3,36,2,1,0.36
3,9,ski,3,37,1,2,0.28
3,9,tea,3,38,0,3,0.32
3,9,too,3,39,1,2,0.28
3,9,two,3,40,1,2,0.28
3,9,way,3,41,0,3,0.32
3,9,wow,3,42,1,2,0.28
4,0,ad,2,0,0,2,0.28
4,0,adj,3,1,2,1,0.24
4,0,aids,4,2,1,3,0.52
4,0,ally,4,3,1,3,0.4
4,0,and,3,4,1,2,0.32
4,0,ask,3,5,1,2,0.28
4,0,auto,4,6,1,3,0.4
4,0,bat,3,7,0,3,0.36
4,0,bath,4,8,3,1,0.28
4,0,bed,3,9,1,2,0.4
4,0,beer,4,10,2,2,0.36
4,0,bell,4,11,2,2,0.32
4,0,best,4,12,2,2,0.4
4,0,bill,4,13,1,3,0.4
4,0,bin,3,14,2,1,0.28
4,0,bite,4,15,2,2,0.44
4,0,blog,4,16,1,3,0.36
4,0,boat,4,17,1,3,0.4
4,0,boil,4,18,2,2,0.32
4,0,bomb,4,19,2,2,0.32
4,0,boot,4,20,2,2,0.32
4,0,bug,3,21,1,2,0.36
4,0,can,3,22,0,3,0.68
4,0,card,4,23,2,2,0.32
4,0,coup,4,24,1,3,0.44
4,0,deal,4,25,0,4,0.44
4,0,deed,4,26,2,2,0.32
4,0,dig,3,27,1,2,0.32
4,0,dirt,4,28,2,2,0.48
4,0,dot,3,29,1,2,0.28
4,0,ear,3,30,0,3,0.36
4,0,exit,4,31,1,3,0.4
4,0,eye,3,32,1,2,0.44
4,0,fair,4,33,0,4,0.52
4,0,fall,4,34,2,2,0.32
4,0,fat,3,35,2,1,0.36
4,0,fear,4,36,1,3,0.4
4,0,fee,3,37,2,1,0.24
4,0,fine,4,38,1,3,0.36
4,0,firm,4,39,2,2,0.56
4,0,fix,3,40,2,1,0.24
4,0,flat,4,41,1,3,0.4
4,0,food,4,42,1,3,0.48
4,0,for,3,43,2,1,0.24
4,0,frog,4,44,1,3,0.36
4,0,go,2,45,0,2,0.24
4,0,god,3,46,2,1,0.28
4,0,gold,4,47,2,2,0.4
4,0,good,4,48,2,2,0.4
4,0,grin,4,49,1,3,0.52
4,0,guy,3,50,1,2,0.28
4,0,hair,4,51,0,4,0.44
4,0,harm,4,52,2,2,0.32
4,0,hate,4,53,2,2,0.32
4,0,heat,4,54,1,3,0.68
4,0,her,3,55,2,1,0.4
4,0,hers,4,56,3,1,0.32
4,0,i,1,57,0,1,0.16
4,0,ice,3,58,1,2,0.32
4,0,icon,4,59,2,2,0.36
4,0,ill,3,60,1,2,0.32
4,0,into,4,61,1,3,0.64
4,0,iron,4,62,1,3,0.6
4,0,jet,3,63,0,3,0.48
4,0,job,3,64,1,2,0.36
4,0,joy,3,65,2,1,0.52
4,0,june,4,66,1,3,0.4
4,0,know,4,67,0,4,0.52
4,0,law,3,68,0,3,0.44
4,0,left,4,69,1,3,0.6
4,0,limb,4,70,1,3,0.44
4,0,link,4,71,2,2,0.44
4,0,lion,4,72,2,2,0.48
4,0,live,4,73,2,2,0.32
4,0,long,4,74,1,3,0.4
4,0,lot,3,75,2,1,0.24
4,0,mail,4,76,0,4,0.6
4,0,main,4,77,3,1,0.28
4,0,mark,4,78,2,2,0.36
4,0,mask,4,79,2,2,0.32
4,0,mess,4,80,1,3,0.4
4,0,much,4,81,1,3,0.48
4,0,must,4,82,2,2,0.44
4,0,my,2,83,1,1,0.2
4,0,norm,4,84,0,4,0.48
4,0,note,4,85,2,2,0.4
4,0,off,3,86,0,3,0.36
4,0,one,3,87,1,2,0.28
4,0,owe,3,88,1,2,0.28
4,0,pace,4,89,0,4,0.56
4,0,pack,4,90,3,1,0.28
4,0,pad,3,91,2,1,0.24
4,0,page,4,92,2,2,0.36
4,0,park,4,93,2,2,0.32
4,0,pig,3,94,1,2,0.28
4,0,pile,4,95,2,2,0.36
4,0,pin,3,96,2,1,0.36
4,0,plan,4,97,1,3,0.52
4,0,play,4,98,3,1,0.28
4,0,post,4,99,1,3,0.4
4,0,pot,3,100,2,1,0.24
4,0,punk,4,101,1,3,0.4
4,0,rear,4,102,0,4,0.64
4,0,rip,3,103,1,2,0.32
4,0,rob,3,104,1,2,0.32
4,0,roll,4,105,2,2,0.68
4,0,roof,4,106,2,2,0.52
4,0,root,4,107,3,1,0.32
4,0,salt,4,108,0,4,0.8
4,0,sand,4,109,2,2,0.6
4,0,scan,4,110,1,3,0.6
4,0,seal,4,111,1,3,1.36
4,0,sexy,4,112,2,2,1.6
4,0,six,3,113,1,2,0.44
4,0,skip,4,114,1,3,0.4
4,0,slam,4,115,1,3,0.4
4,0,soap,4,116,1,3,0.4
4,0,solo,4,117,2,2,0.36
4,0,soup,4,118,2,2,0.36
4,0,stab,4,119,1,3,0.56
4,0,stay,4,120,3,1,0.32
4,0,stem,4,121,2,2,0.36
4,0,stop,4,122,2,2,0.36
4,0,such,4,123,1,3,0.4
4,0,sue,3,124,2,1,0.24
4,0,tail,4,125,0,4,0.52
4,0,tale,4,126,2,2,0.32
4,0,talk,4,127,3,1,0.28
4,0,tank,4,128,2,2,0.32
4,0,tap,3,129,2,1,0.24
4,0,tape,4,130,3,1,0.32
4,0,taxi,4,131,2,2,0.64
4,0,tea,3,132,1,2,0.88
4,0,this,4,133,1,3,0.6
4,0,tidy,4,134,1,3,0.4
4,0,till,4,135,2,2,0.16
4,0,to,2,136,1,1,0.12
4,0,tree,4,137,1,3,0.2
4,0,two,3,138,1,2,0.28
4,0,upon,4,139,0,4,0.28
4,0,walk,4,140,0,4,0.24
4,0,way,3,141,2,1,0.12
4,0,win,3,142,1,2,0.16
4,0,wine,4,143,3,1,0.16
4,0,wipe,4,144,2,2,0.24
4,0,word,4,145,1,3,0.2
4,0,wrap,4,146,1,3,0.24
4,1,a,1,0,0,1,0.08
4,1,acid,4,1,1,3,0.2
4,1,acre,4,2,2,2,0.16
4,1,add,3,3,1,2,0.12
4,1,adj,3,4,2,1,0.12
4,1,and,3,5,1,2,0.12
4,1,app,3,6,1,2,0.12
4,1,arms,4,7,1,3,0.24
4,1,army,4,8,3,1,0.12
4,1,baby,4,9,0,4,0.2
4,1,base,4,10,2,2,0.16
4,1,bat,3,11,2,1,0.12
4,1,bath,4,12,3,1,0.12
4,1,beer,4,13,1,3,0.24
4,1,beg,3,14,2,1,0.12
4,1,bin,3,15,1,2,0.12
4,1,bite,4,16,2,2,0.16
4,1,box,3,17,1,2,0.12
4,1,burn,4,18,1,3,0.16
4,1,cake,4,19,0,4,0.2
4,1,cave,4,20,2,2,0.24
4,1,cite,4,21,1,3,0.16
4,1,club,4,22,1,3,0.16
4,1,cost,4,23,1,3,0.16
4,1,coup,4,24,2,2,0.16
4,1,cry,3,25,1,2,0.12
4,1,dam,3,26,0,3,0.2
4,1,deal,4,27,1,3,0.16
4,1,deed,4,28,2,2,0.16
4,1,deem,4,29,3,1,0.12
4,1,dirt,4,30,1,3,0.16
4,1,dot,3,31,1,2,0.12
4,1,ear,3,32,0,3,0.16
4,1,exit,4,33,1,3,0.24
4,1,fail,4,34,0,4,0.2
4,1,fair,4,35,3,1,0.12
4,1,fat,3,36,2,1,0.12
4,1,fear,4,37,1,3,0.16
4,1,fee,3,38,2,1,0.12
4,1,few,3,39,2,1,0.12
4,1,file,4,40,1,3,0.28
4,1,fix,3,41,2,1,0.12
4,1,flat,4,42,1,3,0.2
4,1,food,4,43,1,3,0.2
4,1,for,3,44,2,1,0.12
4,1,frog,4,45,1,3,0.2
4,1,full,4,46,1,3,0.24
4,1,fur,3,47,2,1,0.12
4,1,god,3,48,0,3,0.16
4,1,gold,4,49,2,2,0.16
4,1,golf,4,50,3,1,0.12
4,1,guy,3,51,1,2,0.16
4,1,hair,4,52,0,4,0.2
4,1,hat,3,53,2,1,0.16
4,1,heat,4,54,1,3,0.16
4,1,her,3,55,2,1,0.12
4,1,herb,4,56,3,1,0.12
4,1,hint,4,57,1,3,0.2
4,1,how,3,58,1,2,0.16
4,1,icon,4,59,0,4,0.24
4,1,ill,3,60,1,2,0.2
4,1,info,4,61,1,3,0.16
4,1,iron,4,62,1,3,0.2
4,1,jump,4,63,0,4,0.2
4,1,june,4,64,2,2,0.16
4,1,just,4,65,2,2,0.16
4,1,key,3,66,0,3,0.24
4,1,kid,3,67,1,2,0.12
4,1,kit,3,68,2,1,0.12
4,1,know,4,69,1,3,0.16
4,1,lack,4,70,0,4,0.2
4,1,lap,3,71,2,1,0.12
4,1,last,4,72,2,2,0.16
4,1,law,3,73,2,1,0.16
4,1,left,4,74,1,3,0.16
4,1,live,4,75,1,3,0.16
4,1,lot,3,76,1,2,0.12
4,1,love,4,77,2,2,0.16
4,1,low,3,78,2,1,0.16
4,1,main,4,79,0,4,0.2
4,1,mask,4,80,2,2,0.24
4,1,meal,4,81,1,3,0.16
4,1,most,4,82,1,3,0.16
4,1,mum,3,83,1,2,0.12
4,1,myth,4,84,1,3,0.16
4,1,neck,4,85,0,4,0.2
4,1,new,3,86,2,1,0.16
4,1,non,3,87,1,2,0.12
4,1,norm,4,88,2,2,0.16
4,1,nut,3,89,1,2,0.12
4,1,off,3,90,0,3,0.16
4,1,once,4,91,1,3,0.16
4,1,pace,4,92,0,4,0.2
4,1,pad,3,93,2,1,0.16
4,1,park,4,94,2,2,0.16
4,1,peer,4,95,1,3,0.16
4,1,pig,3,96,1,2,0.12
4,1,pipe,4,97,2,2,0.16
4,1,plan,4,98,1,3,0.2
4,1,plot,4,99,2,2,0.16
4,1,pond,4,100,1,3,0.24
4,1,pot,3,101,2,1,0.12
4,1,pump,4,102,1,3,0.16
4,1,push,4,103,2,2,0.16
4,1,put,3,104,2,1,0.12
4,1,race,4,105,0,4,0.2
4,1,rest,4,106,1,3,0.24
4,1,rip,3,107,1,2,0.12
4,1,rise,4,108,2,2,0.16
4,1,road,4,109,1,3,0.16
4,1,roll,4,110,2,2,0.16
4,1,ruin,4,111,1,3,0.16
4,1,sale,4,112,0,4,0.28
4,1,sand,4,113,2,2,0.16
4,1,scan,4,114,1,3,0.16
4,1,sexy,4,115,1,3,0.16
4,1,ship,4,116,1,3,0.16
4,1,sin,3,117,1,2,0.12
4,1,ski,3,118,1,2,0.12
4,1,slip,4,119,1,3,0.24
4,1,soap,4,120,1,3,0.16
4,1,some,4,121,2,2,0.16
4,1,soup,4,122,2,2,0.16
4,1,spin,4,123,1,3,0.16
4,1,stab,4,124,1,3,0.16
4,1,stem,4,125,2,2,0.2
4,1,stop,4,126,2,2,0.16
4,1,stun,4,127,2,2,0.16
4,1,such,4,128,1,3,0.16
4,1,sue,3,129,2,1,0.12
4,1,tail,4,130,0,4,0.2
4,1,talk,4,131,2,2,0.2
4,1,task,4,132,2,2,0.16
4,1,taxi,4,133,2,2,0.16
4,1,tea,3,134,1,2,0.12
4,1,team,4,135,3,1,0.12
4,1,this,4,136,1,3,0.16
4,1,till,4,137,1,3,0.16
4,1,tool,4,138,1,3,0.24
4,1,tune,4,139,1,3,0.16
4,1,two,3,140,1,2,0.12
4,1,upon,4,141,0,4,0.2
4,1,vein,4,142,0,4,0.2
4,1,war,3,143,0,3,0.16
4,1,word,4,144,1,3,0.24
4,1,wow,3,145,2,1,0.12
4,1,wrap,4,146,1,3,0.16
4,2,acre,4,0,0,4,0.48
4,2,aids,4,1,1,3,0.4
4,2,app,3,2,1,2,0.28
4,2,army,4,3,1,3,0.4
4,2,at,2,4,1,1,0.2
4,2,baby,4,5,0,4,0.52
4,2,base,4,6,2,2,0.32
4,2,bay,3,7,2,1,0.24
4,2,bed,3,8,1,2,0.28
4,2,beer,4,9,2,2,0.32
4,2,beg,3,10,2,1,0.24
4,2,bell,4,11,2,2,0.4
4,2,best,4,12,2,2,0.32
4,2,bin,3,13,1,2,0.28
4,2,bite,4,14,2,2,0.32
4,2,blow,4,15,1,3,0.36
4,2,boat,4,16,1,3,0.36
4,2,boil,4,17,2,2,0.32
4,2,bomb,4,18,2,2,0.44
4,2,boom,4,19,2,2,0.32
4,2,burn,4,20,1,3,0.36
4,2,cafe,4,21,0,4,0.44
4,2,can,3,22,2,1,0.24
4,2,cave,4,23,2,2,0.32
4,2,cd,2,24,1,1,0.2
4,2,chop,4,25,1,3,0.48
4,2,cost,4,26,1,3,0.4
4,2,coup,4,27,2,2,0.32
4,2,cry,3,28,1,2,0.28
4,2,dam,3,29,0,3,0.36
4,2,deal,4,30,1,3,0.4
4,2,deed,4,31,2,2,0.44
4,2,dig,3,32,1,2,0.28
4,2,dirt,4,33,2,2,0.36
4,2,dust,4,34,1,3,0.4
4,2,fair,4,35,0,4,0.44
4,2,fall,4,36,2,2,0.32
4,2,fast,4,37,2,2,0.4
4,2,fat,3,38,2,1,0.24
4,2,fee,3,39,1,2,0.32
4,2,file,4,40,1,3,0.4
4,2,fine,4,41,2,2,0.32
4,2,flat,4,42,1,3,0.4
4,2,folk,4,43,1,3,0.4
4,2,frog,4,44,1,3,0.48
4,2,full,4,45,1,3,0.4
4,2,fur,3,46,2,1,0.24
4,2,game,4,47,0,4,0.44
4,2,gene,4,48,1,3,0.4
4,2,give,4,49,1,3,0.4
4,2,go,2,50,1,1,0.2
4,2,god,3,51,2,1,0.36
4,2,grey,4,52,1,3,0.4
4,2,grid,4,53,2,2,0.36
4,2,grin,4,54,3,1,0.28
4,2,guy,3,55,1,2,0.28
4,2,hair,4,56,0,4,0.44
4,2,hat,3,57,2,1,0.24
4,2,heat,4,58,1,3,0.4
4,2,herb,4,59,2,2,0.32
4,2,hers,4,60,3,1,0.28
4,2,how,3,61,1,2,0.28
4,2,hunt,4,62,1,3,0.4
4,2,info,4,63,0,4,0.44
4,2,into,4,64,2,2,0.44
4,2,iron,4,65,1,3,0.4
4,2,joy,3,66,0,3,0.32
4,2,jump,4,67,1,3,0.4
4,2,june,4,68,2,2,0.32
4,2,kit,3,69,0,3,0.36
4,2,know,4,70,1,3,0.48
4,2,lack,4,71,0,4,0.44
4,2,lad,3,72,2,1,0.24
4,2,lake,4,73,2,2,0.32
4,2,lap,3,74,2,1,0.24
4,2,last,4,75,2,2,0.32
4,2,lawn,4,76,2,2,0.48
4,2,left,4,77,1,3,0.64
4,2,lens,4,78,2,2,0.32
4,2,lie,3,79,1,2,0.28
4,2,limb,4,80,2,2,0.4
4,2,lot,3,81,1,2,0.56
4,2,love,4,82,2,2,0.4
4,2,low,3,83,2,1,0.28
4,2,mark,4,84,0,4,0.56
4,2,mask,4,85,2,2,0.32
4,2,meal,4,86,1,3,0.4
4,2,mean,4,87,3,1,0.28
4,2,more,4,88,1,3,0.4
4,2,mum,3,89,1,2,0.28
4,2,my,2,90,1,1,0.2
4,2,myth,4,91,2,2,0.44
4,2,name,4,92,0,4,0.44
4,2,not,3,93,1,2,0.28
4,2,pace,4,94,0,4,0.44
4,2,pack,4,95,3,1,0.28
4,2,pad,3,96,2,1,0.24
4,2,page,4,97,2,2,0.44
4,2,park,4,98,2,2,0.36
4,2,pick,4,99,1,3,0.4
4,2,pile,4,100,2,2,0.6
4,2,pin,3,101,2,1,0.24
4,2,pipe,4,102,2,2,0.32
4,2,plan,4,103,1,3,0.4
4,2,post,4,104,1,3,0.48
4,2,pump,4,105,1,3,0.4
4,2,punk,4,106,2,2,0.36
4,2,race,4,107,0,4,0.44
4,2,rail,4,108,2,2,0.32
4,2,rest,4,109,1,3,0.48
4,2,roll,4,110,1,3,0.48
4,2,root,4,111,2,2,0.36
4,2,sale,4,112,0,4,0.44
4,2,salt,4,113,3,1,0.28
4,2,sand,4,114,2,2,0.48
4,2,scan,4,115,1,3,0.52
4,2,seal,4,116,1,3,0.56
4,2,sexy,4,117,2,2,0.32
4,2,ship,4,118,1,3,0.4
4,2,sin,3,119,1,2,0.28
4,2,sit,3,120,2,1,0.24
4,2,slam,4,121,1,3,0.36
4,2,snow,4,122,1,3,0.36
4,2,soap,4,123,1,3,0.48
4,2,solo,4,124,2,2,0.32
4,2,some,4,125,2,2,0.32
4,2,soup,4,126,2,2,0.32
4,2,spin,4,127,1,3,0.36
4,2,star,4,128,1,3,0.4
4,2,stay,4,129,3,1,0.36
4,2,stem,4,130,2,2,0.32
4,2,stop,4,131,2,2,0.32
4,2,stun,4,132,2,2,0.32
4,2,such,4,133,1,3,0.4
4,2,sure,4,134,2,2,0.32
4,2,swim,4,135,1,3,0.48
4,2,task,4,136,0,4,0.44
4,2,team,4,137,1,3,0.4
4,2,tour,4,138,1,3,0.36
4,2,trap,4,139,1,3,0.36
4,2,two,3,140,1,2,0.28
4,2,vary,4,141,0,4,0.52
4,2,wake,4,142,0,4,0.44
4,2,wine,4,143,1,3,0.36
4,2,word,4,144,1,3,0.4
4,2,work,4,145,3,1,0.28
4,2,wrap,4,146,1,3,0.36
4,3,acid,4,0,0,4,0.44
4,3,ad,2,1,1,1,0.12
4,3,app,3,2,1,2,0.24
4,3,arms,4,3,1,3,0.2
4,3,ask,3,4,1,2,0.12
4,3,at,2,5,1,1,0.08
4,3,baby,4,6,0,4,0.2
4,3,bat,3,7,2,1,0.12
4,3,bay,3,8,2,1,0.08
4,3,beat,4,9,1,3,0.24
4,3,beer,4,10,2,2,0.12
4,3,best,4,11,2,2,0.12
4,3,bill,4,12,1,3,0.16
4,3,bin,3,13,2,1,0.08
4,3,bite,4,14,2,2,0.16
4,3,blow,4,15,1,3,0.16
4,3,boat,4,16,1,3,0.24
4,3,boil,4,17,2,2,0.16
4,3,bomb,4,18,2,2,0.12
4,3,boot,4,19,2,2,0.12
4,3,burn,4,20,1,3,0.16
4,3,cake,4,21,0,4,0.16
4,3,cap,3,22,2,1,0.16
4,3,cave,4,23,2,2,0.12
4,3,chop,4,24,1,3,0.16
4,3,city,4,25,1,3,0.16
4,3,club,4,26,1,3,0.16
4,3,cope,4,27,1,3,0.16
4,3,cost,4,28,2,2,0.2
4,3,coup,4,29,2,2,0.12
4,3,cry,3,30,1,2,0.12
4,3,dam,3,31,0,3,0.16
4,3,dare,4,32,2,2,0.16
4,3,day,3,33,2,1,0.12
4,3,deed,4,34,1,3,0.16
4,3,deem,4,35,3,1,0.16
4,3,dig,3,36,1,2,0.12
4,3,dust,4,37,1,3,0.16
4,3,ear,3,38,0,3,0.16
4,3,edit,4,39,1,3,0.16
4,3,exit,4,40,1,3,0.16
4,3,eye,3,41,1,2,0.12
4,3,fail,4,42,0,4,0.28
4,3,fair,4,43,3,1,0.12
4,3,fall,4,44,2,2,0.16
4,3,fear,4,45,1,3,0.16
4,3,fee,3,46,2,1,0.12
4,3,file,4,47,1,3,0.16
4,3,flat,4,48,1,3,0.24
4,3,folk,4,49,1,3,0.16
4,3,for,3,50,2,1,0.12
4,3,full,4,51,1,3,0.16
4,3,game,4,52,0,4,0.2
4,3,go,2,53,1,1,0.08
4,3,god,3,54,2,1,0.12
4,3,golf,4,55,2,2,0.2
4,3,good,4,56,2,2,0.16
4,3,guy,3,57,1,2,0.12
4,3,hair,4,58,0,4,0.2
4,3,hat,3,59,2,1,0.08
4,3,hate,4,60,3,1,0.12
4,3,her,3,61,1,2,0.12
4,3,hint,4,62,1,3,0.24
4,3,hour,4,63,1,3,0.16
4,3,how,3,64,2,1,0.12
4,3,ill,3,65,0,3,0.16
4,3,into,4,66,1,3,0.16
4,3,job,3,67,0,3,0.16
4,3,key,3,68,0,3,0.16
4,3,kid,3,69,1,2,0.2
4,3,king,4,70,2,2,0.12
4,3,lack,4,71,0,4,0.2
4,3,lad,3,72,2,1,0.08
4,3,lake,4,73,2,2,0.12
4,3,lap,3,74,2,1,0.12
4,3,last,4,75,2,2,0.12
4,3,leaf,4,76,1,3,0.24
4,3,lens,4,77,2,2,0.16
4,3,lie,3,78,1,2,0.12
4,3,lion,4,79,2,2,0.12
4,3,load,4,80,1,3,0.16
4,3,look,4,81,2,2,0.12
4,3,lot,3,82,2,1,0.16
4,3,love,4,83,2,2,0.12
4,3,map,3,84,0,3,0.12
4,3,mean,4,85,1,3,0.16
4,3,mess,4,86,2,2,0.16
4,3,more,4,87,1,3,0.16
4,3,most,4,88,2,2,0.16
4,3,name,4,89,0,4,0.24
4,3,non,3,90,1,2,0.12
4,3,norm,4,91,2,2,0.12
4,3,not,3,92,2,1,0.08
4,3,note,4,93,3,1,0.12
4,3,off,3,94,0,3,0.16
4,3,once,4,95,1,3,0.24
4,3,one,3,96,2,1,0.12
4,3,owe,3,97,1,2,0.12
4,3,pad,3,98,0,3,0.16
4,3,pick,4,99,1,3,0.16
4,3,pin,3,100,2,1,0.08
4,3,pipe,4,101,2,2,0.12
4,3,plan,4,102,1,3,0.24
4,3,play,4,103,3,1,0.12
4,3,push,4,104,1,3,0.16
4,3,rear,4,105,0,4,0.2
4,3,rest,4,106,2,2,0.12
4,3,rise,4,107,1,3,0.16
4,3,road,4,108,1,3,0.24
4,3,roll,4,109,2,2,0.12
4,3,roof,4,110,2,2,0.2
4,3,rub,3,111,1,2,0.12
4,3,ruin,4,112,2,2,0.16
4,3,safe,4,113,0,4,0.2
4,3,sale,4,114,2,2,0.16
4,3,sand,4,115,2,2,0.2
4,3,seal,4,116,1,3,0.16
4,3,seem,4,117,2,2,0.12
4,3,sexy,4,118,2,2,0.16
4,3,ship,4,119,1,3,0.16
4,3,slam,4,120,1,3,0.16
4,3,slip,4,121,2,2,0.2
4,3,song,4,122,1,3,0.16
4,3,soup,4,123,2,2,0.16
4,3,stab,4,124,1,3,0.16
4,3,star,4,125,3,1,0.12
4,3,such,4,126,1,3,0.16
4,3,sue,3,127,2,1,0.08
4,3,sure,4,128,2,2,0.2
4,3,tail,4,129,0,4,0.2
4,3,tap,3,130,2,1,0.08
4,3,taxi,4,131,2,2,0.12
4,3,till,4,132,1,3,0.16
4,3,tool,4,133,1,3,0.16
4,3,tree,4,134,1,3,0.24
4,3,trio,4,135,2,2,0.12
4,3,two,3,136,1,2,0.12
4,3,vary,4,137,0,4,0.2
4,3,vein,4,138,1,3,0.16
4,3,wait,4,139,0,4,0.2
4,3,wake,4,140,2,2,0.28
4,3,war,3,141,2,1,0.12
4,3,west,4,142,1,3,0.16
4,3,wind,4,143,1,3,0.16
4,3,wine,4,144,3,1,0.12
4,3,word,4,145,1,3,0.16
4,3,wow,3,146,2,1,0.12
4,4,acre,4,0,0,4,0.2
4,4,aids,4,1,1,3,0.16
4,4,and,3,2,1,2,0.2
4,4,app,3,3,1,2,0.12
4,4,arms,4,4,1,3,0.16
4,4,at,2,5,1,1,0.08
4,4,auto,4,6,1,3,0.16
4,4,bat,3,7,0,3,0.16
4,4,beat,4,8,1,3,0.16
4,4,bell,4,9,2,2,0.2
4,4,bin,3,10,1,2,0.12
4,4,bite,4,11,2,2,0.12
4,4,blog,4,12,1,3,0.16
4,4,blow,4,13,3,1,0.12
4,4,boot,4,14,1,3,0.16
4,4,burn,4,15,1,3,0.24
4,4,cake,4,16,0,4,0.2
4,4,cap,3,17,2,1,0.12
4,4,cave,4,18,2,2,0.16
4,4,cd,2,19,1,1,0.08
4,4,chop,4,20,1,3,0.16
4,4,cite,4,21,1,3,0.16
4,4,club,4,22,1,3,0.2
4,4,cost,4,23,1,3,0.16
4,4,coup,4,24,2,2,0.12
4,4,dam,3,25,0,3,0.16
4,4,dare,4,26,2,2,0.12
4,4,day,3,27,2,1,0.08
4,4,deem,4,28,1,3,0.24
4,4,dig,3,29,1,2,0.12
4,4,dot,3,30,1,2,0.12
4,4,fair,4,31,0,4,0.2
4,4,fall,4,32,2,2,0.16
4,4,fat,3,33,2,1,0.08
4,4,fear,4,34,1,3,0.16
4,4,file,4,35,1,3,0.2
4,4,flag,4,36,1,3,0.16
4,4,flat,4,37,3,1,0.12
4,4,folk,4,38,1,3,0.16
4,4,food,4,39,2,2,0.12
4,4,full,4,40,1,3,0.16
4,4,fur,3,41,2,1,0.16
4,4,game,4,42,0,4,0.2
4,4,gene,4,43,1,3,0.16
4,4,give,4,44,1,3,0.16
4,4,go,2,45,1,1,0.08
4,4,grid,4,46,1,3,0.16
4,4,grin,4,47,3,1,0.12
4,4,guy,3,48,1,2,0.16
4,4,harm,4,49,0,4,0.2
4,4,heat,4,50,1,3,0.16
4,4,herb,4,51,2,2,0.16
4,4,hour,4,52,1,3,0.16
4,4,i,1,53,0,1,0.08
4,4,ill,3,54,1,2,0.12
4,4,info,4,55,1,3,0.2
4,4,into,4,56,2,2,0.12
4,4,jet,3,57,0,3,0.16
4,4,job,3,58,1,2,0.24
4,4,june,4,59,1,3,0.36
4,4,key,3,60,0,3,0.32
4,4,kid,3,61,1,2,0.28
4,4,king,4,62,2,2,0.44
4,4,know,4,63,1,3,0.36
4,4,lack,4,64,0,4,0.44
4,4,lad,3,65,2,1,0.24
4,4,last,4,66,2,2,0.32
4,4,law,3,67,2,1,0.24
4,4,leaf,4,68,1,3,0.48
4,4,lie,3,69,1,2,0.28
4,4,limb,4,70,2,2,0.32
4,4,link,4,71,2,2,0.32
4,4,lion,4,72,2,2,0.32
4,4,live,4,73,2,2,0.32
4,4,long,4,74,1,3,0.44
4,4,look,4,75,2,2,0.44
4,4,love,4,76,2,2,0.32
4,4,mail,4,77,0,4,0.44
4,4,main,4,78,3,1,0.28
4,4,mark,4,79,2,2,0.32
4,4,mean,4,80,1,3,0.36
4,4,mess,4,81,2,2,0.44
4,4,mind,4,82,1,3,0.4
4,4,more,4,83,1,3,0.36
4,4,most,4,84,2,2,0.32
4,4,much,4,85,1,3,0.36
4,4,my,2,86,1,1,0.2
4,4,myth,4,87,2,2,0.32
4,4,name,4,88,0,4,0.52
4,4,neck,4,89,1,3,0.36
4,4,new,3,90,2,1,0.24
4,4,non,3,91,1,2,0.28
4,4,off,3,92,0,3,0.36
4,4,pace,4,93,0,4,0.48
4,4,pack,4,94,3,1,0.4
4,4,pad,3,95,2,1,0.28
4,4,peer,4,96,1,3,0.44
4,4,pick,4,97,1,3,0.44
4,4,pin,3,98,2,1,0.28
4,4,pipe,4,99,2,2,0.36
4,4,plot,4,100,1,3,0.4
4,4,pond,4,101,1,3,0.52
4,4,post,4,102,2,2,0.32
4,4,pump,4,103,1,3,0.36
4,4,race,4,104,0,4,0.44
4,4,rear,4,105,1,3,0.44
4,4,rest,4,106,2,2,0.32
4,4,rise,4,107,1,3,0.52
4,4,roof,4,108,1,3,0.44
4,4,sale,4,109,0,4,0.52
4,4,salt,4,110,3,1,0.32
4,4,sand,4,111,2,2,0.32
4,4,seem,4,112,1,3,0.36
4,4,sexy,4,113,2,2,0.44
4,4,ship,4,114,1,3,0.4
4,4,sink,4,115,1,3,0.36
4,4,sit,3,116,2,1,0.24
4,4,ski,3,117,1,2,0.28
4,4,slam,4,118,1,3,0.4
4,4,snow,4,119,1,3,0.36
4,4,soap,4,120,1,3,0.48
4,4,spin,4,121,1,3,0.4
4,4,stun,4,122,1,3,0.36
4,4,sue,3,123,1,2,0.28
4,4,sure,4,124,2,2,0.4
4,4,swim,4,125,1,3,0.48
4,4,talk,4,126,0,4,0.6
4,4,tank,4,127,2,2,0.32
4,4,tape,4,128,2,2,0.32
4,4,team,4,129,1,3,0.36
4,4,too,3,130,1,2,0.28
4,4,tool,4,131,3,1,0.28
4,4,tour,4,132,2,2,0.44
4,4,trap,4,133,1,3,0.4
4,4,trio,4,134,2,2,0.32
4,4,tune,4,135,1,3,0.36
4,4,two,3,136,1,2,0.28
4,4,upon,4,137,0,4,0.44
4,4,vary,4,138,0,4,0.44
4,4,wait,4,139,0,4,0.56
4,4,wake,4,140,2,2,0.32
4,4,war,3,141,2,1,0.24
4,4,way,3,142,2,1,0.28
4,4,win,3,143,1,2,0.28
4,4,wind,4,144,3,1,0.28
4,4,word,4,145,1,3,0.48
4,4,wrap,4,146,1,3,0.36
4,5,acid,4,0,0,4,0.44
4,5,ad,2,1,1,1,0.2
4,5,adj,3,2,2,1,0.24
4,5,aids,4,3,1,3,0.36
4,5,and,3,4,1,2,0.28
4,5,app,3,5,1,2,0.28
4,5,army,4,6,1,3,0.48
4,5,ask,3,7,1,2,0.28
4,5,at,2,8,1,1,0.2
4,5,base,4,9,0,4,0.44
4,5,beat,4,10,1,3,0.4
4,5,beer,4,11,2,2,0.32
4,5,beg,3,12,2,1,0.24
4,5,bell,4,13,2,2,0.44
4,5,blog,4,14,1,3,0.36
4,5,boil,4,15,1,3,0.36
4,5,bomb,4,16,2,2,0.32
4,5,boot,4,17,2,2,0.32
4,5,box,3,18,2,1,0.24
4,5,city,4,19,0,4,0.52
4,5,club,4,20,1,3,0.4
4,5,coup,4,21,1,3,0.4
4,5,cry,3,22,1,2,0.28
4,5,dam,3,23,0,3,0.36
4,5,day,3,24,2,1,0.24
4,5,deed,4,25,1,3,0.4
4,5,deem,4,26,3,1,0.36
4,5,dig,3,27,1,2,0.32
4,5,dust,4,28,1,3,0.4
4,5,edit,4,29,0,4,0.52
4,5,euro,4,30,1,3,0.44
4,5,exit,4,31,1,3,0.4
4,5,fail,4,32,0,4,0.56
4,5,fair,4,33,3,1,0.28
4,5,fall,4,34,2,2,0.32
4,5,fat,3,35,2,1,0.24
4,5,fear,4,36,1,3,0.36
4,5,fee,3,37,2,1,0.24
4,5,fix,3,38,1,2,0.32
4,5,flag,4,39,1,3,0.48
4,5,flat,4,40,3,1,0.28
4,5,folk,4,41,1,3,0.36
4,5,game,4,42,0,4,0.44
4,5,go,2,43,1,1,0.2
4,5,golf,4,44,2,2,0.32
4,5,grey,4,45,1,3,0.36
4,5,grid,4,46,2,2,0.4
4,5,guy,3,47,1,2,0.28
4,5,gym,3,48,1,2,0.28
4,5,hair,4,49,0,4,0.44
4,5,hat,3,50,2,1,0.24
4,5,her,3,51,1,2,0.28
4,5,hers,4,52,3,1,0.28
4,5,hour,4,53,1,3,0.48
4,5,how,3,54,2,1,0.24
4,5,hunt,4,55,1,3,0.44
4,5,ice,3,56,0,3,0.32
4,5,icon,4,57,2,2,0.32
4,5,ill,3,58,1,2,0.28
4,5,info,4,59,1,3,0.48
4,5,into,4,60,2,2,0.32
4,5,iron,4,61,1,3,0.4
4,5,job,3,62,0,3,0.36
4,5,joy,3,63,2,1,0.24
4,5,jump,4,64,1,3,0.36
4,5,june,4,65,2,2,0.32
4,5,kick,4,66,0,4,0.56
4,5,lad,3,67,0,3,0.32
4,5,lake,4,68,2,2,0.32
4,5,last,4,69,2,2,0.32
4,5,lawn,4,70,2,2,0.4
4,5,leaf,4,71,1,3,0.4
4,5,lens,4,72,2,2,0.44
4,5,live,4,73,1,3,0.36
4,5,load,4,74,1,3,0.4
4,5,log,3,75,2,1,0.24
4,5,long,4,76,2,2,0.32
4,5,look,4,77,2,2,0.32
4,5,mail,4,78,0,4,0.44
4,5,main,4,79,3,1,0.36
4,5,mean,4,80,1,3,0.36
4,5,mind,4,81,1,3,0.4
4,5,more,4,82,1,3,0.36
4,5,most,4,83,2,2,0.32
4,5,much,4,84,1,3,0.36
4,5,must,4,85,2,2,0.4
4,5,my,2,86,1,1,0.12
4,5,name,4,87,0,4,0.28
4,5,neck,4,88,1,3,0.2
4,5,norm,4,89,1,3,0.16
4,5,not,3,90,2,1,0.12
4,5,nut,3,91,1,2,0.12
4,5,off,3,92,0,3,0.2
4,5,once,4,93,1,3,0.16
4,5,one,3,94,2,1,0.12
4,5,pace,4,95,0,4,0.2
4,5,pack,4,96,3,1,0.12
4,5,peer,4,97,1,3,0.16
4,5,pig,3,98,1,2,0.2
4,5,pile,4,99,2,2,0.16
4,5,pin,3,100,2,1,0.12
4,5,pipe,4,101,2,2,0.16
4,5,play,4,102,1,3,0.16
4,5,plot,4,103,2,2,0.16
4,5,post,4,104,1,3,0.16
4,5,pump,4,105,1,3,0.24
4,5,punk,4,106,2,2,0.16
4,5,pure,4,107,2,2,0.12
4,5,race,4,108,0,4,0.24
4,5,rip,3,109,1,2,0.12
4,5,rob,3,110,1,2,0.12
4,5,root,4,111,2,2,0.2
4,5,ruin,4,112,1,3,0.16
4,5,safe,4,113,0,4,0.2
4,5,sale,4,114,2,2,0.12
4,5,sand,4,115,2,2,0.12
4,5,scan,4,116,1,3,0.16
4,5,seal,4,117,1,3,0.16
4,5,seem,4,118,2,2,0.2
4,5,ship,4,119,1,3,0.16
4,5,skip,4,120,1,3,0.16
4,5,slip,4,121,1,3,0.16
4,5,snow,4,122,1,3,0.16
4,5,solo,4,123,1,3,0.16
4,5,some,4,124,2,2,0.2
4,5,song,4,125,2,2,0.16
4,5,soup,4,126,2,2,0.16
4,5,sue,3,127,1,2,0.12
4,5,swim,4,128,1,3,0.16
4,5,tale,4,129,0,4,0.2
4,5,talk,4,130,3,1,0.16
4,5,tap,3,131,2,1,0.08
4,5,tape,4,132,3,1,0.12
4,5,tea,3,133,1,2,0.12
4,5,to,2,134,1,1,0.08
4,5,too,3,135,2,1,0.12
4,5,tool,4,136,3,1,0.12
4,5,tour,4,137,2,2,0.2
4,5,tune,4,138,1,3,0.16
4,5,two,3,139,1,2,0.12
4,5,vein,4,140,0,4,0.16
4,5,wait,4,141,0,4,0.2
4,5,west,4,142,1,3,0.16
4,5,wine,4,143,1,3,0.16
4,5,work,4,144,1,3,0.24
4,5,wow,3,145,2,1,0.08
4,5,wrap,4,146,1,3,0.16
4,6,acid,4,0,0,4,0.2
4,6,acre,4,1,2,2,0.12
4,6,ad,2,2,1,1,0.08
4,6,aids,4,3,1,3,0.16
4,6,arms,4,4,1,3,0.24
4,6,army,4,5,3,1,0.16
4,6,ask,3,6,1,2,0.12
4,6,at,2,7,1,1,0.08
4,6,auto,4,8,1,3,0.2
4,6,baby,4,9,0,4,0.2
4,6,bat,3,10,2,1,0.12
4,6,bath,4,11,3,1,0.2
4,6,beat,4,12,1,3,0.16
4,6,beer,4,13,2,2,0.16
4,6,beg,3,14,2,1,0.12
4,6,best,4,15,2,2,0.12
4,6,bill,4,16,1,3,0.2
4,6,boat,4,17,1,3,0.24
4,6,bug,3,18,1,2,0.12
4,6,burn,4,19,2,2,0.16
4,6,cafe,4,20,0,4,0.2
4,6,cap,3,21,2,1,0.08
4,6,cd,2,22,1,1,0.08
4,6,chop,4,23,1,3,0.16
4,6,city,4,24,1,3,0.24
4,6,cope,4,25,1,3,0.16
4,6,cost,4,26,2,2,0.12
4,6,coup,4,27,2,2,0.16
4,6,dam,3,28,0,3,0.16
4,6,deal,4,29,1,3,0.16
4,6,dig,3,30,1,2,0.12
4,6,dirt,4,31,2,2,0.2
4,6,dot,3,32,1,2,0.12
4,6,dust,4,33,1,3,0.16
4,6,edit,4,34,0,4,0.2
4,6,euro,4,35,1,3,0.16
4,6,exit,4,36,1,3,0.2
4,6,fail,4,37,0,4,0.24
4,6,fair,4,38,3,1,0.12
4,6,fall,4,39,2,2,0.12
4,6,fast,4,40,2,2,0.16
4,6,few,3,41,1,2,0.12
4,6,file,4,42,1,3,0.16
4,6,fine,4,43,2,2,0.2
4,6,firm,4,44,2,2,0.16
4,6,flat,4,45,1,3,0.16
4,6,flu,3,46,2,1,0.12
4,6,food,4,47,1,3,0.16
4,6,for,3,48,2,1,0.12
4,6,give,4,49,0,4,0.2
4,6,go,2,50,1,1,0.12
4,6,god,3,51,2,1,0.12
4,6,golf,4,52,2,2,0.16
4,6,grey,4,53,1,3,0.2
4,6,guy,3,54,1,2,0.12
4,6,gym,3,55,1,2,0.12
4,6,hate,4,56,0,4,0.2
4,6,heat,4,57,1,3,0.24
4,6,her,3,58,2,1,0.08
4,6,hunt,4,59,1,3,0.16
4,6,i,1,60,0,1,0.08
4,6,ice,3,61,1,2,0.12
4,6,ill,3,62,1,2,0.12
4,6,info,4,63,1,3,0.16
4,6,into,4,64,2,2,0.12
4,6,iron,4,65,1,3,0.24
4,6,job,3,66,0,3,0.16
4,6,joy,3,67,2,1,0.12
4,6,june,4,68,1,3,0.16
4,6,key,3,69,0,3,0.16
4,6,kit,3,70,1,2,0.12
4,6,lack,4,71,0,4,0.28
4,6,lad,3,72,2,1,0.12
4,6,lawn,4,73,2,2,0.16
4,6,left,4,74,1,3,0.16
4,6,lie,3,75,1,2,0.12
4,6,limb,4,76,2,2,0.12
4,6,link,4,77,2,2,0.12
4,6,lion,4,78,2,2,0.2
4,6,live,4,79,2,2,0.16
4,6,log,3,80,1,2,0.12
4,6,long,4,81,2,2,0.12
4,6,look,4,82,2,2,0.16
4,6,lot,3,83,2,1,0.12
4,6,love,4,84,2,2,0.16
4,6,map,3,85,0,3,0.2
4,6,mask,4,86,2,2,0.16
4,6,mean,4,87,1,3,0.16
4,6,more,4,88,1,3,0.16
4,6,most,4,89,2,2,0.12
4,6,much,4,90,1,3,0.16
4,6,mum,3,91,2,1,0.16
4,6,my,2,92,1,1,0.08
4,6,name,4,93,0,4,0.2
4,6,neck,4,94,1,3,0.16
4,6,new,3,95,2,1,0.12
4,6,note,4,96,1,3,0.16
4,6,pace,4,97,0,4,0.2
4,6,pack,4,98,3,1,0.2
4,6,pad,3,99,2,1,0.08
4,6,pig,3,100,1,2,0.12
4,6,play,4,101,1,3,0.16
4,6,plot,4,102,2,2,0.16
4,6,pot,3,103,1,2,0.12
4,6,put,3,104,1,2,0.12
4,6,rear,4,105,0,4,0.24
4,6,rest,4,106,2,2,0.16
4,6,rise,4,107,1,3,0.16
4,6,road,4,108,1,3,0.16
4,6,rob,3,109,2,1,0.12
4,6,roll,4,110,2,2,0.16
4,6,ruin,4,111,1,3,0.24
4,6,safe,4,112,0,4,0.2
4,6,scan,4,113,1,3,0.16
4,6,seal,4,114,1,3,0.16
4,6,sexy,4,115,2,2,0.12
4,6,sit,3,116,1,2,0.12
4,6,six,3,117,2,1,0.08
4,6,ski,3,118,1,2,0.2
4,6,skip,4,119,3,1,0.12
4,6,slam,4,120,1,3,0.16
4,6,slip,4,121,2,2,0.12
4,6,snow,4,122,1,3,0.16
4,6,solo,4,123,1,3,0.16
4,6,star,4,124,1,3,0.24
4,6,stem,4,125,2,2,0.12
4,6,stun,4,126,2,2,0.16
4,6,sue,3,127,1,2,0.12
4,6,swim,4,128,1,3,0.16
4,6,tail,4,129,0,4,0.2
4,6,tank,4,130,2,2,0.12
4,6,tap,3,131,2,1,0.16
4,6,tape,4,132,3,1,0.12
4,6,taxi,4,133,2,2,0.12
4,6,tea,3,134,1,2,0.12
4,6,tidy,4,135,1,3,0.16
4,6,till,4,136,2,2,0.16
4,6,tree,4,137,1,3,0.24
4,6,trio,4,138,2,2,0.16
4,6,tune,4,139,1,3,0.16
4,6,upon,4,140,0,4,0.2
4,6,wake,4,141,0,4,0.2
4,6,way,3,142,2,1,0.12
4,6,west,4,143,1,3,0.16
4,6,win,3,144,1,2,0.2
4,6,wipe,4,145,2,2,0.12
4,6,wow,3,146,1,2,0.12
4,7,acid,4,0,0,4,0.2
4,7,acre,4,1,2,2,0.16
4,7,ad,2,2,1,1,0.08
4,7,add,3,3,2,1,0.12
4,7,adj,3,4,2,1,0.12
4,7,arms,4,5,1,3,0.24
4,7,army,4,6,3,1,0.12
4,7,ask,3,7,1,2,0.12
4,7,at,2,8,1,1,0.08
4,7,baby,4,9,0,4,0.2
4,7,base,4,10,2,2,0.16
4,7,bat,3,11,2,1,0.08
4,7,bay,3,12,2,1,0.16
4,7,beat,4,13,1,3,0.16
4,7,bed,3,14,2,1,0.12
4,7,beg,3,15,2,1,0.12
4,7,bell,4,16,2,2,0.16
4,7,bill,4,17,1,3,0.16
4,7,bin,3,18,2,1,0.08
4,7,blog,4,19,1,3,0.24
4,7,blow,4,20,3,1,0.12
4,7,boat,4,21,1,3,0.16
4,7,boot,4,22,2,2,0.12
4,7,box,3,23,2,1,0.08
4,7,bug,3,24,1,2,0.12
4,7,burn,4,25,2,2,0.2
4,7,cafe,4,26,0,4,0.2
4,7,cap,3,27,2,1,0.12
4,7,card,4,28,2,2,0.12
4,7,coup,4,29,1,3,0.16
4,7,dare,4,30,0,4,0.2
4,7,day,3,31,2,1,0.12
4,7,deal,4,32,1,3,0.24
4,7,deed,4,33,2,2,0.12
4,7,deem,4,34,3,1,0.12
4,7,dig,3,35,1,2,0.12
4,7,dot,3,36,1,2,0.2
4,7,ear,3,37,0,3,0.16
4,7,euro,4,38,1,3,0.16
4,7,exit,4,39,1,3,0.24
4,7,eye,3,40,1,2,0.12
4,7,fail,4,41,0,4,0.2
4,7,fair,4,42,3,1,0.12
4,7,fall,4,43,2,2,0.16
4,7,fast,4,44,2,2,0.16
4,7,fear,4,45,1,3,0.24
4,7,fee,3,46,2,1,0.12
4,7,file,4,47,1,3,0.16
4,7,firm,4,48,2,2,0.16
4,7,fix,3,49,2,1,0.08
4,7,flag,4,50,1,3,0.16
4,7,flat,4,51,3,1,0.12
4,7,folk,4,52,1,3,0.24
4,7,frog,4,53,1,3,0.16
4,7,fur,3,54,1,2,0.12
4,7,game,4,55,0,4,0.2
4,7,go,2,56,1,1,0.08
4,7,god,3,57,2,1,0.08
4,7,grey,4,58,1,3,0.16
4,7,grid,4,59,2,2,0.2
4,7,grin,4,60,3,1,0.12
4,7,harm,4,61,0,4,0.2
4,7,hate,4,62,2,2,0.16
4,7,heat,4,63,1,3,0.16
4,7,her,3,64,2,1,0.12
4,7,herb,4,65,3,1,0.2
4,7,hers,4,66,3,1,0.12
4,7,how,3,67,1,2,0.12
4,7,hunt,4,68,1,3,0.16
4,7,ill,3,69,0,3,0.16
4,7,job,3,70,0,3,0.16
4,7,joy,3,71,2,1,0.12
4,7,just,4,72,1,3,0.24
4,7,king,4,73,0,4,0.2
4,7,know,4,74,1,3,0.16
4,7,lad,3,75,0,3,0.16
4,7,lap,3,76,2,1,0.12
4,7,law,3,77,2,1,0.12
4,7,left,4,78,1,3,0.16
4,7,lie,3,79,1,2,0.2
4,7,link,4,80,2,2,0.16
4,7,live,4,81,2,2,0.16
4,7,load,4,82,1,3,0.16
4,7,look,4,83,2,2,0.16
4,7,low,3,84,2,1,0.08
4,7,map,3,85,0,3,0.16
4,7,mean,4,86,1,3,0.24
4,7,mess,4,87,2,2,0.12
4,7,mum,3,88,1,2,0.12
4,7,must,4,89,2,2,0.12
4,7,my,2,90,1,1,0.08
4,7,myth,4,91,2,2,0.12
4,7,new,3,92,0,3,0.16
4,7,non,3,93,1,2,0.2
4,7,norm,4,94,2,2,0.16
4,7,owe,3,95,0,3,0.16
4,7,pad,3,96,0,3,0.16
4,7,page,4,97,2,2,0.12
4,7,pig,3,98,1,2,0.12
4,7,pin,3,99,2,1,0.08
4,7,pipe,4,100,2,2,0.2
4,7,plan,4,101,1,3,0.16
4,7,play,4,102,3,1,0.12
4,7,plot,4,103,2,2,0.12
4,7,pond,4,104,1,3,0.16
4,7,pump,4,105,1,3,0.16
4,7,punk,4,106,2,2,0.2
4,7,push,4,107,2,2,0.16
4,7,race,4,108,0,4,0.2
4,7,rear,4,109,1,3,0.16
4,7,rise,4,110,1,3,0.16
4,7,road,4,111,1,3,0.16
4,7,roll,4,112,2,2,0.2
4,7,ruin,4,113,1,3,0.16
4,7,safe,4,114,0,4,0.2
4,7,sale,4,115,2,2,0.16
4,7,salt,4,116,3,1,0.12
4,7,sand,4,117,2,2,0.12
4,7,seal,4,118,1,3,0.24
4,7,sit,3,119,1,2,0.12
4,7,slam,4,120,1,3,0.16
4,7,song,4,121,1,3,0.16
4,7,spin,4,122,1,3,0.16
4,7,stab,4,123,1,3,0.16
4,7,stay,4,124,3,1,0.12
4,7,such,4,125,1,3,0.2
4,7,sure,4,126,2,2,0.12
4,7,tail,4,127,0,4,0.2
4,7,talk,4,128,2,2,0.16
4,7,tank,4,129,2,2,0.12
4,7,tap,3,130,2,1,0.08
4,7,team,4,131,1,3,0.24
4,7,this,4,132,1,3,0.16
4,7,tidy,4,133,1,3,0.16
4,7,till,4,134,2,2,0.16
4,7,tour,4,135,1,3,0.16
4,7,trap,4,136,1,3,0.16
4,7,tree,4,137,2,2,0.2
4,7,trio,4,138,2,2,0.12
4,7,two,3,139,1,2,0.16
4,7,vary,4,140,0,4,0.28
4,7,vein,4,141,1,3,0.16
4,7,wake,4,142,0,4,0.2
4,7,walk,4,143,2,2,0.12
4,7,way,3,144,2,1,0.16
4,7,wine,4,145,1,3,0.16
4,7,work,4,146,1,3,0.16
4,8,a,1,0,0,1,0.2
4,8,acid,4,1,1,3,0.44
4,8,ad,2,2,1,1,0.24
4,8,adj,3,3,2,1,0.36
4,8,ally,4,4,1,3,0.48
4,8,app,3,5,1,2,0.36
4,8,arms,4,6,1,3,0.44
4,8,army,4,7,3,1,0.32
4,8,ask,3,8,1,2,0.32
4,8,baby,4,9,0,4,0.68
4,8,base,4,10,2,2,0.4
4,8,bat,3,11,2,1,0.32
4,8,beat,4,12,1,3,0.4
4,8,bed,3,13,2,1,0.24
4,8,beer,4,14,2,2,0.4
4,8,boat,4,15,1,3,0.56
4,8,boom,4,16,2,2,0.44
4,8,boot,4,17,3,1,0.32
4,8,box,3,18,2,1,0.28
4,8,bug,3,19,1,2,0.32
4,8,burn,4,20,2,2,0.36
4,8,cake,4,21,0,4,0.44
4,8,cave,4,22,2,2,0.44
4,8,cd,2,23,1,1,0.2
4,8,cite,4,24,1,3,0.4
4,8,city,4,25,3,1,0.28
4,8,cost,4,26,1,3,0.48
4,8,cry,3,27,1,2,0.36
4,8,dam,3,28,0,3,0.44
4,8,day,3,29,2,1,0.28
4,8,deal,4,30,1,3,0.4
4,8,deed,4,31,2,2,0.36
4,8,dig,3,32,1,2,0.32
4,8,dirt,4,33,2,2,0.4
4,8,euro,4,34,0,4,0.44
4,8,exit,4,35,1,3,0.48
4,8,fail,4,36,0,4,0.48
4,8,fall,4,37,2,2,0.44
4,8,fast,4,38,2,2,0.36
4,8,fear,4,39,1,3,0.44
4,8,fee,3,40,2,1,0.24
4,8,fine,4,41,1,3,0.48
4,8,flee,4,42,1,3,0.44
4,8,food,4,43,1,3,0.4
4,8,for,3,44,2,1,0.24
4,8,frog,4,45,1,3,0.4
4,8,full,4,46,1,3,0.4
4,8,fur,3,47,2,1,0.32
4,8,game,4,48,0,4,0.44
4,8,give,4,49,1,3,0.4
4,8,god,3,50,1,2,0.32
4,8,gold,4,51,2,2,0.32
4,8,golf,4,52,3,1,0.28
4,8,good,4,53,2,2,0.32
4,8,grid,4,54,1,3,0.52
4,8,gym,3,55,1,2,0.32
4,8,hat,3,56,0,3,0.4
4,8,heat,4,57,1,3,0.44
4,8,her,3,58,2,1,0.24
4,8,herb,4,59,3,1,0.28
4,8,hers,4,60,3,1,0.36
4,8,hint,4,61,1,3,0.4
4,8,hour,4,62,1,3,0.4
4,8,hunt,4,63,1,3,0.4
4,8,i,1,64,0,1,0.16
4,8,ice,3,65,1,2,0.28
4,8,icon,4,66,2,2,0.32
4,8,ill,3,67,1,2,0.4
4,8,jet,3,68,0,3,0.36
4,8,jump,4,69,1,3,0.4
4,8,june,4,70,2,2,0.32
4,8,just,4,71,2,2,0.32
4,8,key,3,72,0,3,0.36
4,8,kick,4,73,1,3,0.4
4,8,kid,3,74,2,1,0.32
4,8,king,4,75,2,2,0.32
4,8,kit,3,76,2,1,0.24
4,8,lack,4,77,0,4,0.44
4,8,lad,3,78,2,1,0.24
4,8,lap,3,79,2,1,0.36
4,8,last,4,80,2,2,0.36
4,8,leaf,4,81,1,3,0.6
4,8,left,4,82,2,2,0.36
4,8,lens,4,83,2,2,0.32
4,8,lie,3,84,1,2,0.28
4,8,limb,4,85,2,2,0.32
4,8,live,4,86,2,2,0.32
4,8,load,4,87,1,3,0.48
4,8,look,4,88,2,2,0.32
4,8,love,4,89,2,2,0.36
4,8,mail,4,90,0,4,0.44
4,8,mind,4,91,1,3,0.4
4,8,much,4,92,1,3,0.4
4,8,my,2,93,1,1,0.2
4,8,myth,4,94,2,2,0.4
4,8,norm,4,95,0,4,0.48
4,8,one,3,96,0,3,0.36
4,8,pace,4,97,0,4,0.44
4,8,page,4,98,2,2,0.32
4,8,peer,4,99,1,3,0.4
4,8,pig,3,100,1,2,0.4
4,8,pin,3,101,2,1,0.24
4,8,pond,4,102,1,3,0.4
4,8,pot,3,103,2,1,0.24
4,8,pump,4,104,1,3,0.4
4,8,push,4,105,2,2,0.32
4,8,put,3,106,2,1,0.24
4,8,race,4,107,0,4,0.56
4,8,rail,4,108,2,2,0.32
4,8,road,4,109,1,3,0.4
4,8,roll,4,110,2,2,0.32
4,8,roof,4,111,2,2,0.32
4,8,sand,4,112,0,4,0.48
4,8,seem,4,113,1,3,0.48
4,8,ship,4,114,1,3,0.4
4,8,sin,3,115,1,2,0.28
4,8,sink,4,116,3,1,0.28
4,8,six,3,117,2,1,0.24
4,8,ski,3,118,1,2,0.28
4,8,skip,4,119,3,1,0.28
4,8,slip,4,120,1,3,0.48
4,8,some,4,121,1,3,0.4
4,8,soup,4,122,2,2,0.32
4,8,spin,4,123,1,3,0.36
4,8,star,4,124,1,3,0.4
4,8,stem,4,125,2,2,0.32
4,8,such,4,126,1,3,0.48
4,8,sure,4,127,2,2,0.32
4,8,tail,4,128,0,4,0.44
4,8,tale,4,129,2,2,0.32
4,8,talk,4,130,3,1,0.28
4,8,tank,4,131,2,2,0.32
4,8,taxi,4,132,2,2,0.4
4,8,tea,3,133,1,2,0.28
4,8,team,4,134,3,1,0.28
4,8,till,4,135,1,3,0.4
4,8,too,3,136,1,2,0.28
4,8,trap,4,137,1,3,0.44
4,8,two,3,138,1,2,0.32
4,8,vein,4,139,0,4,0.52
4,8,wait,4,140,0,4,0.44
4,8,war,3,141,2,1,0.24
4,8,way,3,142,2,1,0.24
4,8,west,4,143,1,3,0.4
4,8,wind,4,144,1,3,0.36
4,8,wine,4,145,3,1,0.28
4,8,work,4,146,1,3,0.48
4,9,a,1,0,0,1,0.16
4,9,acid,4,1,1,3,0.36
4,9,ad,2,2,1,1,0.2
4,9,adj,3,3,2,1,0.24
4,9,aids,4,4,1,3,0.36
4,9,and,3,5,1,2,0.28
4,9,app,3,6,1,2,0.28
4,9,army,4,7,1,3,0.48
4,9,ask,3,8,1,2,0.28
4,9,at,2,9,1,1,0.2
4,9,bat,3,10,0,3,0.32
4,9,bath,4,11,3,1,0.28
4,9,beat,4,12,1,3,0.4
4,9,beg,3,13,2,1,0.24
4,9,bell,4,14,2,2,0.44
4,9,bin,3,15,1,2,0.32
4,9,bird,4,16,2,2,0.4
4,9,bite,4,17,2,2,0.32
4,9,blog,4,18,1,3,0.4
4,9,blow,4,19,3,1,0.28
4,9,boat,4,20,1,3,0.48
4,9,bomb,4,21,2,2,0.32
4,9,boot,4,22,2,2,0.32
4,9,cake,4,23,0,4,0.44
4,9,city,4,24,1,3,0.36
4,9,club,4,25,1,3,0.24
4,9,cope,4,26,1,3,0.48
4,9,coup,4,27,2,2,0.16
4,9,cry,3,28,1,2,0.16
4,9,dare,4,29,0,4,0.2
4,9,day,3,30,2,1,0.12
4,9,deal,4,31,1,3,0.16
4,9,deed,4,32,2,2,0.16
4,9,dot,3,33,1,2,0.2
4,9,ear,3,34,0,3,0.16
4,9,exit,4,35,1,3,0.16
4,9,eye,3,36,1,2,0.12
4,9,fair,4,37,0,4,0.2
4,9,fast,4,38,2,2,0.12
4,9,fat,3,39,2,1,0.08
4,9,few,3,40,1,2,0.16
4,9,firm,4,41,1,3,0.16
4,9,flat,4,42,1,3,0.16
4,9,flee,4,43,2,2,0.16
4,9,flu,3,44,2,1,0.12
4,9,food,4,45,1,3,0.16
4,9,for,3,46,2,1,0.08
4,9,frog,4,47,1,3,0.24
4,9,fur,3,48,1,2,0.12
4,9,game,4,49,0,4,0.2
4,9,give,4,50,1,3,0.16
4,9,go,2,51,1,1,0.08
4,9,golf,4,52,2,2,0.16
4,9,good,4,53,2,2,0.2
4,9,grey,4,54,1,3,0.16
4,9,guy,3,55,1,2,0.12
4,9,harm,4,56,0,4,0.2
4,9,heat,4,57,1,3,0.16
4,9,her,3,58,2,1,0.08
4,9,hint,4,59,1,3,0.16
4,9,hour,4,60,1,3,0.24
4,9,hunt,4,61,1,3,0.16
4,9,icon,4,62,0,4,0.2
4,9,ill,3,63,1,2,0.12
4,9,iron,4,64,1,3,0.16
4,9,jump,4,65,0,4,0.2
4,9,just,4,66,2,2,0.2
4,9,key,3,67,0,3,0.16
4,9,kid,3,68,1,2,0.16
4,9,king,4,69,2,2,0.2
4,9,know,4,70,1,3,0.16
4,9,lad,3,71,0,3,0.16
4,9,last,4,72,2,2,0.16
4,9,law,3,73,2,1,0.16
4,9,lawn,4,74,3,1,0.12
4,9,lie,3,75,1,2,0.12
4,9,link,4,76,2,2,0.12
4,9,live,4,77,2,2,0.16
4,9,load,4,78,1,3,0.16
4,9,lot,3,79,2,1,0.08
4,9,love,4,80,2,2,0.2
4,9,low,3,81,2,1,0.08
4,9,main,4,82,0,4,0.2
4,9,map,3,83,2,1,0.12
4,9,mark,4,84,2,2,0.12
4,9,meal,4,85,1,3,0.16
4,9,mind,4,86,1,3,0.24
4,9,my,2,87,1,1,0.08
4,9,new,3,88,0,3,0.12
4,9,non,3,89,1,2,0.12
4,9,norm,4,90,2,2,0.12
4,9,not,3,91,2,1,0.08
4,9,once,4,92,0,4,0.2
4,9,pace,4,93,0,4,0.24
4,9,pack,4,94,3,1,0.12
4,9,pad,3,95,2,1,0.08
4,9,pick,4,96,1,3,0.16
4,9,pile,4,97,2,2,0.12
4,9,plan,4,98,1,3,0.16
4,9,pond,4,99,1,3,0.16
4,9,push,4,100,1,3,0.24
4,9,race,4,101,0,4,0.16
4,9,rail,4,102,2,2,0.16
4,9,rear,4,103,1,3,0.16
4,9,rip,3,104,1,2,0.12
4,9,roof,4,105,1,3,0.16
4,9,rub,3,106,1,2,0.16
4,9,ruin,4,107,2,2,0.12
4,9,sale,4,108,0,4,0.24
4,9,salt,4,109,3,1,0.12
4,9,scan,4,110,1,3,0.32
4,9,seal,4,111,1,3,0.2
4,9,seem,4,112,2,2,0.28
4,9,sexy,4,113,2,2,0.16
4,9,ship,4,114,1,3,0.16
4,9,sin,3,115,1,2,0.12
4,9,sink,4,116,3,1,0.12
4,9,sit,3,117,2,1,0.08
4,9,ski,3,118,1,2,0.12
4,9,slam,4,119,1,3,0.2
4,9,slip,4,120,2,2,0.16
4,9,some,4,121,1,3,0.16
4,9,song,4,122,2,2,0.16
4,9,spin,4,123,1,3,0.16
4,9,star,4,124,1,3,0.16
4,9,stem,4,125,2,2,0.2
4,9,stop,4,126,2,2,0.16
4,9,sue,3,127,1,2,0.12
4,9,tale,4,128,0,4,0.24
4,9,tape,4,129,2,2,0.16
4,9,task,4,130,2,2,0.16
4,9,taxi,4,131,2,2,0.16
4,9,tea,3,132,1,2,0.16
4,9,tidy,4,133,1,3,0.16
4,9,till,4,134,2,2,0.12
4,9,to,2,135,1,1,0.08
4,9,too,3,136,2,1,0.08
4,9,tool,4,137,3,1,0.12
4,9,trap,4,138,1,3,0.16
4,9,tree,4,139,2,2,0.2
4,9,upon,4,140,0,4,0.2
4,9,vary,4,141,0,4,0.2
4,9,walk,4,142,0,4,0.2
4,9,win,3,143,1,2,0.12
4,9,wind,4,144,3,1,0.12
4,9,wipe,4,145,2,2,0.2
4,9,wow,3,146,1,2,0.12
5,0,acid,4,0,0,4,0.2
5,0,ad,2,1,1,1,0.08
5,0,adj,3,2,2,1,0.08
5,0,again,5,3,1,4,0.2
5,0,and,3,4,1,2,0.12
5,0,ankle,5,5,2,3,0.24
5,0,arise,5,6,1,4,0.2
5,0,arms,4,7,2,2,0.16
5,0,army,4,8,3,1,0.12
5,0,ask,3,9,1,2,0.12
5,0,baby,4,10,0,4,0.2
5,0,bath,4,11,2,2,0.2
5,0,beat,4,12,1,3,0.16
5,0,bed,3,13,2,1,0.08
5,0,beer,4,14,2,2,0.12
5,0,below,5,15,2,3,0.16
5,0,best,4,16,2,2,0.12
5,0,bill,4,17,1,3,0.16
5,0,bin,3,18,2,1,0.16
5,0,bite,4,19,2,2,0.16
5,0,blank,5,20,1,4,0.2
5,0,blog,4,21,2,2,0.16
5,0,bomb,4,22,1,3,0.16
5,0,boost,5,23,2,3,0.2
5,0,boot,4,24,3,1,0.16
5,0,bound,5,25,2,3,0.2
5,0,brand,5,26,1,4,0.2
5,0,build,5,27,1,4,0.2
5,0,burn,4,28,2,2,0.16
5,0,cafe,4,29,0,4,0.24
5,0,cake,4,30,2,2,0.16
5,0,can,3,31,2,1,0.12
5,0,carve,5,32,2,3,0.2
5,0,cd,2,33,1,1,0.08
5,0,cease,5,34,1,4,0.2
5,0,chair,5,35,1,4,0.28
5,0,charm,5,36,3,2,0.2
5,0,chart,5,37,4,1,0.16
5,0,cheat,5,38,2,3,0.2
5,0,chunk,5,39,2,3,0.16
5,0,civil,5,40,1,4,0.2
5,0,coach,5,41,1,4,0.28
5,0,cope,4,42,2,2,0.12
5,0,cost,4,43,2,2,0.16
5,0,coup,4,44,2,2,0.16
5,0,creep,5,45,1,4,0.2
5,0,crime,5,46,2,3,0.24
5,0,crowd,5,47,2,3,0.2
5,0,crude,5,48,2,3,0.2
5,0,cruel,5,49,3,2,0.16
5,0,cry,3,50,2,1,0.12
5,0,dam,3,51,0,3,0.16
5,0,day,3,52,2,1,0.08
5,0,deed,4,53,1,3,0.2
5,0,deem,4,54,3,1,0.12
5,0,devil,5,55,2,3,0.2
5,0,dig,3,56,1,2,0.12
5,0,dirt,4,57,2,2,0.12
5,0,dirty,5,58,4,1,0.12
5,0,drink,5,59,1,4,0.28
5,0,dust,4,60,1,3,0.16
5,0,earth,5,61,0,5,0.2
5,0,elect,5,62,1,4,0.2
5,0,enemy,5,63,1,4,0.2
5,0,euro,4,64,1,3,0.24
5,0,evoke,5,65,1,4,0.2
5,0,eye,3,66,1,2,0.2
5,0,fair,4,67,0,4,0.2
5,0,fall,4,68,2,2,0.32
5,0,fear,4,69,1,3,0.4
5,0,fee,3,70,2,1,0.32
5,0,few,3,71,2,1,0.24
5,0,fibre,5,72,1,4,0.48
5,0,fifty,5,73,2,3,0.44
5,0,fight,5,74,2,3,0.4
5,0,firm,4,75,2,2,0.32
5,0,flat,4,76,1,3,0.48
5,0,focus,5,77,1,4,0.48
5,0,folk,4,78,2,2,0.32
5,0,food,4,79,2,2,0.32
5,0,force,5,80,2,3,0.44
5,0,fur,3,81,1,2,0.28
5,0,game,4,82,0,4,0.56
5,0,giant,5,83,1,4,0.48
5,0,give,4,84,2,2,0.32
5,0,glass,5,85,1,4,0.48
5,0,globe,5,86,2,3,0.44
5,0,go,2,87,1,1,0.2
5,0,god,3,88,2,1,0.32
5,0,good,4,89,2,2,0.32
5,0,green,5,90,1,4,0.48
5,0,greet,5,91,4,1,0.32
5,0,grey,4,92,3,1,0.28
5,0,grid,4,93,2,2,0.32
5,0,grin,4,94,3,1,0.4
5,0,guess,5,95,1,4,0.56
5,0,guide,5,96,2,3,0.52
5,0,gym,3,97,1,2,0.32
5,0,hair,4,98,0,4,0.56
5,0,handy,5,99,2,3,0.44
5,0,hate,4,100,2,2,0.4
5,0,heart,5,101,1,4,0.48
5,0,herb,4,102,2,2,0.32
5,0,hers,4,103,3,1,0.28
5,0,hour,4,104,1,3,0.36
5,0,how,3,105,2,1,0.24
5,0,hunt,4,106,1,3,0.48
5,0,i,1,107,0,1,0.16
5,0,ill,3,108,1,2,0.28
5,0,image,5,109,1,4,0.48
5,0,into,4,110,1,3,0.4
5,0,jet,3,111,0,3,0.36
5,0,job,3,112,1,2,0.28
5,0,jump,4,113,1,3,0.48
5,0,just,4,114,2,2,0.32
5,0,kick,4,115,0,4,0.44
5,0,kid,3,116,2,1,0.24
5,0,know,4,117,1,3,0.36
5,0,lad,3,118,0,3,0.32
5,0,laser,5,119,2,3,0.4
5,0,last,4,120,3,1,0.4
5,0,laugh,5,121,2,3,0.44
5,0,lawn,4,122,2,2,0.32
5,0,leaf,4,123,1,3,0.4
5,0,left,4,124,2,2,0.32
5,0,lens,4,125,2,2,0.36
5,0,limb,4,126,1,3,0.48
5,0,link,4,127,2,2,0.32
5,0,live,4,128,2,2,0.32
5,0,load,4,129,1,3,0.36
5,0,local,5,130,2,3,0.4
5,0,log,3,131,2,1,0.24
5,0,long,4,132,2,2,0.44
5,0,look,4,133,2,2,0.32
5,0,loose,5,134,3,2,0.36
5,0,love,4,135,2,2,0.32
5,0,low,3,136,2,1,0.24
5,0,mail,4,137,0,4,0.44
5,0,main,4,138,3,1,0.36
5,0,map,3,139,2,1,0.24
5,0,mask,4,140,2,2,0.32
5,0,meal,4,141,1,3,0.36
5,0,mean,4,142,3,1,0.28
5,0,media,5,143,2,3,0.4
5,0,metre,5,144,2,3,0.52
5,0,model,5,145,1,4,0.48
5,0,money,5,146,2,3,0.4
5,0,month,5,147,3,2,0.36
5,0,mouth,5,148,2,3,0.4
5,0,movie,5,149,2,3,0.4
5,0,much,4,150,1,3,0.48
5,0,music,5,151,2,3,0.4
5,0,my,2,152,1,1,0.2
5,0,myth,4,153,2,2,0.32
5,0,name,4,154,0,4,0.44
5,0,nasty,5,155,2,3,0.4
5,0,neck,4,156,1,3,0.48
5,0,new,3,157,2,1,0.24
5,0,night,5,158,1,4,0.48
5,0,noisy,5,159,1,4,0.48
5,0,norm,4,160,2,2,0.32
5,0,not,3,161,2,1,0.24
5,0,nut,3,162,1,2,0.4
5,0,ocean,5,163,0,5,0.52
5,0,off,3,164,1,2,0.28
5,0,once,4,165,1,3,0.36
5,0,ought,5,166,1,4,0.48
5,0,owe,3,167,1,2,0.28
5,0,pace,4,168,0,4,0.56
5,0,pack,4,169,3,1,0.28
5,0,pad,3,170,2,1,0.24
5,0,page,4,171,2,2,0.32
5,0,paint,5,172,2,3,0.4
5,0,pants,5,173,2,3,0.4
5,0,park,4,174,2,2,0.44
5,0,peer,4,175,1,3,0.4
5,0,pin,3,176,1,2,0.28
5,0,pipe,4,177,2,2,0.32
5,0,play,4,178,1,3,0.36
5,0,point,5,179,1,4,0.48
5,0,pot,3,180,2,1,0.24
5,0,prior,5,181,1,4,0.64
5,0,pupil,5,182,1,4,0.56
5,0,pure,4,183,2,2,0.32
5,0,quest,5,184,0,5,0.52
5,0,race,4,185,0,4,0.44
5,0,rail,4,186,2,2,0.44
5,0,rally,5,187,2,3,0.44
5,0,reign,5,188,1,4,0.48
5,0,rise,4,189,1,3,0.4
5,0,rival,5,190,2,3,0.4
5,0,roll,4,191,1,3,0.36
5,0,roof,4,192,2,2,0.44
5,0,root,4,193,3,1,0.28
5,0,round,5,194,2,3,0.44
5,0,ruin,4,195,1,3,0.36
5,0,scan,4,196,0,4,0.44
5,0,score,5,197,2,3,0.64
5,0,seal,4,198,1,3,0.48
5,0,serve,5,199,2,3,0.44
5,0,seven,5,200,2,3,0.44
5,0,sexy,4,201,2,2,0.36
5,0,shape,5,202,1,4,0.52
5,0,sheer,5,203,2,3,0.56
5,0,shell,5,204,3,2,0.36
5,0,ship,4,205,2,2,0.36
5,0,shoot,5,206,2,3,0.44
5,0,sight,5,207,1,4,0.52
5,0,sink,4,208,2,2,0.32
5,0,sit,3,209,2,1,0.36
5,0,skip,4,210,1,3,0.4
5,0,skull,5,211,2,3,0.44
5,0,snow,4,212,1,3,0.4
5,0,soap,4,213,1,3,0.4
5,0,solo,4,214,2,2,0.32
5,0,some,4,215,2,2,0.44
5,0,song,4,216,2,2,0.32
5,0,soup,4,217,2,2,0.32
5,0,space,5,218,1,4,0.48
5,0,spin,4,219,2,2,0.32
5,0,stab,4,220,1,3,0.36
5,0,staff,5,221,3,2,0.48
5,0,star,4,222,3,1,0.28
5,0,stay,4,223,3,1,0.28
5,0,steer,5,224,2,3,0.44
5,0,stem,4,225,3,1,0.28
5,0,stick,5,226,2,3,0.44
5,0,store,5,227,2,3,0.52
5,0,such,4,228,1,3,0.4
5,0,swear,5,229,1,4,0.48
5,0,swim,4,230,2,2,0.32
5,0,tale,4,231,0,4,0.44
5,0,tank,4,232,2,2,0.32
5,0,task,4,233,2,2,0.44
5,0,team,4,234,1,3,0.4
5,0,tempt,5,235,2,3,0.4
5,0,this,4,236,1,3,0.4
5,0,till,4,237,1,3,0.4
5,0,to,2,238,1,1,0.2
5,0,tonne,5,239,2,3,0.6
5,0,too,3,240,2,1,0.24
5,0,tool,4,241,3,1,0.32
5,0,tour,4,242,2,2,0.4
5,0,trial,5,243,1,4,0.52
5,0,tune,4,244,1,3,0.4
5,0,unify,5,245,0,5,0.64
5,0,union,5,246,3,2,0.36
5,0,upon,4,247,1,3,0.4
5,0,urban,5,248,1,4,0.48
5,0,usage,5,249,1,4,0.48
5,0,vein,4,250,0,4,0.56
5,0,virus,5,251,1,4,0.48
5,0,vocal,5,252,1,4,0.48
5,0,voice,5,253,2,3,0.44
5,0,wait,4,254,0,4,0.44
5,0,wake,4,255,2,2,0.32
5,0,walk,4,256,2,2,0.44
5,0,water,5,257,2,3,0.52
5,0,way,3,258,2,1,0.28
5,0,weird,5,259,1,4,0.48
5,0,whose,5,260,1,4,0.48
5,0,wine,4,261,1,3,0.36
5,0,wipe,4,262,2,2,0.44
5,0,word,4,263,1,3,0.36
5,0,wrap,4,264,1,3,0.36
5,1,acre,4,0,0,4,0.2
5,1,ad,2,1,1,1,0.08
5,1,adj,3,2,2,1,0.12
5,1,admit,5,3,2,3,0.16
5,1,again,5,4,1,4,0.28
5,1,agree,5,5,2,3,0.2
5,1,ahead,5,6,1,4,0.2
5,1,ally,4,7,1,3,0.2
5,1,argue,5,8,1,4,0.2
5,1,arise,5,9,2,3,0.24
5,1,arrow,5,10,2,3,0.16
5,1,ask,3,11,1,2,0.12
5,1,at,2,12,1,1,0.08
5,1,beg,3,13,0,3,0.12
5,1,bill,4,14,1,3,0.16
5,1,bin,3,15,2,1,0.08
5,1,bird,4,16,2,2,0.2
5,1,bite,4,17,2,2,0.16
5,1,blade,5,18,1,4,0.2
5,1,blame,5,19,3,2,0.16
5,1,blind,5,20,2,3,0.2
5,1,boil,4,21,1,3,0.24
5,1,bomb,4,22,2,2,0.12
5,1,boom,4,23,2,2,0.16
5,1,boot,4,24,3,1,0.12
5,1,box,3,25,2,1,0.08
5,1,break,5,26,1,4,0.2
5,1,bride,5,27,2,3,0.24
5,1,build,5,28,1,4,0.24
5,1,cafe,4,29,0,4,0.24
5,1,can,3,30,2,1,0.12
5,1,card,4,31,2,2,0.16
5,1,cave,4,32,2,2,0.12
5,1,chart,5,33,1,4,0.28
5,1,cheat,5,34,2,3,0.24
5,1,check,5,35,3,2,0.2
5,1,chop,4,36,2,2,0.16
5,1,cloud,5,37,1,4,0.24
5,1,cost,4,38,1,3,0.16
5,1,could,5,39,2,3,0.28
5,1,coup,4,40,3,1,0.12
5,1,creep,5,41,1,4,0.2
5,1,crime,5,42,2,3,0.2
5,1,cross,5,43,2,3,0.2
5,1,cruel,5,44,2,3,0.24
5,1,dare,4,45,0,4,0.24
5,1,deal,4,46,1,3,0.16
5,1,death,5,47,3,2,0.16
5,1,demon,5,48,2,3,0.2
5,1,devil,5,49,2,3,0.2
5,1,dig,3,50,1,2,0.2
5,1,drama,5,51,1,4,0.2
5,1,dust,4,52,1,3,0.16
5,1,ear,3,53,0,3,0.16
5,1,earth,5,54,3,2,0.16
5,1,edit,4,55,1,3,0.16
5,1,eight,5,56,1,4,0.28
5,1,elect,5,57,1,4,0.2
5,1,enjoy,5,58,1,4,0.2
5,1,entry,5,59,2,3,0.2
5,1,erect,5,60,1,4,0.2
5,1,euro,4,61,1,3,0.24
5,1,event,5,62,1,4,0.2
5,1,exact,5,63,1,4,0.2
5,1,exit,4,64,2,2,0.12
5,1,eye,3,65,1,2,0.12
5,1,fail,4,66,0,4,0.2
5,1,fall,4,67,2,2,0.2
5,1,fast,4,68,2,2,0.16
5,1,fear,4,69,1,3,0.16
5,1,few,3,70,2,1,0.12
5,1,fight,5,71,1,4,0.2
5,1,file,4,72,2,2,0.12
5,1,fix,3,73,2,1,0.16
5,1,fixed,5,74,3,2,0.16
5,1,folk,4,75,1,3,0.16
5,1,food,4,76,2,2,0.12
5,1,frog,4,77,1,3,0.16
5,1,full,4,78,1,3,0.16
5,1,fur,3,79,2,1,0.12
5,1,game,4,80,0,4,0.28
5,1,gene,4,81,1,3,0.2
5,1,giant,5,82,1,4,0.24
5,1,give,4,83,2,2,0.16
5,1,glass,5,84,1,4,0.28
5,1,globe,5,85,2,3,0.44
5,1,golf,4,86,1,3,0.32
5,1,good,4,87,2,2,0.28
5,1,grade,5,88,1,4,0.32
5,1,green,5,89,2,3,0.56
5,1,greet,5,90,4,1,0.4
5,1,grid,4,91,2,2,0.36
5,1,grief,5,92,3,2,0.28
5,1,grin,4,93,3,1,0.2
5,1,grind,5,94,4,1,0.16
5,1,guide,5,95,1,4,0.24
5,1,guy,3,96,2,1,0.2
5,1,gym,3,97,1,2,0.16
5,1,harsh,5,98,0,5,0.24
5,1,hat,3,99,2,1,0.12
5,1,heat,4,100,1,3,0.2
5,1,her,3,101,2,1,0.08
5,1,herb,4,102,3,1,0.12
5,1,hint,4,103,1,3,0.24
5,1,hour,4,104,1,3,0.2
5,1,how,3,105,2,1,0.12
5,1,hunt,4,106,1,3,0.2
5,1,ice,3,107,0,3,0.2
5,1,icon,4,108,2,2,0.16
5,1,ill,3,109,1,2,0.12
5,1,incur,5,110,1,4,0.24
5,1,info,4,111,2,2,0.16
5,1,into,4,112,2,2,0.16
5,1,issue,5,113,1,4,0.2
5,1,jet,3,114,0,3,0.16
5,1,jump,4,115,1,3,0.2
5,1,june,4,116,2,2,0.2
5,1,key,3,117,0,3,0.16
5,1,kick,4,118,1,3,0.16
5,1,kid,3,119,2,1,0.12
5,1,king,4,120,2,2,0.16
5,1,lad,3,121,0,3,0.16
5,1,lap,3,122,2,1,0.12
5,1,laser,5,123,2,3,0.24
5,1,layer,5,124,2,3,0.2
5,1,leaf,4,125,1,3,0.16
5,1,lemon,5,126,2,3,0.2
5,1,lens,4,127,2,2,0.16
5,1,lion,4,128,1,3,0.16
5,1,live,4,129,2,2,0.2
5,1,liver,5,130,4,1,0.12
5,1,log,3,131,1,2,0.12
5,1,long,4,132,2,2,0.12
5,1,loose,5,133,2,3,0.16
5,1,low,3,134,2,1,0.12
5,1,lunch,5,135,1,4,0.24
5,1,mail,4,136,0,4,0.2
5,1,main,4,137,3,1,0.12
5,1,map,3,138,2,1,0.08
5,1,mark,4,139,2,2,0.12
5,1,mask,4,140,2,2,0.12
5,1,meal,4,141,1,3,0.24
5,1,media,5,142,2,3,0.24
5,1,metre,5,143,2,3,0.24
5,1,model,5,144,1,4,0.2
5,1,money,5,145,2,3,0.2
5,1,more,4,146,2,2,0.16
5,1,mouth,5,147,2,3,0.24
5,1,much,4,148,1,3,0.16
5,1,music,5,149,2,3,0.2
5,1,must,4,150,3,1,0.12
5,1,myth,4,151,1,3,0.16
5,1,naked,5,152,0,5,0.28
5,1,nasty,5,153,2,3,0.2
5,1,neck,4,154,1,3,0.16
5,1,new,3,155,2,1,0.12
5,1,night,5,156,1,4,0.2
5,1,norm,4,157,1,3,0.16
5,1,north,5,158,3,2,0.24
5,1,note,4,159,2,2,0.16
5,1,novel,5,160,2,3,0.2
5,1,one,3,161,0,3,0.16
5,1,owe,3,162,1,2,0.2
5,1,pace,4,163,0,4,0.28
5,1,pad,3,164,2,1,0.12
5,1,park,4,165,2,2,0.52
5,1,pause,5,166,2,3,0.68
5,1,peace,5,167,1,4,0.8
5,1,photo,5,168,1,4,0.24
5,1,pipe,4,169,1,3,0.16
5,1,plane,5,170,1,4,0.2
5,1,plead,5,171,2,3,0.2
5,1,plot,4,172,2,2,0.24
5,1,point,5,173,1,4,0.2
5,1,pond,4,174,2,2,0.16
5,1,proof,5,175,1,4,0.2
5,1,pump,4,176,1,3,0.16
5,1,punk,4,177,2,2,0.16
5,1,pure,4,178,2,2,0.2
5,1,push,4,179,2,2,0.16
5,1,quest,5,180,0,5,0.24
5,1,race,4,181,0,4,0.24
5,1,raise,5,182,2,3,0.2
5,1,react,5,183,1,4,0.24
5,1,rear,4,184,3,1,0.2
5,1,rebel,5,185,2,3,0.2
5,1,reign,5,186,2,3,0.2
5,1,rifle,5,187,1,4,0.24
5,1,right,5,188,2,3,0.2
5,1,rip,3,189,2,1,0.16
5,1,rise,4,190,2,2,0.2
5,1,rival,5,191,2,3,0.2
5,1,road,4,192,1,3,0.16
5,1,rob,3,193,2,1,0.12
5,1,roll,4,194,2,2,0.16
5,1,ruin,4,195,1,3,0.16
5,1,safe,4,196,0,4,0.24
5,1,sale,4,197,2,2,0.16
5,1,sand,4,198,2,2,0.16
5,1,score,5,199,1,4,0.2
5,1,seal,4,200,1,3,0.16
5,1,seem,4,201,2,2,0.12
5,1,seven,5,202,2,3,0.24
5,1,sexy,4,203,2,2,0.16
5,1,shape,5,204,1,4,0.2
5,1,share,5,205,3,2,0.16
5,1,shell,5,206,2,3,0.2
5,1,shift,5,207,2,3,0.24
5,1,shoot,5,208,2,3,0.2
5,1,shore,5,209,3,2,0.16
5,1,sight,5,210,1,4,0.2
5,1,sin,3,211,2,1,0.12
5,1,sink,4,212,3,1,0.12
5,1,sit,3,213,2,1,0.16
5,1,skip,4,214,1,3,0.16
5,1,slam,4,215,1,3,0.2
5,1,snow,4,216,1,3,0.16
5,1,soap,4,217,1,3,0.2
5,1,solar,5,218,2,3,0.2
5,1,solid,5,219,3,2,0.24
5,1,solo,4,220,3,1,0.12
5,1,some,4,221,2,2,0.16
5,1,song,4,222,2,2,0.16
5,1,south,5,223,2,3,0.2
5,1,space,5,224,1,4,0.2
5,1,spine,5,225,2,3,0.24
5,1,stab,4,226,1,3,0.2
5,1,staff,5,227,3,2,0.16
5,1,stall,5,228,3,2,0.16
5,1,stay,4,229,3,1,0.12
5,1,stem,4,230,2,2,0.2
5,1,stick,5,231,2,3,0.2
5,1,stop,4,232,2,2,0.16
5,1,such,4,233,1,3,0.16
5,1,super,5,234,2,3,0.2
5,1,swear,5,235,1,4,0.2
5,1,swim,4,236,2,2,0.2
5,1,table,5,237,0,5,0.24
5,1,tap,3,238,2,1,0.08
5,1,tape,4,239,3,1,0.12
5,1,taste,5,240,2,3,0.16
5,1,thumb,5,241,1,4,0.2
5,1,till,4,242,1,3,0.24
5,1,to,2,243,1,1,0.08
5,1,tool,4,244,2,2,0.12
5,1,topic,5,245,2,3,0.2
5,1,tour,4,246,2,2,0.12
5,1,treat,5,247,1,4,0.2
5,1,trend,5,248,3,2,0.24
5,1,tribe,5,249,2,3,0.2
5,1,vague,5,250,0,5,0.2
5,1,video,5,251,1,4,0.2
5,1,vocal,5,252,1,4,0.2
5,1,wait,4,253,0,4,0.24
5,1,wake,4,254,2,2,0.12
5,1,walk,4,255,2,2,0.12
5,1,war,3,256,2,1,0.12
5,1,water,5,257,2,3,0.16
5,1,weave,5,258,1,4,0.2
5,1,weird,5,259,2,3,0.24
5,1,whose,5,260,1,4,0.2
5,1,win,3,261,1,2,0.12
5,1,wind,4,262,3,1,0.12
5,1,wipe,4,263,2,2,0.16
5,1,wow,3,264,1,2,0.16
5,2,a,1,0,0,1,0.08
5,2,acid,4,1,1,3,0.2
5,2,acute,5,2,2,3,0.32
5,2,add,3,3,1,2,0.12
5,2,admit,5,4,2,3,0.16
5,2,adopt,5,5,2,3,0.24
5,2,ahead,5,6,1,4,0.44
5,2,ally,4,7,1,3,0.36
5,2,anger,5,8,1,4,0.6
5,2,ankle,5,9,2,3,0.44
5,2,app,3,10,1,2,0.28
5,2,argue,5,11,1,4,0.48
5,2,arise,5,12,2,3,0.44
5,2,arms,4,13,2,2,0.48
5,2,army,4,14,3,1,0.28
5,2,arrow,5,15,2,3,0.44
5,2,auto,4,16,1,3,0.4
5,2,baby,4,17,0,4,0.44
5,2,base,4,18,2,2,0.32
5,2,bay,3,19,2,1,0.32
5,2,beast,5,20,1,4,0.48
5,2,beer,4,21,2,2,0.32
5,2,bell,4,22,2,2,0.32
5,2,bite,4,23,1,3,0.4
5,2,blade,5,24,1,4,0.48
5,2,bless,5,25,2,3,0.6
5,2,blow,4,26,2,2,0.4
5,2,boat,4,27,1,3,0.44
5,2,bomb,4,28,2,2,0.36
5,2,boom,4,29,2,2,0.32
5,2,bound,5,30,2,3,0.44
5,2,brand,5,31,1,4,0.64
5,2,break,5,32,2,3,0.44
5,2,bride,5,33,2,3,0.56
5,2,build,5,34,1,4,0.52
5,2,bunch,5,35,2,3,0.44
5,2,cafe,4,36,0,4,0.6
5,2,cake,4,37,2,2,0.36
5,2,can,3,38,2,1,0.28
5,2,card,4,39,2,2,0.4
5,2,cave,4,40,2,2,0.36
5,2,cease,5,41,1,4,0.48
5,2,check,5,42,1,4,0.56
5,2,choir,5,43,2,3,0.4
5,2,chop,4,44,3,1,0.28
5,2,city,4,45,1,3,0.4
5,2,civil,5,46,2,3,0.44
5,2,clerk,5,47,1,4,0.48
5,2,cloud,5,48,2,3,0.52
5,2,cost,4,49,1,3,0.4
5,2,court,5,50,2,3,0.44
5,2,craft,5,51,1,4,0.48
5,2,cross,5,52,2,3,0.44
5,2,crude,5,53,2,3,0.52
5,2,cruel,5,54,3,2,0.4
5,2,cry,3,55,2,1,0.24
5,2,cycle,5,56,1,4,0.48
5,2,dare,4,57,0,4,0.44
5,2,death,5,58,1,4,0.48
5,2,dig,3,59,1,2,0.4
5,2,dirt,4,60,2,2,0.32
5,2,drink,5,61,1,4,0.48
5,2,ear,3,62,0,3,0.36
5,2,edit,4,63,1,3,0.4
5,2,erect,5,64,1,4,0.52
5,2,event,5,65,1,4,0.6
5,2,evoke,5,66,2,3,0.44
5,2,exit,4,67,1,3,0.36
5,2,fail,4,68,0,4,0.44
5,2,fair,4,69,3,1,0.28
5,2,few,3,70,1,2,0.32
5,2,fight,5,71,1,4,0.6
5,2,file,4,72,2,2,0.32
5,2,fixed,5,73,2,3,0.44
5,2,flag,4,74,1,3,0.36
5,2,flat,4,75,3,1,0.32
5,2,flee,4,76,2,2,0.32
5,2,flu,3,77,2,1,0.32
5,2,focus,5,78,1,4,0.48
5,2,folk,4,79,2,2,0.32
5,2,force,5,80,2,3,0.48
5,2,full,4,81,1,3,0.4
5,2,gene,4,82,0,4,0.52
5,2,genre,5,83,3,2,0.36
5,2,give,4,84,1,3,0.4
5,2,globe,5,85,1,4,0.56
5,2,go,2,86,1,1,0.2
5,2,golf,4,87,2,2,0.32
5,2,green,5,88,1,4,0.56
5,2,greet,5,89,4,1,0.32
5,2,grid,4,90,2,2,0.32
5,2,guess,5,91,1,4,0.56
5,2,hair,4,92,0,4,0.44
5,2,harm,4,93,2,2,0.32
5,2,harsh,5,94,3,2,0.48
5,2,heart,5,95,1,4,0.48
5,2,heat,4,96,3,1,0.28
5,2,her,3,97,2,1,0.24
5,2,hers,4,98,3,1,0.28
5,2,hint,4,99,1,3,0.4
5,2,how,3,100,1,2,0.28
5,2,hunt,4,101,1,3,0.48
5,2,i,1,102,0,1,0.16
5,2,info,4,103,1,3,0.4
5,2,issue,5,104,1,4,0.48
5,2,jump,4,105,0,4,0.44
5,2,june,4,106,2,2,0.32
5,2,key,3,107,0,3,0.44
5,2,kid,3,108,1,2,0.28
5,2,kit,3,109,2,1,0.24
5,2,knife,5,110,1,4,0.48
5,2,lack,4,111,0,4,0.48
5,2,lad,3,112,2,1,0.28
5,2,lap,3,113,2,1,0.24
5,2,last,4,114,2,2,0.44
5,2,laugh,5,115,2,3,0.44
5,2,law,3,116,2,1,0.24
5,2,lawn,4,117,3,1,0.28
5,2,lemon,5,118,1,4,0.48
5,2,lens,4,119,2,2,0.32
5,2,limb,4,120,1,3,0.48
5,2,link,4,121,2,2,0.32
5,2,live,4,122,2,2,0.32
5,2,liver,5,123,4,1,0.32
5,2,load,4,124,1,3,0.36
5,2,log,3,125,2,1,0.24
5,2,long,4,126,2,2,0.4
5,2,lot,3,127,2,1,0.24
5,2,mail,4,128,0,4,0.44
5,2,main,4,129,3,1,0.28
5,2,map,3,130,2,1,0.24
5,2,mark,4,131,2,2,0.36
5,2,match,5,132,2,3,0.44
5,2,meal,4,133,1,3,0.48
5,2,mess,4,134,2,2,0.32
5,2,mind,4,135,1,3,0.36
5,2,model,5,136,1,4,0.56
5,2,month,5,137,2,3,0.48
5,2,most,4,138,2,2,0.36
5,2,mouth,5,139,2,3,0.56
5,2,much,4,140,1,3,0.44
5,2,mum,3,141,2,1,0.24
5,2,music,5,142,2,3,0.48
5,2,must,4,143,3,1,0.36
5,2,myth,4,144,1,3,0.44
5,2,name,4,145,0,4,0.56
5,2,nasty,5,146,2,3,0.48
5,2,night,5,147,1,4,0.52
5,2,noise,5,148,1,4,0.52
5,2,non,3,149,2,1,0.24
5,2,norm,4,150,2,2,0.36
5,2,note,4,151,2,2,0.4
5,2,ocean,5,152,0,5,0.52
5,2,other,5,153,1,4,0.48
5,2,ought,5,154,1,4,0.48
5,2,pace,4,155,0,4,0.44
5,2,pad,3,156,2,1,0.32
5,2,paint,5,157,2,3,0.4
5,2,pants,5,158,2,3,0.4
5,2,park,4,159,2,2,0.32
5,2,peace,5,160,1,4,0.48
5,2,peer,4,161,2,2,0.32
5,2,pig,3,162,1,2,0.36
5,2,pile,4,163,2,2,0.36
5,2,pin,3,164,2,1,0.24
5,2,plane,5,165,1,4,0.48
5,2,plant,5,166,4,1,0.32
5,2,play,4,167,3,1,0.28
5,2,plead,5,168,2,3,0.52
5,2,point,5,169,1,4,0.48
5,2,post,4,170,2,2,0.32
5,2,pot,3,171,2,1,0.24
5,2,pure,4,172,1,3,0.36
5,2,push,4,173,2,2,0.32
5,2,query,5,174,0,5,0.64
5,2,rally,5,175,0,5,0.68
5,2,react,5,176,1,4,0.48
5,2,rear,4,177,3,1,0.28
5,2,reign,5,178,2,3,0.4
5,2,rival,5,179,1,4,0.56
5,2,rob,3,180,1,2,0.28
5,2,rough,5,181,2,3,0.44
5,2,salt,4,182,0,4,0.44
5,2,scan,4,183,1,3,0.44
5,2,score,5,184,2,3,0.44
5,2,serve,5,185,1,4,0.6
5,2,sexy,4,186,2,2,0.32
5,2,sheer,5,187,1,4,0.48
5,2,shell,5,188,3,2,0.4
5,2,shift,5,189,2,3,0.56
5,2,shore,5,190,2,3,0.76
5,2,sight,5,191,1,4,0.48
5,2,six,3,192,2,1,0.24
5,2,skip,4,193,1,3,0.4
5,2,skirt,5,194,3,2,0.36
5,2,slam,4,195,1,3,0.36
5,2,slice,5,196,2,3,0.52
5,2,snow,4,197,1,3,0.4
5,2,soap,4,198,1,3,0.36
5,2,some,4,199,2,2,0.32
5,2,song,4,200,2,2,0.32
5,2,soup,4,201,2,2,0.32
5,2,south,5,202,3,2,0.48
5,2,space,5,203,1,4,0.48
5,2,spare,5,204,3,2,0.36
5,2,spin,4,205,2,2,0.32
5,2,stab,4,206,1,3,0.36
5,2,stand,5,207,3,2,0.36
5,2,star,4,208,3,1,0.4
5,2,stay,4,209,3,1,0.28
5,2,steer,5,210,2,3,0.52
5,2,stop,4,211,2,2,0.36
5,2,store,5,212,3,2,0.48
5,2,study,5,213,2,3,0.52
5,2,such,4,214,1,3,0.52
5,2,sugar,5,215,2,3,0.44
5,2,super,5,216,2,3,0.44
5,2,sure,4,217,2,2,0.56
5,2,swear,5,218,1,4,0.52
5,2,tail,4,219,0,4,0.44
5,2,tale,4,220,2,2,0.44
5,2,tap,3,221,2,1,0.24
5,2,taxi,4,222,2,2,0.32
5,2,team,4,223,1,3,0.4
5,2,tempt,5,224,2,3,0.44
5,2,three,5,225,1,4,0.48
5,2,tidy,4,226,1,3,0.6
5,2,tight,5,227,2,3,0.6
5,2,till,4,228,2,2,0.32
5,2,to,2,229,1,1,0.2
5,2,tonne,5,230,2,3,0.52
5,2,too,3,231,2,1,0.24
5,2,tool,4,232,3,1,0.6
5,2,treat,5,233,1,4,0.52
5,2,tree,4,234,3,1,0.36
5,2,trend,5,235,3,2,0.4
5,2,tune,4,236,1,3,0.52
5,2,twice,5,237,1,4,0.56
5,2,unify,5,238,0,5,0.84
5,2,union,5,239,3,2,0.4
5,2,upon,4,240,1,3,0.44
5,2,usage,5,241,1,4,0.56
5,2,usual,5,242,2,3,0.52
5,2,vague,5,243,0,5,0.76
5,2,vary,4,244,2,2,0.32
5,2,video,5,245,1,4,0.76
5,2,virus,5,246,2,3,0.52
5,2,vital,5,247,2,3,0.52
5,2,war,3,248,0,3,0.52
5,2,water,5,249,2,3,0.6
5,2,way,3,250,2,1,0.24
5,2,weave,5,251,1,4,0.6
5,2,which,5,252,1,4,0.64
5,2,whose,5,253,2,3,0.44
5,2,width,5,254,1,4,0.76
5,2,win,3,255,2,1,0.24
5,2,wind,4,256,3,1,0.28
5,2,wine,4,257,3,1,0.28
5,2,wipe,4,258,2,2,0.32
5,2,work,4,259,1,3,0.4
5,2,worry,5,260,3,2,0.48
5,2,wow,3,261,2,1,0.24
5,2,wrap,4,262,1,3,0.4
5,2,wrist,5,263,2,3,0.68
5,2,young,5,264,0,5,0.84
5,3,a,1,0,0,1,0.08
5,3,acre,4,1,1,3,0.24
5,3,acute,5,2,2,3,0.32
5,3,ad,2,3,1,1,0.08
5,3,add,3,4,2,1,0.12
5,3,adopt,5,5,2,3,0.2
5,3,again,5,6,1,4,0.24
5,3,agree,5,7,2,3,0.16
5,3,align,5,8,1,4,0.28
5,3,ally,4,9,2,2,0.2
5,3,ankle,5,10,1,4,0.24
5,3,arms,4,11,1,3,0.2
5,3,arrow,5,12,2,3,0.2
5,3,at,2,13,1,1,0.08
5,3,bat,3,14,0,3,0.16
5,3,bath,4,15,3,1,0.16
5,3,bed,3,16,1,2,0.16
5,3,below,5,17,2,3,0.2
5,3,best,4,18,2,2,0.16
5,3,bird,4,19,1,3,0.16
5,3,blind,5,20,1,4,0.24
5,3,blog,4,21,2,2,0.2
5,3,boost,5,22,1,4,0.2
5,3,boot,4,23,3,1,0.12
5,3,bride,5,24,1,4,0.2
5,3,cake,4,25,0,4,0.2
5,3,can,3,26,2,1,0.08
5,3,carve,5,27,2,3,0.32
5,3,cave,4,28,2,2,0.16
5,3,chart,5,29,1,4,0.24
5,3,cheat,5,30,2,3,0.2
5,3,check,5,31,3,2,0.2
5,3,chop,4,32,2,2,0.2
5,3,cite,4,33,1,3,0.16
5,3,city,4,34,3,1,0.12
5,3,clean,5,35,1,4,0.2
5,3,clerk,5,36,3,2,0.16
5,3,club,4,37,2,2,0.12
5,3,coach,5,38,1,4,0.28
5,3,cost,4,39,2,2,0.12
5,3,could,5,40,2,3,0.2
5,3,court,5,41,3,2,0.16
5,3,crowd,5,42,1,4,0.2
5,3,dance,5,43,0,5,0.28
5,3,dare,4,44,2,2,0.16
5,3,deal,4,45,1,3,0.16
5,3,death,5,46,3,2,0.16
5,3,deem,4,47,2,2,0.16
5,3,dirt,4,48,1,3,0.16
5,3,dot,3,49,1,2,0.2
5,3,drama,5,50,1,4,0.2
5,3,drink,5,51,2,3,0.2
5,3,earth,5,52,0,5,0.24
5,3,edit,4,53,1,3,0.16
5,3,eight,5,54,1,4,0.2
5,3,elect,5,55,1,4,0.28
5,3,enjoy,5,56,1,4,0.2
5,3,enter,5,57,2,3,0.16
5,3,erect,5,58,1,4,0.2
5,3,exit,4,59,1,3,0.16
5,3,fail,4,60,0,4,0.24
5,3,fall,4,61,2,2,0.12
5,3,fast,4,62,2,2,0.12
5,3,fee,3,63,1,2,0.12
5,3,fibre,5,64,1,4,0.2
5,3,fifty,5,65,2,3,0.16
5,3,fight,5,66,2,3,0.24
5,3,fine,4,67,2,2,0.16
5,3,fixed,5,68,2,3,0.2
5,3,floor,5,69,1,4,0.2
5,3,flu,3,70,2,1,0.08
5,3,focus,5,71,1,4,0.28
5,3,folk,4,72,2,2,0.12
5,3,food,4,73,2,2,0.12
5,3,for,3,74,2,1,0.12
5,3,force,5,75,3,2,0.16
5,3,frog,4,76,1,3,0.16
5,3,fur,3,77,1,2,0.12
5,3,genre,5,78,0,5,0.28
5,3,giant,5,79,1,4,0.2
5,3,give,4,80,2,2,0.12
5,3,go,2,81,1,1,0.08
5,3,god,3,82,2,1,0.08
5,3,grace,5,83,1,4,0.2
5,3,grade,5,84,3,2,0.2
5,3,green,5,85,2,3,0.16
5,3,grief,5,86,2,3,0.2
5,3,grin,4,87,3,1,0.12
5,3,grind,5,88,4,1,0.16
5,3,guest,5,89,1,4,0.28
5,3,guide,5,90,2,3,0.2
5,3,guy,3,91,2,1,0.08
5,3,gym,3,92,1,2,0.12
5,3,hair,4,93,0,4,0.24
5,3,hate,4,94,2,2,0.16
5,3,heart,5,95,1,4,0.2
5,3,her,3,96,2,1,0.2
5,3,herb,4,97,3,1,0.12
5,3,hunt,4,98,1,3,0.16
5,3,i,1,99,0,1,0.08
5,3,icon,4,100,1,3,0.16
5,3,ideal,5,101,1,4,0.2
5,3,into,4,102,1,3,0.24
5,3,iron,4,103,1,3,0.2
5,3,issue,5,104,1,4,0.2
5,3,jet,3,105,0,3,0.16
5,3,joy,3,106,1,2,0.16
5,3,june,4,107,1,3,0.16
5,3,king,4,108,0,4,0.16
5,3,know,4,109,1,3,0.24
5,3,lack,4,110,0,4,0.2
5,3,laser,5,111,2,3,0.16
5,3,last,4,112,3,1,0.12
5,3,laugh,5,113,2,3,0.2
5,3,law,3,114,2,1,0.12
5,3,lawn,4,115,3,1,0.2
5,3,lens,4,116,1,3,0.16
5,3,limb,4,117,1,3,0.16
5,3,lion,4,118,2,2,0.12
5,3,live,4,119,2,2,0.12
5,3,log,3,120,1,2,0.12
5,3,long,4,121,2,2,0.2
5,3,loose,5,122,2,3,0.16
5,3,lot,3,123,2,1,0.08
5,3,love,4,124,2,2,0.12
5,3,low,3,125,2,1,0.12
5,3,lunch,5,126,1,4,0.2
5,3,mail,4,127,0,4,0.24
5,3,map,3,128,2,1,0.08
5,3,mark,4,129,2,2,0.12
5,3,mask,4,130,2,2,0.12
5,3,meal,4,131,1,3,0.16
5,3,media,5,132,2,3,0.16
5,3,metre,5,133,2,3,0.24
5,3,mind,4,134,1,3,0.16
5,3,mixed,5,135,2,3,0.16
5,3,model,5,136,1,4,0.2
5,3,money,5,137,2,3,0.16
5,3,more,4,138,2,2,0.16
5,3,most,4,139,2,2,0.2
5,3,movie,5,140,2,3,0.2
5,3,mum,3,141,1,2,0.12
5,3,music,5,142,2,3,0.2
5,3,my,2,143,1,1,0.08
5,3,naked,5,144,0,5,0.24
5,3,neck,4,145,1,3,0.24
5,3,new,3,146,2,1,0.12
5,3,noisy,5,147,1,4,0.2
5,3,novel,5,148,2,3,0.2
5,3,nut,3,149,1,2,0.12
5,3,ocean,5,150,0,5,0.24
5,3,off,3,151,1,2,0.2
5,3,other,5,152,1,4,0.2
5,3,ought,5,153,1,4,0.2
5,3,owe,3,154,1,2,0.12
5,3,paint,5,155,0,5,0.24
5,3,pants,5,156,2,3,0.2
5,3,park,4,157,2,2,0.2
5,3,pause,5,158,2,3,0.2
5,3,peer,4,159,1,3,0.16
5,3,photo,5,160,1,4,0.24
5,3,pick,4,161,1,3,0.2
5,3,pig,3,162,2,1,0.16
5,3,place,5,163,1,4,0.24
5,3,plan,4,164,3,1,0.16
5,3,plane,5,165,4,1,0.16
5,3,plant,5,166,4,1,0.16
5,3,play,4,167,3,1,0.12
5,3,plead,5,168,2,3,0.24
5,3,plot,4,169,2,2,0.16
5,3,point,5,170,1,4,0.2
5,3,prior,5,171,1,4,0.48
5,3,pump,4,172,1,3,0.4
5,3,race,4,173,0,4,0.44
5,3,radar,5,174,2,3,0.56
5,3,rail,4,175,2,2,0.36
5,3,react,5,176,1,4,0.6
5,3,realm,5,177,3,2,0.64
5,3,reign,5,178,2,3,0.44
5,3,relax,5,179,2,3,0.56
5,3,renew,5,180,2,3,0.52
5,3,right,5,181,1,4,0.48
5,3,rival,5,182,2,3,0.44
5,3,rob,3,183,1,2,0.32
5,3,root,4,184,2,2,0.32
5,3,rough,5,185,2,3,0.6
5,3,round,5,186,3,2,0.4
5,3,rub,3,187,1,2,0.32
5,3,safe,4,188,0,4,0.56
5,3,sale,4,189,2,2,0.4
5,3,salt,4,190,3,1,0.28
5,3,scan,4,191,1,3,0.48
5,3,sexy,4,192,1,3,0.4
5,3,shape,5,193,1,4,0.56
5,3,share,5,194,3,2,0.4
5,3,shell,5,195,2,3,0.44
5,3,shift,5,196,2,3,0.56
5,3,shiny,5,197,3,2,0.4
5,3,ship,4,198,3,1,0.28
5,3,sit,3,199,1,2,0.32
5,3,six,3,200,2,1,0.24
5,3,skip,4,201,1,3,0.48
5,3,slip,4,202,1,3,0.4
5,3,smile,5,203,1,4,0.6
5,3,snow,4,204,1,3,0.4
5,3,song,4,205,1,3,0.4
5,3,soup,4,206,2,2,0.32
5,3,space,5,207,1,4,0.48
5,3,spare,5,208,3,2,0.4
5,3,speak,5,209,2,3,0.52
5,3,stall,5,210,1,4,0.48
5,3,stamp,5,211,3,2,0.36
5,3,stand,5,212,3,2,0.36
5,3,star,4,213,3,1,0.32
5,3,stem,4,214,2,2,0.48
5,3,store,5,215,2,3,0.44
5,3,study,5,216,2,3,0.4
5,3,super,5,217,1,4,0.48
5,3,sweep,5,218,1,4,0.48
5,3,table,5,219,0,5,0.64
5,3,tale,4,220,2,2,0.32
5,3,talk,4,221,3,1,0.28
5,3,tape,4,222,2,2,0.36
5,3,task,4,223,2,2,0.48
5,3,taste,5,224,3,2,0.4
5,3,taxi,4,225,2,2,0.48
5,3,tea,3,226,1,2,0.32
5,3,team,4,227,3,1,0.32
5,3,three,5,228,1,4,0.52
5,3,thumb,5,229,2,3,0.48
5,3,tight,5,230,1,4,0.52
5,3,till,4,231,2,2,0.48
5,3,tonne,5,232,1,4,0.52
5,3,too,3,233,2,1,0.24
5,3,tool,4,234,3,1,0.32
5,3,topic,5,235,2,3,0.6
5,3,trap,4,236,1,3,0.4
5,3,tree,4,237,2,2,0.48
5,3,trend,5,238,3,2,0.64
5,3,tribe,5,239,2,3,0.72
5,3,trio,4,240,3,1,0.32
5,3,truck,5,241,2,3,0.52
5,3,tune,4,242,1,3,0.48
5,3,unify,5,243,0,5,0.76
5,3,union,5,244,3,2,0.4
5,3,until,5,245,2,3,0.44
5,3,usual,5,246,1,4,0.52
5,3,vague,5,247,0,5,0.6
5,3,vary,4,248,2,2,0.52
5,3,vein,4,249,1,3,0.4
5,3,video,5,250,1,4,0.52
5,3,vocal,5,251,1,4,0.52
5,3,voice,5,252,2,3,0.44
5,3,wake,4,253,0,4,0.44
5,3,war,3,254,2,1,0.36
5,3,water,5,255,2,3,0.52
5,3,west,4,256,1,3,0.44
5,3,whose,5,257,1,4,0.6
5,3,width,5,258,1,4,0.52
5,3,win,3,259,2,1,0.24
5,3,wipe,4,260,2,2,0.44
5,3,word,4,261,1,3,0.4
5,3,world,5,262,3,2,0.36
5,3,worry,5,263,3,2,0.36
5,3,wow,3,264,2,1,0.24
5,4,acre,4,0,0,4,0.96
5,4,acute,5,1,2,3,0.64
5,4,again,5,2,1,4,0.76
5,4,agree,5,3,2,3,0.44
5,4,ahead,5,4,1,4,0.48
5,4,align,5,5,1,4,0.48
5,4,ally,4,6,2,2,0.32
5,4,anger,5,7,1,4,0.6
5,4,ankle,5,8,2,3,0.4
5,4,argue,5,9,1,4,0.4
5,4,army,4,10,2,2,0.2
5,4,arrow,5,11,2,3,0.24
5,4,ask,3,12,1,2,0.2
5,4,auto,4,13,1,3,0.16
5,4,beat,4,14,0,4,0.2
5,4,beer,4,15,2,2,0.16
5,4,bell,4,16,2,2,0.16
5,4,below,5,17,3,2,0.16
5,4,bill,4,18,1,3,0.24
5,4,bin,3,19,2,1,0.08
5,4,bird,4,20,2,2,0.16
5,4,blank,5,21,1,4,0.24
5,4,blow,4,22,2,2,0.16
5,4,boat,4,23,1,3,0.16
5,4,boom,4,24,2,2,0.2
5,4,boot,4,25,3,1,0.12
5,4,bride,5,26,1,4,0.2
5,4,build,5,27,1,4,0.2
5,4,bunch,5,28,2,3,0.2
5,4,cafe,4,29,0,4,0.2
5,4,cake,4,30,2,2,0.2
5,4,cap,3,31,2,1,0.12
5,4,cd,2,32,1,1,0.08
5,4,cease,5,33,1,4,0.2
5,4,chair,5,34,1,4,0.2
5,4,chart,5,35,3,2,0.16
5,4,chunk,5,36,2,3,0.24
5,4,civil,5,37,1,4,0.24
5,4,cloud,5,38,1,4,0.2
5,4,club,4,39,2,2,0.16
5,4,coach,5,40,1,4,0.2
5,4,cost,4,41,2,2,0.16
5,4,could,5,42,2,3,0.28
5,4,coup,4,43,3,1,0.12
5,4,court,5,44,3,2,0.2
5,4,craft,5,45,1,4,0.24
5,4,crime,5,46,2,3,0.2
5,4,cross,5,47,2,3,0.28
5,4,cry,3,48,2,1,0.12
5,4,day,3,49,0,3,0.16
5,4,deed,4,50,1,3,0.16
5,4,dirt,4,51,1,3,0.16
5,4,dirty,5,52,4,1,0.12
5,4,drama,5,53,1,4,0.28
5,4,ear,3,54,0,3,0.16
5,4,earth,5,55,3,2,0.16
5,4,edit,4,56,1,3,0.16
5,4,eight,5,57,1,4,0.2
5,4,elect,5,58,1,4,0.2
5,4,enemy,5,59,1,4,0.32
5,4,enjoy,5,60,2,3,0.2
5,4,enter,5,61,2,3,0.2
5,4,essay,5,62,1,4,0.4
5,4,event,5,63,1,4,0.2
5,4,evoke,5,64,2,3,0.24
5,4,exact,5,65,1,4,0.2
5,4,exit,4,66,2,2,0.12
5,4,eye,3,67,1,2,0.16
5,4,fall,4,68,0,4,0.2
5,4,fear,4,69,1,3,0.16
5,4,fee,3,70,2,1,0.16
5,4,fight,5,71,1,4,0.2
5,4,fine,4,72,2,2,0.16
5,4,firm,4,73,2,2,0.12
5,4,floor,5,74,1,4,0.2
5,4,flu,3,75,2,1,0.12
5,4,for,3,76,1,2,0.2
5,4,force,5,77,3,2,0.16
5,4,front,5,78,1,4,0.2
5,4,full,4,79,1,3,0.16
5,4,give,4,80,0,4,0.2
5,4,glass,5,81,1,4,0.2
5,4,god,3,82,1,2,0.2
5,4,good,4,83,2,2,0.16
5,4,grade,5,84,1,4,0.2
5,4,grey,4,85,2,2,0.16
5,4,grin,4,86,2,2,0.16
5,4,grind,5,87,4,1,0.12
5,4,guide,5,88,1,4,0.4
5,4,guy,3,89,2,1,0.12
5,4,gym,3,90,1,2,0.12
5,4,hair,4,91,0,4,0.2
5,4,hat,3,92,2,1,0.08
5,4,heat,4,93,1,3,0.16
5,4,her,3,94,2,1,0.16
5,4,hers,4,95,3,1,0.12
5,4,hour,4,96,1,3,0.16
5,4,how,3,97,2,1,0.12
5,4,hunt,4,98,1,3,0.2
5,4,i,1,99,0,1,0.08
5,4,ice,3,100,1,2,0.12
5,4,icon,4,101,2,2,0.16
5,4,image,5,102,1,4,0.28
5,4,incur,5,103,1,4,0.2
5,4,index,5,104,2,3,0.2
5,4,into,4,105,2,2,0.16
5,4,jet,3,106,0,3,0.16
5,4,joy,3,107,1,2,0.12
5,4,june,4,108,1,3,0.24
5,4,kick,4,109,0,4,0.2
5,4,kit,3,110,2,1,0.12
5,4,knife,5,111,1,4,0.2
5,4,lack,4,112,0,4,0.2
5,4,lad,3,113,2,1,0.12
5,4,lap,3,114,2,1,0.16
5,4,laser,5,115,2,3,0.2
5,4,law,3,116,2,1,0.12
5,4,layer,5,117,2,3,0.2
5,4,leaf,4,118,1,3,0.16
5,4,left,4,119,2,2,0.16
5,4,lie,3,120,1,2,0.2
5,4,limb,4,121,2,2,0.16
5,4,live,4,122,2,2,0.16
5,4,liver,5,123,4,1,0.12
5,4,low,3,124,1,2,0.12
5,4,lunch,5,125,1,4,0.2
5,4,mail,4,126,0,4,0.24
5,4,map,3,127,2,1,0.12
5,4,mark,4,128,2,2,0.16
5,4,mask,4,129,2,2,0.16
5,4,match,5,130,2,3,0.2
5,4,mess,4,131,1,3,0.16
5,4,metre,5,132,2,3,0.24
5,4,mind,4,133,1,3,0.16
5,4,model,5,134,1,4,0.24
5,4,money,5,135,2,3,0.2
5,4,month,5,136,3,2,0.16
5,4,more,4,137,2,2,0.16
5,4,mouth,5,138,2,3,0.24
5,4,movie,5,139,2,3,0.2
5,4,much,4,140,1,3,0.16
5,4,nasty,5,141,0,5,0.24
5,4,new,3,142,1,2,0.12
5,4,newly,5,143,3,2,0.16
5,4,non,3,144,1,2,0.2
5,4,note,4,145,2,2,0.16
5,4,novel,5,146,2,3,0.2
5,4,off,3,147,0,3,0.16
5,4,one,3,148,1,2,0.12
5,4,owe,3,149,1,2,0.16
5,4,pack,4,150,0,4,0.28
5,4,paint,5,151,2,3,0.2
5,4,pause,5,152,2,3,0.2
5,4,photo,5,153,1,4,0.2
5,4,piece,5,154,1,4,0.24
5,4,pig,3,155,2,1,0.12
5,4,pin,3,156,2,1,0.16
5,4,place,5,157,1,4,0.2
5,4,plane,5,158,3,2,0.16
5,4,plant,5,159,4,1,0.12
5,4,plead,5,160,2,3,0.2
5,4,plot,4,161,2,2,0.12
5,4,point,5,162,1,4,0.28
5,4,pot,3,163,2,1,0.12
5,4,proof,5,164,1,4,0.2
5,4,pump,4,165,1,3,0.16
5,4,punk,4,166,2,2,0.16
5,4,push,4,167,2,2,0.16
5,4,query,5,168,0,5,0.28
5,4,race,4,169,0,4,0.2
5,4,raise,5,170,2,3,0.2
5,4,rally,5,171,2,3,0.2
5,4,react,5,172,1,4,0.2
5,4,realm,5,173,3,2,0.24
5,4,refer,5,174,2,3,0.2
5,4,reign,5,175,2,3,0.2
5,4,rifle,5,176,1,4,0.24
5,4,rip,3,177,2,1,0.12
5,4,roll,4,178,1,3,0.16
5,4,sale,4,179,0,4,0.28
5,4,sand,4,180,2,2,0.16
5,4,score,5,181,1,4,0.2
5,4,serve,5,182,1,4,0.24
5,4,seven,5,183,2,3,0.2
5,4,sexy,4,184,2,2,0.24
5,4,shape,5,185,1,4,0.24
5,4,sheer,5,186,2,3,0.28
5,4,shell,5,187,3,2,0.16
5,4,ship,4,188,2,2,0.16
5,4,shoot,5,189,2,3,0.28
5,4,shore,5,190,3,2,0.16
5,4,sight,5,191,1,4,0.2
5,4,six,3,192,2,1,0.12
5,4,ski,3,193,1,2,0.12
5,4,skip,4,194,3,1,0.12
5,4,skull,5,195,2,3,0.2
5,4,slam,4,196,1,3,0.24
5,4,slice,5,197,2,3,0.2
5,4,slip,4,198,3,1,0.12
5,4,snow,4,199,1,3,0.2
5,4,soap,4,200,1,3,0.16
5,4,solar,5,201,2,3,0.24
5,4,solid,5,202,3,2,0.16
5,4,solo,4,203,3,1,0.12
5,4,song,4,204,2,2,0.16
5,4,soup,4,205,2,2,0.16
5,4,speak,5,206,1,4,0.24
5,4,spin,4,207,2,2,0.24
5,4,staff,5,208,1,4,0.24
5,4,stamp,5,209,3,2,0.2
5,4,stand,5,210,3,2,0.16
5,4,star,4,211,3,1,0.12
5,4,stay,4,212,3,1,0.12
5,4,steer,5,213,2,3,0.24
5,4,stick,5,214,2,3,0.2
5,4,store,5,215,2,3,0.16
5,4,story,5,216,4,1,0.16
5,4,study,5,217,2,3,0.2
5,4,sue,3,218,1,2,0.12
5,4,sweep,5,219,1,4,0.28
5,4,swim,4,220,2,2,0.16
5,4,table,5,221,0,5,0.24
5,4,tale,4,222,2,2,0.16
5,4,talk,4,223,3,1,0.12
5,4,tank,4,224,2,2,0.16
5,4,tap,3,225,2,1,0.16
5,4,tape,4,226,3,1,0.12
5,4,task,4,227,2,2,0.12
5,4,taste,5,228,3,2,0.16
5,4,tea,3,229,1,2,0.12
5,4,team,4,230,3,1,0.12
5,4,tempt,5,231,2,3,0.24
5,4,thumb,5,232,1,4,0.4
5,4,tidy,4,233,1,3,0.36
5,4,tight,5,234,2,3,0.44
5,4,till,4,235,2,2,0.32
5,4,to,2,236,1,1,0.2
5,4,tonne,5,237,2,3,0.52
5,4,topic,5,238,2,3,0.4
5,4,tree,4,239,1,3,0.4
5,4,twice,5,240,1,4,0.48
5,4,two,3,241,2,1,0.24
5,4,union,5,242,0,5,0.52
5,4,until,5,243,2,3,0.52
5,4,upon,4,244,1,3,0.4
5,4,urban,5,245,1,4,0.48
5,4,usage,5,246,1,4,0.48
5,4,usual,5,247,2,3,0.4
5,4,vague,5,248,0,5,0.64
5,4,vary,4,249,2,2,0.32
5,4,video,5,250,1,4,0.48
5,4,virus,5,251,2,3,0.44
5,4,vocal,5,252,1,4,0.48
5,4,wait,4,253,0,4,0.56
5,4,war,3,254,2,1,0.24
5,4,watch,5,255,2,3,0.4
5,4,weird,5,256,1,4,0.48
5,4,west,4,257,2,2,0.32
5,4,whose,5,258,1,4,0.52
5,4,width,5,259,1,4,0.6
5,4,wine,4,260,2,2,0.36
5,4,word,4,261,1,3,0.4
5,4,worry,5,262,3,2,0.36
5,4,wrap,4,263,1,3,0.4
5,4,wrist,5,264,2,3,0.44
5,5,a,1,0,0,1,0.16
5,5,acre,4,1,1,3,0.36
5,5,acute,5,2,2,3,0.52
5,5,add,3,3,1,2,0.28
5,5,adj,3,4,2,1,0.24
5,5,adopt,5,5,2,3,0.44
5,5,agree,5,6,1,4,0.52
5,5,ahead,5,7,1,4,0.48
5,5,and,3,8,1,2,0.4
5,5,argue,5,9,1,4,0.48
5,5,arms,4,10,2,2,0.32
5,5,arrow,5,11,2,3,0.4
5,5,ask,3,12,1,2,0.28
5,5,auto,4,13,1,3,0.4
5,5,baby,4,14,0,4,0.56
5,5,bat,3,15,2,1,0.24
5,5,bath,4,16,3,1,0.28
5,5,beast,5,17,1,4,0.56
5,5,beg,3,18,2,1,0.24
5,5,below,5,19,2,3,0.44
5,5,best,4,20,2,2,0.44
5,5,bill,4,21,1,3,0.36
5,5,bin,3,22,2,1,0.24
5,5,blame,5,23,1,4,0.48
5,5,boil,4,24,1,3,0.4
5,5,bomb,4,25,2,2,0.32
5,5,boot,4,26,2,2,0.44
5,5,bound,5,27,2,3,0.44
5,5,box,3,28,2,1,0.24
5,5,break,5,29,1,4,0.48
5,5,bride,5,30,2,3,0.4
5,5,bug,3,31,1,2,0.28
5,5,build,5,32,2,3,0.52
5,5,bunch,5,33,2,3,0.4
5,5,cake,4,34,0,4,0.44
5,5,card,4,35,2,2,0.32
5,5,carve,5,36,3,2,0.36
5,5,cave,4,37,2,2,0.32
5,5,chair,5,38,1,4,0.56
5,5,chart,5,39,3,2,0.36
5,5,cheat,5,40,2,3,0.44
5,5,check,5,41,3,2,0.36
5,5,city,4,42,1,3,0.4
5,5,cloud,5,43,1,4,0.6
5,5,coach,5,44,1,4,0.48
5,5,cost,4,45,2,2,0.32
5,5,coup,4,46,2,2,0.32
5,5,craft,5,47,1,4,0.48
5,5,creep,5,48,2,3,0.44
5,5,crime,5,49,2,3,0.52
5,5,crowd,5,50,2,3,0.44
5,5,cruel,5,51,2,3,0.44
5,5,cry,3,52,2,1,0.24
5,5,dare,4,53,0,4,0.44
5,5,deem,4,54,1,3,0.4
5,5,demon,5,55,2,3,0.6
5,5,dirt,4,56,1,3,0.4
5,5,dirty,5,57,4,1,0.32
5,5,drama,5,58,1,4,0.56
5,5,drink,5,59,2,3,0.48
5,5,ear,3,60,0,3,0.6
5,5,earth,5,61,3,2,0.36
5,5,edit,4,62,1,3,0.4
5,5,eight,5,63,1,4,0.48
5,5,elect,5,64,1,4,0.72
5,5,enemy,5,65,1,4,0.48
5,5,enjoy,5,66,2,3,0.56
5,5,enter,5,67,2,3,0.44
5,5,essay,5,68,1,4,0.48
5,5,fall,4,69,0,4,0.44
5,5,few,3,70,1,2,0.28
5,5,fibre,5,71,1,4,0.56
5,5,fight,5,72,2,3,0.44
5,5,fine,4,73,2,2,0.32
5,5,firm,4,74,2,2,0.32
5,5,fixed,5,75,2,3,0.44
5,5,flag,4,76,1,3,0.36
5,5,flee,4,77,2,2,0.44
5,5,floor,5,78,2,3,0.4
5,5,flu,3,79,2,1,0.24
5,5,focus,5,80,1,4,0.48
5,5,food,4,81,2,2,0.32
5,5,for,3,82,2,1,0.24
5,5,front,5,83,1,4,0.56
5,5,full,4,84,1,3,0.36
5,5,game,4,85,0,4,0.44
5,5,genre,5,86,1,4,0.48
5,5,giant,5,87,1,4,0.48
5,5,globe,5,88,1,4,0.6
5,5,go,2,89,1,1,0.2
5,5,god,3,90,2,1,0.24
5,5,green,5,91,1,4,0.56
5,5,greet,5,92,4,1,0.36
5,5,guess,5,93,1,4,0.48
5,5,gym,3,94,1,2,0.28
5,5,harm,4,95,0,4,0.56
5,5,hat,3,96,2,1,0.24
5,5,heart,5,97,1,4,0.48
5,5,heat,4,98,3,1,0.28
5,5,her,3,99,2,1,0.24
5,5,herb,4,100,3,1,0.28
5,5,hers,4,101,3,1,0.36
5,5,hint,4,102,1,3,0.36
5,5,hotel,5,103,1,4,0.48
5,5,hunt,4,104,1,3,0.36
5,5,ideal,5,105,0,5,0.52
5,5,image,5,106,1,4,0.48
5,5,index,5,107,1,4,0.56
5,5,into,4,108,2,2,0.32
5,5,jet,3,109,0,3,0.32
5,5,joy,3,110,1,2,0.28
5,5,jump,4,111,1,3,0.36
5,5,just,4,112,2,2,0.32
5,5,key,3,113,0,3,0.44
5,5,king,4,114,1,3,0.36
5,5,know,4,115,1,3,0.36
5,5,lake,4,116,0,4,0.44
5,5,laser,5,117,2,3,0.44
5,5,laugh,5,118,2,3,0.44
5,5,left,4,119,1,3,0.52
5,5,lens,4,120,2,2,0.4
5,5,limb,4,121,1,3,0.44
5,5,link,4,122,2,2,0.4
5,5,lion,4,123,2,2,0.4
5,5,liver,5,124,2,3,0.48
5,5,load,4,125,1,3,0.52
5,5,local,5,126,2,3,0.4
5,5,log,3,127,2,1,0.24
5,5,long,4,128,2,2,0.32
5,5,lunch,5,129,1,4,0.52
5,5,map,3,130,0,3,0.36
5,5,match,5,131,2,3,0.56
5,5,meal,4,132,1,3,0.4
5,5,mixed,5,133,1,4,0.48
5,5,model,5,134,1,4,0.48
5,5,money,5,135,2,3,0.44
5,5,month,5,136,3,2,0.48
5,5,most,4,137,2,2,0.32
5,5,mum,3,138,1,2,0.28
5,5,must,4,139,2,2,0.32
5,5,myth,4,140,1,3,0.36
5,5,nasty,5,141,0,5,0.52
5,5,new,3,142,1,2,0.28
5,5,norm,4,143,1,3,0.48
5,5,not,3,144,2,1,0.24
5,5,note,4,145,3,1,0.32
5,5,nut,3,146,1,2,0.28
5,5,once,4,147,0,4,0.48
5,5,other,5,148,1,4,0.52
5,5,owe,3,149,1,2,0.4
5,5,pace,4,150,0,4,0.44
5,5,pad,3,151,2,1,0.24
5,5,pants,5,152,2,3,0.52
5,5,park,4,153,2,2,0.4
5,5,pause,5,154,2,3,0.48
5,5,peace,5,155,1,4,0.64
5,5,phone,5,156,1,4,0.48
5,5,photo,5,157,3,2,0.4
5,5,pick,4,158,1,3,0.4
5,5,pile,4,159,2,2,0.36
5,5,pin,3,160,2,1,0.24
5,5,place,5,161,1,4,0.64
5,5,plot,4,162,2,2,0.32
5,5,point,5,163,1,4,0.48
5,5,pond,4,164,2,2,0.32
5,5,post,4,165,2,2,0.32
5,5,pot,3,166,2,1,0.24
5,5,prior,5,167,1,4,0.6
5,5,proof,5,168,2,3,0.44
5,5,push,4,169,1,3,0.4
5,5,put,3,170,2,1,0.24
5,5,query,5,171,0,5,0.52
5,5,quite,5,172,2,3,0.4
5,5,race,4,173,0,4,0.52
5,5,realm,5,174,1,4,0.48
5,5,rear,4,175,3,1,0.28
5,5,rebel,5,176,2,3,0.44
5,5,relax,5,177,2,3,0.4
5,5,rifle,5,178,1,4,0.6
5,5,right,5,179,2,3,0.4
5,5,rip,3,180,2,1,0.24
5,5,rise,4,181,2,2,0.24
5,5,road,4,182,1,3,0.16
5,5,rob,3,183,2,1,0.12
5,5,roll,4,184,2,2,0.2
5,5,roof,4,185,2,2,0.16
5,5,root,4,186,3,1,0.12
5,5,rough,5,187,2,3,0.28
5,5,round,5,188,3,2,0.2
5,5,ruin,4,189,1,3,0.2
5,5,salt,4,190,0,4,0.28
5,5,sand,4,191,2,2,0.16
5,5,seem,4,192,1,3,0.16
5,5,shape,5,193,1,4,0.2
5,5,sheer,5,194,2,3,0.16
5,5,shift,5,195,2,3,0.2
5,5,shoot,5,196,2,3,0.24
5,5,shore,5,197,3,2,0.16
5,5,sink,4,198,1,3,0.16
5,5,ski,3,199,1,2,0.12
5,5,skip,4,200,3,1,0.12
5,5,skirt,5,201,3,2,0.16
5,5,skull,5,202,2,3,0.24
5,5,slice,5,203,1,4,0.2
5,5,slip,4,204,3,1,0.12
5,5,smile,5,205,1,4,0.2
5,5,snow,4,206,1,3,0.16
5,5,soap,4,207,1,3,0.24
5,5,solar,5,208,2,3,0.2
5,5,solo,4,209,3,1,0.12
5,5,song,4,210,2,2,0.12
5,5,soup,4,211,2,2,0.16
5,5,speak,5,212,1,4,0.2
5,5,staff,5,213,1,4,0.24
5,5,star,4,214,3,1,0.12
5,5,steer,5,215,2,3,0.2
5,5,stop,4,216,2,2,0.12
5,5,study,5,217,2,3,0.16
5,5,stun,4,218,3,1,0.12
5,5,such,4,219,1,3,0.24
5,5,swim,4,220,1,3,0.16
5,5,table,5,221,0,5,0.2
5,5,talk,4,222,2,2,0.16
5,5,tank,4,223,2,2,0.16
5,5,tap,3,224,2,1,0.08
5,5,tape,4,225,3,1,0.2
5,5,taxi,4,226,2,2,0.16
5,5,tempt,5,227,1,4,0.24
5,5,three,5,228,1,4,0.2
5,5,thumb,5,229,2,3,0.2
5,5,tight,5,230,1,4,0.2
5,5,till,4,231,2,2,0.2
5,5,tonne,5,232,1,4,0.2
5,5,too,3,233,2,1,0.08
5,5,tool,4,234,3,1,0.12
5,5,topic,5,235,2,3,0.16
5,5,trap,4,236,1,3,0.16
5,5,treat,5,237,2,3,0.24
5,5,tree,4,238,3,1,0.12
5,5,trend,5,239,3,2,0.16
5,5,tune,4,240,1,3,0.16
5,5,unify,5,241,0,5,0.28
5,5,urban,5,242,1,4,0.28
5,5,usual,5,243,1,4,0.2
5,5,vague,5,244,0,5,0.24
5,5,video,5,245,1,4,0.2
5,5,vital,5,246,2,3,0.16
5,5,voice,5,247,1,4,0.28
5,5,wake,4,248,0,4,0.2
5,5,war,3,249,2,1,0.08
5,5,watch,5,250,2,3,0.2
5,5,water,5,251,3,2,0.16
5,5,weave,5,252,1,4,0.2
5,5,weird,5,253,2,3,0.24
5,5,which,5,254,1,4,0.2
5,5,width,5,255,1,4,0.2
5,5,win,3,256,2,1,0.08
5,5,wine,4,257,3,1,0.12
5,5,wipe,4,258,2,2,0.12
5,5,woman,5,259,1,4,0.28
5,5,word,4,260,2,2,0.12
5,5,work,4,261,3,1,0.12
5,5,world,5,262,3,2,0.16
5,5,worry,5,263,3,2,0.16
5,5,young,5,264,0,5,0.28
5,6,a,1,0,0,1,0.12
5,6,add,3,1,1,2,0.16
5,6,adj,3,2,2,1,0.12
5,6,adopt,5,3,2,3,0.28
5,6,ankle,5,4,1,4,0.24
5,6,app,3,5,1,2,0.12
5,6,arise,5,6,1,4,0.24
5,6,army,4,7,2,2,0.16
5,6,arrow,5,8,2,3,0.32
5,6,ask,3,9,1,2,0.16
5,6,at,2,10,1,1,0.08
5,6,base,4,11,0,4,0.2
5,6,bat,3,12,2,1,0.12
5,6,bath,4,13,3,1,0.12
5,6,bay,3,14,2,1,0.12
5,6,beast,5,15,1,4,0.32
5,6,beat,4,16,3,1,0.12
5,6,beer,4,17,2,2,0.16
5,6,beg,3,18,2,1,0.12
5,6,below,5,19,2,3,0.2
5,6,best,4,20,2,2,0.16
5,6,bin,3,21,1,2,0.2
5,6,bird,4,22,2,2,0.16
5,6,bite,4,23,2,2,0.16
5,6,blade,5,24,1,4,0.28
5,6,blame,5,25,3,2,0.2
5,6,blank,5,26,3,2,0.28
5,6,blind,5,27,2,3,0.28
5,6,blog,4,28,2,2,0.16
5,6,blow,4,29,3,1,0.12
5,6,bomb,4,30,1,3,0.2
5,6,boom,4,31,2,2,0.16
5,6,boot,4,32,3,1,0.2
5,6,bound,5,33,2,3,0.2
5,6,box,3,34,2,1,0.16
5,6,bride,5,35,1,4,0.24
5,6,buddy,5,36,1,4,0.2
5,6,bug,3,37,2,1,0.12
5,6,burn,4,38,2,2,0.24
5,6,cap,3,39,0,3,0.16
5,6,card,4,40,2,2,0.16
5,6,carve,5,41,3,2,0.2
5,6,cd,2,42,1,1,0.08
5,6,cease,5,43,1,4,0.2
5,6,chair,5,44,1,4,0.28
5,6,check,5,45,2,3,0.2
5,6,chunk,5,46,2,3,0.2
5,6,cite,4,47,1,3,0.16
5,6,city,4,48,3,1,0.12
5,6,coach,5,49,1,4,0.2
5,6,cost,4,50,2,2,0.2
5,6,coup,4,51,2,2,0.2
5,6,craft,5,52,1,4,0.2
5,6,creep,5,53,2,3,0.2
5,6,cross,5,54,2,3,0.2
5,6,cycle,5,55,1,4,0.28
5,6,dam,3,56,0,3,0.16
5,6,death,5,57,1,4,0.2
5,6,deed,4,58,2,2,0.16
5,6,demon,5,59,2,3,0.2
5,6,devil,5,60,2,3,0.2
5,6,dirt,4,61,1,3,0.24
5,6,dot,3,62,1,2,0.12
5,6,drink,5,63,1,4,0.2
5,6,edit,4,64,0,4,0.2
5,6,eight,5,65,1,4,0.24
5,6,elect,5,66,1,4,0.28
5,6,enemy,5,67,1,4,0.24
5,6,enter,5,68,2,3,0.2
5,6,entry,5,69,3,2,0.2
5,6,essay,5,70,1,4,0.24
5,6,euro,4,71,1,3,0.24
5,6,evoke,5,72,1,4,0.2
5,6,exact,5,73,1,4,0.24
5,6,exit,4,74,2,2,0.16
5,6,eye,3,75,1,2,0.12
5,6,fair,4,76,0,4,0.2
5,6,fat,3,77,2,1,0.08
5,6,few,3,78,1,2,0.24
5,6,fibre,5,79,1,4,0.2
5,6,fifty,5,80,2,3,0.2
5,6,file,4,81,2,2,0.16
5,6,fine,4,82,2,2,0.16
5,6,firm,4,83,2,2,0.2
5,6,fix,3,84,2,1,0.12
5,6,fixed,5,85,3,2,0.16
5,6,floor,5,86,1,4,0.2
5,6,flu,3,87,2,1,0.12
5,6,focus,5,88,1,4,0.2
5,6,food,4,89,2,2,0.2
5,6,for,3,90,2,1,0.12
5,6,front,5,91,1,4,0.24
5,6,fur,3,92,1,2,0.12
5,6,game,4,93,0,4,0.24
5,6,gene,4,94,1,3,0.16
5,6,giant,5,95,1,4,0.24
5,6,glass,5,96,1,4,0.28
5,6,golf,4,97,1,3,0.2
5,6,good,4,98,2,2,0.12
5,6,greet,5,99,1,4,0.24
5,6,grey,4,100,3,1,0.12
5,6,grid,4,101,2,2,0.24
5,6,guy,3,102,1,2,0.12
5,6,hair,4,103,0,4,0.2
5,6,handy,5,104,2,3,0.2
5,6,harsh,5,105,2,3,0.2
5,6,hate,4,106,2,2,0.16
5,6,heat,4,107,1,3,0.24
5,6,herb,4,108,2,2,0.16
5,6,hers,4,109,3,1,0.12
5,6,how,3,110,1,2,0.12
5,6,i,1,111,0,1,0.08
5,6,icon,4,112,1,3,0.16
5,6,ill,3,113,1,2,0.12
5,6,incur,5,114,1,4,0.28
5,6,index,5,115,2,3,0.16
5,6,into,4,116,2,2,0.16
5,6,jet,3,117,0,3,0.16
5,6,joy,3,118,1,2,0.12
5,6,june,4,119,1,3,0.16
5,6,just,4,120,2,2,0.2
5,6,key,3,121,0,3,0.16
5,6,kick,4,122,1,3,0.16
5,6,king,4,123,2,2,0.16
5,6,kit,3,124,2,1,0.12
5,6,know,4,125,1,3,0.16
5,6,lack,4,126,0,4,0.2
5,6,lad,3,127,2,1,0.16
5,6,lake,4,128,2,2,0.16
5,6,lap,3,129,2,1,0.12
5,6,last,4,130,2,2,0.12
5,6,laugh,5,131,2,3,0.2
5,6,left,4,132,1,3,0.16
5,6,lemon,5,133,2,3,0.24
5,6,link,4,134,1,3,0.16
5,6,log,3,135,1,2,0.12
5,6,love,4,136,2,2,0.16
5,6,mask,4,137,0,4,0.2
5,6,mean,4,138,1,3,0.16
5,6,media,5,139,2,3,0.24
5,6,most,4,140,1,3,0.16
5,6,much,4,141,1,3,0.16
5,6,music,5,142,2,3,0.2
5,6,my,2,143,1,1,0.08
5,6,myth,4,144,2,2,0.16
5,6,naked,5,145,0,5,0.28
5,6,neck,4,146,1,3,0.16
5,6,newly,5,147,2,3,0.2
5,6,noise,5,148,1,4,0.2
5,6,norm,4,149,2,2,0.12
5,6,note,4,150,2,2,0.16
5,6,novel,5,151,2,3,0.24
5,6,other,5,152,0,5,0.24
5,6,ought,5,153,1,4,0.2
5,6,pack,4,154,0,4,0.2
5,6,pants,5,155,2,3,0.2
5,6,park,4,156,2,2,0.2
5,6,pause,5,157,2,3,0.2
5,6,peer,4,158,1,3,0.16
5,6,phone,5,159,1,4,0.2
5,6,pig,3,160,1,2,0.12
5,6,pile,4,161,2,2,0.16
5,6,pin,3,162,2,1,0.12
5,6,play,4,163,1,3,0.24
5,6,plead,5,164,2,3,0.24
5,6,plot,4,165,2,2,0.16
5,6,point,5,166,1,4,0.2
5,6,post,4,167,2,2,0.16
5,6,pot,3,168,2,1,0.08
5,6,prior,5,169,1,4,0.28
5,6,proof,5,170,2,3,0.2
5,6,pump,4,171,1,3,0.16
5,6,punk,4,172,2,2,0.16
5,6,push,4,173,2,2,0.16
5,6,race,4,174,0,4,0.24
5,6,radar,5,175,2,3,0.2
5,6,raise,5,176,2,3,0.2
5,6,react,5,177,1,4,0.2
5,6,rifle,5,178,1,4,0.2
5,6,rival,5,179,2,3,0.28
5,6,roll,4,180,1,3,0.2
5,6,roof,4,181,2,2,0.16
5,6,root,4,182,3,1,0.12
5,6,round,5,183,2,3,0.2
5,6,ruin,4,184,1,3,0.16
5,6,safe,4,185,0,4,0.24
5,6,sale,4,186,2,2,0.16
5,6,salt,4,187,3,1,0.12
5,6,sand,4,188,2,2,0.12
5,6,scan,4,189,1,3,0.16
5,6,seem,4,190,1,3,0.2
5,6,seven,5,191,2,3,0.28
5,6,sexy,4,192,2,2,0.16
5,6,sheer,5,193,1,4,0.24
5,6,shell,5,194,3,2,0.16
5,6,ship,4,195,2,2,0.16
5,6,shoot,5,196,2,3,0.2
5,6,six,3,197,1,2,0.2
5,6,skirt,5,198,1,4,0.24
5,6,slice,5,199,1,4,0.2
5,6,solar,5,200,1,4,0.2
5,6,solid,5,201,3,2,0.16
5,6,solo,4,202,3,1,0.12
5,6,some,4,203,2,2,0.2
5,6,space,5,204,1,4,0.2
5,6,speak,5,205,2,3,0.2
5,6,spin,4,206,2,2,0.16
5,6,spine,5,207,4,1,0.12
5,6,stab,4,208,1,3,0.2
5,6,stamp,5,209,3,2,0.16
5,6,stand,5,210,3,2,0.16
5,6,steer,5,211,2,3,0.16
5,6,stick,5,212,2,3,0.2
5,6,stop,4,213,2,2,0.16
5,6,study,5,214,2,3,0.24
5,6,stun,4,215,3,1,0.12
5,6,sue,3,216,1,2,0.12
5,6,sugar,5,217,2,3,0.2
5,6,super,5,218,2,3,0.2
5,6,swear,5,219,1,4,0.2
5,6,sweep,5,220,3,2,0.2
5,6,swim,4,221,2,2,0.16
5,6,table,5,222,0,5,0.24
5,6,tail,4,223,2,2,0.16
5,6,tap,3,224,2,1,0.12
5,6,task,4,225,2,2,0.16
5,6,taste,5,226,3,2,0.24
5,6,this,4,227,1,3,0.16
5,6,three,5,228,2,3,0.2
5,6,tidy,4,229,1,3,0.16
5,6,tight,5,230,2,3,0.2
5,6,till,4,231,2,2,0.16
5,6,to,2,232,1,1,0.16
5,6,too,3,233,2,1,0.12
5,6,tour,4,234,2,2,0.16
5,6,trend,5,235,1,4,0.2
5,6,trial,5,236,2,3,0.2
5,6,truck,5,237,2,3,0.2
5,6,tune,4,238,1,3,0.24
5,6,twice,5,239,1,4,0.2
5,6,two,3,240,2,1,0.12
5,6,unify,5,241,0,5,0.24
5,6,until,5,242,2,3,0.2
5,6,urban,5,243,1,4,0.28
5,6,usage,5,244,1,4,0.2
5,6,usual,5,245,2,3,0.2
5,6,vary,4,246,0,4,0.2
5,6,vein,4,247,1,3,0.16
5,6,video,5,248,1,4,0.2
5,6,vital,5,249,2,3,0.24
5,6,vocal,5,250,1,4,0.2
5,6,voice,5,251,2,3,0.16
5,6,walk,4,252,0,4,0.2
5,6,weird,5,253,1,4,0.2
5,6,which,5,254,1,4,0.28
5,6,whose,5,255,2,3,0.2
5,6,width,5,256,1,4,0.2
5,6,win,3,257,2,1,0.12
5,6,woman,5,258,1,4,0.2
5,6,word,4,259,2,2,0.2
5,6,work,4,260,3,1,0.12
5,6,worry,5,261,3,2,0.16
5,6,wow,3,262,2,1,0.12
5,6,wrist,5,263,1,4,0.2
5,6,young,5,264,0,5,0.24
5,7,a,1,0,0,1,0.16
5,7,acid,4,1,1,3,0.4
5,7,add,3,2,1,2,0.4
5,7,adopt,5,3,2,3,0.44
5,7,ahead,5,4,1,4,0.48
5,7,ally,4,5,1,3,0.36
5,7,and,3,6,1,2,0.32
5,7,anger,5,7,2,3,0.4
5,7,ankle,5,8,2,3,0.52
5,7,app,3,9,1,2,0.28
5,7,arrow,5,10,1,4,0.48
5,7,ask,3,11,1,2,0.32
5,7,auto,4,12,1,3,0.36
5,7,base,4,13,0,4,0.44
5,7,bath,4,14,2,2,0.44
5,7,beat,4,15,1,3,0.4
5,7,beer,4,16,2,2,0.32
5,7,beg,3,17,2,1,0.24
5,7,best,4,18,2,2,0.32
5,7,bite,4,19,1,3,0.4
5,7,blade,5,20,1,4,0.6
5,7,blame,5,21,3,2,0.4
5,7,blank,5,22,3,2,0.36
5,7,bless,5,23,2,3,0.44
5,7,blind,5,24,2,3,0.44
5,7,bomb,4,25,1,3,0.4
5,7,boom,4,26,2,2,0.44
5,7,boot,4,27,3,1,0.28
5,7,bound,5,28,2,3,0.44
5,7,box,3,29,2,1,0.24
5,7,break,5,30,1,4,0.52
5,7,buddy,5,31,1,4,0.52
5,7,burn,4,32,2,2,0.44
5,7,cafe,4,33,0,4,0.48
5,7,cake,4,34,2,2,0.32
5,7,can,3,35,2,1,0.24
5,7,card,4,36,2,2,0.36
5,7,cd,2,37,1,1,0.2
5,7,cease,5,38,1,4,0.6
5,7,charm,5,39,1,4,0.52
5,7,chunk,5,40,2,3,0.44
5,7,cite,4,41,1,3,0.44
5,7,city,4,42,3,1,0.32
5,7,clerk,5,43,1,4,0.52
5,7,club,4,44,2,2,0.44
5,7,coach,5,45,1,4,0.48
5,7,cope,4,46,2,2,0.32
5,7,could,5,47,2,3,0.44
5,7,court,5,48,3,2,0.44
5,7,craft,5,49,1,4,0.6
5,7,crude,5,50,2,3,0.4
5,7,cruel,5,51,3,2,0.36
5,7,day,3,52,0,3,0.32
5,7,deed,4,53,1,3,0.36
5,7,deem,4,54,3,1,0.28
5,7,drama,5,55,1,4,0.6
5,7,drink,5,56,2,3,0.4
5,7,dust,4,57,1,3,0.36
5,7,enemy,5,58,0,5,0.52
5,7,enjoy,5,59,2,3,0.4
5,7,erect,5,60,1,4,0.6
5,7,essay,5,61,1,4,0.52
5,7,euro,4,62,1,3,0.44
5,7,event,5,63,1,4,0.52
5,7,evoke,5,64,2,3,0.48
5,7,fall,4,65,0,4,0.48
5,7,fat,3,66,2,1,0.36
5,7,fee,3,67,1,2,0.28
5,7,few,3,68,2,1,0.24
5,7,fibre,5,69,1,4,0.48
5,7,fifty,5,70,2,3,0.4
5,7,fight,5,71,2,3,0.44
5,7,fine,4,72,2,2,0.44
5,7,firm,4,73,2,2,0.32
5,7,flag,4,74,1,3,0.4
5,7,flat,4,75,3,1,0.28
5,7,flee,4,76,2,2,0.32
5,7,floor,5,77,2,3,0.44
5,7,flu,3,78,2,1,0.36
5,7,focus,5,79,1,4,0.48
5,7,force,5,80,2,3,0.48
5,7,fur,3,81,1,2,0.28
5,7,game,4,82,0,4,0.44
5,7,giant,5,83,1,4,0.48
5,7,give,4,84,2,2,0.44
5,7,go,2,85,1,1,0.2
5,7,god,3,86,2,1,0.24
5,7,grace,5,87,1,4,0.48
5,7,grade,5,88,3,2,0.4
5,7,greet,5,89,2,3,0.44
5,7,grey,4,90,3,1,0.4
5,7,grid,4,91,2,2,0.32
5,7,grin,4,92,3,1,0.28
5,7,guest,5,93,1,4,0.52
5,7,gym,3,94,1,2,0.28
5,7,handy,5,95,0,5,0.64
5,7,harm,4,96,2,2,0.44
5,7,harsh,5,97,3,2,0.36
5,7,heart,5,98,1,4,0.48
5,7,herb,4,99,2,2,0.36
5,7,hour,4,100,1,3,0.4
5,7,how,3,101,2,1,0.28
5,7,hunt,4,102,1,3,0.52
5,7,ice,3,103,0,3,0.36
5,7,into,4,104,1,3,0.44
5,7,iron,4,105,1,3,0.36
5,7,jet,3,106,0,3,0.36
5,7,job,3,107,1,2,0.28
5,7,jump,4,108,1,3,0.44
5,7,key,3,109,0,3,0.6
5,7,kick,4,110,1,3,0.44
5,7,kid,3,111,2,1,0.24
5,7,king,4,112,2,2,0.36
5,7,kit,3,113,2,1,0.24
5,7,lack,4,114,0,4,0.44
5,7,lap,3,115,2,1,0.24
5,7,laser,5,116,2,3,0.56
5,7,last,4,117,3,1,0.32
5,7,lawn,4,118,2,2,0.32
5,7,layer,5,119,2,3,0.44
5,7,left,4,120,1,3,0.44
5,7,lemon,5,121,2,3,0.52
5,7,lens,4,122,2,2,0.48
5,7,lie,3,123,1,2,0.32
5,7,link,4,124,2,2,0.36
5,7,load,4,125,1,3,0.44
5,7,local,5,126,2,3,0.44
5,7,look,4,127,2,2,0.32
5,7,lot,3,128,2,1,0.36
5,7,low,3,129,2,1,0.28
5,7,main,4,130,0,4,0.44
5,7,map,3,131,2,1,0.24
5,7,mask,4,132,2,2,0.32
5,7,meal,4,133,1,3,0.4
5,7,mean,4,134,3,1,0.28
5,7,mind,4,135,1,3,0.48
5,7,mixed,5,136,2,3,0.44
5,7,money,5,137,1,4,0.48
5,7,more,4,138,2,2,0.32
5,7,most,4,139,2,2,0.32
5,7,mouth,5,140,2,3,0.52
5,7,movie,5,141,2,3,0.4
5,7,much,4,142,1,3,0.4
5,7,my,2,143,1,1,0.2
5,7,myth,4,144,2,2,0.32
5,7,neck,4,145,0,4,0.44
5,7,new,3,146,2,1,0.24
5,7,non,3,147,1,2,0.4
5,7,north,5,148,2,3,0.44
5,7,note,4,149,2,2,0.36
5,7,nut,3,150,1,2,0.36
5,7,ocean,5,151,0,5,0.56
5,7,off,3,152,1,2,0.28
5,7,other,5,153,1,4,0.6
5,7,owe,3,154,1,2,0.28
5,7,pack,4,155,0,4,0.44
5,7,pad,3,156,2,1,0.24
5,7,park,4,157,2,2,0.32
5,7,pause,5,158,2,3,0.44
5,7,peer,4,159,1,3,0.4
5,7,phone,5,160,1,4,0.6
5,7,photo,5,161,3,2,0.36
5,7,piece,5,162,1,4,0.48
5,7,pipe,4,163,2,2,0.32
5,7,plead,5,164,1,4,0.48
5,7,plot,4,165,2,2,0.44
5,7,pond,4,166,1,3,0.4
5,7,post,4,167,2,2,0.32
5,7,pot,3,168,2,1,0.28
5,7,prior,5,169,1,4,0.56
5,7,proof,5,170,2,3,0.48
5,7,pupil,5,171,1,4,0.6
5,7,pure,4,172,2,2,0.32
5,7,put,3,173,2,1,0.24
5,7,quite,5,174,0,5,0.52
5,7,realm,5,175,0,5,0.56
5,7,rear,4,176,3,1,0.28
5,7,rebel,5,177,2,3,0.52
5,7,rifle,5,178,1,4,0.48
5,7,rise,4,179,2,2,0.32
5,7,rival,5,180,2,3,0.44
5,7,roof,4,181,1,3,0.44
5,7,salt,4,182,0,4,0.56
5,7,scan,4,183,1,3,0.36
5,7,seal,4,184,1,3,0.36
5,7,serve,5,185,2,3,0.44
5,7,seven,5,186,2,3,0.44
5,7,sheer,5,187,1,4,0.52
5,7,shell,5,188,3,2,0.48
5,7,shoot,5,189,2,3,0.4
5,7,shore,5,190,3,2,0.36
5,7,sight,5,191,1,4,0.48
5,7,sin,3,192,2,1,0.24
5,7,sink,4,193,3,1,0.48
5,7,six,3,194,2,1,0.32
5,7,ski,3,195,1,2,0.32
5,7,skirt,5,196,3,2,0.4
5,7,slam,4,197,1,3,0.4
5,7,slip,4,198,2,2,0.32
5,7,smile,5,199,1,4,0.48
5,7,soap,4,200,1,3,0.48
5,7,solar,5,201,2,3,0.4
5,7,solid,5,202,3,2,0.36
5,7,solo,4,203,3,1,0.28
5,7,some,4,204,2,2,0.32
5,7,soup,4,205,2,2,0.36
5,7,spare,5,206,1,4,0.6
5,7,speak,5,207,2,3,0.48
5,7,spine,5,208,2,3,0.44
5,7,staff,5,209,1,4,0.48
5,7,star,4,210,3,1,0.28
5,7,store,5,211,2,3,0.52
5,7,study,5,212,2,3,0.44
5,7,stun,4,213,3,1,0.28
5,7,such,4,214,1,3,0.44
5,7,super,5,215,2,3,0.52
5,7,sure,4,216,2,2,0.4
5,7,swear,5,217,1,4,0.6
5,7,swim,4,218,2,2,0.32
5,7,table,5,219,0,5,0.52
5,7,tale,4,220,2,2,0.32
5,7,talk,4,221,3,1,0.28
5,7,tank,4,222,2,2,0.32
5,7,tape,4,223,2,2,0.44
5,7,taxi,4,224,2,2,0.36
5,7,three,5,225,1,4,0.56
5,7,thumb,5,226,2,3,0.48
5,7,tidy,4,227,1,3,0.44
5,7,tight,5,228,2,3,0.6
5,7,to,2,229,1,1,0.2
5,7,too,3,230,2,1,0.24
5,7,topic,5,231,2,3,0.4
5,7,trend,5,232,1,4,0.48
5,7,tribe,5,233,2,3,0.4
5,7,truck,5,234,2,3,0.56
5,7,tune,4,235,1,3,0.4
5,7,twice,5,236,1,4,0.48
5,7,two,3,237,2,1,0.24
5,7,union,5,238,0,5,0.52
5,7,until,5,239,2,3,0.4
5,7,upon,4,240,1,3,0.52
5,7,urban,5,241,1,4,0.48
5,7,usage,5,242,1,4,0.48
5,7,vague,5,243,0,5,0.56
5,7,vary,4,244,2,2,0.36
5,7,vein,4,245,1,3,0.48
5,7,virus,5,246,1,4,0.6
5,7,vocal,5,247,1,4,0.48
5,7,wait,4,248,0,4,0.44
5,7,walk,4,249,2,2,0.32
5,7,war,3,250,2,1,0.24
5,7,watch,5,251,2,3,0.56
5,7,weird,5,252,1,4,0.52
5,7,west,4,253,2,2,0.36
5,7,which,5,254,1,4,0.48
5,7,whose,5,255,2,3,0.44
5,7,width,5,256,1,4,0.48
5,7,win,3,257,2,1,0.32
5,7,wind,4,258,3,1,0.28
5,7,wine,4,259,3,1,0.28
5,7,wipe,4,260,2,2,0.32
5,7,woman,5,261,1,4,0.48
5,7,word,4,262,2,2,0.32
5,7,wrist,5,263,1,4,0.6
5,7,young,5,264,0,5,0.52
5,8,a,1,0,0,1,0.08
5,8,acre,4,1,1,3,0.16
5,8,acute,5,2,2,3,0.16
5,8,ad,2,3,1,1,0.08
5,8,adj,3,4,2,1,0.08
5,8,admit,5,5,2,3,0.24
5,8,adopt,5,6,2,3,0.16
5,8,again,5,7,1,4,0.2
5,8,aids,4,8,1,3,0.16
5,8,ally,4,9,1,3,0.16
5,8,app,3,10,1,2,0.12
5,8,argue,5,11,1,4,0.28
5,8,ask,3,12,1,2,0.12
5,8,auto,4,13,1,3,0.2
5,8,baby,4,14,0,4,0.2
5,8,bat,3,15,2,1,0.12
5,8,bay,3,16,2,1,0.12
5,8,beast,5,17,1,4,0.28
5,8,bed,3,18,2,1,0.12
5,8,beg,3,19,2,1,0.12
5,8,bell,4,20,2,2,0.16
5,8,best,4,21,2,2,0.16
5,8,bird,4,22,1,3,0.16
5,8,boat,4,23,1,3,0.16
5,8,bomb,4,24,2,2,0.2
5,8,break,5,25,1,4,0.24
5,8,bride,5,26,2,3,0.16
5,8,buddy,5,27,1,4,0.2
5,8,bug,3,28,2,1,0.12
5,8,build,5,29,2,3,0.16
5,8,bunch,5,30,2,3,0.28
5,8,burn,4,31,2,2,0.12
5,8,cafe,4,32,0,4,0.2
5,8,cake,4,33,2,2,0.12
5,8,card,4,34,2,2,0.12
5,8,cave,4,35,2,2,0.12
5,8,cd,2,36,1,1,0.16
5,8,cease,5,37,1,4,0.2
5,8,chair,5,38,1,4,0.2
5,8,charm,5,39,3,2,0.16
5,8,choir,5,40,2,3,0.2
5,8,chop,4,41,3,1,0.16
5,8,civil,5,42,1,4,0.2
5,8,clean,5,43,1,4,0.2
5,8,clerk,5,44,3,2,0.16
5,8,club,4,45,2,2,0.16
5,8,cost,4,46,1,3,0.16
5,8,court,5,47,2,3,0.24
5,8,craft,5,48,1,4,0.2
5,8,creep,5,49,2,3,0.2
5,8,crime,5,50,2,3,0.2
5,8,cry,3,51,2,1,0.12
5,8,dance,5,52,0,5,0.32
5,8,deal,4,53,1,3,0.16
5,8,ear,3,54,0,3,0.12
5,8,earth,5,55,3,2,0.16
5,8,enjoy,5,56,1,4,0.2
5,8,entry,5,57,2,3,0.16
5,8,erect,5,58,1,4,0.28
5,8,event,5,59,1,4,0.2
5,8,evoke,5,60,2,3,0.16
5,8,eye,3,61,1,2,0.12
5,8,fall,4,62,0,4,0.2
5,8,fast,4,63,2,2,0.12
5,8,fat,3,64,2,1,0.16
5,8,fee,3,65,1,2,0.12
5,8,fifty,5,66,1,4,0.2
5,8,fight,5,67,2,3,0.2
5,8,file,4,68,2,2,0.12
5,8,firm,4,69,2,2,0.12
5,8,fix,3,70,2,1,0.16
5,8,floor,5,71,1,4,0.2
5,8,flu,3,72,2,1,0.08
5,8,focus,5,73,1,4,0.2
5,8,folk,4,74,2,2,0.12
5,8,food,4,75,2,2,0.12
5,8,force,5,76,2,3,0.24
5,8,full,4,77,1,3,0.16
5,8,fur,3,78,2,1,0.08
5,8,give,4,79,0,4,0.16
5,8,glass,5,80,1,4,0.24
5,8,go,2,81,1,1,0.12
5,8,golf,4,82,2,2,0.16
5,8,grade,5,83,1,4,0.6
5,8,green,5,84,2,3,0.24
5,8,greet,5,85,4,1,0.2
5,8,grey,4,86,3,1,0.12
5,8,guess,5,87,1,4,0.2
5,8,gym,3,88,1,2,0.2
5,8,hair,4,89,0,4,0.24
5,8,harsh,5,90,2,3,0.2
5,8,hate,4,91,2,2,0.12
5,8,herb,4,92,1,3,0.2
5,8,hint,4,93,1,3,0.16
5,8,hotel,5,94,1,4,0.24
5,8,how,3,95,2,1,0.08
5,8,i,1,96,0,1,0.12
5,8,ice,3,97,1,2,0.16
5,8,ideal,5,98,1,4,0.2
5,8,index,5,99,1,4,0.2
5,8,jet,3,100,0,3,0.16
5,8,jump,4,101,1,3,0.24
5,8,just,4,102,2,2,0.12
5,8,key,3,103,0,3,0.16
5,8,kid,3,104,1,2,0.16
5,8,king,4,105,2,2,0.16
5,8,kit,3,106,2,1,0.08
5,8,know,4,107,1,3,0.16
5,8,lad,3,108,0,3,0.24
5,8,laser,5,109,2,3,0.2
5,8,last,4,110,3,1,0.12
5,8,laugh,5,111,2,3,0.16
5,8,lawn,4,112,2,2,0.16
5,8,leaf,4,113,1,3,0.16
5,8,left,4,114,2,2,0.2
5,8,lie,3,115,1,2,0.12
5,8,limb,4,116,2,2,0.16
5,8,link,4,117,2,2,0.16
5,8,lion,4,118,2,2,0.16
5,8,live,4,119,2,2,0.16
5,8,long,4,120,1,3,0.28
5,8,look,4,121,2,2,0.16
5,8,loose,5,122,3,2,0.16
5,8,lot,3,123,2,1,0.12
5,8,low,3,124,2,1,0.12
5,8,lunch,5,125,1,4,0.24
5,8,mail,4,126,0,4,0.24
5,8,mark,4,127,2,2,0.12
5,8,mask,4,128,2,2,0.16
5,8,match,5,129,2,3,0.2
5,8,mess,4,130,1,3,0.16
5,8,metre,5,131,2,3,0.16
5,8,mind,4,132,1,3,0.24
5,8,model,5,133,1,4,0.2
5,8,money,5,134,2,3,0.2
5,8,most,4,135,2,2,0.12
5,8,mouth,5,136,2,3,0.2
5,8,much,4,137,1,3,0.16
5,8,music,5,138,2,3,0.6
5,8,must,4,139,3,1,0.36
5,8,name,4,140,0,4,0.72
5,8,nasty,5,141,2,3,0.24
5,8,noise,5,142,1,4,0.2
5,8,non,3,143,2,1,0.12
5,8,north,5,144,2,3,0.2
5,8,novel,5,145,2,3,0.2
5,8,nut,3,146,1,2,0.2
5,8,once,4,147,0,4,0.2
5,8,one,3,148,2,1,0.12
5,8,owe,3,149,1,2,0.12
5,8,pack,4,150,0,4,0.2
5,8,pad,3,151,2,1,0.12
5,8,paint,5,152,2,3,0.2
5,8,pants,5,153,2,3,0.28
5,8,park,4,154,2,2,0.16
5,8,pause,5,155,2,3,0.2
5,8,peace,5,156,1,4,0.2
5,8,phone,5,157,1,4,0.2
5,8,photo,5,158,3,2,0.24
5,8,piece,5,159,1,4,0.2
5,8,pile,4,160,2,2,0.12
5,8,place,5,161,1,4,0.2
5,8,plant,5,162,3,2,0.2
5,8,pond,4,163,1,3,0.16
5,8,post,4,164,2,2,0.2
5,8,pump,4,165,1,3,0.16
5,8,pupil,5,166,2,3,0.2
5,8,radar,5,167,0,5,0.24
5,8,rail,4,168,2,2,0.16
5,8,raise,5,169,3,2,0.2
5,8,rally,5,170,2,3,0.2
5,8,react,5,171,1,4,0.2
5,8,realm,5,172,3,2,0.16
5,8,rear,4,173,3,1,0.12
5,8,rebel,5,174,2,3,0.16
5,8,refer,5,175,2,3,0.24
5,8,reign,5,176,2,3,0.2
5,8,rip,3,177,1,2,0.12
5,8,rise,4,178,2,2,0.16
5,8,road,4,179,1,3,0.16
5,8,rob,3,180,2,1,0.12
5,8,roof,4,181,2,2,0.2
5,8,root,4,182,3,1,0.12
5,8,rough,5,183,2,3,0.2
5,8,rub,3,184,1,2,0.12
5,8,safe,4,185,0,4,0.24
5,8,salt,4,186,2,2,0.16
5,8,sand,4,187,2,2,0.2
5,8,score,5,188,1,4,0.2
5,8,seal,4,189,1,3,0.16
5,8,seem,4,190,2,2,0.16
5,8,serve,5,191,2,3,0.2
5,8,share,5,192,1,4,0.2
5,8,sheer,5,193,2,3,0.32
5,8,shell,5,194,3,2,0.2
5,8,shoot,5,195,2,3,0.2
5,8,shore,5,196,3,2,0.16
5,8,sight,5,197,1,4,0.2
5,8,sin,3,198,2,1,0.2
5,8,sink,4,199,3,1,0.12
5,8,six,3,200,2,1,0.12
5,8,skull,5,201,1,4,0.2
5,8,slam,4,202,1,3,0.16
5,8,snow,4,203,1,3,0.2
5,8,soap,4,204,1,3,0.16
5,8,solo,4,205,2,2,0.2
5,8,some,4,206,2,2,0.16
5,8,soup,4,207,2,2,0.16
5,8,south,5,208,3,2,0.16
5,8,space,5,209,1,4,0.2
5,8,speak,5,210,2,3,0.24
5,8,stand,5,211,1,4,0.2
5,8,stay,4,212,3,1,0.12
5,8,stick,5,213,2,3,0.2
5,8,store,5,214,2,3,0.2
5,8,study,5,215,2,3,0.2
5,8,such,4,216,1,3,0.24
5,8,super,5,217,2,3,0.16
5,8,swear,5,218,1,4,0.2
5,8,sweep,5,219,3,2,0.16
5,8,swim,4,220,2,2,0.12
5,8,tale,4,221,0,4,0.24
5,8,talk,4,222,3,1,0.12
5,8,tank,4,223,2,2,0.12
5,8,task,4,224,2,2,0.16
5,8,tea,3,225,1,2,0.12
5,8,team,4,226,3,1,0.12
5,8,tempt,5,227,2,3,0.2
5,8,three,5,228,1,4,0.28
5,8,tidy,4,229,1,3,0.16
5,8,till,4,230,2,2,0.12
5,8,to,2,231,1,1,0.08
5,8,tool,4,232,2,2,0.16
5,8,trap,4,233,1,3,0.16
5,8,treat,5,234,2,3,0.24
5,8,tree,4,235,3,1,0.12
5,8,trend,5,236,3,2,0.16
5,8,trial,5,237,2,3,0.2
5,8,tribe,5,238,3,2,0.16
5,8,trio,4,239,3,1,0.12
5,8,truck,5,240,2,3,0.24
5,8,two,3,241,1,2,0.12
5,8,unify,5,242,0,5,0.24
5,8,until,5,243,2,3,0.16
5,8,upon,4,244,1,3,0.16
5,8,usual,5,245,1,4,0.28
5,8,virus,5,246,0,5,0.24
5,8,vital,5,247,2,3,0.2
5,8,wait,4,248,0,4,0.2
5,8,wake,4,249,2,2,0.16
5,8,walk,4,250,2,2,0.12
5,8,watch,5,251,2,3,0.28
5,8,water,5,252,3,2,0.16
5,8,way,3,253,2,1,0.08
5,8,weird,5,254,1,4,0.2
5,8,west,4,255,2,2,0.16
5,8,width,5,256,1,4,0.2
5,8,win,3,257,2,1,0.16
5,8,wind,4,258,3,1,0.12
5,8,woman,5,259,1,4,0.2
5,8,world,5,260,2,3,0.16
5,8,worry,5,261,3,2,0.16
5,8,wow,3,262,2,1,0.12
5,8,wrap,4,263,1,3,0.2
5,8,wrist,5,264,2,3,0.2
5,9,acid,4,0,0,4,0.2
5,9,acre,4,1,2,2,0.16
5,9,add,3,2,1,2,0.12
5,9,adj,3,3,2,1,0.08
5,9,agree,5,4,1,4,0.28
5,9,ahead,5,5,1,4,0.2
5,9,anger,5,6,1,4,0.24
5,9,app,3,7,1,2,0.16
5,9,arms,4,8,1,3,0.2
5,9,ask,3,9,1,2,0.12
5,9,auto,4,10,1,3,0.24
5,9,base,4,11,0,4,0.2
5,9,bat,3,12,2,1,0.12
5,9,bath,4,13,3,1,0.12
5,9,bay,3,14,2,1,0.12
5,9,beer,4,15,1,3,0.16
5,9,bill,4,16,1,3,0.16
5,9,bird,4,17,2,2,0.2
5,9,bite,4,18,2,2,0.12
5,9,blow,4,19,1,3,0.16
5,9,boil,4,20,1,3,0.16
5,9,bomb,4,21,2,2,0.12
5,9,boom,4,22,2,2,0.16
5,9,boost,5,23,3,2,0.24
5,9,boot,4,24,3,1,0.12
5,9,bound,5,25,2,3,0.2
5,9,box,3,26,2,1,0.08
5,9,brand,5,27,1,4,0.2
5,9,break,5,28,2,3,0.16
5,9,build,5,29,1,4,0.24
5,9,bunch,5,30,2,3,0.2
5,9,burn,4,31,2,2,0.16
5,9,carve,5,32,0,5,0.24
5,9,cease,5,33,1,4,0.2
5,9,charm,5,34,1,4,0.28
5,9,check,5,35,2,3,0.16
5,9,choir,5,36,2,3,0.16
5,9,chop,4,37,3,1,0.12
5,9,city,4,38,1,3,0.16
5,9,cloud,5,39,1,4,0.2
5,9,coach,5,40,1,4,0.28
5,9,cope,4,41,2,2,0.12
5,9,could,5,42,2,3,0.16
5,9,court,5,43,3,2,0.2
5,9,craft,5,44,1,4,0.48
5,9,creep,5,45,2,3,0.52
5,9,cross,5,46,2,3,0.44
5,9,crowd,5,47,3,2,0.36
5,9,crude,5,48,2,3,0.4
5,9,cry,3,49,2,1,0.24
5,9,cycle,5,50,1,4,0.56
5,9,deal,4,51,0,4,0.44
5,9,death,5,52,3,2,0.36
5,9,dirt,4,53,1,3,0.4
5,9,dot,3,54,1,2,0.28
5,9,drama,5,55,1,4,0.48
5,9,drink,5,56,2,3,0.52
5,9,dust,4,57,1,3,0.4
5,9,ear,3,58,0,3,0.36
5,9,earth,5,59,3,2,0.4
5,9,edit,4,60,1,3,0.44
5,9,eight,5,61,1,4,0.48
5,9,enemy,5,62,1,4,0.56
5,9,erect,5,63,1,4,0.48
5,9,euro,4,64,1,3,0.36
5,9,evoke,5,65,1,4,0.48
5,9,exit,4,66,1,3,0.36
5,9,eye,3,67,1,2,0.28
5,9,fail,4,68,0,4,0.56
5,9,fall,4,69,2,2,0.32
5,9,fat,3,70,2,1,0.24
5,9,fear,4,71,1,3,0.4
5,9,fibre,5,72,1,4,0.52
5,9,fight,5,73,2,3,0.48
5,9,file,4,74,2,2,0.52
5,9,firm,4,75,2,2,0.4
5,9,fix,3,76,2,1,0.28
5,9,flag,4,77,1,3,0.44
5,9,flat,4,78,3,1,0.32
5,9,flee,4,79,2,2,0.56
5,9,food,4,80,1,3,0.52
5,9,for,3,81,2,1,0.24
5,9,force,5,82,3,2,0.36
5,9,frog,4,83,1,3,0.36
5,9,front,5,84,3,2,0.36
5,9,fur,3,85,1,2,0.28
5,9,game,4,86,0,4,0.56
5,9,gene,4,87,1,3,0.44
5,9,giant,5,88,1,4,0.56
5,9,give,4,89,2,2,0.36
5,9,globe,5,90,1,4,0.52
5,9,go,2,91,1,1,0.2
5,9,gold,4,92,2,2,0.32
5,9,grace,5,93,1,4,0.6
5,9,green,5,94,2,3,0.44
5,9,greet,5,95,4,1,0.32
5,9,grid,4,96,2,2,0.32
5,9,guide,5,97,1,4,0.48
5,9,gym,3,98,1,2,0.36
5,9,harm,4,99,0,4,0.44
5,9,harsh,5,100,3,2,0.36
5,9,heat,4,101,1,3,0.36
5,9,her,3,102,2,1,0.24
5,9,hers,4,103,3,1,0.28
5,9,hotel,5,104,1,4,0.56
5,9,how,3,105,2,1,0.24
5,9,hunt,4,106,1,3,0.36
5,9,ice,3,107,0,3,0.32
5,9,icon,4,108,2,2,0.32
5,9,ideal,5,109,1,4,0.48
5,9,index,5,110,1,4,0.56
5,9,info,4,111,2,2,0.36
5,9,iron,4,112,1,3,0.4
5,9,job,3,113,0,3,0.36
5,9,just,4,114,1,3,0.4
5,9,king,4,115,0,4,0.44
5,9,kit,3,116,2,1,0.24
5,9,lack,4,117,0,4,0.52
5,9,lap,3,118,2,1,0.24
5,9,laugh,5,119,2,3,0.4
5,9,law,3,120,2,1,0.24
5,9,lawn,4,121,3,1,0.28
5,9,layer,5,122,2,3,0.4
5,9,left,4,123,1,3,0.48
5,9,lens,4,124,2,2,0.32
5,9,limb,4,125,1,3,0.36
5,9,link,4,126,2,2,0.32
5,9,lion,4,127,2,2,0.32
5,9,liver,5,128,2,3,0.4
5,9,local,5,129,1,4,0.56
5,9,lot,3,130,2,1,0.24
5,9,love,4,131,2,2,0.32
5,9,mark,4,132,0,4,0.44
5,9,match,5,133,2,3,0.44
5,9,meal,4,134,1,3,0.4
5,9,mean,4,135,3,1,0.36
5,9,media,5,136,2,3,0.44
5,9,mind,4,137,1,3,0.44
5,9,model,5,138,1,4,0.52
5,9,money,5,139,2,3,0.44
5,9,mouth,5,140,2,3,0.4
5,9,movie,5,141,2,3,0.52
5,9,much,4,142,1,3,0.4
5,9,music,5,143,2,3,0.44
5,9,myth,4,144,1,3,0.4
5,9,naked,5,145,0,5,0.52
5,9,nasty,5,146,2,3,0.52
5,9,neck,4,147,1,3,0.36
5,9,noise,5,148,1,4,0.48
5,9,not,3,149,2,1,0.24
5,9,nut,3,150,1,2,0.28
5,9,once,4,151,0,4,0.44
5,9,other,5,152,1,4,0.6
5,9,owe,3,153,1,2,0.28
5,9,pace,4,154,0,4,0.44
5,9,page,4,155,2,2,0.32
5,9,paint,5,156,2,3,0.4
5,9,pants,5,157,2,3,0.4
5,9,pause,5,158,2,3,0.56
5,9,peace,5,159,1,4,0.48
5,9,photo,5,160,1,4,0.48
5,9,pick,4,161,1,3,0.4
5,9,piece,5,162,2,3,0.44
5,9,pig,3,163,2,1,0.32
5,9,pin,3,164,2,1,0.24
5,9,plan,4,165,1,3,0.36
5,9,plant,5,166,4,1,0.32
5,9,play,4,167,3,1,0.28
5,9,plot,4,168,2,2,0.32
5,9,pond,4,169,1,3,0.36
5,9,post,4,170,2,2,0.4
5,9,pump,4,171,1,3,0.36
5,9,punk,4,172,2,2,0.32
5,9,pure,4,173,2,2,0.32
5,9,push,4,174,2,2,0.32
5,9,put,3,175,2,1,0.24
5,9,query,5,176,0,5,0.64
5,9,quest,5,177,3,2,0.36
5,9,quite,5,178,2,3,0.44
5,9,race,4,179,0,4,0.44
5,9,radar,5,180,2,3,0.44
5,9,rail,4,181,2,2,0.32
5,9,raise,5,182,3,2,0.48
5,9,react,5,183,1,4,0.48
5,9,reign,5,184,2,3,0.44
5,9,relax,5,185,2,3,0.4
5,9,rifle,5,186,1,4,0.48
5,9,road,4,187,1,3,0.48
5,9,rob,3,188,2,1,0.32
5,9,roof,4,189,2,2,0.4
5,9,round,5,190,2,3,0.52
5,9,safe,4,191,0,4,0.48
5,9,seem,4,192,1,3,0.36
5,9,serve,5,193,2,3,0.56
5,9,seven,5,194,2,3,0.44
5,9,sexy,4,195,2,2,0.32
5,9,shift,5,196,1,4,0.48
5,9,shiny,5,197,3,2,0.4
5,9,ship,4,198,3,1,0.28
5,9,shoot,5,199,2,3,0.52
5,9,sin,3,200,1,2,0.28
5,9,sit,3,201,2,1,0.24
5,9,ski,3,202,1,2,0.28
5,9,skip,4,203,3,1,0.28
5,9,skirt,5,204,3,2,0.36
5,9,skull,5,205,2,3,0.52
5,9,slice,5,206,1,4,0.48
5,9,slip,4,207,3,1,0.28
5,9,smile,5,208,1,4,0.48
5,9,snow,4,209,1,3,0.4
5,9,soap,4,210,1,3,0.4
5,9,solar,5,211,2,3,0.52
5,9,solo,4,212,3,1,0.28
5,9,song,4,213,2,2,0.32
5,9,soup,4,214,2,2,0.32
5,9,space,5,215,1,4,0.48
5,9,spin,4,216,2,2,0.32
5,9,stab,4,217,1,3,0.48
5,9,stall,5,218,3,2,0.44
5,9,stay,4,219,3,1,0.32
5,9,stem,4,220,2,2,0.4
5,9,stick,5,221,2,3,0.48
5,9,story,5,222,2,3,0.52
5,9,such,4,223,1,3,0.36
5,9,sue,3,224,2,1,0.24
5,9,super,5,225,2,3,0.44
5,9,sure,4,226,2,2,0.36
5,9,swear,5,227,1,4,0.48
5,9,tank,4,228,0,4,0.56
5,9,tape,4,229,2,2,0.32
5,9,task,4,230,2,2,0.32
5,9,team,4,231,1,3,0.36
5,9,tempt,5,232,2,3,0.44
5,9,thumb,5,233,1,4,0.6
5,9,tidy,4,234,1,3,0.48
5,9,till,4,235,2,2,0.32
5,9,to,2,236,1,1,0.2
5,9,tool,4,237,2,2,0.32
5,9,trial,5,238,1,4,0.48
5,9,tribe,5,239,3,2,0.36
5,9,tune,4,240,1,3,0.48
5,9,twice,5,241,1,4,0.48
5,9,union,5,242,0,5,0.52
5,9,upon,4,243,1,3,0.4
5,9,urban,5,244,1,4,0.48
5,9,usage,5,245,1,4,0.48
5,9,vary,4,246,0,4,0.56
5,9,vital,5,247,1,4,0.48
5,9,vocal,5,248,1,4,0.48
5,9,wait,4,249,0,4,0.44
5,9,wake,4,250,2,2,0.32
5,9,walk,4,251,2,2,0.44
5,9,watch,5,252,2,3,0.44
5,9,water,5,253,3,2,0.36
5,9,way,3,254,2,1,0.24
5,9,weird,5,255,1,4,0.48
5,9,which,5,256,1,4,0.48
5,9,width,5,257,1,4,0.6
5,9,win,3,258,2,1,0.24
5,9,wine,4,259,3,1,0.28
5,9,woman,5,260,1,4,0.48
5,9,word,4,261,2,2,0.32
5,9,world,5,262,3,2,0.36
5,9,wrist,5,263,1,4,0.56
5,9,young,5,264,0,5,0.52
6,0,absorb,6,0,0,6,0.6
6,0,acid,4,1,1,3,0.24
6,0,acre,4,2,2,2,0.16
6,0,acute,5,3,2,3,0.28
6,0,ad,2,4,1,1,0.08
6,0,adj,3,5,2,1,0.12
6,0,admit,5,6,2,3,0.2
6,0,advice,6,7,2,4,0.24
6,0,again,5,8,1,4,0.2
6,0,agree,5,9,2,3,0.24
6,0,ahead,5,10,1,4,0.2
6,0,aids,4,11,1,3,0.16
6,0,align,5,12,1,4,0.2
6,0,and,3,13,1,2,0.12
6,0,anger,5,14,2,3,0.2
6,0,animal,6,15,2,4,0.28
6,0,ankle,5,16,2,3,0.16
6,0,app,3,17,1,2,0.12
6,0,argue,5,18,1,4,0.2
6,0,arms,4,19,2,2,0.12
6,0,arrest,6,20,2,4,0.28
6,0,arrow,5,21,3,2,0.16
6,0,ask,3,22,1,2,0.12
6,0,baby,4,23,0,4,0.2
6,0,bath,4,24,2,2,0.12
6,0,bay,3,25,2,1,0.12
6,0,beauty,6,26,1,5,0.28
6,0,bed,3,27,2,1,0.08
6,0,beer,4,28,2,2,0.16
6,0,betray,6,29,2,4,0.2
6,0,beyond,6,30,2,4,0.2
6,0,bill,4,31,1,3,0.2
6,0,bin,3,32,2,1,0.12
6,0,bird,4,33,2,2,0.12
6,0,bishop,6,34,2,4,0.2
6,0,bite,4,35,2,2,0.12
6,0,bitter,6,36,3,3,0.2
6,0,blame,5,37,1,4,0.24
6,0,blank,5,38,3,2,0.16
6,0,boil,4,39,1,3,0.16
6,0,bother,6,40,2,4,0.2
6,0,bottle,6,41,3,3,0.2
6,0,box,3,42,2,1,0.16
6,0,brand,5,43,1,4,0.24
6,0,breach,6,44,2,4,0.2
6,0,break,5,45,4,1,0.12
6,0,bride,5,46,2,3,0.2
6,0,bridge,6,47,4,2,0.24
6,0,broken,6,48,2,4,0.2
6,0,buddy,5,49,1,4,0.2
6,0,buffer,6,50,2,4,0.2
6,0,build,5,51,2,3,0.16
6,0,burden,6,52,2,4,0.28
6,0,butter,6,53,2,4,0.24
6,0,cafe,4,54,0,4,0.2
6,0,cake,4,55,2,2,0.16
6,0,card,4,56,2,2,0.12
6,0,career,6,57,3,3,0.28
6,0,carpet,6,58,3,3,0.2
6,0,cave,4,59,2,2,0.16
6,0,check,5,60,1,4,0.2
6,0,choose,6,61,2,4,0.24
6,0,chop,4,62,3,1,0.16
6,0,chunk,5,63,2,3,0.2
6,0,circle,6,64,1,5,0.24
6,0,city,4,65,2,2,0.16
6,0,civil,5,66,2,3,0.16
6,0,clean,5,67,1,4,0.2
6,0,clerk,5,68,3,2,0.2
6,0,coffee,6,69,1,5,0.24
6,0,colony,6,70,2,4,0.2
6,0,comply,6,71,2,4,0.24
6,0,cooker,6,72,2,4,0.28
6,0,cope,4,73,2,2,0.16
6,0,could,5,74,2,3,0.2
6,0,course,6,75,3,3,0.2
6,0,court,5,76,4,1,0.12
6,0,craft,5,77,1,4,0.28
6,0,crowd,5,78,2,3,0.16
6,0,crude,5,79,2,3,0.16
6,0,cruise,6,80,3,3,0.2
6,0,dance,5,81,0,5,0.24
6,0,day,3,82,2,1,0.08
6,0,death,5,83,1,4,0.24
6,0,defect,6,84,2,4,0.24
6,0,demon,5,85,2,3,0.16
6,0,detect,6,86,2,4,0.2
6,0,devil,5,87,2,3,0.2
6,0,dirt,4,88,1,3,0.24
6,0,dirty,5,89,4,1,0.12
6,0,divine,6,90,2,4,0.24
6,0,domain,6,91,1,5,0.24
6,0,double,6,92,2,4,0.28
6,0,drama,5,93,1,4,0.2
6,0,drink,5,94,2,3,0.2
6,0,dust,4,95,1,3,0.16
6,0,ear,3,96,0,3,0.16
6,0,edit,4,97,1,3,0.16
6,0,embody,6,98,1,5,0.32
6,0,enable,6,99,1,5,0.24
6,0,enrich,6,100,2,4,0.24
6,0,enter,5,101,2,3,0.2
6,0,essay,5,102,1,4,0.2
6,0,event,5,103,1,4,0.28
6,0,evoke,5,104,2,3,0.2
6,0,exceed,6,105,1,5,0.24
6,0,exit,4,106,2,2,0.16
6,0,extend,6,107,2,4,0.2
6,0,eye,3,108,1,2,0.2
6,0,failed,6,109,0,6,0.32
6,0,fair,4,110,3,1,0.12
6,0,fairly,6,111,4,2,0.2
6,0,fall,4,112,2,2,0.28
6,0,fast,4,113,2,2,0.28
6,0,fasten,6,114,4,2,0.28
6,0,fear,4,115,1,3,0.28
6,0,fee,3,116,2,1,0.2
6,0,fellow,6,117,2,4,0.24
6,0,fibre,5,118,1,4,0.2
6,0,fifty,5,119,2,3,0.24
6,0,file,4,120,2,2,0.16
6,0,fine,4,121,2,2,0.16
6,0,floor,5,122,1,4,0.2
6,0,flower,6,123,3,3,0.2
6,0,flu,3,124,2,1,0.16
6,0,food,4,125,1,3,0.16
6,0,force,5,126,2,3,0.16
6,0,former,6,127,3,3,0.2
6,0,foster,6,128,2,4,0.2
6,0,friday,6,129,1,5,0.28
6,0,fridge,6,130,4,2,0.16
6,0,frog,4,131,2,2,0.12
6,0,front,5,132,3,2,0.16
6,0,fulfil,6,133,1,5,0.24
6,0,fur,3,134,2,1,0.08
6,0,gallon,6,135,0,6,0.32
6,0,garage,6,136,2,4,0.2
6,0,gender,6,137,1,5,0.24
6,0,giant,5,138,1,4,0.2
6,0,give,4,139,2,2,0.12
6,0,god,3,140,1,2,0.2
6,0,good,4,141,2,2,0.16
6,0,govern,6,142,2,4,0.24
6,0,grace,5,143,1,4,0.2
6,0,grade,5,144,3,2,0.16
6,0,green,5,145,2,3,0.24
6,0,greet,5,146,4,1,0.12
6,0,grey,4,147,3,1,0.12
6,0,grind,5,148,2,3,0.16
6,0,ground,6,149,2,4,0.24
6,0,guest,5,150,1,4,0.24
6,0,guide,5,151,2,3,0.2
6,0,guy,3,152,2,1,0.08
6,0,happen,6,153,0,6,0.28
6,0,hat,3,154,2,1,0.12
6,0,hate,4,155,3,1,0.12
6,0,heart,5,156,1,4,0.28
6,0,heat,4,157,3,1,0.12
6,0,herb,4,158,2,2,0.12
6,0,horror,6,159,1,5,0.24
6,0,how,3,160,2,1,0.12
6,0,humble,6,161,1,5,0.24
6,0,humour,6,162,3,3,0.24
6,0,hunger,6,163,2,4,0.24
6,0,hunt,4,164,3,1,0.12
6,0,icon,4,165,0,4,0.2
6,0,ideal,5,166,1,4,0.24
6,0,image,5,167,1,4,0.28
6,0,incur,5,168,1,4,0.2
6,0,info,4,169,2,2,0.12
6,0,inform,6,170,4,2,0.16
6,0,injure,6,171,2,4,0.24
6,0,injury,6,172,5,1,0.2
6,0,insert,6,173,2,4,0.24
6,0,intake,6,174,2,4,0.2
6,0,into,4,175,3,1,0.12
6,0,invest,6,176,2,4,0.24
6,0,iron,4,177,1,3,0.2
6,0,island,6,178,1,5,0.24
6,0,issue,5,179,2,3,0.2
6,0,jump,4,180,0,4,0.2
6,0,june,4,181,2,2,0.12
6,0,kidney,6,182,0,6,0.32
6,0,kit,3,183,2,1,0.12
6,0,knife,5,184,1,4,0.2
6,0,lap,3,185,0,3,0.16
6,0,latest,6,186,2,4,0.24
6,0,laugh,5,187,2,3,0.2
6,0,law,3,188,2,1,0.16
6,0,lawn,4,189,3,1,0.12
6,0,layer,5,190,2,3,0.16
6,0,leaf,4,191,1,3,0.16
6,0,left,4,192,2,2,0.12
6,0,legend,6,193,2,4,0.28
6,0,lesser,6,194,2,4,0.24
6,0,lie,3,195,1,2,0.12
6,0,lion,4,196,2,2,0.16
6,0,log,3,197,1,2,0.12
6,0,lonely,6,198,2,4,0.24
6,0,look,4,199,2,2,0.2
6,0,loose,5,200,3,2,0.16
6,0,loudly,6,201,2,4,0.2
6,0,love,4,202,2,2,0.12
6,0,low,3,203,2,1,0.08
6,0,lunch,5,204,1,4,0.2
6,0,main,4,205,0,4,0.24
6,0,mask,4,206,2,2,0.16
6,0,match,5,207,2,3,0.2
6,0,meal,4,208,1,3,0.32
6,0,melody,6,209,2,4,0.52
6,0,memory,6,210,2,4,0.6
6,0,mental,6,211,2,4,0.52
6,0,mentor,6,212,4,2,0.4
6,0,merger,6,213,2,4,0.52
6,0,mess,4,214,2,2,0.32
6,0,metre,5,215,2,3,0.56
6,0,model,5,216,1,4,0.48
6,0,modify,6,217,3,3,0.48
6,0,month,5,218,2,3,0.44
6,0,most,4,219,2,2,0.32
6,0,mouth,5,220,2,3,0.52
6,0,much,4,221,1,3,0.36
6,0,museum,6,222,2,4,0.52
6,0,my,2,223,1,1,0.2
6,0,naked,5,224,0,5,0.52
6,0,nasty,5,225,2,3,0.44
6,0,nation,6,226,2,4,0.64
6,0,nature,6,227,3,3,0.48
6,0,neck,4,228,1,3,0.36
6,0,new,3,229,2,1,0.24
6,0,night,5,230,1,4,0.48
6,0,non,3,231,1,2,0.28
6,0,norm,4,232,2,2,0.44
6,0,normal,6,233,4,2,0.4
6,0,nut,3,234,1,2,0.28
6,0,obsess,6,235,0,6,0.64
6,0,ocean,5,236,1,4,0.48
6,0,off,3,237,1,2,0.4
6,0,once,4,238,1,3,0.36
6,0,one,3,239,2,1,0.24
6,0,online,6,240,2,4,0.52
6,0,option,6,241,1,5,0.56
6,0,outing,6,242,1,5,0.64
6,0,outlet,6,243,3,3,0.44
6,0,owe,3,244,1,2,0.28
6,0,pace,4,245,0,4,0.44
6,0,pad,3,246,2,1,0.24
6,0,page,4,247,2,2,0.32
6,0,park,4,248,2,2,0.32
6,0,patent,6,249,2,4,0.64
6,0,photo,5,250,1,4,0.48
6,0,pipe,4,251,1,3,0.36
6,0,place,5,252,1,4,0.48
6,0,plan,4,253,3,1,0.28
6,0,pledge,6,254,2,4,0.64
6,0,plot,4,255,2,2,0.32
6,0,post,4,256,1,3,0.4
6,0,prior,5,257,1,4,0.56
6,0,proof,5,258,2,3,0.44
6,0,proper,6,259,3,3,0.56
6,0,punk,4,260,1,3,0.36
6,0,put,3,261,2,1,0.24
6,0,query,5,262,0,5,0.52
6,0,quest,5,263,3,2,0.36
6,0,race,4,264,0,4,0.44
6,0,racial,6,265,3,3,0.56
6,0,racism,6,266,4,2,0.44
6,0,radar,5,267,2,3,0.44
6,0,rally,5,268,2,3,0.52
6,0,react,5,269,1,4,0.68
6,0,rebel,5,270,2,3,0.56
6,0,recall,6,271,2,4,0.52
6,0,reduce,6,272,2,4,0.52
6,0,refuse,6,273,2,4,0.52
6,0,regard,6,274,2,4,0.64
6,0,regime,6,275,3,3,0.48
6,0,region,6,276,4,2,0.4
6,0,reign,5,277,2,3,0.44
6,0,relax,5,278,2,3,0.4
6,0,relief,6,279,3,3,0.56
6,0,remark,6,280,2,4,0.52
6,0,renew,5,281,2,3,0.4
6,0,repeat,6,282,2,4,0.52
6,0,rest,4,283,2,2,0.32
6,0,retire,6,284,2,4,0.64
6,0,reveal,6,285,2,4,0.52
6,0,revise,6,286,3,3,0.48
6,0,revive,6,287,4,2,0.44
6,0,rip,3,288,1,2,0.32
6,0,rival,5,289,2,3,0.56
6,0,road,4,290,1,3,0.36
6,0,rob,3,291,2,1,0.24
6,0,root,4,292,2,2,0.32
6,0,rotate,6,293,2,4,0.52
6,0,rough,5,294,2,3,0.4
6,0,round,5,295,3,2,0.48
6,0,rubber,6,296,1,5,0.56
6,0,ruin,4,297,2,2,0.32
6,0,sacred,6,298,0,6,0.6
6,0,safe,4,299,2,2,0.32
6,0,sale,4,300,2,2,0.44
6,0,salt,4,301,3,1,0.28
6,0,sample,6,302,2,4,0.56
6,0,scared,6,303,1,5,0.56
6,0,school,6,304,2,4,0.52
6,0,score,5,305,2,3,0.52
6,0,secure,6,306,1,5,0.56
6,0,seeker,6,307,2,4,0.52
6,0,serve,5,308,2,3,0.4
6,0,sexy,4,309,2,2,0.32
6,0,shift,5,310,1,4,0.56
6,0,shiny,5,311,3,2,0.36
6,0,shore,5,312,2,3,0.4
6,0,sink,4,313,1,3,0.36
6,0,sister,6,314,2,4,0.52
6,0,sit,3,315,2,1,0.24
6,0,six,3,316,2,1,0.32
6,0,skull,5,317,1,4,0.48
6,0,slam,4,318,1,3,0.36
6,0,slice,5,319,2,3,0.4
6,0,smile,5,320,1,4,0.48
6,0,soap,4,321,1,3,0.48
6,0,solar,5,322,2,3,0.4
6,0,solo,4,323,3,1,0.28
6,0,some,4,324,2,2,0.32
6,0,speak,5,325,1,4,0.48
6,0,sphere,6,326,2,4,0.52
6,0,spin,4,327,2,2,0.44
6,0,spine,5,328,4,1,0.32
6,0,stamp,5,329,1,4,0.48
6,0,stance,6,330,3,3,0.44
6,0,stand,5,331,4,1,0.32
6,0,star,4,332,3,1,0.36
6,0,statue,6,333,3,3,0.44
6,0,stay,4,334,3,1,0.28
6,0,stem,4,335,2,2,0.32
6,0,stick,5,336,2,3,0.4
6,0,sticky,6,337,5,1,0.36
6,0,strike,6,338,2,4,0.6
6,0,strong,6,339,3,3,0.76
6,0,studio,6,340,2,4,0.52
6,0,sudden,6,341,1,5,0.56
6,0,sure,4,342,2,2,0.32
6,0,switch,6,343,1,5,0.64
6,0,tale,4,344,0,4,0.44
6,0,talent,6,345,4,2,0.44
6,0,tape,4,346,2,2,0.32
6,0,team,4,347,1,3,0.36
6,0,tempt,5,348,2,3,0.52
6,0,tender,6,349,2,4,0.52
6,0,thesis,6,350,1,5,0.56
6,0,this,4,351,2,2,0.32
6,0,three,5,352,2,3,0.48
6,0,ticket,6,353,1,5,0.8
6,0,tidy,4,354,2,2,0.32
6,0,to,2,355,1,1,0.2
6,0,tonne,5,356,2,3,0.44
6,0,too,3,357,2,1,0.24
6,0,tour,4,358,2,2,0.32
6,0,trend,5,359,1,4,0.6
6,0,tribe,5,360,2,3,0.44
6,0,trio,4,361,3,1,0.28
6,0,truck,5,362,2,3,0.44
6,0,twice,5,363,1,4,0.52
6,0,two,3,364,2,1,0.24
6,0,unfair,6,365,0,6,0.72
6,0,unify,5,366,2,3,0.44
6,0,unique,6,367,3,3,0.48
6,0,until,5,368,2,3,0.44
6,0,unveil,6,369,2,4,0.68
6,0,uphold,6,370,1,5,0.56
6,0,urgent,6,371,1,5,0.6
6,0,valley,6,372,0,6,0.72
6,0,verify,6,373,1,5,0.64
6,0,video,5,374,1,4,0.6
6,0,virtue,6,375,2,4,0.52
6,0,visual,6,376,2,4,0.52
6,0,vital,5,377,2,3,0.4
6,0,wait,4,378,0,4,0.44
6,0,waiter,6,379,4,2,0.52
6,0,watch,5,380,2,3,0.4
6,0,way,3,381,2,1,0.24
6,0,weight,6,382,1,5,0.56
6,0,weird,5,383,3,2,0.36
6,0,which,5,384,1,4,0.56
6,0,width,5,385,1,4,0.48
6,0,wipe,4,386,2,2,0.32
6,0,woman,5,387,1,4,0.48
6,0,wrap,4,388,1,3,0.36
6,0,yellow,6,389,0,6,0.76
6,1,absurd,6,0,0,6,0.28
6,1,acid,4,1,1,3,0.16
6,1,acute,5,2,2,3,0.2
6,1,adj,3,3,1,2,0.12
6,1,admit,5,4,2,3,0.16
6,1,agree,5,5,1,4,0.28
6,1,ahead,5,6,1,4,0.2
6,1,aids,4,7,1,3,0.16
6,1,align,5,8,1,4,0.2
6,1,and,3,9,1,2,0.12
6,1,anger,5,10,2,3,0.24
6,1,anyway,6,11,2,4,0.24
6,1,app,3,12,1,2,0.12
6,1,around,6,13,1,5,0.24
6,1,artist,6,14,2,4,0.24
6,1,at,2,15,1,1,0.08
6,1,baby,4,16,0,4,0.28
6,1,ballet,6,17,2,4,0.2
6,1,banner,6,18,2,4,0.24
6,1,base,4,19,2,2,0.12
6,1,bay,3,20,2,1,0.08
6,1,beast,5,21,1,4,0.28
6,1,bed,3,22,2,1,0.08
6,1,beer,4,23,2,2,0.16
6,1,beg,3,24,2,1,0.08
6,1,behalf,6,25,2,4,0.2
6,1,behave,6,26,4,2,0.2
6,1,belief,6,27,2,4,0.28
6,1,below,5,28,3,2,0.16
6,1,best,4,29,2,2,0.12
6,1,betray,6,30,2,4,0.24
6,1,beyond,6,31,2,4,0.2
6,1,blade,5,32,1,4,0.28
6,1,blame,5,33,3,2,0.16
6,1,bless,5,34,2,3,0.2
6,1,blog,4,35,2,2,0.12
6,1,blow,4,36,3,1,0.12
6,1,bomb,4,37,1,3,0.16
6,1,boom,4,38,2,2,0.2
6,1,boost,5,39,3,2,0.16
6,1,bother,6,40,2,4,0.24
6,1,bound,5,41,2,3,0.16
6,1,box,3,42,2,1,0.12
6,1,break,5,43,1,4,0.28
6,1,buffer,6,44,1,5,0.24
6,1,bug,3,45,2,1,0.12
6,1,burden,6,46,2,4,0.2
6,1,burn,4,47,3,1,0.12
6,1,cake,4,48,0,4,0.16
6,1,cap,3,49,2,1,0.16
6,1,carpet,6,50,2,4,0.2
6,1,cd,2,51,1,1,0.08
6,1,chair,5,52,1,4,0.24
6,1,charm,5,53,3,2,0.16
6,1,cheat,5,54,2,3,0.2
6,1,check,5,55,3,2,0.24
6,1,choose,6,56,2,4,0.2
6,1,chunk,5,57,2,3,0.16
6,1,city,4,58,1,3,0.16
6,1,clerk,5,59,1,4,0.2
6,1,coffee,6,60,1,5,0.32
6,1,comply,6,61,2,4,0.2
6,1,confer,6,62,2,4,0.2
6,1,convey,6,63,3,3,0.2
6,1,cooker,6,64,2,4,0.28
6,1,cope,4,65,2,2,0.16
6,1,cost,4,66,2,2,0.12
6,1,coup,4,67,2,2,0.12
6,1,course,6,68,3,3,0.2
6,1,court,5,69,4,1,0.12
6,1,creep,5,70,1,4,0.28
6,1,crowd,5,71,2,3,0.16
6,1,curved,6,72,1,5,0.24
6,1,cycle,5,73,1,4,0.2
6,1,damage,6,74,0,6,0.28
6,1,dance,5,75,2,3,0.24
6,1,dare,4,76,2,2,0.12
6,1,day,3,77,2,1,0.08
6,1,death,5,78,1,4,0.2
6,1,deed,4,79,2,2,0.12
6,1,deem,4,80,3,1,0.2
6,1,deputy,6,81,2,4,0.24
6,1,devil,5,82,2,3,0.16
6,1,dig,3,83,1,2,0.12
6,1,dinner,6,84,2,4,0.2
6,1,dirty,5,85,2,3,0.2
6,1,divine,6,86,2,4,0.28
6,1,domain,6,87,1,5,0.28
6,1,drink,5,88,1,4,0.2
6,1,earth,5,89,0,5,0.24
6,1,edit,4,90,1,3,0.16
6,1,eight,5,91,1,4,0.28
6,1,either,6,92,2,4,0.24
6,1,eleven,6,93,1,5,0.24
6,1,embark,6,94,1,5,0.24
6,1,embody,6,95,3,3,0.28
6,1,enable,6,96,1,5,0.24
6,1,ending,6,97,2,4,0.24
6,1,enemy,5,98,2,3,0.2
6,1,enjoy,5,99,2,3,0.2
6,1,enter,5,100,2,3,0.24
6,1,erect,5,101,1,4,0.2
6,1,evoke,5,102,1,4,0.2
6,1,exact,5,103,1,4,0.2
6,1,exit,4,104,2,2,0.16
6,1,extend,6,105,2,4,0.28
6,1,fail,4,106,0,4,0.2
6,1,failed,6,107,4,2,0.16
6,1,fall,4,108,2,2,0.16
6,1,fear,4,109,1,3,0.16
6,1,fee,3,110,2,1,0.08
6,1,fellow,6,111,2,4,0.28
6,1,few,3,112,2,1,0.08
6,1,fifty,5,113,1,4,0.2
6,1,file,4,114,2,2,0.12
6,1,fixed,5,115,2,3,0.2
6,1,floor,5,116,1,4,0.28
6,1,flower,6,117,3,3,0.2
6,1,focus,5,118,1,4,0.2
6,1,folk,4,119,2,2,0.12
6,1,food,4,120,2,2,0.12
6,1,force,5,121,2,3,0.2
6,1,former,6,122,3,3,0.24
6,1,foster,6,123,2,4,0.2
6,1,fridge,6,124,1,5,0.24
6,1,frog,4,125,2,2,0.16
6,1,front,5,126,3,2,0.2
6,1,fur,3,127,1,2,0.12
6,1,game,4,128,0,4,0.2
6,1,gaming,6,129,3,3,0.2
6,1,garage,6,130,2,4,0.2
6,1,give,4,131,1,3,0.16
6,1,glass,5,132,1,4,0.28
6,1,grade,5,133,1,4,0.2
6,1,green,5,134,2,3,0.2
6,1,grid,4,135,2,2,0.12
6,1,grief,5,136,3,2,0.16
6,1,grin,4,137,3,1,0.2
6,1,growth,6,138,2,4,0.24
6,1,guest,5,139,1,4,0.2
6,1,guide,5,140,2,3,0.2
6,1,guitar,6,141,3,3,0.2
6,1,gym,3,142,1,2,0.12
6,1,hair,4,143,0,4,0.24
6,1,harm,4,144,2,2,0.16
6,1,hazard,6,145,2,4,0.24
6,1,health,6,146,1,5,0.24
6,1,hers,4,147,2,2,0.16
6,1,hotel,5,148,1,4,0.28
6,1,hour,4,149,2,2,0.12
6,1,how,3,150,2,1,0.12
6,1,humour,6,151,1,5,0.24
6,1,i,1,152,0,1,0.08
6,1,ice,3,153,1,2,0.16
6,1,icon,4,154,2,2,0.24
6,1,ideal,5,155,1,4,0.2
6,1,image,5,156,1,4,0.2
6,1,incur,5,157,1,4,0.2
6,1,infant,6,158,2,4,0.24
6,1,inform,6,159,3,3,0.28
6,1,inject,6,160,2,4,0.24
6,1,injure,6,161,3,3,0.2
6,1,injury,6,162,5,1,0.16
6,1,intake,6,163,2,4,0.24
6,1,into,4,164,3,1,0.16
6,1,iron,4,165,1,3,0.2
6,1,island,6,166,1,5,0.28
6,1,issue,5,167,2,3,0.2
6,1,job,3,168,0,3,0.16
6,1,key,3,169,0,3,0.2
6,1,kick,4,170,1,3,0.28
6,1,kid,3,171,2,1,0.08
6,1,king,4,172,2,2,0.16
6,1,lad,3,173,0,3,0.16
6,1,lake,4,174,2,2,0.16
6,1,last,4,175,2,2,0.16
6,1,latest,6,176,2,4,0.32
6,1,laugh,5,177,2,3,0.2
6,1,law,3,178,2,1,0.08
6,1,layer,5,179,2,3,0.2
6,1,lens,4,180,1,3,0.16
6,1,lethal,6,181,2,4,0.24
6,1,limb,4,182,1,3,0.24
6,1,link,4,183,2,2,0.12
6,1,lion,4,184,2,2,0.12
6,1,litter,6,185,2,4,0.2
6,1,little,6,186,4,2,0.16
6,1,liver,5,187,2,3,0.24
6,1,local,5,188,1,4,0.2
6,1,log,3,189,2,1,0.08
6,1,lonely,6,190,2,4,0.24
6,1,long,4,191,3,1,0.12
6,1,loose,5,192,2,3,0.16
6,1,lot,3,193,2,1,0.16
6,1,loudly,6,194,2,4,0.2
6,1,low,3,195,2,1,0.12
6,1,mail,4,196,0,4,0.2
6,1,master,6,197,2,4,0.2
6,1,mean,4,198,1,3,0.16
6,1,melody,6,199,2,4,0.28
6,1,mental,6,200,2,4,0.24
6,1,mentor,6,201,4,2,0.16
6,1,method,6,202,2,4,0.24
6,1,metre,5,203,3,2,0.24
6,1,mixed,5,204,1,4,0.2
6,1,model,5,205,1,4,0.2
6,1,modify,6,206,3,3,0.2
6,1,moment,6,207,2,4,0.24
6,1,more,4,208,2,2,0.2
6,1,mouth,5,209,2,3,0.2
6,1,movie,5,210,2,3,0.16
6,1,mum,3,211,1,2,0.12
6,1,nature,6,212,0,6,0.28
6,1,needle,6,213,1,5,0.32
6,1,night,5,214,1,4,0.2
6,1,noisy,5,215,1,4,0.2
6,1,norm,4,216,2,2,0.16
6,1,normal,6,217,4,2,0.16
6,1,not,3,218,2,1,0.08
6,1,note,4,219,3,1,0.2
6,1,notion,6,220,3,3,0.2
6,1,novel,5,221,2,3,0.2
6,1,ocean,5,222,0,5,0.24
6,1,off,3,223,1,2,0.12
6,1,offend,6,224,3,3,0.28
6,1,online,6,225,1,5,0.24
6,1,option,6,226,1,5,0.24
6,1,other,5,227,1,4,0.2
6,1,outing,6,228,1,5,0.24
6,1,owe,3,229,1,2,0.44
6,1,pack,4,230,0,4,0.72
6,1,page,4,231,2,2,0.64
6,1,pants,5,232,2,3,0.32
6,1,parade,6,233,2,4,0.28
6,1,park,4,234,3,1,0.12
6,1,patron,6,235,2,4,0.24
6,1,pause,5,236,2,3,0.2
6,1,peace,5,237,1,4,0.28
6,1,peer,4,238,2,2,0.16
6,1,photo,5,239,1,4,0.2
6,1,pick,4,240,1,3,0.2
6,1,piece,5,241,2,3,0.2
6,1,pin,3,242,2,1,0.16
6,1,place,5,243,1,4,0.2
6,1,plan,4,244,3,1,0.12
6,1,plant,5,245,4,1,0.12
6,1,play,4,246,3,1,0.12
6,1,plot,4,247,2,2,0.12
6,1,point,5,248,1,4,0.28
6,1,poster,6,249,2,4,0.24
6,1,proof,5,250,1,4,0.2
6,1,proper,6,251,3,3,0.2
6,1,push,4,252,1,3,0.2
6,1,puzzle,6,253,2,4,0.28
6,1,quest,5,254,0,5,0.24
6,1,quite,5,255,2,3,0.16
6,1,race,4,256,0,4,0.2
6,1,racial,6,257,3,3,0.2
6,1,racism,6,258,4,2,0.24
6,1,radar,5,259,2,3,0.2
6,1,rail,4,260,2,2,0.16
6,1,raise,5,261,3,2,0.16
6,1,rather,6,262,2,4,0.24
6,1,rating,6,263,3,3,0.24
6,1,react,5,264,1,4,0.2
6,1,rear,4,265,3,1,0.12
6,1,rebel,5,266,2,3,0.16
6,1,recall,6,267,2,4,0.24
6,1,reduce,6,268,2,4,0.28
6,1,refer,5,269,2,3,0.2
6,1,refuse,6,270,3,3,0.2
6,1,regime,6,271,2,4,0.24
6,1,region,6,272,4,2,0.16
6,1,relax,5,273,2,3,0.24
6,1,relief,6,274,3,3,0.2
6,1,remark,6,275,2,4,0.2
6,1,remind,6,276,3,3,0.2
6,1,renew,5,277,2,3,0.16
6,1,repeat,6,278,2,4,0.28
6,1,retail,6,279,2,4,0.2
6,1,retire,6,280,3,3,0.2
6,1,rip,3,281,1,2,0.12
6,1,rise,4,282,2,2,0.16
6,1,road,4,283,1,3,0.2
6,1,robust,6,284,2,4,0.2
6,1,roof,4,285,2,2,0.2
6,1,root,4,286,3,1,0.2
6,1,rotate,6,287,2,4,0.2
6,1,rough,5,288,2,3,0.24
6,1,round,5,289,3,2,0.16
6,1,rubber,6,290,1,5,0.24
6,1,sailor,6,291,0,6,0.28
6,1,salt,4,292,2,2,0.12
6,1,sand,4,293,2,2,0.12
6,1,scan,4,294,1,3,0.24
6,1,scared,6,295,3,3,0.2
6,1,second,6,296,1,5,0.24
6,1,secret,6,297,3,3,0.2
6,1,secure,6,298,3,3,0.24
6,1,serve,5,299,2,3,0.2
6,1,seven,5,300,2,3,0.16
6,1,sexual,6,301,2,4,0.24
6,1,shift,5,302,1,4,0.2
6,1,shore,5,303,2,3,0.32
6,1,simply,6,304,1,5,0.44
6,1,sister,6,305,2,4,0.24
6,1,sit,3,306,2,1,0.12
6,1,ski,3,307,1,2,0.12
6,1,skull,5,308,2,3,0.2
6,1,slice,5,309,1,4,0.28
6,1,snow,4,310,1,3,0.16
6,1,solar,5,311,1,4,0.2
6,1,solo,4,312,3,1,0.12
6,1,song,4,313,2,2,0.16
6,1,soup,4,314,2,2,0.12
6,1,south,5,315,3,2,0.2
6,1,spare,5,316,1,4,0.2
6,1,sphere,6,317,2,4,0.2
6,1,spin,4,318,2,2,0.12
6,1,spine,5,319,4,1,0.12
6,1,stable,6,320,1,5,0.32
6,1,stamp,5,321,3,2,0.16
6,1,stand,5,322,3,2,0.16
6,1,statue,6,323,3,3,0.2
6,1,stay,4,324,3,1,0.12
6,1,stem,4,325,2,2,0.2
6,1,sticky,6,326,2,4,0.24
6,1,store,5,327,2,3,0.16
6,1,street,6,328,2,4,0.2
6,1,studio,6,329,2,4,0.24
6,1,study,5,330,4,1,0.2
6,1,stun,4,331,3,1,0.12
6,1,sugar,5,332,1,4,0.2
6,1,surely,6,333,2,4,0.2
6,1,sweep,5,334,1,4,0.2
6,1,swim,4,335,2,2,0.2
6,1,switch,6,336,3,3,0.28
6,1,table,5,337,0,5,0.28
6,1,tail,4,338,2,2,0.16
6,1,tale,4,339,2,2,0.16
6,1,talent,6,340,4,2,0.16
6,1,tank,4,341,2,2,0.2
6,1,tap,3,342,2,1,0.12
6,1,task,4,343,2,2,0.16
6,1,team,4,344,1,3,0.16
6,1,tempt,5,345,2,3,0.2
6,1,this,4,346,1,3,0.16
6,1,thumb,5,347,2,3,0.24
6,1,tight,5,348,1,4,0.2
6,1,too,3,349,1,2,0.12
6,1,tool,4,350,3,1,0.12
6,1,tragic,6,351,1,5,0.24
6,1,trap,4,352,3,1,0.12
6,1,tree,4,353,2,2,0.24
6,1,trial,5,354,2,3,0.2
6,1,trio,4,355,3,1,0.12
6,1,two,3,356,1,2,0.12
6,1,unfair,6,357,0,6,0.28
6,1,unify,5,358,2,3,0.24
6,1,unique,6,359,3,3,0.2
6,1,until,5,360,2,3,0.2
6,1,upon,4,361,1,3,0.16
6,1,urgent,6,362,1,5,0.24
6,1,usage,5,363,1,4,0.28
6,1,usual,5,364,2,3,0.16
6,1,vary,4,365,0,4,0.2
6,1,vessel,6,366,1,5,0.24
6,1,viable,6,367,1,5,0.24
6,1,video,5,368,2,3,0.24
6,1,viewer,6,369,2,4,0.2
6,1,virus,5,370,2,3,0.16
6,1,visual,6,371,2,4,0.24
6,1,vital,5,372,2,3,0.16
6,1,watch,5,373,0,5,0.28
6,1,water,5,374,3,2,0.16
6,1,way,3,375,2,1,0.08
6,1,weapon,6,376,1,5,0.32
6,1,weave,5,377,3,2,0.36
6,1,weight,6,378,2,4,0.64
6,1,whose,5,379,1,4,0.56
6,1,width,5,380,1,4,0.56
6,1,win,3,381,2,1,0.24
6,1,wine,4,382,3,1,0.32
6,1,wisdom,6,383,2,4,0.56
6,1,woman,5,384,1,4,0.56
6,1,work,4,385,2,2,0.32
6,1,worry,5,386,3,2,0.36
6,1,wow,3,387,2,1,0.24
6,1,wrap,4,388,1,3,0.36
6,1,yellow,6,389,0,6,0.72
6,2,accept,6,0,0,6,0.76
6,2,acre,4,1,2,2,0.4
6,2,acute,5,2,2,3,0.52
6,2,ad,2,3,1,1,0.2
6,2,add,3,4,2,1,0.28
6,2,adj,3,5,2,1,0.24
6,2,adopt,5,6,2,3,0.56
6,2,advice,6,7,2,4,0.52
6,2,ahead,5,8,1,4,0.48
6,2,aids,4,9,1,3,0.36
6,2,ankle,5,10,1,4,0.48
6,2,argue,5,11,1,4,0.64
6,2,arise,5,12,2,3,0.52
6,2,arms,4,13,2,2,0.4
6,2,around,6,14,2,4,0.64
6,2,arrest,6,15,2,4,0.56
6,2,artist,6,16,2,4,0.68
6,2,at,2,17,1,1,0.2
6,2,auto,4,18,1,3,0.4
6,2,baby,4,19,0,4,0.44
6,2,banner,6,20,2,4,0.56
6,2,bath,4,21,2,2,0.4
6,2,bed,3,22,1,2,0.44
6,2,beg,3,23,2,1,0.28
6,2,betray,6,24,2,4,0.64
6,2,beyond,6,25,2,4,0.56
6,2,bin,3,26,1,2,0.32
6,2,bitter,6,27,2,4,0.68
6,2,blade,5,28,1,4,0.52
6,2,blame,5,29,3,2,0.4
6,2,bless,5,30,2,3,0.4
6,2,blind,5,31,2,3,0.4
6,2,boat,4,32,1,3,0.36
6,2,boil,4,33,2,2,0.44
6,2,bomb,4,34,2,2,0.32
6,2,boom,4,35,2,2,0.32
6,2,boost,5,36,3,2,0.36
6,2,bother,6,37,2,4,0.52
6,2,bound,5,38,2,3,0.52
6,2,break,5,39,1,4,0.48
6,2,bride,5,40,2,3,0.4
6,2,bright,6,41,3,3,0.52
6,2,buddy,5,42,1,4,0.52
6,2,buffer,6,43,2,4,0.72
6,2,burn,4,44,2,2,0.4
6,2,cake,4,45,0,4,0.48
6,2,can,3,46,2,1,0.28
6,2,card,4,47,2,2,0.4
6,2,career,6,48,3,3,0.52
6,2,cave,4,49,2,2,0.48
6,2,cd,2,50,1,1,0.2
6,2,charm,5,51,1,4,0.52
6,2,chart,5,52,4,1,0.32
6,2,cheat,5,53,2,3,0.48
6,2,check,5,54,3,2,0.44
6,2,choose,6,55,2,4,0.64
6,2,chop,4,56,3,1,0.28
6,2,chunk,5,57,2,3,0.4
6,2,civil,5,58,1,4,0.48
6,2,clean,5,59,1,4,0.48
6,2,cloud,5,60,2,3,0.52
6,2,coffee,6,61,1,5,0.6
6,2,comedy,6,62,2,4,0.52
6,2,comply,6,63,3,3,0.48
6,2,confer,6,64,2,4,0.52
6,2,cope,4,65,2,2,0.44
6,2,could,5,66,2,3,0.44
6,2,county,6,67,3,3,0.48
6,2,coup,4,68,3,1,0.28
6,2,course,6,69,3,3,0.48
6,2,craft,5,70,1,4,0.56
6,2,crime,5,71,2,3,0.44
6,2,crisis,6,72,3,3,0.48
6,2,cross,5,73,2,3,0.44
6,2,crowd,5,74,3,2,0.36
6,2,crude,5,75,2,3,0.52
6,2,cruel,5,76,3,2,0.36
6,2,cruise,6,77,3,3,0.44
6,2,cry,3,78,2,1,0.24
6,2,dam,3,79,0,3,0.32
6,2,dance,5,80,2,3,0.4
6,2,deal,4,81,1,3,0.48
6,2,death,5,82,3,2,0.44
6,2,deputy,6,83,2,4,0.64
6,2,dinner,6,84,1,5,0.6
6,2,divine,6,85,2,4,0.56
6,2,domain,6,86,1,5,0.76
6,2,double,6,87,2,4,0.6
6,2,drink,5,88,1,4,0.52
6,2,edit,4,89,0,4,0.6
6,2,editor,6,90,4,2,0.6
6,2,effort,6,91,1,5,0.6
6,2,eighty,6,92,1,5,0.6
6,2,eleven,6,93,1,5,0.6
6,2,embody,6,94,1,5,0.6
6,2,enable,6,95,1,5,0.68
6,2,enjoy,5,96,2,3,0.44
6,2,enrich,6,97,2,4,0.52
6,2,euro,4,98,1,3,0.36
6,2,event,5,99,1,4,0.48
6,2,evoke,5,100,2,3,0.52
6,2,exact,5,101,1,4,0.48
6,2,exit,4,102,2,2,0.32
6,2,failed,6,103,0,6,0.64
6,2,famous,6,104,2,4,0.64
6,2,fast,4,105,2,2,0.32
6,2,few,3,106,1,2,0.28
6,2,fifty,5,107,1,4,0.48
6,2,fight,5,108,2,3,0.44
6,2,file,4,109,2,2,0.32
6,2,fine,4,110,2,2,0.44
6,2,firm,4,111,2,2,0.32
6,2,flag,4,112,1,3,0.4
6,2,flee,4,113,2,2,0.32
6,2,flower,6,114,2,4,0.52
6,2,flu,3,115,2,1,0.24
6,2,flying,6,116,2,4,0.64
6,2,focus,5,117,1,4,0.52
6,2,food,4,118,2,2,0.32
6,2,for,3,119,2,1,0.24
6,2,foster,6,120,2,4,0.52
6,2,frog,4,121,1,3,0.44
6,2,front,5,122,3,2,0.44
6,2,fulfil,6,123,1,5,0.56
6,2,full,4,124,3,1,0.28
6,2,game,4,125,0,4,0.44
6,2,gender,6,126,1,5,0.56
6,2,gene,4,127,3,1,0.4
6,2,genre,5,128,3,2,0.36
6,2,giant,5,129,1,4,0.48
6,2,give,4,130,2,2,0.32
6,2,golf,4,131,1,3,0.4
6,2,govern,6,132,2,4,0.64
6,2,grade,5,133,1,4,0.28
6,2,green,5,134,2,3,0.2
6,2,greet,5,135,4,1,0.12
6,2,grey,4,136,3,1,0.12
6,2,grid,4,137,2,2,0.16
6,2,grin,4,138,3,1,0.16
6,2,grind,5,139,4,1,0.16
6,2,guess,5,140,1,4,0.2
6,2,guest,5,141,4,1,0.16
6,2,guide,5,142,2,3,0.2
6,2,guitar,6,143,3,3,0.2
6,2,guy,3,144,2,1,0.16
6,2,gym,3,145,1,2,0.12
6,2,handy,5,146,0,5,0.24
6,2,happen,6,147,2,4,0.2
6,2,hat,3,148,2,1,0.12
6,2,hate,4,149,3,1,0.12
6,2,heart,5,150,1,4,0.24
6,2,her,3,151,2,1,0.08
6,2,herb,4,152,3,1,0.12
6,2,hint,4,153,1,3,0.16
6,2,horror,6,154,1,5,0.24
6,2,hour,4,155,2,2,0.12
6,2,how,3,156,2,1,0.16
6,2,hunger,6,157,1,5,0.24
6,2,i,1,158,0,1,0.08
6,2,ice,3,159,1,2,0.12
6,2,icon,4,160,2,2,0.12
6,2,ideal,5,161,1,4,0.2
6,2,ill,3,162,1,2,0.16
6,2,incur,5,163,1,4,0.2
6,2,infant,6,164,2,4,0.24
6,2,inform,6,165,3,3,0.24
6,2,inject,6,166,2,4,0.28
6,2,intake,6,167,2,4,0.28
6,2,into,4,168,3,1,0.12
6,2,invade,6,169,2,4,0.24
6,2,island,6,170,1,5,0.24
6,2,jet,3,171,0,3,0.12
6,2,job,3,172,1,2,0.2
6,2,joy,3,173,2,1,0.16
6,2,jump,4,174,1,3,0.16
6,2,just,4,175,2,2,0.12
6,2,key,3,176,0,3,0.16
6,2,kick,4,177,1,3,0.16
6,2,kid,3,178,2,1,0.08
6,2,kit,3,179,2,1,0.08
6,2,knife,5,180,1,4,0.28
6,2,know,4,181,2,2,0.16
6,2,lap,3,182,0,3,0.16
6,2,last,4,183,2,2,0.12
6,2,law,3,184,2,1,0.08
6,2,lawn,4,185,3,1,0.12
6,2,leaf,4,186,1,3,0.24
6,2,left,4,187,2,2,0.12
6,2,legend,6,188,2,4,0.2
6,2,lemon,5,189,2,3,0.16
6,2,lesser,6,190,2,4,0.24
6,2,lethal,6,191,2,4,0.28
6,2,lie,3,192,1,2,0.12
6,2,link,4,193,2,2,0.12
6,2,little,6,194,2,4,0.24
6,2,liver,5,195,2,3,0.16
6,2,load,4,196,1,3,0.16
6,2,local,5,197,2,3,0.24
6,2,log,3,198,2,1,0.08
6,2,lonely,6,199,2,4,0.2
6,2,loudly,6,200,2,4,0.24
6,2,low,3,201,2,1,0.08
6,2,mail,4,202,0,4,0.24
6,2,main,4,203,3,1,0.12
6,2,map,3,204,2,1,0.08
6,2,marine,6,205,2,4,0.24
6,2,mark,4,206,3,1,0.12
6,2,mask,4,207,2,2,0.12
6,2,match,5,208,2,3,0.24
6,2,melody,6,209,1,5,0.24
6,2,mental,6,210,2,4,0.24
6,2,mentor,6,211,4,2,0.16
6,2,metre,5,212,2,3,0.2
6,2,mixed,5,213,1,4,0.28
6,2,month,5,214,1,4,0.2
6,2,more,4,215,2,2,0.16
6,2,most,4,216,2,2,0.12
6,2,mother,6,217,2,4,0.24
6,2,music,5,218,1,4,0.28
6,2,must,4,219,3,1,0.12
6,2,name,4,220,0,4,0.2
6,2,nature,6,221,2,4,0.24
6,2,new,3,222,1,2,0.12
6,2,newly,5,223,3,2,0.16
6,2,non,3,224,1,2,0.2
6,2,north,5,225,2,3,0.16
6,2,notice,6,226,2,4,0.24
6,2,notion,6,227,4,2,0.16
6,2,novel,5,228,2,3,0.2
6,2,oblige,6,229,0,6,0.32
6,2,obsess,6,230,2,4,0.24
6,2,ocean,5,231,1,4,0.2
6,2,off,3,232,1,2,0.12
6,2,offend,6,233,3,3,0.2
6,2,once,4,234,1,3,0.24
6,2,online,6,235,2,4,0.24
6,2,ought,5,236,1,4,0.2
6,2,outfit,6,237,2,4,0.2
6,2,outing,6,238,3,3,0.2
6,2,owe,3,239,1,2,0.2
6,2,pace,4,240,0,4,0.2
6,2,pack,4,241,3,1,0.12
6,2,page,4,242,2,2,0.16
6,2,parade,6,243,2,4,0.24
6,2,park,4,244,3,1,0.16
6,2,patent,6,245,2,4,0.28
6,2,pause,5,246,2,3,0.2
6,2,peer,4,247,1,3,0.16
6,2,pepper,6,248,2,4,0.24
6,2,photo,5,249,1,4,0.2
6,2,piece,5,250,1,4,0.28
6,2,place,5,251,1,4,0.2
6,2,plane,5,252,3,2,0.16
6,2,plant,5,253,4,1,0.12
6,2,play,4,254,3,1,0.12
6,2,police,6,255,1,5,0.32
6,2,pond,4,256,2,2,0.16
6,2,poster,6,257,2,4,0.2
6,2,pot,3,258,2,1,0.08
6,2,pump,4,259,1,3,0.16
6,2,punk,4,260,2,2,0.12
6,2,pupil,5,261,2,3,0.24
6,2,push,4,262,2,2,0.12
6,2,put,3,263,2,1,0.08
6,2,puzzle,6,264,2,4,0.24
6,2,quest,5,265,0,5,0.24
6,2,quite,5,266,2,3,0.16
6,2,racial,6,267,0,6,0.32
6,2,radar,5,268,2,3,0.16
6,2,rail,4,269,2,2,0.16
6,2,rather,6,270,2,4,0.24
6,2,rebel,5,271,1,4,0.2
6,2,reduce,6,272,2,4,0.28
6,2,refer,5,273,2,3,0.2
6,2,region,6,274,2,4,0.2
6,2,reign,5,275,2,3,0.16
6,2,relax,5,276,2,3,0.16
6,2,remind,6,277,2,4,0.28
6,2,remove,6,278,3,3,0.2
6,2,repeat,6,279,2,4,0.24
6,2,reside,6,280,2,4,0.2
6,2,rest,4,281,3,1,0.16
6,2,retail,6,282,2,4,0.24
6,2,rifle,5,283,1,4,0.2
6,2,rip,3,284,2,1,0.08
6,2,ritual,6,285,2,4,0.2
6,2,roll,4,286,1,3,0.16
6,2,root,4,287,2,2,0.2
6,2,rotate,6,288,2,4,0.2
6,2,rough,5,289,2,3,0.2
6,2,round,5,290,3,2,0.16
6,2,rub,3,291,1,2,0.12
6,2,ruin,4,292,2,2,0.2
6,2,safe,4,293,0,4,0.2
6,2,sale,4,294,2,2,0.16
6,2,scared,6,295,1,5,0.24
6,2,school,6,296,2,4,0.24
6,2,seal,4,297,1,3,0.16
6,2,second,6,298,2,4,0.28
6,2,secret,6,299,3,3,0.2
6,2,secure,6,300,3,3,0.2
6,2,serve,5,301,2,3,0.2
6,2,seven,5,302,2,3,0.24
6,2,shape,5,303,1,4,0.2
6,2,shiny,5,304,2,3,0.2
6,2,shore,5,305,2,3,0.2
6,2,sight,5,306,1,4,0.2
6,2,simply,6,307,2,4,0.28
6,2,sit,3,308,2,1,0.08
6,2,ski,3,309,1,2,0.12
6,2,skirt,5,310,3,2,0.16
6,2,slam,4,311,1,3,0.16
6,2,smile,5,312,1,4,0.2
6,2,snow,4,313,1,3,0.24
6,2,soap,4,314,1,3,0.16
6,2,solo,4,315,2,2,0.12
6,2,some,4,316,2,2,0.12
6,2,south,5,317,2,3,0.2
6,2,space,5,318,1,4,0.2
6,2,speak,5,319,2,3,0.28
6,2,speech,6,320,3,3,0.2
6,2,sphere,6,321,2,4,0.24
6,2,spin,4,322,2,2,0.12
6,2,spine,5,323,4,1,0.12
6,2,stab,4,324,1,3,0.2
6,2,stable,6,325,4,2,0.16
6,2,stamp,5,326,3,2,0.16
6,2,stand,5,327,3,2,0.16
6,2,statue,6,328,3,3,0.2
6,2,stem,4,329,2,2,0.12
6,2,stick,5,330,2,3,0.24
6,2,sticky,6,331,5,1,0.16
6,2,story,5,332,2,3,0.16
6,2,strong,6,333,2,4,0.24
6,2,studio,6,334,2,4,0.2
6,2,sugar,5,335,1,4,0.24
6,2,super,5,336,2,3,0.2
6,2,switch,6,337,1,5,0.24
6,2,table,5,338,0,5,0.24
6,2,tale,4,339,2,2,0.16
6,2,talent,6,340,4,2,0.24
6,2,tap,3,341,2,1,0.12
6,2,taste,5,342,2,3,0.2
6,2,taxi,4,343,2,2,0.16
6,2,tea,3,344,1,2,0.16
6,2,tempt,5,345,2,3,0.2
6,2,this,4,346,1,3,0.24
6,2,three,5,347,2,3,0.28
6,2,tidy,4,348,1,3,0.4
6,2,to,2,349,1,1,0.2
6,2,too,3,350,2,1,0.24
6,2,tool,4,351,3,1,0.28
6,2,topic,5,352,2,3,0.52
6,2,tree,4,353,1,3,0.4
6,2,trend,5,354,3,2,0.36
6,2,tribal,6,355,2,4,0.52
6,2,tribe,5,356,4,1,0.32
6,2,truck,5,357,2,3,0.52
6,2,tune,4,358,1,3,0.36
6,2,twice,5,359,1,4,0.48
6,2,unable,6,360,0,6,0.6
6,2,unfair,6,361,2,4,0.52
6,2,unify,5,362,2,3,0.52
6,2,unique,6,363,3,3,0.48
6,2,uphold,6,364,1,5,0.64
6,2,usual,5,365,1,4,0.48
6,2,vague,5,366,0,5,0.52
6,2,valley,6,367,2,4,0.64
6,2,vein,4,368,1,3,0.4
6,2,verify,6,369,2,4,0.52
6,2,vessel,6,370,2,4,0.52
6,2,video,5,371,1,4,0.48
6,2,viewer,6,372,2,4,0.6
6,2,virtue,6,373,2,4,0.52
6,2,virus,5,374,3,2,0.36
6,2,visual,6,375,2,4,0.52
6,2,voice,5,376,1,4,0.56
6,2,wait,4,377,0,4,0.44
6,2,walk,4,378,2,2,0.32
6,2,war,3,379,2,1,0.24
6,2,weight,6,380,1,5,0.56
6,2,win,3,381,1,2,0.28
6,2,wind,4,382,3,1,0.28
6,2,window,6,383,4,2,0.52
6,2,wisdom,6,384,2,4,0.52
6,2,woman,5,385,1,4,0.48
6,2,word,4,386,2,2,0.36
6,2,wow,3,387,2,1,0.28
6,2,wrap,4,388,1,3,0.48
6,2,yellow,6,389,0,6,0.64
6,3,a,1,0,0,1,0.16
6,3,absorb,6,1,1,5,0.6
6,3,acre,4,2,1,3,0.44
6,3,acute,5,3,2,3,0.44
6,3,ad,2,4,1,1,0.2
6,3,add,3,5,2,1,0.36
6,3,adj,3,6,2,1,0.24
6,3,admit,5,7,2,3,0.4
6,3,adopt,5,8,2,3,0.4
6,3,agree,5,9,1,4,0.48
6,3,ahead,5,10,1,4,0.48
6,3,align,5,11,1,4,0.56
6,3,ally,4,12,2,2,0.32
6,3,and,3,13,1,2,0.28
6,3,anger,5,14,2,3,0.4
6,3,army,4,15,1,3,0.36
6,3,around,6,16,2,4,0.6
6,3,artist,6,17,2,4,0.52
6,3,auto,4,18,1,3,0.36
6,3,baby,4,19,0,4,0.44
6,3,bath,4,20,2,2,0.32
6,3,beat,4,21,1,3,0.36
6,3,beauty,6,22,3,3,0.6
6,3,bed,3,23,2,1,0.16
6,3,beer,4,24,2,2,0.2
6,3,behave,6,25,2,4,0.28
6,3,below,5,26,2,3,0.2
6,3,betray,6,27,2,4,0.28
6,3,bill,4,28,1,3,0.16
6,3,bin,3,29,2,1,0.12
6,3,bite,4,30,2,2,0.16
6,3,bitter,6,31,3,3,0.2
6,3,blame,5,32,1,4,0.2
6,3,blog,4,33,2,2,0.2
6,3,blow,4,34,3,1,0.12
6,3,boat,4,35,1,3,0.16
6,3,boom,4,36,2,2,0.16
6,3,boost,5,37,3,2,0.16
6,3,box,3,38,2,1,0.08
6,3,bridge,6,39,1,5,0.28
6,3,bright,6,40,3,3,0.2
6,3,broken,6,41,2,4,0.24
6,3,bug,3,42,1,2,0.12
6,3,build,5,43,2,3,0.16
6,3,burn,4,44,2,2,0.2
6,3,butter,6,45,2,4,0.24
6,3,cake,4,46,0,4,0.2
6,3,can,3,47,2,1,0.12
6,3,cancer,6,48,3,3,0.2
6,3,career,6,49,2,4,0.28
6,3,carpet,6,50,3,3,0.2
6,3,carve,5,51,3,2,0.16
6,3,cease,5,52,1,4,0.2
6,3,check,5,53,1,4,0.2
6,3,choir,5,54,2,3,0.24
6,3,choose,6,55,3,3,0.2
6,3,chop,4,56,3,1,0.12
6,3,chunk,5,57,2,3,0.2
6,3,circle,6,58,1,5,0.24
6,3,cite,4,59,2,2,0.2
6,3,club,4,60,1,3,0.16
6,3,coffee,6,61,1,5,0.24
6,3,comedy,6,62,2,4,0.2
6,3,comply,6,63,3,3,0.2
6,3,confer,6,64,2,4,0.28
6,3,convey,6,65,3,3,0.2
6,3,cost,4,66,2,2,0.12
6,3,could,5,67,2,3,0.2
6,3,county,6,68,3,3,0.2
6,3,craft,5,69,1,4,0.28
6,3,create,6,70,2,4,0.24
6,3,cross,5,71,2,3,0.16
6,3,crowd,5,72,3,2,0.16
6,3,cry,3,73,2,1,0.12
6,3,damage,6,74,0,6,0.32
6,3,dance,5,75,2,3,0.2
6,3,dare,4,76,2,2,0.12
6,3,deed,4,77,1,3,0.16
6,3,detect,6,78,2,4,0.24
6,3,dig,3,79,1,2,0.16
6,3,dirty,5,80,2,3,0.24
6,3,divine,6,81,2,4,0.2
6,3,dollar,6,82,1,5,0.24
6,3,domain,6,83,2,4,0.24
6,3,dust,4,84,1,3,0.16
6,3,ear,3,85,0,3,0.24
6,3,earth,5,86,3,2,0.16
6,3,edit,4,87,1,3,0.2
6,3,editor,6,88,4,2,0.16
6,3,effort,6,89,1,5,0.24
6,3,eighty,6,90,1,5,0.32
6,3,either,6,91,2,4,0.2
6,3,elect,5,92,1,4,0.2
6,3,embark,6,93,1,5,0.24
6,3,embody,6,94,3,3,0.2
6,3,enable,6,95,1,5,0.32
6,3,enemy,5,96,2,3,0.16
6,3,entry,5,97,2,3,0.2
6,3,essay,5,98,1,4,0.2
6,3,exact,5,99,1,4,0.2
6,3,exceed,6,100,2,4,0.28
6,3,excuse,6,101,3,3,0.2
6,3,eye,3,102,1,2,0.12
6,3,fall,4,103,0,4,0.2
6,3,famous,6,104,2,4,0.24
6,3,fat,3,105,2,1,0.2
6,3,fee,3,106,1,2,0.12
6,3,few,3,107,2,1,0.12
6,3,fight,5,108,1,4,0.28
6,3,file,4,109,2,2,0.16
6,3,fine,4,110,2,2,0.16
6,3,firm,4,111,2,2,0.24
6,3,flying,6,112,1,5,0.36
6,3,folk,4,113,1,3,0.28
6,3,food,4,114,2,2,0.2
6,3,force,5,115,2,3,0.2
6,3,foster,6,116,2,4,0.28
6,3,friday,6,117,1,5,0.32
6,3,frog,4,118,2,2,0.16
6,3,front,5,119,3,2,0.24
6,3,fulfil,6,120,1,5,0.36
6,3,gaming,6,121,0,6,0.48
6,3,garage,6,122,2,4,0.4
6,3,gender,6,123,1,5,0.28
6,3,giant,5,124,1,4,0.4
6,3,glass,5,125,1,4,0.32
6,3,go,2,126,1,1,0.24
6,3,gold,4,127,2,2,0.2
6,3,golf,4,128,3,1,0.16
6,3,good,4,129,2,2,0.36
6,3,govern,6,130,2,4,0.52
6,3,grace,5,131,1,4,0.48
6,3,grade,5,132,3,2,0.24
6,3,greet,5,133,2,3,0.2
6,3,grief,5,134,2,3,0.28
6,3,grin,4,135,3,1,0.12
6,3,grind,5,136,4,1,0.12
6,3,growth,6,137,2,4,0.32
6,3,guitar,6,138,1,5,0.24
6,3,guy,3,139,2,1,0.12
6,3,handy,5,140,0,5,0.24
6,3,harsh,5,141,2,3,0.2
6,3,hat,3,142,2,1,0.12
6,3,hate,4,143,3,1,0.28
6,3,hazard,6,144,2,4,0.6
6,3,health,6,145,1,5,0.32
6,3,heart,5,146,3,2,0.16
6,3,heat,4,147,3,1,0.12
6,3,herb,4,148,2,2,0.24
6,3,hers,4,149,3,1,0.16
6,3,highly,6,150,1,5,0.28
6,3,horror,6,151,1,5,0.48
6,3,hotel,5,152,2,3,0.24
6,3,how,3,153,2,1,0.12
6,3,humble,6,154,1,5,0.36
6,3,humour,6,155,3,3,0.24
6,3,icon,4,156,0,4,0.2
6,3,ideal,5,157,1,4,0.28
6,3,ill,3,158,1,2,0.16
6,3,import,6,159,1,5,0.36
6,3,infant,6,160,1,5,0.28
6,3,info,4,161,3,1,0.12
6,3,injury,6,162,2,4,0.24
6,3,invade,6,163,2,4,0.24
6,3,issue,5,164,1,4,0.28
6,3,joy,3,165,0,3,0.16
6,3,jump,4,166,1,3,0.24
6,3,kid,3,167,0,3,0.16
6,3,kidney,6,168,3,3,0.2
6,3,king,4,169,2,2,0.16
6,3,kit,3,170,2,1,0.2
6,3,knife,5,171,1,4,0.2
6,3,know,4,172,2,2,0.12
6,3,last,4,173,0,4,0.2
6,3,latest,6,174,2,4,0.32
6,3,laugh,5,175,2,3,0.24
6,3,law,3,176,2,1,0.08
6,3,lawn,4,177,3,1,0.12
6,3,layer,5,178,2,3,0.16
6,3,leaf,4,179,1,3,0.16
6,3,league,6,180,3,3,0.2
6,3,left,4,181,2,2,0.2
6,3,lens,4,182,2,2,0.16
6,3,link,4,183,1,3,0.16
6,3,lion,4,184,2,2,0.12
6,3,little,6,185,2,4,0.2
6,3,live,4,186,2,2,0.12
6,3,liver,5,187,4,1,0.2
6,3,load,4,188,1,3,0.16
6,3,local,5,189,2,3,0.2
6,3,log,3,190,2,1,0.08
6,3,lonely,6,191,2,4,0.24
6,3,look,4,192,2,2,0.32
6,3,lot,3,193,2,1,0.24
6,3,love,4,194,2,2,0.16
6,3,low,3,195,2,1,0.12
6,3,lunch,5,196,1,4,0.28
6,3,main,4,197,0,4,0.2
6,3,map,3,198,2,1,0.12
6,3,marine,6,199,2,4,0.28
6,3,mark,4,200,3,1,0.12
6,3,mask,4,201,2,2,0.16
6,3,master,6,202,3,3,0.2
6,3,media,5,203,1,4,0.24
6,3,memory,6,204,2,4,0.28
6,3,merger,6,205,2,4,0.24
6,3,metre,5,206,2,3,0.2
6,3,mirror,6,207,1,5,0.24
6,3,mixed,5,208,2,3,0.2
6,3,month,5,209,1,4,0.44
6,3,more,4,210,2,2,0.32
6,3,mother,6,211,2,4,0.52
6,3,mouth,5,212,2,3,0.4
6,3,much,4,213,1,3,0.36
6,3,museum,6,214,2,4,0.6
6,3,music,5,215,3,2,0.36
6,3,must,4,216,3,1,0.28
6,3,myth,4,217,1,3,0.36
6,3,name,4,218,0,4,0.44
6,3,nasty,5,219,2,3,0.48
6,3,new,3,220,1,2,0.4
6,3,newly,5,221,3,2,0.36
6,3,noise,5,222,1,4,0.48
6,3,noisy,5,223,4,1,0.32
6,3,non,3,224,2,1,0.24
6,3,norm,4,225,2,2,0.32
6,3,normal,6,226,4,2,0.48
6,3,notice,6,227,2,4,0.52
6,3,notion,6,228,4,2,0.4
6,3,novel,5,229,2,3,0.44
6,3,nut,3,230,1,2,0.28
6,3,obsess,6,231,0,6,0.72
6,3,once,4,232,1,3,0.36
6,3,one,3,233,2,1,0.24
6,3,outing,6,234,1,5,0.56
6,3,outlet,6,235,3,3,0.44
6,3,pack,4,236,0,4,0.44
6,3,paint,5,237,2,3,0.52
6,3,pants,5,238,2,3,0.44
6,3,parade,6,239,2,4,0.52
6,3,peer,4,240,1,3,0.4
6,3,pig,3,241,1,2,0.28
6,3,pile,4,242,2,2,0.44
6,3,pin,3,243,2,1,0.24
6,3,plant,5,244,1,4,0.48
6,3,play,4,245,3,1,0.28
6,3,pledge,6,246,2,4,0.52
6,3,plot,4,247,2,2,0.32
6,3,police,6,248,1,5,0.68
6,3,pond,4,249,2,2,0.32
6,3,poster,6,250,2,4,0.52
6,3,proof,5,251,1,4,0.52
6,3,proper,6,252,3,3,0.48
6,3,pump,4,253,1,3,0.48
6,3,punk,4,254,2,2,0.32
6,3,pure,4,255,2,2,0.32
6,3,put,3,256,2,1,0.24
6,3,quest,5,257,0,5,0.52
6,3,quite,5,258,2,3,0.4
6,3,racial,6,259,0,6,0.72
6,3,raise,5,260,2,3,0.4
6,3,rating,6,261,2,4,0.52
6,3,react,5,262,1,4,0.48
6,3,rear,4,263,3,1,0.28
6,3,recall,6,264,2,4,0.64
6,3,record,6,265,3,3,0.48
6,3,refuse,6,266,2,4,0.52
6,3,regard,6,267,2,4,0.52
6,3,regime,6,268,3,3,0.56
6,3,region,6,269,4,2,0.4
6,3,relief,6,270,2,4,0.52
6,3,renew,5,271,2,3,0.4
6,3,repeat,6,272,2,4,0.52
6,3,retail,6,273,2,4,0.6
6,3,reveal,6,274,2,4,0.52
6,3,revive,6,275,3,3,0.44
6,3,right,5,276,1,4,0.48
6,3,rip,3,277,2,1,0.24
6,3,rise,4,278,2,2,0.44
6,3,ritual,6,279,2,4,0.52
6,3,rival,5,280,2,3,0.4
6,3,root,4,281,1,3,0.36
6,3,rub,3,282,1,2,0.28
6,3,safe,4,283,0,4,0.44
6,3,sale,4,284,2,2,0.44
6,3,salt,4,285,3,1,0.28
6,3,sample,6,286,2,4,0.6
6,3,school,6,287,1,5,0.6
6,3,score,5,288,2,3,0.44
6,3,seal,4,289,1,3,0.48
6,3,second,6,290,2,4,0.52
6,3,secret,6,291,3,3,0.44
6,3,seem,4,292,2,2,0.32
6,3,sheer,5,293,1,4,0.48
6,3,shell,5,294,3,2,0.48
6,3,shift,5,295,2,3,0.4
6,3,shiny,5,296,3,2,0.36
6,3,sight,5,297,1,4,0.48
6,3,silver,6,298,2,4,0.52
6,3,simply,6,299,2,4,0.64
6,3,sin,3,300,2,1,0.24
6,3,sister,6,301,2,4,0.52
6,3,sit,3,302,2,1,0.24
6,3,six,3,303,2,1,0.24
6,3,ski,3,304,1,2,0.28
6,3,skip,4,305,3,1,0.28
6,3,slam,4,306,1,3,0.48
6,3,slice,5,307,2,3,0.44
6,3,slip,4,308,3,1,0.28
6,3,smile,5,309,1,4,0.48
6,3,snow,4,310,1,3,0.36
6,3,solid,5,311,1,4,0.6
6,3,some,4,312,2,2,0.32
6,3,song,4,313,2,2,0.32
6,3,south,5,314,2,3,0.4
6,3,space,5,315,1,4,0.48
6,3,spare,5,316,3,2,0.36
6,3,speak,5,317,2,3,0.52
6,3,sphere,6,318,2,4,0.52
6,3,spread,6,319,2,4,0.52
6,3,stab,4,320,1,3,0.36
6,3,stall,5,321,3,2,0.36
6,3,stamp,5,322,3,2,0.48
6,3,stance,6,323,3,3,0.48
6,3,stand,5,324,4,1,0.32
6,3,stay,4,325,3,1,0.28
6,3,stem,4,326,2,2,0.32
6,3,sticky,6,327,2,4,0.64
6,3,stop,4,328,2,2,0.32
6,3,story,5,329,3,2,0.36
6,3,strong,6,330,2,4,0.52
6,3,studio,6,331,2,4,0.52
6,3,stun,4,332,3,1,0.28
6,3,such,4,333,1,3,0.48
6,3,sudden,6,334,2,4,0.52
6,3,sugar,5,335,2,3,0.4
6,3,super,5,336,2,3,0.44
6,3,sure,4,337,2,2,0.32
6,3,sweep,5,338,1,4,0.56
6,3,swim,4,339,2,2,0.32
6,3,switch,6,340,3,3,0.44
6,3,tale,4,341,0,4,0.44
6,3,tank,4,342,2,2,0.4
6,3,tape,4,343,2,2,0.32
6,3,task,4,344,2,2,0.44
6,3,taste,5,345,3,2,0.36
6,3,tea,3,346,1,2,0.28
6,3,tender,6,347,2,4,0.84
6,3,terror,6,348,2,4,0.52
6,3,thesis,6,349,1,5,0.68
6,3,thumb,5,350,2,3,0.44
6,3,till,4,351,1,3,0.36
6,3,to,2,352,1,1,0.2
6,3,too,3,353,2,1,0.24
6,3,tour,4,354,2,2,0.32
6,3,tragic,6,355,1,5,0.68
6,3,treat,5,356,2,3,0.44
6,3,treaty,6,357,5,1,0.36
6,3,tribe,5,358,2,3,0.44
6,3,truck,5,359,2,3,0.4
6,3,two,3,360,1,2,0.28
6,3,unfair,6,361,0,6,0.76
6,3,union,5,362,2,3,0.44
6,3,until,5,363,2,3,0.44
6,3,unveil,6,364,2,4,0.52
6,3,uphold,6,365,1,5,0.68
6,3,urgent,6,366,1,5,0.56
6,3,vague,5,367,0,5,0.52
6,3,valley,6,368,2,4,0.52
6,3,verify,6,369,1,5,0.56
6,3,virus,5,370,1,4,0.6
6,3,visual,6,371,2,4,0.52
6,3,voice,5,372,1,4,0.48
6,3,walk,4,373,0,4,0.44
6,3,watch,5,374,2,3,0.4
6,3,way,3,375,2,1,0.36
6,3,weight,6,376,1,5,0.56
6,3,whose,5,377,1,4,0.48
6,3,win,3,378,1,2,0.28
6,3,wind,4,379,3,1,0.28
6,3,wine,4,380,3,1,0.28
6,3,wipe,4,381,2,2,0.44
6,3,within,6,382,2,4,0.52
6,3,woman,5,383,1,4,0.48
6,3,word,4,384,2,2,0.32
6,3,work,4,385,3,1,0.28
6,3,world,5,386,3,2,0.48
6,3,wow,3,387,2,1,0.24
6,3,wrist,5,388,1,4,0.48
6,3,young,5,389,0,5,0.52
6,4,absorb,6,0,0,6,0.28
6,4,acid,4,1,1,3,0.16
6,4,ad,2,2,1,1,0.08
6,4,adopt,5,3,2,3,0.24
6,4,advice,6,4,2,4,0.2
6,4,ahead,5,5,1,4,0.2
6,4,and,3,6,1,2,0.12
6,4,app,3,7,1,2,0.12
6,4,arms,4,8,1,3,0.24
6,4,artist,6,9,2,4,0.2
6,4,at,2,10,1,1,0.08
6,4,auto,4,11,1,3,0.16
6,4,baby,4,12,0,4,0.16
6,4,ballet,6,13,2,4,0.24
6,4,banner,6,14,2,4,0.28
6,4,base,4,15,2,2,0.12
6,4,bat,3,16,2,1,0.08
6,4,bath,4,17,3,1,0.12
6,4,bay,3,18,2,1,0.08
6,4,beast,5,19,1,4,0.2
6,4,beat,4,20,3,1,0.2
6,4,beauty,6,21,3,3,0.2
6,4,bed,3,22,2,1,0.12
6,4,beg,3,23,2,1,0.12
6,4,belief,6,24,2,4,0.24
6,4,bell,4,25,3,1,0.12
6,4,beyond,6,26,2,4,0.28
6,4,bill,4,27,1,3,0.16
6,4,bin,3,28,2,1,0.12
6,4,bishop,6,29,2,4,0.2
6,4,bite,4,30,2,2,0.16
6,4,blind,5,31,1,4,0.2
6,4,blog,4,32,2,2,0.2
6,4,boat,4,33,1,3,0.16
6,4,boost,5,34,2,3,0.16
6,4,boot,4,35,3,1,0.12
6,4,bottle,6,36,2,4,0.2
6,4,breach,6,37,1,5,0.32
6,4,break,5,38,4,1,0.12
6,4,bridge,6,39,2,4,0.24
6,4,buffer,6,40,1,5,0.24
6,4,bug,3,41,2,1,0.12
6,4,build,5,42,2,3,0.24
6,4,cake,4,43,0,4,0.2
6,4,can,3,44,2,1,0.08
6,4,cancer,6,45,3,3,0.2
6,4,cap,3,46,2,1,0.12
6,4,career,6,47,2,4,0.24
6,4,carpet,6,48,3,3,0.24
6,4,carve,5,49,3,2,0.16
6,4,chart,5,50,1,4,0.2
6,4,cheat,5,51,2,3,0.16
6,4,choir,5,52,2,3,0.16
6,4,choose,6,53,3,3,0.28
6,4,chunk,5,54,2,3,0.16
6,4,circle,6,55,1,5,0.24
6,4,civil,5,56,2,3,0.16
6,4,clean,5,57,1,4,0.2
6,4,clerk,5,58,3,2,0.24
6,4,coffee,6,59,1,5,0.24
6,4,colony,6,60,2,4,0.2
6,4,confer,6,61,2,4,0.24
6,4,cooker,6,62,2,4,0.28
6,4,cope,4,63,2,2,0.12
6,4,cost,4,64,2,2,0.12
6,4,coup,4,65,2,2,0.16
6,4,court,5,66,3,2,0.16
6,4,create,6,67,1,5,0.24
6,4,crime,5,68,2,3,0.24
6,4,crisis,6,69,3,3,0.2
6,4,cruel,5,70,2,3,0.16
6,4,cruise,6,71,3,3,0.2
6,4,curved,6,72,1,5,0.24
6,4,dance,5,73,0,5,0.28
6,4,dare,4,74,2,2,0.12
6,4,death,5,75,1,4,0.2
6,4,demon,5,76,2,3,0.16
6,4,detect,6,77,2,4,0.24
6,4,devil,5,78,2,3,0.24
6,4,drink,5,79,1,4,0.2
6,4,ear,3,80,0,3,0.12
6,4,earth,5,81,3,2,0.16
6,4,editor,6,82,1,5,0.24
6,4,either,6,83,1,5,0.32
6,4,eleven,6,84,1,5,0.28
6,4,enemy,5,85,1,4,0.2
6,4,enjoy,5,86,2,3,0.2
6,4,entry,5,87,2,3,0.2
6,4,essay,5,88,1,4,0.28
6,4,event,5,89,1,4,0.2
6,4,exact,5,90,1,4,0.2
6,4,exceed,6,91,2,4,0.24
6,4,expire,6,92,2,4,0.32
6,4,eye,3,93,1,2,0.12
6,4,fair,4,94,0,4,0.2
6,4,fairly,6,95,4,2,0.2
6,4,famous,6,96,2,4,0.24
6,4,fat,3,97,2,1,0.12
6,4,fellow,6,98,1,5,0.36
6,4,few,3,99,2,1,0.12
6,4,fifty,5,100,1,4,0.32
6,4,fix,3,101,2,1,0.12
6,4,flag,4,102,1,3,0.16
6,4,flat,4,103,3,1,0.12
6,4,flee,4,104,2,2,0.24
6,4,flower,6,105,2,4,0.24
6,4,flu,3,106,2,1,0.12
6,4,focus,5,107,1,4,0.2
6,4,folk,4,108,2,2,0.16
6,4,food,4,109,2,2,0.16
6,4,for,3,110,2,1,0.2
6,4,former,6,111,3,3,0.2
6,4,foster,6,112,2,4,0.24
6,4,friday,6,113,1,5,0.24
6,4,full,4,114,1,3,0.16
6,4,fur,3,115,2,1,0.12
6,4,game,4,116,0,4,0.28
6,4,gaming,6,117,3,3,0.2
6,4,garage,6,118,2,4,0.24
6,4,gene,4,119,1,3,0.16
6,4,give,4,120,1,3,0.16
6,4,globe,5,121,1,4,0.28
6,4,go,2,122,1,1,0.08
6,4,golf,4,123,2,2,0.16
6,4,grace,5,124,1,4,0.24
6,4,grade,5,125,3,2,0.16
6,4,green,5,126,2,3,0.2
6,4,greet,5,127,4,1,0.24
6,4,grief,5,128,2,3,0.2
6,4,growth,6,129,2,4,0.24
6,4,guess,5,130,1,4,0.24
6,4,guide,5,131,2,3,0.2
6,4,guitar,6,132,3,3,0.28
6,4,gym,3,133,1,2,0.12
6,4,harsh,5,134,0,5,0.24
6,4,hate,4,135,2,2,0.16
6,4,hazard,6,136,2,4,0.24
6,4,health,6,137,1,5,0.36
6,4,heart,5,138,3,2,0.16
6,4,her,3,139,2,1,0.12
6,4,highly,6,140,1,5,0.24
6,4,hint,4,141,2,2,0.16
6,4,hour,4,142,1,3,0.16
6,4,how,3,143,2,1,0.2
6,4,humble,6,144,1,5,0.28
6,4,humour,6,145,3,3,0.2
6,4,hunger,6,146,2,4,0.24
6,4,ice,3,147,0,3,0.16
6,4,ideal,5,148,1,4,0.32
6,4,image,5,149,1,4,0.24
6,4,infant,6,150,1,5,0.24
6,4,info,4,151,3,1,0.12
6,4,inject,6,152,2,4,0.24
6,4,injury,6,153,3,3,0.28
6,4,insert,6,154,2,4,0.24
6,4,intake,6,155,2,4,0.24
6,4,invade,6,156,2,4,0.24
6,4,invest,6,157,3,3,0.32
6,4,jet,3,158,0,3,0.16
6,4,job,3,159,1,2,0.12
6,4,just,4,160,1,3,0.16
6,4,key,3,161,0,3,0.16
6,4,kid,3,162,1,2,0.12
6,4,kidney,6,163,3,3,0.2
6,4,knife,5,164,1,4,0.36
6,4,know,4,165,2,2,0.2
6,4,lake,4,166,0,4,0.24
6,4,latest,6,167,2,4,0.72
6,4,layer,5,168,2,3,0.2
6,4,leaf,4,169,1,3,0.24
6,4,league,6,170,3,3,0.2
6,4,legend,6,171,2,4,0.28
6,4,lethal,6,172,2,4,0.24
6,4,letter,6,173,3,3,0.24
6,4,link,4,174,1,3,0.28
6,4,lion,4,175,2,2,0.16
6,4,live,4,176,2,2,0.16
6,4,log,3,177,1,2,0.12
6,4,lonely,6,178,2,4,0.24
6,4,long,4,179,3,1,0.12
6,4,loose,5,180,2,3,0.28
6,4,lot,3,181,2,1,0.12
6,4,loudly,6,182,2,4,0.24
6,4,love,4,183,2,2,0.16
6,4,low,3,184,2,1,0.12
6,4,marine,6,185,0,6,0.4
6,4,mark,4,186,3,1,0.12
6,4,master,6,187,2,4,0.24
6,4,mean,4,188,1,3,0.16
6,4,media,5,189,2,3,0.2
6,4,melody,6,190,2,4,0.24
6,4,memory,6,191,2,4,0.32
6,4,mentor,6,192,2,4,0.24
6,4,metre,5,193,2,3,0.2
6,4,mirror,6,194,1,5,0.24
6,4,mixed,5,195,2,3,0.28
6,4,model,5,196,1,4,0.24
6,4,money,5,197,2,3,0.2
6,4,most,4,198,2,2,0.16
6,4,mother,6,199,2,4,0.24
6,4,mum,3,200,1,2,0.12
6,4,museum,6,201,2,4,0.32
6,4,my,2,202,1,1,0.08
6,4,myth,4,203,2,2,0.16
6,4,naked,5,204,0,5,0.24
6,4,name,4,205,2,2,0.16
6,4,nasty,5,206,2,3,0.2
6,4,nature,6,207,2,4,0.32
6,4,needle,6,208,1,5,0.28
6,4,newly,5,209,2,3,0.2
6,4,night,5,210,1,4,0.24
6,4,noise,5,211,1,4,0.32
6,4,noisy,5,212,4,1,0.16
6,4,not,3,213,2,1,0.12
6,4,notice,6,214,3,3,0.2
6,4,notion,6,215,4,2,0.2
6,4,novel,5,216,2,3,0.2
6,4,nut,3,217,1,2,0.2
6,4,oblige,6,218,0,6,0.28
6,4,off,3,219,1,2,0.12
6,4,offend,6,220,3,3,0.2
6,4,one,3,221,1,2,0.12
6,4,online,6,222,2,4,0.32
6,4,ought,5,223,1,4,0.2
6,4,owe,3,224,1,2,0.12
6,4,pad,3,225,0,3,0.16
6,4,paint,5,226,2,3,0.2
6,4,pants,5,227,2,3,0.2
6,4,park,4,228,2,2,0.24
6,4,patent,6,229,2,4,0.24
6,4,patron,6,230,3,3,0.2
6,4,pause,5,231,2,3,0.2
6,4,peace,5,232,1,4,0.24
6,4,peer,4,233,2,2,0.24
6,4,pick,4,234,1,3,0.16
6,4,pig,3,235,2,1,0.12
6,4,pipe,4,236,2,2,0.16
6,4,place,5,237,1,4,0.24
6,4,plant,5,238,3,2,0.16
6,4,plot,4,239,2,2,0.32
6,4,poster,6,240,1,5,0.24
6,4,pot,3,241,2,1,0.12
6,4,praise,6,242,1,5,0.28
6,4,prior,5,243,2,3,0.2
6,4,proof,5,244,2,3,0.2
6,4,punk,4,245,1,3,0.28
6,4,pupil,5,246,2,3,0.2
6,4,pure,4,247,2,2,0.16
6,4,push,4,248,2,2,0.16
6,4,puzzle,6,249,2,4,0.24
6,4,query,5,250,0,5,0.32
6,4,quest,5,251,3,2,0.16
6,4,quite,5,252,2,3,0.2
6,4,racial,6,253,0,6,0.28
6,4,radar,5,254,2,3,0.2
6,4,raise,5,255,2,3,0.28
6,4,rally,5,256,2,3,0.2
6,4,rating,6,257,2,4,0.24
6,4,react,5,258,1,4,0.24
6,4,rebel,5,259,2,3,0.2
6,4,reduce,6,260,2,4,0.32
6,4,regime,6,261,2,4,0.36
6,4,region,6,262,4,2,0.44
6,4,relax,5,263,2,3,0.24
6,4,relief,6,264,3,3,0.2
6,4,remind,6,265,2,4,0.28
6,4,remove,6,266,3,3,0.2
6,4,renew,5,267,2,3,0.2
6,4,retire,6,268,2,4,0.24
6,4,revise,6,269,2,4,0.28
6,4,revive,6,270,4,2,0.16
6,4,rifle,5,271,1,4,0.2
6,4,right,5,272,2,3,0.16
6,4,rip,3,273,2,1,0.08
6,4,rise,4,274,2,2,0.12
6,4,ritual,6,275,2,4,0.28
6,4,rival,5,276,2,3,0.16
6,4,rob,3,277,1,2,0.12
6,4,robust,6,278,3,3,0.2
6,4,roll,4,279,2,2,0.16
6,4,root,4,280,2,2,0.2
6,4,rubber,6,281,1,5,0.24
6,4,sacred,6,282,0,6,0.28
6,4,safe,4,283,2,2,0.12
6,4,sailor,6,284,2,4,0.2
6,4,sample,6,285,2,4,0.32
6,4,school,6,286,1,5,0.24
6,4,score,5,287,2,3,0.2
6,4,seal,4,288,1,3,0.16
6,4,second,6,289,2,4,0.28
6,4,secret,6,290,3,3,0.6
6,4,sexy,4,291,2,2,0.32
6,4,shape,5,292,1,4,0.48
6,4,share,5,293,3,2,0.36
6,4,shift,5,294,2,3,0.4
6,4,shoot,5,295,2,3,0.52
6,4,shore,5,296,3,2,0.36
6,4,sight,5,297,1,4,0.48
6,4,sink,4,298,2,2,0.32
6,4,sister,6,299,2,4,0.52
6,4,sit,3,300,2,1,0.24
6,4,six,3,301,2,1,0.36
6,4,skip,4,302,1,3,0.4
6,4,skirt,5,303,3,2,0.36
6,4,slam,4,304,1,3,0.36
6,4,smile,5,305,1,4,0.48
6,4,soap,4,306,1,3,0.36
6,4,solar,5,307,2,3,0.52
6,4,solid,5,308,3,2,0.36
6,4,soup,4,309,2,2,0.32
6,4,space,5,310,1,4,0.48
6,4,spare,5,311,3,2,0.36
6,4,speech,6,312,2,4,0.64
6,4,sphere,6,313,2,4,0.52
6,4,spread,6,314,2,4,0.52
6,4,stable,6,315,1,5,0.56
6,4,stance,6,316,3,3,0.56
6,4,stand,5,317,4,1,0.32
6,4,stop,4,318,2,2,0.36
6,4,store,5,319,3,2,0.36
6,4,story,5,320,4,1,0.32
6,4,street,6,321,2,4,0.52
6,4,strike,6,322,3,3,0.6
6,4,study,5,323,2,3,0.44
6,4,stun,4,324,3,1,0.36
6,4,such,4,325,1,3,0.48
6,4,super,5,326,2,3,0.44
6,4,sure,4,327,2,2,0.44
6,4,surely,6,328,4,2,0.4
6,4,sweep,5,329,1,4,0.48
6,4,switch,6,330,2,4,0.52
6,4,table,5,331,0,5,0.52
6,4,talent,6,332,2,4,0.6
6,4,tank,4,333,2,2,0.32
6,4,tap,3,334,2,1,0.24
6,4,task,4,335,2,2,0.32
6,4,taste,5,336,3,2,0.36
6,4,taxi,4,337,2,2,0.32
6,4,team,4,338,1,3,0.92
6,4,thesis,6,339,1,5,1.44
6,4,three,5,340,2,3,1.36
6,4,ticket,6,341,1,5,1.92
6,4,tidy,4,342,2,2,0.72
6,4,till,4,343,2,2,0.36
6,4,timing,6,344,2,4,0.52
6,4,to,2,345,1,1,0.2
6,4,tonne,5,346,2,3,0.44
6,4,too,3,347,2,1,0.36
6,4,tool,4,348,3,1,0.28
6,4,tour,4,349,2,2,0.32
6,4,tragic,6,350,1,5,0.56
6,4,treat,5,351,2,3,0.4
6,4,tree,4,352,3,1,0.28
6,4,trend,5,353,3,2,0.44
6,4,trial,5,354,2,3,0.4
6,4,tribal,6,355,3,3,0.44
6,4,trio,4,356,3,1,0.28
6,4,truck,5,357,2,3,0.4
6,4,unable,6,358,0,6,0.76
6,4,union,5,359,2,3,0.4
6,4,unique,6,360,3,3,0.44
6,4,until,5,361,2,3,0.4
6,4,unveil,6,362,2,4,0.52
6,4,urban,5,363,1,4,0.6
6,4,usage,5,364,1,4,0.48
6,4,usual,5,365,2,3,0.44
6,4,vague,5,366,0,5,0.56
6,4,vary,4,367,2,2,0.32
6,4,verify,6,368,1,5,0.68
6,4,vessel,6,369,2,4,0.52
6,4,viable,6,370,1,5,0.56
6,4,vital,5,371,2,3,0.4
6,4,vocal,5,372,1,4,0.48
6,4,voice,5,373,2,3,0.52
6,4,waiter,6,374,0,6,0.64
6,4,wake,4,375,2,2,0.32
6,4,war,3,376,2,1,0.24
6,4,weight,6,377,1,5,0.56
6,4,weird,5,378,3,2,0.48
6,4,west,4,379,2,2,0.32
6,4,whose,5,380,1,4,0.48
6,4,width,5,381,1,4,0.48
6,4,wind,4,382,2,2,0.36
6,4,wine,4,383,3,1,0.36
6,4,wipe,4,384,2,2,0.44
6,4,woman,5,385,1,4,0.48
6,4,work,4,386,2,2,0.32
6,4,worry,5,387,3,2,0.36
6,4,wow,3,388,2,1,0.24
6,4,wrap,4,389,1,3,0.36
6,5,absorb,6,0,0,6,0.68
6,5,absurd,6,1,3,3,0.56
6,5,ad,2,2,1,1,0.2
6,5,add,3,3,2,1,0.24
6,5,adj,3,4,2,1,0.24
6,5,admit,5,5,2,3,0.4
6,5,again,5,6,1,4,0.48
6,5,agree,5,7,2,3,0.52
6,5,ahead,5,8,1,4,0.52
6,5,aids,4,9,1,3,0.36
6,5,anger,5,10,1,4,0.48
6,5,ankle,5,11,2,3,0.44
6,5,anyway,6,12,2,4,0.6
6,5,arms,4,13,1,3,0.4
6,5,army,4,14,3,1,0.28
6,5,around,6,15,2,4,0.52
6,5,arrest,6,16,2,4,0.52
6,5,artist,6,17,2,4,0.6
6,5,auto,4,18,1,3,0.4
6,5,baby,4,19,0,4,0.44
6,5,barrel,6,20,2,4,0.52
6,5,bat,3,21,2,1,0.24
6,5,bath,4,22,3,1,0.28
6,5,beast,5,23,1,4,0.56
6,5,beat,4,24,3,1,0.28
6,5,bed,3,25,2,1,0.24
6,5,beer,4,26,2,2,0.32
6,5,beg,3,27,2,1,0.24
6,5,behalf,6,28,2,4,0.52
6,5,belief,6,29,2,4,0.6
6,5,best,4,30,2,2,0.32
6,5,bill,4,31,1,3,0.4
6,5,bird,4,32,2,2,0.4
6,5,bishop,6,33,2,4,0.6
6,5,blame,5,34,1,4,0.64
6,5,blank,5,35,3,2,0.4
6,5,bless,5,36,2,3,0.44
6,5,boom,4,37,1,3,0.4
6,5,boost,5,38,3,2,0.4
6,5,bother,6,39,2,4,0.56
6,5,bound,5,40,2,3,0.52
6,5,box,3,41,2,1,0.24
6,5,breach,6,42,1,5,0.56
6,5,bride,5,43,2,3,0.4
6,5,bridge,6,44,4,2,0.28
6,5,bright,6,45,3,3,0.32
6,5,broken,6,46,2,4,0.28
6,5,buffer,6,47,1,5,0.28
6,5,bug,3,48,2,1,0.12
6,5,bunch,5,49,2,3,0.24
6,5,burden,6,50,2,4,0.36
6,5,butter,6,51,2,4,0.28
6,5,cafe,4,52,0,4,0.24
6,5,cake,4,53,2,2,0.2
6,5,cap,3,54,2,1,0.12
6,5,career,6,55,2,4,0.36
6,5,cave,4,56,2,2,0.16
6,5,cd,2,57,1,1,0.16
6,5,cease,5,58,1,4,0.28
6,5,chart,5,59,1,4,0.2
6,5,cheat,5,60,2,3,0.2
6,5,check,5,61,3,2,0.24
6,5,choir,5,62,2,3,0.2
6,5,choose,6,63,3,3,0.2
6,5,chop,4,64,3,1,0.12
6,5,clean,5,65,1,4,0.2
6,5,club,4,66,2,2,0.16
6,5,coach,5,67,1,4,0.24
6,5,comedy,6,68,2,4,0.24
6,5,confer,6,69,2,4,0.2
6,5,convey,6,70,3,3,0.2
6,5,cooker,6,71,2,4,0.28
6,5,cope,4,72,2,2,0.16
6,5,could,5,73,2,3,0.16
6,5,coup,4,74,3,1,0.12
6,5,couple,6,75,4,2,0.2
6,5,create,6,76,1,5,0.32
6,5,creep,5,77,3,2,0.16
6,5,crisis,6,78,2,4,0.24
6,5,crude,5,79,2,3,0.16
6,5,cruel,5,80,3,2,0.16
6,5,cry,3,81,2,1,0.12
6,5,curved,6,82,1,5,0.36
6,5,damage,6,83,0,6,0.28
6,5,dance,5,84,2,3,0.2
6,5,day,3,85,2,1,0.12
6,5,deal,4,86,1,3,0.16
6,5,demon,5,87,2,3,0.28
6,5,detect,6,88,2,4,0.24
6,5,devil,5,89,2,3,0.16
6,5,dinner,6,90,1,5,0.24
6,5,dirt,4,91,2,2,0.16
6,5,divine,6,92,2,4,0.32
6,5,dollar,6,93,1,5,0.24
6,5,dot,3,94,2,1,0.12
6,5,double,6,95,2,4,0.2
6,5,drama,5,96,1,4,0.2
6,5,ear,3,97,0,3,0.2
6,5,earth,5,98,3,2,0.16
6,5,edit,4,99,1,3,0.16
6,5,effort,6,100,1,5,0.24
6,5,eighty,6,101,1,5,0.24
6,5,elect,5,102,1,4,0.28
6,5,enjoy,5,103,1,4,0.24
6,5,enter,5,104,2,3,0.2
6,5,entry,5,105,3,2,0.16
6,5,essay,5,106,1,4,0.2
6,5,euro,4,107,1,3,0.24
6,5,event,5,108,1,4,0.2
6,5,evoke,5,109,2,3,0.2
6,5,exact,5,110,1,4,0.2
6,5,expire,6,111,2,4,0.2
6,5,extend,6,112,2,4,0.28
6,5,fairly,6,113,0,6,0.28
6,5,fast,4,114,2,2,0.12
6,5,fat,3,115,2,1,0.12
6,5,few,3,116,1,2,0.12
6,5,fibre,5,117,1,4,0.2
6,5,fifty,5,118,2,3,0.24
6,5,fight,5,119,2,3,0.2
6,5,fine,4,120,2,2,0.16
6,5,firm,4,121,2,2,0.12
6,5,fixed,5,122,2,3,0.16
6,5,flag,4,123,1,3,0.16
6,5,flat,4,124,3,1,0.16
6,5,flee,4,125,2,2,0.16
6,5,floor,5,126,2,3,0.16
6,5,flower,6,127,3,3,0.2
6,5,focus,5,128,1,4,0.2
6,5,food,4,129,2,2,0.2
6,5,force,5,130,2,3,0.2
6,5,foster,6,131,2,4,0.24
6,5,fridge,6,132,1,5,0.24
6,5,full,4,133,1,3,0.16
6,5,fur,3,134,2,1,0.08
6,5,game,4,135,0,4,0.24
6,5,gaming,6,136,3,3,0.2
6,5,garage,6,137,2,4,0.2
6,5,giant,5,138,1,4,0.2
6,5,give,4,139,2,2,0.16
6,5,golf,4,140,1,3,0.28
6,5,green,5,141,1,4,0.2
6,5,greet,5,142,4,1,0.12
6,5,grey,4,143,3,1,0.12
6,5,grief,5,144,2,3,0.16
6,5,grin,4,145,3,1,0.16
6,5,grind,5,146,4,1,0.12
6,5,growth,6,147,2,4,0.2
6,5,guest,5,148,1,4,0.2
6,5,guy,3,149,2,1,0.08
6,5,happen,6,150,0,6,0.28
6,5,hate,4,151,2,2,0.2
6,5,hazard,6,152,2,4,0.24
6,5,herb,4,153,1,3,0.16
6,5,hers,4,154,3,1,0.12
6,5,hint,4,155,1,3,0.16
6,5,hotel,5,156,1,4,0.24
6,5,humble,6,157,1,5,0.24
6,5,humour,6,158,3,3,0.2
6,5,icon,4,159,0,4,0.2
6,5,ideal,5,160,1,4,0.2
6,5,import,6,161,1,5,0.32
6,5,incur,5,162,1,4,0.2
6,5,index,5,163,2,3,0.16
6,5,infant,6,164,2,4,0.2
6,5,info,4,165,3,1,0.12
6,5,inform,6,166,4,2,0.24
6,5,inject,6,167,2,4,0.24
6,5,insert,6,168,2,4,0.24
6,5,intake,6,169,2,4,0.24
6,5,invade,6,170,2,4,0.2
6,5,invest,6,171,3,3,0.28
6,5,iron,4,172,1,3,0.16
6,5,issue,5,173,1,4,0.2
6,5,joy,3,174,0,3,0.16
6,5,key,3,175,0,3,0.16
6,5,lake,4,176,0,4,0.2
6,5,lap,3,177,2,1,0.16
6,5,laser,5,178,2,3,0.16
6,5,latest,6,179,2,4,0.2
6,5,laugh,5,180,2,3,0.2
6,5,lawn,4,181,2,2,0.12
6,5,layer,5,182,2,3,0.24
6,5,league,6,183,1,5,0.24
6,5,left,4,184,2,2,0.16
6,5,letter,6,185,2,4,0.24
6,5,limb,4,186,1,3,0.16
6,5,link,4,187,2,2,0.2
6,5,lion,4,188,2,2,0.16
6,5,litter,6,189,2,4,0.24
6,5,little,6,190,4,2,0.16
6,5,liver,5,191,2,3,0.2
6,5,load,4,192,1,3,0.16
6,5,lonely,6,193,2,4,0.28
6,5,love,4,194,2,2,0.12
6,5,low,3,195,2,1,0.12
6,5,mail,4,196,0,4,0.2
6,5,main,4,197,3,1,0.12
6,5,map,3,198,2,1,0.08
6,5,marine,6,199,2,4,0.28
6,5,mean,4,200,1,3,0.16
6,5,melody,6,201,2,4,0.2
6,5,memory,6,202,2,4,0.24
6,5,merely,6,203,2,4,0.2
6,5,mirror,6,204,1,5,0.28
6,5,model,5,205,1,4,0.2
6,5,modify,6,206,3,3,0.2
6,5,money,5,207,2,3,0.16
6,5,month,5,208,3,2,0.2
6,5,more,4,209,2,2,0.12
6,5,most,4,210,2,2,0.12
6,5,mouth,5,211,2,3,0.16
6,5,much,4,212,1,3,0.16
6,5,music,5,213,2,3,0.16
6,5,nature,6,214,0,6,0.32
6,5,neck,4,215,1,3,0.16
6,5,newly,5,216,2,3,0.16
6,5,noise,5,217,1,4,0.2
6,5,noisy,5,218,4,1,0.12
6,5,norm,4,219,2,2,0.2
6,5,normal,6,220,4,2,0.16
6,5,note,4,221,2,2,0.16
6,5,notice,6,222,3,3,0.2
6,5,notion,6,223,4,2,0.2
6,5,novel,5,224,2,3,0.24
6,5,oblige,6,225,0,6,0.28
6,5,off,3,226,1,2,0.12
6,5,offend,6,227,3,3,0.2
6,5,once,4,228,1,3,0.16
6,5,one,3,229,2,1,0.12
6,5,ought,5,230,1,4,0.28
6,5,outing,6,231,2,4,0.2
6,5,owe,3,232,1,2,0.12
6,5,pack,4,233,0,4,0.2
6,5,page,4,234,2,2,0.12
6,5,paint,5,235,2,3,0.16
6,5,park,4,236,2,2,0.2
6,5,patron,6,237,2,4,0.24
6,5,pepper,6,238,1,5,0.28
6,5,photo,5,239,1,4,0.2
6,5,pick,4,240,1,3,0.16
6,5,piece,5,241,2,3,0.24
6,5,pipe,4,242,2,2,0.12
6,5,place,5,243,1,4,0.2
6,5,plane,5,244,3,2,0.16
6,5,plant,5,245,4,1,0.12
6,5,pledge,6,246,2,4,0.28
6,5,point,5,247,1,4,0.4
6,5,pond,4,248,2,2,0.32
6,5,post,4,249,2,2,0.32
6,5,poster,6,250,4,2,0.4
6,5,prior,5,251,1,4,0.56
6,5,proper,6,252,2,4,0.52
6,5,pump,4,253,1,3,0.36
6,5,punk,4,254,2,2,0.32
6,5,pupil,5,255,2,3,0.44
6,5,put,3,256,2,1,0.24
6,5,quest,5,257,0,5,0.64
6,5,rather,6,258,0,6,0.64
6,5,react,5,259,1,4,0.48
6,5,recall,6,260,2,4,0.52
6,5,record,6,261,3,3,0.48
6,5,reduce,6,262,2,4,0.6
6,5,refuse,6,263,2,4,0.52
6,5,regime,6,264,2,4,0.52
6,5,reign,5,265,2,3,0.4
6,5,relief,6,266,2,4,0.6
6,5,repeat,6,267,2,4,0.52
6,5,rest,4,268,2,2,0.32
6,5,retail,6,269,2,4,0.52
6,5,retire,6,270,3,3,0.48
6,5,reveal,6,271,2,4,0.64
6,5,revise,6,272,3,3,0.68
6,5,revive,6,273,4,2,0.4
6,5,right,5,274,1,4,0.48
6,5,rise,4,275,2,2,0.36
6,5,road,4,276,1,3,0.48
6,5,rob,3,277,2,1,0.24
6,5,roll,4,278,2,2,0.32
6,5,roof,4,279,2,2,0.32
6,5,root,4,280,3,1,0.28
6,5,rotate,6,281,2,4,0.52
6,5,rough,5,282,2,3,0.52
6,5,rub,3,283,1,2,0.28
6,5,rubber,6,284,3,3,0.44
6,5,ruin,4,285,2,2,0.36
6,5,safe,4,286,0,4,0.44
6,5,sailor,6,287,2,4,0.52
6,5,sample,6,288,2,4,0.6
6,5,sand,4,289,2,2,0.32
6,5,scared,6,290,1,5,0.56
6,5,seal,4,291,1,3,0.4
6,5,secret,6,292,2,4,0.52
6,5,secure,6,293,3,3,0.56
6,5,seeker,6,294,2,4,0.52
6,5,seem,4,295,3,1,0.28
6,5,serve,5,296,2,3,0.44
6,5,sexual,6,297,2,4,0.52
6,5,sexy,4,298,3,1,0.4
6,5,shape,5,299,1,4,0.48
6,5,share,5,300,3,2,0.36
6,5,sheer,5,301,2,3,0.44
6,5,shell,5,302,3,2,0.36
6,5,shift,5,303,2,3,0.52
6,5,shiny,5,304,3,2,0.36
6,5,shoot,5,305,2,3,0.44
6,5,sight,5,306,1,4,0.48
6,5,silver,6,307,2,4,0.52
6,5,simply,6,308,2,4,0.6
6,5,sin,3,309,2,1,0.24
6,5,sink,4,310,3,1,0.28
6,5,sister,6,311,2,4,0.52
6,5,sit,3,312,2,1,0.24
6,5,six,3,313,2,1,0.24
6,5,ski,3,314,1,2,0.36
6,5,slip,4,315,1,3,0.4
6,5,snow,4,316,1,3,0.36
6,5,soap,4,317,1,3,0.4
6,5,solid,5,318,2,3,0.44
6,5,song,4,319,2,2,0.32
6,5,soup,4,320,2,2,0.32
6,5,south,5,321,3,2,0.48
6,5,spare,5,322,1,4,0.48
6,5,sphere,6,323,2,4,0.52
6,5,spine,5,324,2,3,0.44
6,5,spread,6,325,2,4,0.64
6,5,stand,5,326,1,4,0.48
6,5,stick,5,327,2,3,0.44
6,5,store,5,328,2,3,0.44
6,5,story,5,329,4,1,0.32
6,5,street,6,330,2,4,0.6
6,5,string,6,331,3,3,0.48
6,5,studio,6,332,2,4,0.52
6,5,such,4,333,1,3,0.36
6,5,sudden,6,334,2,4,0.52
6,5,sue,3,335,2,1,0.24
6,5,sugar,5,336,2,3,0.56
6,5,super,5,337,2,3,0.44
6,5,swear,5,338,1,4,0.84
6,5,sweep,5,339,3,2,0.36
6,5,swim,4,340,2,2,0.36
6,5,switch,6,341,3,3,0.6
6,5,table,5,342,0,5,0.52
6,5,tale,4,343,2,2,0.32
6,5,talk,4,344,3,1,0.28
6,5,tap,3,345,2,1,0.24
6,5,team,4,346,1,3,0.36
6,5,terror,6,347,2,4,0.64
6,5,thesis,6,348,1,5,0.56
6,5,this,4,349,2,2,0.32
6,5,three,5,350,2,3,0.4
6,5,ticket,6,351,1,5,0.56
6,5,tidy,4,352,2,2,0.44
6,5,till,4,353,2,2,0.32
6,5,tour,4,354,1,3,0.4
6,5,tragic,6,355,1,5,0.56
6,5,treat,5,356,2,3,0.44
6,5,tree,4,357,3,1,0.28
6,5,trial,5,358,2,3,0.56
6,5,trio,4,359,3,1,0.28
6,5,twice,5,360,1,4,0.48
6,5,unfair,6,361,0,6,0.64
6,5,unify,5,362,2,3,0.44
6,5,unique,6,363,3,3,0.56
6,5,until,5,364,2,3,0.4
6,5,uphold,6,365,1,5,0.56
6,5,urban,5,366,1,4,0.48
6,5,urgent,6,367,2,4,0.68
6,5,usual,5,368,1,4,0.48
6,5,vague,5,369,0,5,0.52
6,5,vessel,6,370,1,5,0.6
6,5,viewer,6,371,1,5,0.56
6,5,virus,5,372,2,3,0.56
6,5,vocal,5,373,1,4,0.48
6,5,voice,5,374,2,3,0.4
6,5,waiter,6,375,0,6,0.6
6,5,way,3,376,2,1,0.24
6,5,weave,5,377,1,4,0.6
6,5,weight,6,378,2,4,0.52
6,5,west,4,379,2,2,0.32
6,5,win,3,380,1,2,0.28
6,5,wine,4,381,3,1,0.28
6,5,wipe,4,382,2,2,0.32
6,5,wisdom,6,383,2,4,0.64
6,5,within,6,384,2,4,0.52
6,5,woman,5,385,1,4,0.48
6,5,work,4,386,2,2,0.32
6,5,world,5,387,3,2,0.36
6,5,wow,3,388,2,1,0.32
6,5,wrist,5,389,1,4,0.48
6,6,absorb,6,0,0,6,0.28
6,6,accept,6,1,1,5,0.24
6,6,acid,4,2,2,2,0.16
6,6,acre,4,3,2,2,0.16
6,6,acute,5,4,2,3,0.24
6,6,ad,2,5,1,1,0.08
6,6,adj,3,6,2,1,0.12
6,6,advice,6,7,2,4,0.2
6,6,again,5,8,1,4,0.2
6,6,aids,4,9,1,3,0.16
6,6,and,3,10,1,2,0.2
6,6,app,3,11,1,2,0.12
6,6,argue,5,12,1,4,0.2
6,6,arms,4,13,2,2,0.12
6,6,army,4,14,3,1,0.12
6,6,arrest,6,15,2,4,0.24
6,6,artist,6,16,2,4,0.28
6,6,ballet,6,17,0,6,0.28
6,6,base,4,18,2,2,0.12
6,6,bat,3,19,2,1,0.08
6,6,bath,4,20,3,1,0.12
6,6,bay,3,21,2,1,0.12
6,6,beauty,6,22,1,5,0.32
6,6,bed,3,23,2,1,0.08
6,6,beer,4,24,2,2,0.12
6,6,behalf,6,25,2,4,0.24
6,6,best,4,26,2,2,0.16
6,6,betray,6,27,2,4,0.28
6,6,bird,4,28,1,3,0.16
6,6,blade,5,29,1,4,0.2
6,6,blame,5,30,3,2,0.16
6,6,blow,4,31,2,2,0.12
6,6,boat,4,32,1,3,0.16
6,6,boil,4,33,2,2,0.2
6,6,bother,6,34,2,4,0.2
6,6,bottle,6,35,3,3,0.2
6,6,breach,6,36,1,5,0.24
6,6,bright,6,37,2,4,0.28
6,6,broken,6,38,2,4,0.24
6,6,buddy,5,39,1,4,0.2
6,6,cafe,4,40,0,4,0.2
6,6,cake,4,41,2,2,0.12
6,6,cancer,6,42,2,4,0.32
6,6,card,4,43,2,2,0.12
6,6,career,6,44,3,3,0.2
6,6,cd,2,45,1,1,0.08
6,6,cease,5,46,1,4,0.2
6,6,cheat,5,47,1,4,0.2
6,6,check,5,48,3,2,0.24
6,6,chop,4,49,2,2,0.16
6,6,chunk,5,50,2,3,0.16
6,6,cite,4,51,1,3,0.16
6,6,city,4,52,3,1,0.12
6,6,clean,5,53,1,4,0.2
6,6,clerk,5,54,3,2,0.2
6,6,club,4,55,2,2,0.12
6,6,coffee,6,56,1,5,0.24
6,6,colony,6,57,2,4,0.2
6,6,comply,6,58,2,4,0.24
6,6,could,5,59,2,3,0.24
6,6,coup,4,60,3,1,0.12
6,6,couple,6,61,4,2,0.16
6,6,course,6,62,3,3,0.2
6,6,crime,5,63,1,4,0.2
6,6,crisis,6,64,3,3,0.24
6,6,cross,5,65,2,3,0.16
6,6,crowd,5,66,3,2,0.16
6,6,crude,5,67,2,3,0.16
6,6,cruel,5,68,3,2,0.16
6,6,cruise,6,69,3,3,0.24
6,6,cry,3,70,2,1,0.08
6,6,cycle,5,71,1,4,0.2
6,6,damage,6,72,0,6,0.24
6,6,dare,4,73,2,2,0.16
6,6,deem,4,74,1,3,0.2
6,6,defect,6,75,2,4,0.24
6,6,demon,5,76,2,3,0.16
6,6,deputy,6,77,2,4,0.24
6,6,devil,5,78,2,3,0.2
6,6,dirt,4,79,1,3,0.24
6,6,dirty,5,80,4,1,0.12
6,6,divine,6,81,2,4,0.24
6,6,dollar,6,82,1,5,0.24
6,6,dot,3,83,2,1,0.08
6,6,double,6,84,2,4,0.32
6,6,drama,5,85,1,4,0.24
6,6,drink,5,86,2,3,0.16
6,6,dust,4,87,1,3,0.2
6,6,editor,6,88,0,6,0.24
6,6,effort,6,89,1,5,0.32
6,6,either,6,90,1,5,0.24
6,6,elect,5,91,1,4,0.2
6,6,eleven,6,92,3,3,0.2
6,6,embark,6,93,1,5,0.24
6,6,enable,6,94,1,5,0.32
6,6,ending,6,95,2,4,0.24
6,6,enjoy,5,96,2,3,0.2
6,6,enter,5,97,2,3,0.16
6,6,erect,5,98,1,4,0.24
6,6,essay,5,99,1,4,0.24
6,6,euro,4,100,1,3,0.16
6,6,event,5,101,1,4,0.2
6,6,evoke,5,102,2,3,0.2
6,6,exceed,6,103,1,5,0.24
6,6,excuse,6,104,3,3,0.28
6,6,exit,4,105,2,2,0.12
6,6,extend,6,106,2,4,0.24
6,6,eye,3,107,1,2,0.12
6,6,fail,4,108,0,4,0.2
6,6,failed,6,109,4,2,0.24
6,6,fair,4,110,3,1,0.12
6,6,fairly,6,111,4,2,0.16
6,6,fall,4,112,2,2,0.12
6,6,fast,4,113,2,2,0.12
6,6,fasten,6,114,4,2,0.16
6,6,fee,3,115,1,2,0.2
6,6,few,3,116,2,1,0.12
6,6,fibre,5,117,1,4,0.2
6,6,fifty,5,118,2,3,0.16
6,6,fight,5,119,2,3,0.16
6,6,fine,4,120,2,2,0.12
6,6,firm,4,121,2,2,0.2
6,6,fix,3,122,2,1,0.08
6,6,floor,5,123,1,4,0.2
6,6,flower,6,124,3,3,0.2
6,6,focus,5,125,1,4,0.2
6,6,folk,4,126,2,2,0.2
6,6,foster,6,127,2,4,0.24
6,6,fridge,6,128,1,5,0.24
6,6,front,5,129,2,3,0.2
6,6,fur,3,130,1,2,0.12
6,6,gaming,6,131,0,6,0.36
6,6,gene,4,132,1,3,0.16
6,6,giant,5,133,1,4,0.2
6,6,globe,5,134,1,4,0.2
6,6,god,3,135,1,2,0.12
6,6,gold,4,136,2,2,0.16
6,6,golf,4,137,3,1,0.16
6,6,good,4,138,2,2,0.12
6,6,govern,6,139,2,4,0.24
6,6,grace,5,140,1,4,0.2
6,6,greet,5,141,2,3,0.16
6,6,grey,4,142,3,1,0.12
6,6,growth,6,143,2,4,0.28
6,6,guest,5,144,1,4,0.24
6,6,guitar,6,145,2,4,0.28
6,6,guy,3,146,2,1,0.12
6,6,gym,3,147,1,2,0.16
6,6,happen,6,148,0,6,0.36
6,6,harm,4,149,2,2,0.12
6,6,hate,4,150,2,2,0.12
6,6,hazard,6,151,2,4,0.24
6,6,heart,5,152,1,4,0.2
6,6,heat,4,153,3,1,0.16
6,6,her,3,154,2,1,0.08
6,6,hour,4,155,1,3,0.16
6,6,humour,6,156,1,5,0.24
6,6,hunt,4,157,2,2,0.12
6,6,i,1,158,0,1,0.08
6,6,ice,3,159,1,2,0.12
6,6,ideal,5,160,1,4,0.28
6,6,ill,3,161,1,2,0.16
6,6,import,6,162,1,5,0.28
6,6,index,5,163,1,4,0.36
6,6,info,4,164,2,2,0.28
6,6,injury,6,165,2,4,0.4
6,6,invest,6,166,2,4,0.2
6,6,iron,4,167,1,3,0.2
6,6,island,6,168,1,5,0.28
6,6,issue,5,169,2,3,0.2
6,6,job,3,170,0,3,0.2
6,6,jump,4,171,1,3,0.16
6,6,just,4,172,2,2,0.12
6,6,kit,3,173,0,3,0.16
6,6,lake,4,174,0,4,0.2
6,6,lap,3,175,2,1,0.12
6,6,last,4,176,2,2,0.16
6,6,latest,6,177,2,4,0.28
6,6,laugh,5,178,2,3,0.2
6,6,law,3,179,2,1,0.08
6,6,layer,5,180,2,3,0.2
6,6,league,6,181,1,5,0.28
6,6,left,4,182,2,2,0.24
6,6,lemon,5,183,2,3,0.16
6,6,lens,4,184,2,2,0.12
6,6,lie,3,185,1,2,0.12
6,6,lion,4,186,2,2,0.16
6,6,litter,6,187,2,4,0.24
6,6,liver,5,188,2,3,0.28
6,6,local,5,189,1,4,0.2
6,6,log,3,190,2,1,0.12
6,6,long,4,191,2,2,0.16
6,6,look,4,192,2,2,0.12
6,6,loose,5,193,3,2,0.16
6,6,love,4,194,2,2,0.2
6,6,low,3,195,2,1,0.12
6,6,lunch,5,196,1,4,0.2
6,6,mail,4,197,0,4,0.2
6,6,marine,6,198,2,4,0.24
6,6,mark,4,199,3,1,0.12
6,6,master,6,200,2,4,0.28
6,6,match,5,201,2,3,0.16
6,6,meal,4,202,1,3,0.16
6,6,melody,6,203,2,4,0.24
6,6,mental,6,204,2,4,0.24
6,6,mentor,6,205,4,2,0.24
6,6,merely,6,206,2,4,0.24
6,6,merger,6,207,3,3,0.2
6,6,mess,4,208,2,2,0.12
6,6,method,6,209,2,4,0.32
6,6,metre,5,210,3,2,0.16
6,6,mirror,6,211,1,5,0.24
6,6,money,5,212,1,4,0.2
6,6,month,5,213,3,2,0.16
6,6,most,4,214,2,2,0.12
6,6,mother,6,215,2,4,0.28
6,6,mum,3,216,1,2,0.12
6,6,music,5,217,2,3,0.2
6,6,must,4,218,3,1,0.12
6,6,my,2,219,1,1,0.08
6,6,myth,4,220,2,2,0.12
6,6,name,4,221,0,4,0.24
6,6,nasty,5,222,2,3,0.16
6,6,nation,6,223,2,4,0.2
6,6,nature,6,224,3,3,0.2
6,6,neck,4,225,1,3,0.16
6,6,norm,4,226,1,3,0.24
6,6,north,5,227,3,2,0.16
6,6,not,3,228,2,1,0.12
6,6,note,4,229,3,1,0.12
6,6,notice,6,230,3,3,0.2
6,6,notion,6,231,4,2,0.16
6,6,novel,5,232,2,3,0.24
6,6,nut,3,233,1,2,0.12
6,6,oblige,6,234,0,6,0.28
6,6,obsess,6,235,2,4,0.24
6,6,ocean,5,236,1,4,0.2
6,6,offend,6,237,1,5,0.28
6,6,ought,5,238,1,4,0.2
6,6,outfit,6,239,2,4,0.2
6,6,pace,4,240,0,4,0.2
6,6,paint,5,241,2,3,0.2
6,6,pants,5,242,2,3,0.24
6,6,park,4,243,2,2,0.12
6,6,patent,6,244,2,4,0.24
6,6,pepper,6,245,1,5,0.24
6,6,photo,5,246,1,4,0.2
6,6,piece,5,247,1,4,0.28
6,6,pig,3,248,2,1,0.12
6,6,pile,4,249,2,2,0.12
6,6,pin,3,250,2,1,0.08
6,6,pipe,4,251,2,2,0.12
6,6,place,5,252,1,4,0.2
6,6,plan,4,253,3,1,0.16
6,6,plant,5,254,4,1,0.12
6,6,play,4,255,3,1,0.12
6,6,pond,4,256,1,3,0.16
6,6,pot,3,257,2,1,0.12
6,6,prior,5,258,1,4,0.2
6,6,proper,6,259,2,4,0.28
6,6,pump,4,260,1,3,0.16
6,6,puzzle,6,261,2,4,0.24
6,6,query,5,262,0,5,0.24
6,6,race,4,263,0,4,0.2
6,6,radar,5,264,2,3,0.24
6,6,raise,5,265,2,3,0.2
6,6,rating,6,266,2,4,0.2
6,6,realm,5,267,1,4,0.2
6,6,rear,4,268,3,1,0.12
6,6,rebel,5,269,2,3,0.24
6,6,record,6,270,2,4,0.2
6,6,refuse,6,271,2,4,0.24
6,6,regard,6,272,2,4,0.2
6,6,reign,5,273,2,3,0.16
6,6,remark,6,274,2,4,0.28
6,6,renew,5,275,2,3,0.2
6,6,retail,6,276,2,4,0.24
6,6,reveal,6,277,2,4,0.24
6,6,revive,6,278,3,3,0.28
6,6,right,5,279,1,4,0.2
6,6,rise,4,280,2,2,0.16
6,6,rival,5,281,2,3,0.2
6,6,robust,6,282,1,5,0.24
6,6,roll,4,283,2,2,0.12
6,6,roof,4,284,2,2,0.24
6,6,root,4,285,3,1,0.12
6,6,round,5,286,2,3,0.2
6,6,rubber,6,287,1,5,0.24
6,6,ruin,4,288,2,2,0.12
6,6,safe,4,289,0,4,0.24
6,6,sailor,6,290,2,4,0.24
6,6,sample,6,291,2,4,0.2
6,6,scared,6,292,1,5,0.24
6,6,score,5,293,2,3,0.16
6,6,seal,4,294,1,3,0.24
6,6,second,6,295,2,4,0.2
6,6,seven,5,296,2,3,0.2
6,6,sexual,6,297,2,4,0.2
6,6,sexy,4,298,3,1,0.12
6,6,shape,5,299,1,4,0.28
6,6,share,5,300,3,2,0.16
6,6,shell,5,301,2,3,0.2
6,6,shift,5,302,2,3,0.2
6,6,shiny,5,303,3,2,0.16
6,6,ship,4,304,3,1,0.12
6,6,shoot,5,305,2,3,0.24
6,6,sight,5,306,1,4,0.2
6,6,silver,6,307,2,4,0.2
6,6,simply,6,308,2,4,0.2
6,6,sin,3,309,2,1,0.08
6,6,sink,4,310,3,1,0.2
6,6,sister,6,311,2,4,0.24
6,6,ski,3,312,1,2,0.12
6,6,skip,4,313,3,1,0.12
6,6,skirt,5,314,3,2,0.16
6,6,slam,4,315,1,3,0.16
6,6,slip,4,316,2,2,0.2
6,6,smile,5,317,1,4,0.2
6,6,soap,4,318,1,3,0.16
6,6,solid,5,319,2,3,0.16
6,6,solo,4,320,3,1,0.12
6,6,some,4,321,2,2,0.16
6,6,song,4,322,2,2,0.2
6,6,speak,5,323,1,4,0.2
6,6,spin,4,324,2,2,0.12
6,6,spine,5,325,4,1,0.12
6,6,stab,4,326,1,3,0.16
6,6,staff,5,327,3,2,0.16
6,6,star,4,328,3,1,0.16
6,6,statue,6,329,3,3,0.2
6,6,stay,4,330,3,1,0.12
6,6,stem,4,331,2,2,0.12
6,6,stop,4,332,2,2,0.12
6,6,story,5,333,3,2,0.16
6,6,street,6,334,2,4,0.28
6,6,strike,6,335,3,3,0.2
6,6,sudden,6,336,1,5,0.24
6,6,sue,3,337,2,1,0.12
6,6,sugar,5,338,2,3,0.32
6,6,super,5,339,2,3,0.52
6,6,swear,5,340,1,4,0.48
6,6,swim,4,341,2,2,0.32
6,6,tale,4,342,0,4,0.44
6,6,talk,4,343,3,1,0.28
6,6,tank,4,344,2,2,0.32
6,6,team,4,345,1,3,0.8
6,6,tender,6,346,2,4,0.52
6,6,three,5,347,1,4,0.48
6,6,tidy,4,348,1,3,0.36
6,6,tight,5,349,2,3,0.4
6,6,tonne,5,350,1,4,0.6
6,6,tragic,6,351,1,5,0.56
6,6,trap,4,352,3,1,0.28
6,6,trend,5,353,2,3,0.4
6,6,trial,5,354,2,3,0.44
6,6,tribal,6,355,3,3,0.56
6,6,trio,4,356,3,1,0.28
6,6,twice,5,357,1,4,0.48
6,6,two,3,358,2,1,0.24
6,6,unable,6,359,0,6,0.6
6,6,unfair,6,360,2,4,0.64
6,6,unify,5,361,2,3,0.4
6,6,union,5,362,3,2,0.36
6,6,unveil,6,363,2,4,0.52
6,6,uphold,6,364,1,5,0.6
6,6,upon,4,365,2,2,0.44
6,6,vague,5,366,0,5,0.52
6,6,vary,4,367,2,2,0.32
6,6,verify,6,368,1,5,0.56
6,6,vessel,6,369,2,4,0.52
6,6,viable,6,370,1,5,0.68
6,6,viewer,6,371,2,4,0.52
6,6,virus,5,372,2,3,0.44
6,6,vocal,5,373,1,4,0.48
6,6,voice,5,374,2,3,0.4
6,6,walk,4,375,0,4,0.56
6,6,war,3,376,2,1,0.24
6,6,watch,5,377,2,3,0.48
6,6,water,5,378,3,2,0.44
6,6,west,4,379,1,3,0.44
6,6,whose,5,380,1,4,0.56
6,6,width,5,381,1,4,0.6
6,6,win,3,382,2,1,0.24
6,6,wine,4,383,3,1,0.28
6,6,wisdom,6,384,2,4,0.52
6,6,woman,5,385,1,4,0.48
6,6,word,4,386,2,2,0.44
6,6,world,5,387,3,2,0.36
6,6,worry,5,388,3,2,0.36
6,6,wrist,5,389,1,4,0.48
6,7,absorb,6,0,0,6,0.64
6,7,absurd,6,1,3,3,0.48
6,7,accept,6,2,1,5,0.68
6,7,acute,5,3,2,3,0.44
6,7,add,3,4,1,2,0.28
6,7,adj,3,5,2,1,0.24
6,7,adopt,5,6,2,3,0.44
6,7,again,5,7,1,4,0.6
6,7,agree,5,8,2,3,0.44
6,7,ahead,5,9,1,4,0.48
6,7,anyway,6,10,1,5,0.56
6,7,argue,5,11,1,4,0.48
6,7,arms,4,12,2,2,0.44
6,7,army,4,13,3,1,0.28
6,7,around,6,14,2,4,0.52
6,7,ballet,6,15,0,6,0.6
6,7,barrel,6,16,2,4,0.52
6,7,base,4,17,2,2,0.44
6,7,bat,3,18,2,1,0.24
6,7,bath,4,19,3,1,0.28
6,7,beat,4,20,1,3,0.36
6,7,behalf,6,21,2,4,0.52
6,7,belief,6,22,2,4,0.52
6,7,below,5,23,3,2,0.48
6,7,betray,6,24,2,4,0.52
6,7,beyond,6,25,2,4,0.52
6,7,bin,3,26,1,2,0.28
6,7,bishop,6,27,2,4,0.52
6,7,bite,4,28,2,2,0.44
6,7,bitter,6,29,3,3,0.44
6,7,blade,5,30,1,4,0.48
6,7,bless,5,31,2,3,0.4
6,7,blind,5,32,2,3,0.44
6,7,boat,4,33,1,3,0.48
6,7,boil,4,34,2,2,0.32
6,7,bomb,4,35,2,2,0.32
6,7,boom,4,36,2,2,0.32
6,7,boost,5,37,3,2,0.36
6,7,boot,4,38,3,1,0.28
6,7,bother,6,39,2,4,0.68
6,7,breach,6,40,1,5,0.6
6,7,break,5,41,4,1,0.32
6,7,broken,6,42,2,4,0.52
6,7,build,5,43,1,4,0.48
6,7,burn,4,44,2,2,0.44
6,7,butter,6,45,2,4,0.52
6,7,cake,4,46,0,4,0.44
6,7,cancer,6,47,2,4,0.52
6,7,carve,5,48,2,3,0.44
6,7,cave,4,49,2,2,0.44
6,7,cd,2,50,1,1,0.4
6,7,cease,5,51,1,4,0.48
6,7,chair,5,52,1,4,0.48
6,7,cheat,5,53,2,3,0.4
6,7,choir,5,54,2,3,0.44
6,7,city,4,55,1,3,0.52
6,7,clause,6,56,1,5,0.68
6,7,clean,5,57,2,3,0.4
6,7,cloud,5,58,2,3,0.4
6,7,club,4,59,2,2,0.32
6,7,comply,6,60,1,5,0.72
6,7,cope,4,61,2,2,0.32
6,7,could,5,62,2,3,0.44
6,7,county,6,63,3,3,0.48
6,7,coup,4,64,3,1,0.28
6,7,couple,6,65,4,2,0.52
6,7,court,5,66,3,2,0.36
6,7,craft,5,67,1,4,0.48
6,7,create,6,68,2,4,0.52
6,7,crime,5,69,2,3,0.44
6,7,crisis,6,70,3,3,0.6
6,7,cross,5,71,2,3,0.52
6,7,crude,5,72,2,3,0.52
6,7,cruise,6,73,3,3,0.56
6,7,cry,3,74,2,1,0.24
6,7,cycle,5,75,1,4,0.52
6,7,dam,3,76,0,3,0.44
6,7,damage,6,77,3,3,0.48
6,7,death,5,78,1,4,0.48
6,7,defect,6,79,2,4,0.52
6,7,detect,6,80,2,4,0.56
6,7,devil,5,81,2,3,0.56
6,7,dinner,6,82,1,5,0.64
6,7,dirt,4,83,2,2,0.36
6,7,dot,3,84,1,2,0.28
6,7,drink,5,85,1,4,0.52
6,7,dust,4,86,1,3,0.52
6,7,effort,6,87,0,6,0.68
6,7,eighty,6,88,1,5,0.64
6,7,either,6,89,2,4,0.56
6,7,elect,5,90,1,4,0.52
6,7,ending,6,91,1,5,0.68
6,7,enemy,5,92,2,3,0.4
6,7,enjoy,5,93,2,3,0.44
6,7,erect,5,94,1,4,0.48
6,7,essay,5,95,1,4,0.32
6,7,exceed,6,96,1,5,0.4
6,7,excuse,6,97,3,3,0.24
6,7,extent,6,98,2,4,0.28
6,7,fail,4,99,0,4,0.2
6,7,failed,6,100,4,2,0.28
6,7,famous,6,101,2,4,0.24
6,7,fasten,6,102,2,4,0.24
6,7,fee,3,103,1,2,0.12
6,7,fellow,6,104,2,4,0.2
6,7,fifty,5,105,1,4,0.28
6,7,fight,5,106,2,3,0.2
6,7,firm,4,107,2,2,0.12
6,7,fix,3,108,2,1,0.08
6,7,fixed,5,109,3,2,0.16
6,7,floor,5,110,1,4,0.2
6,7,flu,3,111,2,1,0.16
6,7,flying,6,112,2,4,0.24
6,7,folk,4,113,1,3,0.16
6,7,food,4,114,2,2,0.12
6,7,for,3,115,2,1,0.08
6,7,force,5,116,3,2,0.16
6,7,former,6,117,3,3,0.24
6,7,fridge,6,118,1,5,0.24
6,7,front,5,119,2,3,0.2
6,7,gallon,6,120,0,6,0.28
6,7,game,4,121,2,2,0.12
6,7,gaming,6,122,3,3,0.28
6,7,gene,4,123,1,3,0.16
6,7,genre,5,124,3,2,0.16
6,7,giant,5,125,1,4,0.2
6,7,glass,5,126,1,4,0.2
6,7,go,2,127,1,1,0.16
6,7,golf,4,128,2,2,0.12
6,7,good,4,129,2,2,0.12
6,7,grace,5,130,1,4,0.2
6,7,green,5,131,2,3,0.16
6,7,grief,5,132,2,3,0.16
6,7,grin,4,133,3,1,0.2
6,7,grind,5,134,4,1,0.12
6,7,ground,6,135,2,4,0.24
6,7,guide,5,136,1,4,0.2
6,7,guy,3,137,2,1,0.12
6,7,gym,3,138,1,2,0.12
6,7,hair,4,139,0,4,0.24
6,7,handy,5,140,2,3,0.16
6,7,happen,6,141,2,4,0.2
6,7,harsh,5,142,2,3,0.2
6,7,hate,4,143,2,2,0.12
6,7,hers,4,144,1,3,0.24
6,7,highly,6,145,1,5,0.28
6,7,hint,4,146,2,2,0.16
6,7,hotel,5,147,1,4,0.24
6,7,hour,4,148,2,2,0.16
6,7,how,3,149,2,1,0.08
6,7,hunger,6,150,1,5,0.32
6,7,i,1,151,0,1,0.08
6,7,ice,3,152,1,2,0.12
6,7,icon,4,153,2,2,0.16
6,7,ideal,5,154,1,4,0.2
6,7,ill,3,155,1,2,0.12
6,7,image,5,156,1,4,0.28
6,7,import,6,157,2,4,0.2
6,7,index,5,158,1,4,0.2
6,7,infant,6,159,2,4,0.2
6,7,info,4,160,3,1,0.12
6,7,inform,6,161,4,2,0.24
6,7,injury,6,162,2,4,0.24
6,7,into,4,163,2,2,0.12
6,7,invest,6,164,2,4,0.2
6,7,island,6,165,1,5,0.32
6,7,jump,4,166,0,4,0.24
6,7,june,4,167,2,2,0.12
6,7,just,4,168,2,2,0.16
6,7,key,3,169,0,3,0.16
6,7,kidney,6,170,1,5,0.24
6,7,king,4,171,2,2,0.12
6,7,kit,3,172,2,1,0.16
6,7,knife,5,173,1,4,0.2
6,7,lad,3,174,0,3,0.12
6,7,lap,3,175,2,1,0.08
6,7,laser,5,176,2,3,0.2
6,7,latest,6,177,2,4,0.2
6,7,laugh,5,178,2,3,0.24
6,7,law,3,179,2,1,0.08
6,7,lawn,4,180,3,1,0.12
6,7,lethal,6,181,1,5,0.24
6,7,lie,3,182,1,2,0.12
6,7,limb,4,183,2,2,0.12
6,7,litter,6,184,2,4,0.28
6,7,little,6,185,4,2,0.16
6,7,live,4,186,2,2,0.12
6,7,load,4,187,1,3,0.16
6,7,lot,3,188,2,1,0.08
6,7,loudly,6,189,2,4,0.2
6,7,lunch,5,190,1,4,0.28
6,7,mail,4,191,0,4,0.2
6,7,main,4,192,3,1,0.12
6,7,master,6,193,2,4,0.24
6,7,media,5,194,1,4,0.2
6,7,memory,6,195,2,4,0.28
6,7,mental,6,196,2,4,0.2
6,7,merely,6,197,2,4,0.2
6,7,mixed,5,198,1,4,0.2
6,7,model,5,199,1,4,0.28
6,7,modify,6,200,3,3,0.2
6,7,month,5,201,2,3,0.16
6,7,most,4,202,2,2,0.12
6,7,mother,6,203,2,4,0.24
6,7,much,4,204,1,3,0.16
6,7,museum,6,205,2,4,0.28
6,7,music,5,206,3,2,0.16
6,7,naked,5,207,0,5,0.24
6,7,neck,4,208,1,3,0.16
6,7,noise,5,209,1,4,0.2
6,7,noisy,5,210,4,1,0.2
6,7,non,3,211,2,1,0.08
6,7,normal,6,212,2,4,0.24
6,7,note,4,213,2,2,0.12
6,7,notion,6,214,3,3,0.2
6,7,novel,5,215,2,3,0.24
6,7,nut,3,216,1,2,0.12
6,7,oblige,6,217,0,6,0.28
6,7,off,3,218,1,2,0.12
6,7,offend,6,219,3,3,0.2
6,7,one,3,220,1,2,0.12
6,7,online,6,221,2,4,0.28
6,7,option,6,222,1,5,0.24
6,7,outfit,6,223,1,5,0.24
6,7,outlet,6,224,3,3,0.2
6,7,pack,4,225,0,4,0.2
6,7,pad,3,226,2,1,0.16
6,7,paint,5,227,2,3,0.16
6,7,palace,6,228,2,4,0.24
6,7,parade,6,229,2,4,0.24
6,7,park,4,230,3,1,0.12
6,7,patron,6,231,2,4,0.28
6,7,pause,5,232,2,3,0.16
6,7,phone,5,233,1,4,0.2
6,7,photo,5,234,3,2,0.16
6,7,pick,4,235,1,3,0.16
6,7,pile,4,236,2,2,0.2
6,7,pin,3,237,2,1,0.12
6,7,plan,4,238,1,3,0.16
6,7,plant,5,239,4,1,0.12
6,7,play,4,240,3,1,0.12
6,7,plead,5,241,2,3,0.2
6,7,plot,4,242,2,2,0.16
6,7,pond,4,243,1,3,0.24
6,7,post,4,244,2,2,0.12
6,7,poster,6,245,4,2,0.16
6,7,prayer,6,246,1,5,0.24
6,7,pump,4,247,1,3,0.16
6,7,punk,4,248,2,2,0.2
6,7,pure,4,249,2,2,0.12
6,7,query,5,250,0,5,0.24
6,7,quite,5,251,2,3,0.16
6,7,racial,6,252,0,6,0.28
6,7,radar,5,253,2,3,0.24
6,7,rail,4,254,2,2,0.16
6,7,realm,5,255,1,4,0.2
6,7,rebel,5,256,2,3,0.2
6,7,recall,6,257,2,4,0.24
6,7,reduce,6,258,2,4,0.28
6,7,regard,6,259,2,4,0.24
6,7,region,6,260,3,3,0.2
6,7,reign,5,261,2,3,0.2
6,7,relax,5,262,2,3,0.2
6,7,relief,6,263,3,3,0.28
6,7,remove,6,264,2,4,0.2
6,7,repeat,6,265,2,4,0.2
6,7,reside,6,266,2,4,0.24
6,7,rest,4,267,3,1,0.12
6,7,revise,6,268,2,4,0.28
6,7,revive,6,269,4,2,0.16
6,7,rifle,5,270,1,4,0.2
6,7,ritual,6,271,2,4,0.24
6,7,rival,5,272,2,3,0.2
6,7,road,4,273,1,3,0.24
6,7,rob,3,274,2,1,0.08
6,7,robust,6,275,3,3,0.2
6,7,roll,4,276,2,2,0.12
6,7,roof,4,277,2,2,0.16
6,7,root,4,278,3,1,0.12
6,7,rotate,6,279,2,4,0.28
6,7,round,5,280,2,3,0.16
6,7,rubber,6,281,1,5,0.24
6,7,sailor,6,282,0,6,0.28
6,7,sale,4,283,2,2,0.16
6,7,salt,4,284,3,1,0.2
6,7,sand,4,285,2,2,0.12
6,7,scan,4,286,1,3,0.16
6,7,seal,4,287,1,3,0.16
6,7,second,6,288,2,4,0.24
6,7,secret,6,289,3,3,0.28
6,7,secure,6,290,3,3,0.2
6,7,seem,4,291,2,2,0.16
6,7,serve,5,292,2,3,0.16
6,7,sexual,6,293,2,4,0.2
6,7,shape,5,294,1,4,0.28
6,7,shift,5,295,2,3,0.2
6,7,ship,4,296,3,1,0.12
6,7,shore,5,297,2,3,0.2
6,7,simply,6,298,1,5,0.24
6,7,sin,3,299,2,1,0.12
6,7,sister,6,300,2,4,0.28
6,7,skip,4,301,1,3,0.16
6,7,skull,5,302,2,3,0.2
6,7,slam,4,303,1,3,0.32
6,7,slice,5,304,2,3,0.44
6,7,slip,4,305,3,1,0.4
6,7,soap,4,306,1,3,0.4
6,7,solo,4,307,2,2,0.32
6,7,space,5,308,1,4,0.48
6,7,spread,6,309,2,4,0.52
6,7,stab,4,310,1,3,0.4
6,7,staff,5,311,3,2,0.48
6,7,stall,5,312,3,2,0.36
6,7,stamp,5,313,3,2,0.36
6,7,statue,6,314,3,3,0.48
6,7,stem,4,315,2,2,0.32
6,7,stick,5,316,2,3,0.52
6,7,sticky,6,317,5,1,0.36
6,7,stop,4,318,2,2,0.32
6,7,store,5,319,3,2,0.36
6,7,strong,6,320,2,4,0.52
6,7,study,5,321,2,3,0.52
6,7,stun,4,322,3,1,0.28
6,7,such,4,323,1,3,0.36
6,7,sugar,5,324,2,3,0.4
6,7,super,5,325,2,3,0.4
6,7,sure,4,326,2,2,0.32
6,7,surely,6,327,4,2,0.52
6,7,swim,4,328,1,3,0.44
6,7,table,5,329,0,5,0.52
6,7,tail,4,330,2,2,0.32
6,7,tale,4,331,2,2,0.32
6,7,talk,4,332,3,1,0.28
6,7,tank,4,333,2,2,0.44
6,7,tape,4,334,2,2,0.32
6,7,tempt,5,335,1,4,0.48
6,7,tender,6,336,2,4,0.52
6,7,terror,6,337,2,4,0.52
6,7,this,4,338,1,3,0.48
6,7,three,5,339,2,3,0.72
6,7,thumb,5,340,2,3,0.44
6,7,ticket,6,341,1,5,0.64
6,7,tidy,4,342,2,2,0.32
6,7,till,4,343,2,2,0.4
6,7,timing,6,344,2,4,0.64
6,7,to,2,345,1,1,0.2
6,7,tonne,5,346,2,3,0.4
6,7,too,3,347,2,1,0.28
6,7,tour,4,348,2,2,0.4
6,7,trap,4,349,1,3,0.44
6,7,trial,5,350,2,3,0.56
6,7,tribal,6,351,3,3,0.44
6,7,tribe,5,352,4,1,0.32
6,7,truck,5,353,2,3,0.4
6,7,twice,5,354,1,4,0.48
6,7,unable,6,355,0,6,0.76
6,7,unfair,6,356,2,4,0.52
6,7,until,5,357,2,3,0.4
6,7,upon,4,358,1,3,0.4
6,7,urban,5,359,1,4,0.48
6,7,urgent,6,360,2,4,0.64
6,7,usage,5,361,1,4,0.48
6,7,usual,5,362,2,3,0.4
6,7,vague,5,363,0,5,0.52
6,7,vary,4,364,2,2,0.32
6,7,vein,4,365,1,3,0.52
6,7,viable,6,366,1,5,0.56
6,7,viewer,6,367,2,4,0.52
6,7,virtue,6,368,2,4,0.52
6,7,virus,5,369,3,2,0.36
6,7,visual,6,370,2,4,0.64
6,7,vital,5,371,2,3,0.4
6,7,vocal,5,372,1,4,0.48
6,7,waiter,6,373,0,6,0.64
6,7,wake,4,374,2,2,0.32
6,7,walk,4,375,2,2,0.44
6,7,watch,5,376,2,3,0.44
6,7,weave,5,377,1,4,0.48
6,7,weird,5,378,2,3,0.44
6,7,west,4,379,2,2,0.32
6,7,width,5,380,1,4,0.6
6,7,win,3,381,2,1,0.24
6,7,window,6,382,3,3,0.48
6,7,wine,4,383,3,1,0.28
6,7,within,6,384,2,4,0.56
6,7,word,4,385,1,3,0.4
6,7,work,4,386,3,1,0.4
6,7,world,5,387,3,2,0.36
6,7,worry,5,388,3,2,0.4
6,7,wrist,5,389,1,4,0.64
6,8,absorb,6,0,0,6,0.28
6,8,acid,4,1,1,3,0.16
6,8,acute,5,2,2,3,0.24
6,8,adj,3,3,1,2,0.12
6,8,admit,5,4,2,3,0.16
6,8,ahead,5,5,1,4,0.2
6,8,aids,4,6,1,3,0.16
6,8,ally,4,7,1,3,0.24
6,8,and,3,8,1,2,0.12
6,8,ankle,5,9,2,3,0.2
6,8,anyway,6,10,2,4,0.2
6,8,app,3,11,1,2,0.12
6,8,argue,5,12,1,4,0.2
6,8,arise,5,13,2,3,0.24
6,8,army,4,14,2,2,0.12
6,8,around,6,15,2,4,0.2
6,8,arrest,6,16,2,4,0.2
6,8,arrow,5,17,3,2,0.16
6,8,ask,3,18,1,2,0.2
6,8,at,2,19,1,1,0.08
6,8,auto,4,20,1,3,0.16
6,8,baby,4,21,0,4,0.2
6,8,ballet,6,22,2,4,0.24
6,8,banner,6,23,2,4,0.24
6,8,barrel,6,24,2,4,0.28
6,8,base,4,25,2,2,0.16
6,8,bat,3,26,2,1,0.08
6,8,bath,4,27,3,1,0.12
6,8,beast,5,28,1,4,0.2
6,8,beauty,6,29,3,3,0.28
6,8,bed,3,30,2,1,0.08
6,8,beer,4,31,2,2,0.16
6,8,behalf,6,32,2,4,0.2
6,8,behave,6,33,4,2,0.16
6,8,bell,4,34,2,2,0.12
6,8,belong,6,35,3,3,0.28
6,8,best,4,36,2,2,0.12
6,8,betray,6,37,2,4,0.2
6,8,bill,4,38,1,3,0.16
6,8,bin,3,39,2,1,0.08
6,8,bird,4,40,2,2,0.16
6,8,bless,5,41,1,4,0.24
6,8,blog,4,42,2,2,0.16
6,8,blow,4,43,3,1,0.12
6,8,boat,4,44,1,3,0.16
6,8,boot,4,45,2,2,0.16
6,8,bottle,6,46,2,4,0.2
6,8,bound,5,47,2,3,0.24
6,8,box,3,48,2,1,0.08
6,8,brand,5,49,1,4,0.2
6,8,breach,6,50,2,4,0.2
6,8,bride,5,51,2,3,0.16
6,8,bright,6,52,3,3,0.28
6,8,broken,6,53,2,4,0.2
6,8,bug,3,54,1,2,0.12
6,8,build,5,55,2,3,0.16
6,8,cake,4,56,0,4,0.2
6,8,cancer,6,57,2,4,0.28
6,8,carpet,6,58,2,4,0.24
6,8,carve,5,59,3,2,0.16
6,8,cave,4,60,2,2,0.16
6,8,check,5,61,1,4,0.2
6,8,choose,6,62,2,4,0.28
6,8,chop,4,63,3,1,0.12
6,8,city,4,64,1,3,0.16
6,8,civil,5,65,2,3,0.16
6,8,clause,6,66,1,5,0.24
6,8,clean,5,67,2,3,0.24
6,8,coach,5,68,1,4,0.2
6,8,coffee,6,69,2,4,0.24
6,8,cost,4,70,2,2,0.16
6,8,course,6,71,2,4,0.24
6,8,court,5,72,4,1,0.2
6,8,creep,5,73,1,4,0.2
6,8,crime,5,74,2,3,0.16
6,8,crowd,5,75,2,3,0.16
6,8,cruise,6,76,2,4,0.2
6,8,cry,3,77,2,1,0.08
6,8,cycle,5,78,1,4,0.28
6,8,dare,4,79,0,4,0.2
6,8,death,5,80,1,4,0.2
6,8,deed,4,81,2,2,0.12
6,8,deem,4,82,3,1,0.12
6,8,deputy,6,83,2,4,0.28
6,8,dig,3,84,1,2,0.12
6,8,dirty,5,85,2,3,0.2
6,8,dollar,6,86,1,5,0.28
6,8,dot,3,87,2,1,0.12
6,8,drama,5,88,1,4,0.24
6,8,dust,4,89,1,3,0.24
6,8,ear,3,90,0,3,0.16
6,8,earth,5,91,3,2,0.16
6,8,editor,6,92,1,5,0.24
6,8,eighty,6,93,1,5,0.28
6,8,either,6,94,2,4,0.32
6,8,elect,5,95,1,4,0.2
6,8,eleven,6,96,3,3,0.2
6,8,embark,6,97,1,5,0.24
6,8,enable,6,98,1,5,0.32
6,8,enemy,5,99,2,3,0.2
6,8,enter,5,100,2,3,0.16
6,8,entry,5,101,3,2,0.16
6,8,erect,5,102,1,4,0.2
6,8,essay,5,103,1,4,0.2
6,8,exact,5,104,1,4,0.28
6,8,exceed,6,105,2,4,0.24
6,8,extend,6,106,2,4,0.2
6,8,extent,6,107,5,1,0.16
6,8,eye,3,108,1,2,0.12
6,8,fall,4,109,0,4,0.28
6,8,famous,6,110,2,4,0.24
6,8,fasten,6,111,2,4,0.2
6,8,fellow,6,112,1,5,0.24
6,8,few,3,113,2,1,0.12
6,8,file,4,114,1,3,0.24
6,8,fine,4,115,2,2,0.16
6,8,fix,3,116,2,1,0.08
6,8,floor,5,117,1,4,0.2
6,8,focus,5,118,1,4,0.2
6,8,folk,4,119,2,2,0.16
6,8,food,4,120,2,2,0.24
6,8,former,6,121,2,4,0.2
6,8,foster,6,122,2,4,0.2
6,8,friday,6,123,1,5,0.24
6,8,front,5,124,2,3,0.16
6,8,fulfil,6,125,1,5,0.32
6,8,gallon,6,126,0,6,0.28
6,8,gaming,6,127,2,4,0.2
6,8,garage,6,128,2,4,0.24
6,8,gender,6,129,1,5,0.32
6,8,giant,5,130,1,4,0.2
6,8,god,3,131,1,2,0.12
6,8,grace,5,132,1,4,0.2
6,8,grade,5,133,3,2,0.16
6,8,grind,5,134,2,3,0.28
6,8,ground,6,135,2,4,0.24
6,8,guess,5,136,1,4,0.24
6,8,guitar,6,137,2,4,0.32
6,8,guy,3,138,2,1,0.12
6,8,gym,3,139,1,2,0.16
6,8,happen,6,140,0,6,0.56
6,8,harm,4,141,2,2,0.16
6,8,hate,4,142,2,2,0.24
6,8,hazard,6,143,2,4,0.36
6,8,heart,5,144,1,4,0.24
6,8,heat,4,145,3,1,0.28
6,8,herb,4,146,2,2,0.16
6,8,hers,4,147,3,1,0.12
6,8,highly,6,148,1,5,0.28
6,8,hint,4,149,2,2,0.16
6,8,hour,4,150,1,3,0.36
6,8,how,3,151,2,1,0.24
6,8,humble,6,152,1,5,0.32
6,8,hunger,6,153,2,4,0.52
6,8,hunt,4,154,3,1,0.24
6,8,i,1,155,0,1,0.16
6,8,icon,4,156,1,3,0.24
6,8,ideal,5,157,1,4,0.32
6,8,ill,3,158,1,2,0.16
6,8,incur,5,159,1,4,0.28
6,8,index,5,160,2,3,0.2
6,8,infant,6,161,2,4,0.24
6,8,info,4,162,3,1,0.24
6,8,inject,6,163,2,4,0.36
6,8,insert,6,164,2,4,0.32
6,8,into,4,165,2,2,0.2
6,8,invest,6,166,2,4,0.24
6,8,jet,3,167,0,3,0.36
6,8,job,3,168,1,2,0.2
6,8,joy,3,169,2,1,0.16
6,8,key,3,170,0,3,0.2
6,8,kick,4,171,1,3,0.56
6,8,kid,3,172,2,1,0.32
6,8,kidney,6,173,3,3,0.56
6,8,king,4,174,2,2,0.6
6,8,knife,5,175,1,4,0.48
6,8,lap,3,176,0,3,0.32
6,8,latest,6,177,2,4,0.52
6,8,lawn,4,178,2,2,0.32
6,8,layer,5,179,2,3,0.44
6,8,league,6,180,1,5,0.72
6,8,left,4,181,2,2,0.32
6,8,lemon,5,182,2,3,0.72
6,8,lens,4,183,2,2,0.36
6,8,lesser,6,184,2,4,0.56
6,8,letter,6,185,2,4,0.68
6,8,lie,3,186,1,2,0.28
6,8,limb,4,187,2,2,0.32
6,8,lion,4,188,2,2,0.4
6,8,litter,6,189,2,4,0.68
6,8,load,4,190,1,3,0.6
6,8,local,5,191,2,3,0.44
6,8,loudly,6,192,2,4,0.56
6,8,love,4,193,2,2,0.32
6,8,low,3,194,2,1,0.24
6,8,lunch,5,195,1,4,0.56
6,8,marine,6,196,0,6,0.84
6,8,mark,4,197,3,1,0.28
6,8,master,6,198,2,4,0.56
6,8,media,5,199,1,4,0.56
6,8,melody,6,200,2,4,0.56
6,8,mental,6,201,2,4,0.76
6,8,merger,6,202,2,4,0.52
6,8,mess,4,203,2,2,0.32
6,8,method,6,204,2,4,0.52
6,8,metre,5,205,3,2,0.36
6,8,most,4,206,1,3,0.52
6,8,much,4,207,1,3,0.36
6,8,mum,3,208,2,1,0.24
6,8,museum,6,209,2,4,0.6
6,8,my,2,210,1,1,0.24
6,8,myth,4,211,2,2,0.4
6,8,nature,6,212,0,6,0.8
6,8,newly,5,213,1,4,0.48
6,8,night,5,214,1,4,0.48
6,8,noise,5,215,1,4,0.48
6,8,noisy,5,216,4,1,0.32
6,8,norm,4,217,2,2,0.44
6,8,normal,6,218,4,2,0.4
6,8,north,5,219,3,2,0.36
6,8,not,3,220,2,1,0.24
6,8,notice,6,221,3,3,0.44
6,8,notion,6,222,4,2,0.52
6,8,novel,5,223,2,3,0.44
6,8,nut,3,224,1,2,0.28
6,8,oblige,6,225,0,6,0.64
6,8,obsess,6,226,2,4,0.52
6,8,ocean,5,227,1,4,0.48
6,8,one,3,228,1,2,0.4
6,8,option,6,229,1,5,0.56
6,8,ought,5,230,1,4,0.48
6,8,outing,6,231,2,4,0.52
6,8,outlet,6,232,3,3,0.56
6,8,pace,4,233,0,4,0.44
6,8,pack,4,234,3,1,0.28
6,8,pad,3,235,2,1,0.24
6,8,page,4,236,2,2,0.32
6,8,paint,5,237,2,3,0.44
6,8,palace,6,238,2,4,0.64
6,8,pants,5,239,2,3,0.44
6,8,parade,6,240,2,4,0.52
6,8,patron,6,241,2,4,0.56
6,8,peace,5,242,1,4,0.48
6,8,pepper,6,243,2,4,0.64
6,8,photo,5,244,1,4,0.52
6,8,piece,5,245,1,4,0.52
6,8,pile,4,246,2,2,0.36
6,8,pin,3,247,2,1,0.24
6,8,plan,4,248,1,3,0.44
6,8,play,4,249,3,1,0.48
6,8,plead,5,250,2,3,0.44
6,8,plot,4,251,2,2,0.32
6,8,police,6,252,1,5,0.6
6,8,pond,4,253,2,2,0.32
6,8,pot,3,254,2,1,0.24
6,8,prayer,6,255,1,5,0.68
6,8,prior,5,256,2,3,0.4
6,8,punk,4,257,1,3,0.36
6,8,pupil,5,258,2,3,0.44
6,8,pure,4,259,2,2,0.32
6,8,puzzle,6,260,2,4,0.64
6,8,query,5,261,0,5,0.56
6,8,radar,5,262,0,5,0.56
6,8,raise,5,263,2,3,0.68
6,8,rally,5,264,2,3,0.6
6,8,rating,6,265,2,4,0.64
6,8,react,5,266,1,4,0.48
6,8,realm,5,267,3,2,0.4
6,8,rear,4,268,3,1,0.28
6,8,recall,6,269,2,4,0.52
6,8,reduce,6,270,2,4,0.64
6,8,refer,5,271,2,3,0.4
6,8,regard,6,272,2,4,0.52
6,8,regime,6,273,3,3,0.44
6,8,region,6,274,4,2,0.56
6,8,reign,5,275,2,3,0.56
6,8,relax,5,276,2,3,0.44
6,8,relief,6,277,3,3,0.48
6,8,remark,6,278,2,4,0.52
6,8,remind,6,279,3,3,0.56
6,8,renew,5,280,2,3,0.4
6,8,rest,4,281,2,2,0.32
6,8,retail,6,282,2,4,0.52
6,8,reveal,6,283,2,4,0.52
6,8,revise,6,284,3,3,0.56
6,8,rifle,5,285,1,4,0.48
6,8,rip,3,286,2,1,0.24
6,8,rob,3,287,1,2,0.28
6,8,robust,6,288,3,3,0.44
6,8,roll,4,289,2,2,0.32
6,8,root,4,290,2,2,0.48
6,8,rotate,6,291,2,4,0.52
6,8,rough,5,292,2,3,0.4
6,8,sailor,6,293,0,6,0.6
6,8,scan,4,294,1,3,0.36
6,8,scared,6,295,3,3,0.56
6,8,school,6,296,2,4,0.52
6,8,score,5,297,2,3,0.4
6,8,seal,4,298,1,3,0.36
6,8,second,6,299,2,4,0.52
6,8,secret,6,300,3,3,0.6
6,8,secure,6,301,3,3,0.44
6,8,seem,4,302,2,2,0.32
6,8,seven,5,303,2,3,0.4
6,8,sexy,4,304,2,2,0.32
6,8,shape,5,305,1,4,0.6
6,8,share,5,306,3,2,0.36
6,8,shell,5,307,2,3,0.44
6,8,silver,6,308,1,5,0.56
6,8,sin,3,309,2,1,0.24
6,8,sink,4,310,3,1,0.28
6,8,skirt,5,311,1,4,0.6
6,8,snow,4,312,1,3,0.36
6,8,soap,4,313,1,3,0.36
6,8,solid,5,314,2,3,0.4
6,8,south,5,315,2,3,0.4
6,8,space,5,316,1,4,0.48
6,8,spare,5,317,3,2,0.52
6,8,sphere,6,318,2,4,0.52
6,8,spine,5,319,2,3,0.4
6,8,stable,6,320,1,5,0.56
6,8,stall,5,321,3,2,0.48
6,8,stamp,5,322,3,2,0.36
6,8,stand,5,323,3,2,0.36
6,8,star,4,324,3,1,0.28
6,8,stay,4,325,3,1,0.28
6,8,steer,5,326,2,3,0.4
6,8,stem,4,327,3,1,0.36
6,8,store,5,328,2,3,0.4
6,8,strict,6,329,2,4,0.52
6,8,studio,6,330,2,4,0.52
6,8,study,5,331,4,1,0.32
6,8,such,4,332,1,3,0.48
6,8,sugar,5,333,2,3,0.4
6,8,super,5,334,2,3,0.44
6,8,surely,6,335,2,4,0.72
6,8,swear,5,336,1,4,0.6
6,8,table,5,337,0,5,0.72
6,8,tail,4,338,2,2,0.32
6,8,tap,3,339,2,1,0.24
6,8,tape,4,340,3,1,0.28
6,8,task,4,341,2,2,0.32
6,8,taste,5,342,3,2,0.36
6,8,tea,3,343,1,2,0.28
6,8,tempt,5,344,2,3,0.56
6,8,tender,6,345,2,4,0.52
6,8,terror,6,346,2,4,0.52
6,8,this,4,347,1,3,0.36
6,8,tidy,4,348,1,3,0.36
6,8,tight,5,349,2,3,0.52
6,8,till,4,350,2,2,0.32
6,8,to,2,351,1,1,0.2
6,8,tonne,5,352,2,3,0.4
6,8,too,3,353,2,1,0.24
6,8,topic,5,354,2,3,0.4
6,8,tour,4,355,2,2,0.44
6,8,trial,5,356,1,4,0.48
6,8,tribal,6,357,3,3,0.48
6,8,trio,4,358,3,1,0.28
6,8,unify,5,359,0,5,0.52
6,8,union,5,360,3,2,0.4
6,8,unveil,6,361,2,4,0.64
6,8,urban,5,362,1,4,0.48
6,8,usage,5,363,1,4,0.48
6,8,usual,5,364,2,3,0.4
6,8,vague,5,365,0,5,0.52
6,8,valley,6,366,2,4,0.64
6,8,viable,6,367,1,5,0.6
6,8,video,5,368,2,3,0.4
6,8,virtue,6,369,2,4,0.52
6,8,visual,6,370,2,4,0.64
6,8,wait,4,371,0,4,0.44
6,8,wake,4,372,2,2,0.32
6,8,walk,4,373,2,2,0.32
6,8,watch,5,374,2,3,0.4
6,8,way,3,375,2,1,0.24
6,8,weave,5,376,1,4,0.6
6,8,weight,6,377,2,4,0.52
6,8,weird,5,378,3,2,0.36
6,8,which,5,379,1,4,0.48
6,8,whose,5,380,2,3,0.44
6,8,width,5,381,1,4,0.6
6,8,window,6,382,2,4,0.52
6,8,wisdom,6,383,2,4,0.52
6,8,word,4,384,1,3,0.36
6,8,world,5,385,3,2,0.36
6,8,wrap,4,386,1,3,0.48
6,8,wrist,5,387,2,3,0.4
6,8,yellow,6,388,0,6,0.6
6,8,young,5,389,1,4,0.48
6,9,absorb,6,0,0,6,0.32
6,9,acid,4,1,1,3,0.28
6,9,ad,2,2,1,1,0.12
6,9,add,3,3,2,1,0.16
6,9,admit,5,4,2,3,0.2
6,9,again,5,5,1,4,0.24
6,9,ankle,5,6,1,4,0.28
6,9,app,3,7,1,2,0.2
6,9,argue,5,8,1,4,0.24
6,9,arise,5,9,2,3,0.2
6,9,artist,6,10,2,4,0.24
6,9,auto,4,11,1,3,0.2
6,9,baby,4,12,0,4,0.28
6,9,ballet,6,13,2,4,0.28
6,9,banner,6,14,2,4,0.28
6,9,beer,4,15,1,3,0.2
6,9,beg,3,16,2,1,0.12
6,9,belief,6,17,2,4,0.32
6,9,best,4,18,2,2,0.16
6,9,beyond,6,19,2,4,0.24
6,9,bill,4,20,1,3,0.2
6,9,bitter,6,21,2,4,0.28
6,9,blade,5,22,1,4,0.28
6,9,blame,5,23,3,2,0.16
6,9,bless,5,24,2,3,0.2
6,9,blog,4,25,2,2,0.16
6,9,boat,4,26,1,3,0.16
6,9,boost,5,27,2,3,0.24
6,9,boot,4,28,3,1,0.12
6,9,bound,5,29,2,3,0.24
6,9,box,3,30,2,1,0.16
6,9,break,5,31,1,4,0.24
6,9,bride,5,32,2,3,0.24
6,9,bug,3,33,1,2,0.12
6,9,burden,6,34,2,4,0.28
6,9,burn,4,35,3,1,0.16
6,9,cake,4,36,0,4,0.2
6,9,cancer,6,37,2,4,0.24
6,9,cap,3,38,2,1,0.16
6,9,career,6,39,2,4,0.24
6,9,carve,5,40,3,2,0.16
6,9,cave,4,41,2,2,0.16
6,9,chart,5,42,1,4,0.24
6,9,chop,4,43,2,2,0.2
6,9,cite,4,44,1,3,0.16
6,9,city,4,45,3,1,0.16
6,9,civil,5,46,2,3,0.2
6,9,clause,6,47,1,5,0.24
6,9,clerk,5,48,2,3,0.2
6,9,club,4,49,2,2,0.2
6,9,coach,5,50,1,4,0.2
6,9,comedy,6,51,2,4,0.24
6,9,comply,6,52,3,3,0.2
6,9,convey,6,53,2,4,0.24
6,9,cooker,6,54,2,4,0.28
6,9,cope,4,55,2,2,0.16
6,9,could,5,56,2,3,0.2
6,9,coup,4,57,3,1,0.12
6,9,craft,5,58,1,4,0.24
6,9,creep,5,59,2,3,0.24
6,9,crisis,6,60,2,4,0.24
6,9,cross,5,61,2,3,0.2
6,9,crowd,5,62,3,2,0.16
6,9,crude,5,63,2,3,0.2
6,9,cruel,5,64,3,2,0.28
6,9,cruise,6,65,3,3,0.2
6,9,cycle,5,66,1,4,0.2
6,9,damage,6,67,0,6,0.28
6,9,dare,4,68,2,2,0.16
6,9,deal,4,69,1,3,0.24
6,9,death,5,70,3,2,0.2
6,9,detect,6,71,2,4,0.24
6,9,devil,5,72,2,3,0.2
6,9,dig,3,73,1,2,0.12
6,9,dirt,4,74,2,2,0.16
6,9,dirty,5,75,4,1,0.2
6,9,dollar,6,76,1,5,0.24
6,9,drink,5,77,1,4,0.2
6,9,dust,4,78,1,3,0.16
6,9,editor,6,79,0,6,0.4
6,9,effort,6,80,1,5,0.28
6,9,either,6,81,1,5,0.24
6,9,ending,6,82,1,5,0.28
6,9,enemy,5,83,2,3,0.2
6,9,enjoy,5,84,2,3,0.24
6,9,enrich,6,85,2,4,0.24
6,9,enter,5,86,2,3,0.2
6,9,essay,5,87,1,4,0.2
6,9,euro,4,88,1,3,0.16
6,9,evoke,5,89,1,4,0.28
6,9,exact,5,90,1,4,0.2
6,9,exceed,6,91,2,4,0.24
6,9,exit,4,92,2,2,0.16
6,9,extent,6,93,2,4,0.24
6,9,fail,4,94,0,4,0.24
6,9,failed,6,95,4,2,0.16
6,9,fair,4,96,3,1,0.12
6,9,fairly,6,97,4,2,0.2
6,9,fat,3,98,2,1,0.12
6,9,fear,4,99,1,3,0.16
6,9,fellow,6,100,2,4,0.28
6,9,fibre,5,101,1,4,0.2
6,9,fight,5,102,2,3,0.2
6,9,firm,4,103,2,2,0.16
6,9,fixed,5,104,2,3,0.2
6,9,flag,4,105,1,3,0.24
6,9,flee,4,106,2,2,0.16
6,9,floor,5,107,2,3,0.2
6,9,flower,6,108,3,3,0.2
6,9,focus,5,109,1,4,0.2
6,9,folk,4,110,2,2,0.2
6,9,food,4,111,2,2,0.12
6,9,for,3,112,2,1,0.12
6,9,force,5,113,3,2,0.16
6,9,former,6,114,3,3,0.2
6,9,friday,6,115,1,5,0.24
6,9,fridge,6,116,4,2,0.24
6,9,full,4,117,1,3,0.16
6,9,fur,3,118,2,1,0.12
6,9,game,4,119,0,4,0.2
6,9,gaming,6,120,3,3,0.2
6,9,gender,6,121,1,5,0.32
6,9,gene,4,122,3,1,0.12
6,9,give,4,123,1,3,0.16
6,9,glass,5,124,1,4,0.2
6,9,globe,5,125,2,3,0.16
6,9,god,3,126,1,2,0.12
6,9,golf,4,127,2,2,0.2
6,9,good,4,128,2,2,0.16
6,9,govern,6,129,2,4,0.24
6,9,grade,5,130,1,4,0.2
6,9,green,5,131,2,3,0.2
6,9,grey,4,132,3,1,0.12
6,9,grid,4,133,2,2,0.2
6,9,grin,4,134,3,1,0.12
6,9,grind,5,135,4,1,0.12
6,9,ground,6,136,2,4,0.24
6,9,guide,5,137,1,4,0.2
6,9,guy,3,138,2,1,0.16
6,9,gym,3,139,1,2,0.12
6,9,handy,5,140,0,5,0.24
6,9,harm,4,141,2,2,0.16
6,9,harsh,5,142,3,2,0.16
6,9,hate,4,143,2,2,0.16
6,9,hazard,6,144,2,4,0.28
6,9,health,6,145,1,5,0.24
6,9,heart,5,146,3,2,0.16
6,9,heat,4,147,3,1,0.12
6,9,highly,6,148,1,5,0.24
6,9,hour,4,149,1,3,0.24
6,9,how,3,150,2,1,0.12
6,9,humble,6,151,1,5,0.24
6,9,i,1,152,0,1,0.08
6,9,ideal,5,153,1,4,0.2
6,9,ill,3,154,1,2,0.12
6,9,image,5,155,1,4,0.28
6,9,incur,5,156,1,4,0.2
6,9,index,5,157,2,3,0.2
6,9,infant,6,158,2,4,0.24
6,9,info,4,159,3,1,0.12
6,9,inform,6,160,4,2,0.24
6,9,injure,6,161,2,4,0.24
6,9,insert,6,162,2,4,0.24
6,9,invest,6,163,2,4,0.28
6,9,iron,4,164,1,3,0.2
6,9,island,6,165,1,5,0.36
6,9,jet,3,166,0,3,0.16
6,9,job,3,167,1,2,0.12
6,9,joy,3,168,2,1,0.08
6,9,just,4,169,1,3,0.16
6,9,key,3,170,0,3,0.16
6,9,kidney,6,171,1,5,0.36
6,9,king,4,172,2,2,0.16
6,9,kit,3,173,2,1,0.12
6,9,know,4,174,1,3,0.16
6,9,laser,5,175,0,5,0.24
6,9,last,4,176,3,1,0.12
6,9,latest,6,177,2,4,0.28
6,9,laugh,5,178,2,3,0.2
6,9,law,3,179,2,1,0.08
6,9,leaf,4,180,1,3,0.16
6,9,league,6,181,3,3,0.2
6,9,legend,6,182,2,4,0.24
6,9,lemon,5,183,2,3,0.24
6,9,lesser,6,184,2,4,0.28
6,9,lethal,6,185,2,4,0.24
6,9,lie,3,186,1,2,0.16
6,9,little,6,187,2,4,0.24
6,9,liver,5,188,2,3,0.24
6,9,log,3,189,1,2,0.12
6,9,look,4,190,2,2,0.16
6,9,loose,5,191,3,2,0.16
6,9,love,4,192,2,2,0.16
6,9,mail,4,193,0,4,0.2
6,9,map,3,194,2,1,0.16
6,9,mean,4,195,1,3,0.16
6,9,media,5,196,2,3,0.2
6,9,memory,6,197,2,4,0.24
6,9,mental,6,198,2,4,0.24
6,9,mentor,6,199,4,2,0.24
6,9,mind,4,200,1,3,0.16
6,9,mirror,6,201,2,4,0.24
6,9,model,5,202,1,4,0.2
6,9,modify,6,203,3,3,0.2
6,9,money,5,204,2,3,0.24
6,9,more,4,205,2,2,0.16
6,9,mouth,5,206,2,3,0.2
6,9,movie,5,207,2,3,0.2
6,9,much,4,208,1,3,0.2
6,9,mum,3,209,2,1,0.12
6,9,must,4,210,2,2,0.2
6,9,nasty,5,211,0,5,0.24
6,9,nature,6,212,2,4,0.24
6,9,neck,4,213,1,3,0.16
6,9,needle,6,214,2,4,0.24
6,9,night,5,215,1,4,0.28
6,9,noise,5,216,1,4,0.2
6,9,normal,6,217,2,4,0.24
6,9,not,3,218,2,1,0.12
6,9,note,4,219,3,1,0.12
6,9,notice,6,220,3,3,0.28
6,9,nut,3,221,1,2,0.12
6,9,oblige,6,222,0,6,0.28
6,9,obsess,6,223,2,4,0.24
6,9,off,3,224,1,2,0.12
6,9,one,3,225,1,2,0.12
6,9,online,6,226,2,4,0.28
6,9,option,6,227,1,5,0.24
6,9,other,5,228,1,4,0.2
6,9,outing,6,229,1,5,0.24
6,9,pack,4,230,0,4,0.2
6,9,pad,3,231,2,1,0.16
6,9,page,4,232,2,2,0.16
6,9,paint,5,233,2,3,0.2
6,9,palace,6,234,2,4,0.24
6,9,parade,6,235,2,4,0.24
6,9,park,4,236,3,1,0.16
6,9,peer,4,237,1,3,0.16
6,9,pick,4,238,1,3,0.16
6,9,piece,5,239,2,3,0.2
6,9,pin,3,240,2,1,0.08
6,9,plane,5,241,1,4,0.2
6,9,plant,5,242,4,1,0.2
6,9,pledge,6,243,2,4,0.24
6,9,plot,4,244,2,2,0.16
6,9,point,5,245,1,4,0.2
6,9,police,6,246,2,4,0.24
6,9,pond,4,247,2,2,0.2
6,9,poster,6,248,2,4,0.2
6,9,prayer,6,249,1,5,0.24
6,9,prior,5,250,2,3,0.2
6,9,proof,5,251,2,3,0.2
6,9,pump,4,252,1,3,0.2
6,9,punk,4,253,2,2,0.16
6,9,put,3,254,2,1,0.12
6,9,puzzle,6,255,2,4,0.2
6,9,quest,5,256,0,5,0.24
6,9,quite,5,257,2,3,0.16
6,9,race,4,258,0,4,0.24
6,9,rail,4,259,2,2,0.12
6,9,rally,5,260,2,3,0.2
6,9,rather,6,261,2,4,0.2
6,9,realm,5,262,1,4,0.2
6,9,rebel,5,263,2,3,0.24
6,9,recall,6,264,2,4,0.24
6,9,record,6,265,3,3,0.2
6,9,regard,6,266,2,4,0.24
6,9,region,6,267,3,3,0.24
6,9,reign,5,268,2,3,0.2
6,9,relax,5,269,2,3,0.2
6,9,remark,6,270,2,4,0.2
6,9,remind,6,271,3,3,0.2
6,9,remove,6,272,3,3,0.24
6,9,renew,5,273,2,3,0.2
6,9,repeat,6,274,2,4,0.24
6,9,rest,4,275,2,2,0.16
6,9,revise,6,276,2,4,0.2
6,9,revive,6,277,4,2,0.24
6,9,rifle,5,278,1,4,0.2
6,9,rip,3,279,2,1,0.12
6,9,rise,4,280,2,2,0.16
6,9,rival,5,281,2,3,0.2
6,9,road,4,282,1,3,0.16
6,9,robust,6,283,2,4,0.28
6,9,rub,3,284,1,2,0.12
6,9,sailor,6,285,0,6,0.28
6,9,sale,4,286,2,2,0.16
6,9,salt,4,287,3,1,0.12
6,9,sample,6,288,2,4,0.28
6,9,sand,4,289,2,2,0.16
6,9,school,6,290,1,5,0.24
6,9,seal,4,291,1,3,0.16
6,9,second,6,292,2,4,0.24
6,9,sexual,6,293,2,4,0.28
6,9,shape,5,294,1,4,0.2
6,9,shell,5,295,2,3,0.2
6,9,shiny,5,296,2,3,0.2
6,9,shoot,5,297,2,3,0.2
6,9,simply,6,298,1,5,0.32
6,9,sin,3,299,2,1,0.12
6,9,sink,4,300,3,1,0.12
6,9,sister,6,301,2,4,0.2
6,9,sit,3,302,2,1,0.12
6,9,slam,4,303,1,3,0.16
6,9,slip,4,304,2,2,0.12
6,9,snow,4,305,1,3,0.24
6,9,solar,5,306,1,4,0.2
6,9,solo,4,307,3,1,0.12
6,9,some,4,308,2,2,0.12
6,9,song,4,309,2,2,0.16
6,9,soup,4,310,2,2,0.16
6,9,space,5,311,1,4,0.28
6,9,spare,5,312,3,2,0.16
6,9,speak,5,313,2,3,0.2
6,9,speech,6,314,3,3,0.2
6,9,spin,4,315,2,2,0.16
6,9,spine,5,316,4,1,0.2
6,9,spread,6,317,2,4,0.24
6,9,stab,4,318,1,3,0.16
6,9,staff,5,319,3,2,0.16
6,9,stall,5,320,3,2,0.16
6,9,stance,6,321,3,3,0.24
6,9,stand,5,322,4,1,0.12
6,9,star,4,323,3,1,0.12
6,9,statue,6,324,3,3,0.2
6,9,stick,5,325,2,3,0.2
6,9,sticky,6,326,5,1,0.2
6,9,stop,4,327,2,2,0.16
6,9,street,6,328,2,4,0.2
6,9,strike,6,329,3,3,0.2
6,9,strong,6,330,3,3,0.2
6,9,stun,4,331,2,2,0.16
6,9,sudden,6,332,1,5,0.32
6,9,sugar,5,333,2,3,0.2
6,9,super,5,334,2,3,0.2
6,9,sure,4,335,2,2,0.16
6,9,sweep,5,336,1,4,0.28
6,9,swim,4,337,2,2,0.44
6,9,switch,6,338,3,3,0.48
6,9,tank,4,339,0,4,0.44
6,9,taxi,4,340,2,2,0.36
6,9,tea,3,341,1,2,0.28
6,9,team,4,342,3,1,0.28
6,9,tempt,5,343,2,3,0.52
6,9,thesis,6,344,1,5,1
6,9,this,4,345,2,2,0.32
6,9,thumb,5,346,2,3,0.44
6,9,tight,5,347,1,4,0.56
6,9,to,2,348,1,1,0.24
6,9,tonne,5,349,2,3,0.52
6,9,too,3,350,2,1,0.24
6,9,tool,4,351,3,1,0.36
6,9,treat,5,352,1,4,0.6
6,9,tribe,5,353,2,3,0.44
6,9,trio,4,354,3,1,0.4
6,9,tune,4,355,1,3,0.4
6,9,twice,5,356,1,4,0.48
6,9,two,3,357,2,1,0.24
6,9,union,5,358,0,5,0.56
6,9,unique,6,359,3,3,0.48
6,9,until,5,360,2,3,0.52
6,9,unveil,6,361,2,4,0.52
6,9,urgent,6,362,1,5,0.64
6,9,usage,5,363,1,4,0.48
6,9,verify,6,364,0,6,0.64
6,9,viewer,6,365,1,5,0.8
6,9,virus,5,366,2,3,0.48
6,9,visual,6,367,2,4,0.56
6,9,vital,5,368,2,3,0.44
6,9,vocal,5,369,1,4,0.6
6,9,wait,4,370,0,4,0.44
6,9,waiter,6,371,4,2,0.48
6,9,wake,4,372,2,2,0.36
6,9,water,5,373,2,3,0.44
6,9,way,3,374,2,1,0.24
6,9,weight,6,375,1,5,0.72
6,9,weird,5,376,3,2,0.36
6,9,west,4,377,2,2,0.32
6,9,window,6,378,1,5,0.64
6,9,wipe,4,379,2,2,0.36
6,9,wisdom,6,380,2,4,0.68
6,9,within,6,381,2,4,0.52
6,9,woman,5,382,1,4,0.52
6,9,word,4,383,2,2,0.4
6,9,work,4,384,3,1,0.32
6,9,worry,5,385,3,2,0.52
6,9,wow,3,386,2,1,0.24
6,9,wrap,4,387,1,3,0.4
6,9,wrist,5,388,2,3,0.44
6,9,yellow,6,389,0,6,0.64
7,0,absorb,6,0,0,6,0.68
7,0,adj,3,1,1,2,0.4
7,0,admit,5,2,2,3,0.44
7,0,advice,6,3,2,4,0.52
7,0,ahead,5,4,1,4,0.48
7,0,aids,4,5,1,3,0.36
7,0,align,5,6,1,4,0.56
7,0,amusing,7,7,1,6,0.64
7,0,anger,5,8,1,4,0.48
7,0,ankle,5,9,2,3,0.4
7,0,anxiety,7,10,2,5,0.6
7,0,app,3,11,1,2,0.4
7,0,applaud,7,12,3,4,0.56
7,0,approve,7,13,3,4,0.56
7,0,army,4,14,1,3,0.36
7,0,arrest,6,15,2,4,0.64
7,0,arrow,5,16,3,2,0.4
7,0,artist,6,17,2,4,0.52
7,0,ask,3,18,1,2,0.28
7,0,at,2,19,1,1,0.2
7,0,auction,7,20,1,6,0.68
7,0,average,7,21,1,6,0.76
7,0,baby,4,22,0,4,0.52
7,0,banner,6,23,2,4,0.6
7,0,base,4,24,2,2,0.4
7,0,bat,3,25,2,1,0.24
7,0,bath,4,26,3,1,0.44
7,0,beast,5,27,1,4,0.48
7,0,bed,3,28,2,1,0.24
7,0,beg,3,29,2,1,0.24
7,0,behave,6,30,2,4,0.52
7,0,betray,6,31,2,4,0.52
7,0,between,7,32,3,4,0.64
7,0,bill,4,33,1,3,0.4
7,0,bin,3,34,2,1,0.28
7,0,bird,4,35,2,2,0.4
7,0,bishop,6,36,2,4,0.6
7,0,blade,5,37,1,4,0.64
7,0,bless,5,38,2,3,0.44
7,0,blind,5,39,2,3,0.4
7,0,boat,4,40,1,3,0.36
7,0,boil,4,41,2,2,0.36
7,0,bomb,4,42,2,2,0.36
7,0,boom,4,43,2,2,0.44
7,0,boot,4,44,3,1,0.28
7,0,bound,5,45,2,3,0.4
7,0,box,3,46,2,1,0.24
7,0,brand,5,47,1,4,0.48
7,0,break,5,48,2,3,0.44
7,0,breathe,7,49,4,3,0.64
7,0,bride,5,50,2,3,0.44
7,0,bright,6,51,3,3,0.52
7,0,buddy,5,52,1,4,0.52
7,0,bug,3,53,2,1,0.24
7,0,build,5,54,2,3,0.6
7,0,burden,6,55,2,4,0.64
7,0,butter,6,56,2,4,0.56
7,0,cafe,4,57,0,4,0.48
7,0,cake,4,58,2,2,0.36
7,0,can,3,59,2,1,0.36
7,0,cancer,6,60,3,3,0.44
7,0,cap,3,61,2,1,0.24
7,0,career,6,62,2,4,0.52
7,0,careful,7,63,4,3,0.48
7,0,carpet,6,64,3,3,0.56
7,0,carve,5,65,3,2,0.36
7,0,cd,2,66,1,1,0.2
7,0,cease,5,67,1,4,0.48
7,0,chair,5,68,1,4,0.48
7,0,chapter,7,69,3,4,0.56
7,0,charity,7,70,3,4,0.64
7,0,chart,5,71,4,1,0.4
7,0,choose,6,72,2,4,0.52
7,0,chop,4,73,3,1,0.28
7,0,chunk,5,74,2,3,0.4
7,0,city,4,75,1,3,0.48
7,0,clarity,7,76,1,6,0.68
7,0,clean,5,77,2,3,0.4
7,0,clerk,5,78,3,2,0.36
7,0,closely,7,79,2,5,0.72
7,0,cloud,5,80,3,2,0.36
7,0,club,4,81,2,2,0.32
7,0,cluster,7,82,3,4,0.56
7,0,coffee,6,83,1,5,0.64
7,0,comedy,6,84,2,4,0.64
7,0,comfort,7,85,3,4,0.56
7,0,comment,7,86,3,4,0.6
7,0,company,7,87,3,4,0.6
7,0,comply,6,88,4,2,0.52
7,0,concern,7,89,2,5,0.6
7,0,concert,7,90,6,1,0.4
7,0,confer,6,91,3,3,0.44
7,0,consent,7,92,3,4,0.68
7,0,contend,7,93,3,4,0.28
7,0,convey,6,94,3,3,0.24
7,0,cooker,6,95,2,4,0.28
7,0,correct,7,96,2,5,0.28
7,0,cottage,7,97,2,5,0.32
7,0,could,5,98,2,3,0.2
7,0,course,6,99,3,3,0.2
7,0,court,5,100,4,1,0.12
7,0,create,6,101,1,5,0.28
7,0,creep,5,102,3,2,0.16
7,0,crisis,6,103,2,4,0.2
7,0,crowded,7,104,2,5,0.24
7,0,crucial,7,105,2,5,0.28
7,0,cruise,6,106,3,3,0.24
7,0,cry,3,107,2,1,0.08
7,0,current,7,108,1,6,0.28
7,0,curved,6,109,3,3,0.2
7,0,cycle,5,110,1,4,0.28
7,0,damage,6,111,0,6,0.28
7,0,declare,7,112,1,6,0.28
7,0,deed,4,113,2,2,0.16
7,0,deem,4,114,3,1,0.12
7,0,defence,7,115,2,5,0.32
7,0,delight,7,116,2,5,0.28
7,0,dentist,7,117,2,5,0.28
7,0,deputy,6,118,2,4,0.2
7,0,desktop,7,119,2,5,0.32
7,0,despite,7,120,3,4,0.24
7,0,develop,7,121,2,5,0.24
7,0,diagram,7,122,1,6,0.28
7,0,dictate,7,123,2,5,0.32
7,0,dig,3,124,2,1,0.08
7,0,digital,7,125,3,4,0.24
7,0,dinner,6,126,2,4,0.2
7,0,display,7,127,2,5,0.32
7,0,distant,7,128,3,4,0.24
7,0,divine,6,129,2,4,0.2
7,0,domain,6,130,1,5,0.24
7,0,double,6,131,2,4,0.2
7,0,drawing,7,132,1,6,0.36
7,0,drink,5,133,2,3,0.16
7,0,earth,5,134,0,5,0.24
7,0,edit,4,135,1,3,0.16
7,0,edition,7,136,4,3,0.28
7,0,eight,5,137,1,4,0.2
7,0,either,6,138,2,4,0.24
7,0,eleven,6,139,1,5,0.24
7,0,embark,6,140,1,5,0.24
7,0,emotion,7,141,2,5,0.32
7,0,empower,7,142,2,5,0.28
7,0,ending,6,143,1,5,0.24
7,0,enjoy,5,144,2,3,0.2
7,0,enter,5,145,2,3,0.24
7,0,entry,5,146,3,2,0.16
7,0,essay,5,147,1,4,0.28
7,0,essence,7,148,3,4,0.28
7,0,euro,4,149,1,3,0.16
7,0,event,5,150,1,4,0.28
7,0,examine,7,151,1,6,0.28
7,0,exit,4,152,2,2,0.12
7,0,expire,6,153,2,4,0.24
7,0,extend,6,154,2,4,0.2
7,0,extent,6,155,5,1,0.2
7,0,eye,3,156,1,2,0.12
7,0,fail,4,157,0,4,0.2
7,0,failed,6,158,4,2,0.16
7,0,failure,7,159,4,3,0.2
7,0,fair,4,160,3,1,0.16
7,0,fall,4,161,2,2,0.12
7,0,fasten,6,162,2,4,0.2
7,0,fat,3,163,2,1,0.08
7,0,fee,3,164,1,2,0.12
7,0,fiction,7,165,1,6,0.28
7,0,fight,5,166,2,3,0.24
7,0,firm,4,167,2,2,0.16
7,0,fix,3,168,2,1,0.08
7,0,fixture,7,169,3,4,0.24
7,0,flag,4,170,1,3,0.16
7,0,flavour,7,171,3,4,0.32
7,0,flee,4,172,2,2,0.16
7,0,floor,5,173,2,3,0.2
7,0,flu,3,174,2,1,0.12
7,0,flying,6,175,2,4,0.24
7,0,focus,5,176,1,4,0.24
7,0,for,3,177,2,1,0.12
7,0,forward,7,178,3,4,0.24
7,0,founder,7,179,2,5,0.32
7,0,freedom,7,180,1,6,0.32
7,0,frog,4,181,2,2,0.32
7,0,fulfil,6,182,1,5,0.96
7,0,fur,3,183,2,1,0.4
7,0,gallery,7,184,0,7,0.36
7,0,gallon,6,185,4,2,0.16
7,0,game,4,186,2,2,0.16
7,0,garage,6,187,2,4,0.24
7,0,gene,4,188,1,3,0.24
7,0,genetic,7,189,4,3,0.24
7,0,genre,5,190,3,2,0.16
7,0,give,4,191,1,3,0.16
7,0,glimpse,7,192,1,6,0.28
7,0,golf,4,193,1,3,0.2
7,0,good,4,194,2,2,0.12
7,0,goodbye,7,195,4,3,0.2
7,0,govern,6,196,2,4,0.2
7,0,grace,5,197,1,4,0.2
7,0,gravity,7,198,3,4,0.28
7,0,green,5,199,2,3,0.16
7,0,grid,4,200,2,2,0.16
7,0,grin,4,201,3,1,0.12
7,0,guest,5,202,1,4,0.24
7,0,guitar,6,203,2,4,0.28
7,0,guy,3,204,2,1,0.08
7,0,hair,4,205,0,4,0.2
7,0,handful,7,206,2,5,0.24
7,0,handy,5,207,4,1,0.12
7,0,hat,3,208,2,1,0.12
7,0,health,6,209,1,5,0.32
7,0,heat,4,210,3,1,0.12
7,0,herb,4,211,2,2,0.16
7,0,highly,6,212,1,5,0.24
7,0,hint,4,213,2,2,0.12
7,0,holiday,7,214,1,6,0.36
7,0,honesty,7,215,2,5,0.28
7,0,however,7,216,2,5,0.28
7,0,humble,6,217,1,5,0.24
7,0,ice,3,218,0,3,0.2
7,0,ill,3,219,1,2,0.12
7,0,illegal,7,220,3,4,0.24
7,0,image,5,221,1,4,0.2
7,0,imagery,7,222,5,2,0.2
7,0,infant,6,223,1,5,0.32
7,0,inform,6,224,3,3,0.2
7,0,inject,6,225,2,4,0.2
7,0,injury,6,226,3,3,0.2
7,0,insert,6,227,2,4,0.24
7,0,intake,6,228,2,4,0.28
7,0,intense,7,229,3,4,0.28
7,0,invest,6,230,2,4,0.24
7,0,iron,4,231,1,3,0.16
7,0,island,6,232,1,5,0.32
7,0,job,3,233,0,3,0.12
7,0,june,4,234,1,3,0.2
7,0,just,4,235,2,2,0.12
7,0,justify,7,236,4,3,0.24
7,0,key,3,237,0,3,0.16
7,0,kidney,6,238,1,5,0.32
7,0,kingdom,7,239,2,5,0.24
7,0,kit,3,240,2,1,0.12
7,0,lad,3,241,0,3,0.16
7,0,lap,3,242,2,1,0.12
7,0,last,4,243,2,2,0.16
7,0,law,3,244,2,1,0.16
7,0,lawn,4,245,3,1,0.12
7,0,leading,7,246,1,6,0.28
7,0,left,4,247,2,2,0.12
7,0,lens,4,248,2,2,0.16
7,0,lesbian,7,249,2,5,0.32
7,0,lesser,6,250,3,3,0.2
7,0,lethal,6,251,2,4,0.2
7,0,letter,6,252,3,3,0.2
7,0,licence,7,253,1,6,0.32
7,0,license,7,254,5,2,0.2
7,0,lie,3,255,2,1,0.08
7,0,limited,7,256,2,5,0.28
7,0,link,4,257,2,2,0.12
7,0,little,6,258,2,4,0.28
7,0,liver,5,259,2,3,0.2
7,0,located,7,260,1,6,0.28
7,0,look,4,261,2,2,0.12
7,0,loose,5,262,3,2,0.16
7,0,love,4,263,2,2,0.12
7,0,low,3,264,2,1,0.16
7,0,mail,4,265,0,4,0.2
7,0,main,4,266,3,1,0.12
7,0,mandate,7,267,2,5,0.24
7,0,master,6,268,2,4,0.2
7,0,match,5,269,2,3,0.24
7,0,meal,4,270,1,3,0.16
7,0,media,5,271,2,3,0.2
7,0,meeting,7,272,2,5,0.24
7,0,memory,6,273,2,4,0.24
7,0,mental,6,274,2,4,0.28
7,0,mentor,6,275,4,2,0.16
7,0,merely,6,276,2,4,0.48
7,0,mess,4,277,2,2,0.36
7,0,method,6,278,2,4,0.52
7,0,militia,7,279,1,6,0.76
7,0,mind,4,280,2,2,0.32
7,0,missing,7,281,2,5,0.6
7,0,modify,6,282,1,5,0.6
7,0,month,5,283,2,3,0.52
7,0,mother,6,284,2,4,0.52
7,0,mouth,5,285,2,3,0.44
7,0,mum,3,286,1,2,0.4
7,0,museum,6,287,2,4,0.52
7,0,name,4,288,0,4,0.56
7,0,nasty,5,289,2,3,0.44
7,0,nation,6,290,2,4,0.56
7,0,nature,6,291,3,3,0.56
7,0,needle,6,292,1,5,0.72
7,0,neutral,7,293,2,5,0.76
7,0,newly,5,294,2,3,0.48
7,0,noise,5,295,1,4,0.56
7,0,noisy,5,296,4,1,0.36
7,0,norm,4,297,2,2,0.4
7,0,normal,6,298,4,2,0.56
7,0,north,5,299,3,2,0.4
7,0,note,4,300,2,2,0.36
7,0,notice,6,301,3,3,0.48
7,0,novel,5,302,2,3,0.4
7,0,nut,3,303,1,2,0.36
7,0,obesity,7,304,0,7,0.88
7,0,oblige,6,305,2,4,0.76
7,0,obsess,6,306,2,4,0.68
7,0,off,3,307,1,2,0.4
7,0,once,4,308,1,3,0.6
7,0,opposed,7,309,1,6,0.72
7,0,ought,5,310,1,4,0.48
7,0,outdoor,7,311,2,5,0.6
7,0,outfit,6,312,3,3,0.48
7,0,outing,6,313,3,3,0.56
7,0,overall,7,314,1,6,0.64
7,0,oversee,7,315,4,3,0.48
7,0,owe,3,316,1,2,0.28
7,0,pack,4,317,0,4,0.52
7,0,pad,3,318,2,1,0.28
7,0,page,4,319,2,2,0.4
7,0,painful,7,320,2,5,0.72
7,0,paint,5,321,4,1,0.36
7,0,pants,5,322,2,3,0.48
7,0,parade,6,323,2,4,0.64
7,0,park,4,324,3,1,0.28
7,0,partner,7,325,3,4,0.6
7,0,patron,6,326,2,4,0.56
7,0,peer,4,327,1,3,0.48
7,0,pepper,6,328,2,4,0.64
7,0,perfect,7,329,2,5,0.64
7,0,phone,5,330,1,4,0.48
7,0,picture,7,331,1,6,0.64
7,0,pipe,4,332,2,2,0.44
7,0,plastic,7,333,1,6,0.68
7,0,pleased,7,334,2,5,0.6
7,0,pledge,6,335,3,3,0.48
7,0,point,5,336,1,4,0.48
7,0,pond,4,337,2,2,0.44
7,0,pot,3,338,2,1,0.24
7,0,precise,7,339,1,6,0.68
7,0,prior,5,340,2,3,0.44
7,0,produce,7,341,2,5,0.6
7,0,profile,7,342,3,4,0.64
7,0,program,7,343,3,4,0.56
7,0,proof,5,344,3,2,0.36
7,0,punk,4,345,1,3,0.4
7,0,pupil,5,346,2,3,0.52
7,0,pure,4,347,2,2,0.32
7,0,purpose,7,348,3,4,0.56
7,0,pursuit,7,349,3,4,0.56
7,0,puzzle,6,350,2,4,0.52
7,0,race,4,351,0,4,0.56
7,0,radar,5,352,2,3,0.48
7,0,railway,7,353,2,5,0.72
7,0,rally,5,354,2,3,0.52
7,0,rather,6,355,2,4,0.56
7,0,rating,6,356,3,3,0.56
7,0,rear,4,357,1,3,0.36
7,0,rebel,5,358,2,3,0.4
7,0,record,6,359,2,4,0.52
7,0,recycle,7,360,3,4,0.64
7,0,referee,7,361,2,5,0.6
7,0,reign,5,362,2,3,0.44
7,0,relax,5,363,2,3,0.44
7,0,relief,6,364,3,3,0.44
7,0,replace,7,365,2,5,0.72
7,0,reside,6,366,2,4,0.52
7,0,resolve,7,367,3,4,0.56
7,0,rest,4,368,3,1,0.28
7,0,retire,6,369,2,4,0.6
7,0,reveal,6,370,2,4,0.52
7,0,revival,7,371,3,4,0.56
7,0,rifle,5,372,1,4,0.48
7,0,ritual,6,373,2,4,0.52
7,0,road,4,374,1,3,0.52
7,0,robbery,7,375,2,5,0.64
7,0,robust,6,376,3,3,0.48
7,0,roll,4,377,2,2,0.36
7,0,romance,7,378,2,5,0.76
7,0,root,4,379,2,2,0.44
7,0,rotate,6,380,2,4,0.56
7,0,rough,5,381,2,3,0.44
7,0,rub,3,382,1,2,0.28
7,0,rubbish,7,383,3,4,0.56
7,0,ruin,4,384,2,2,0.4
7,0,sample,6,385,0,6,0.64
7,0,sand,4,386,2,2,0.32
7,0,scared,6,387,1,5,0.6
7,0,scheme,6,388,2,4,0.52
7,0,scholar,7,389,3,4,0.68
7,0,school,6,390,4,2,0.4
7,0,second,6,391,1,5,0.56
7,0,secure,6,392,3,3,0.48
7,0,seem,4,393,2,2,0.44
7,0,seminar,7,394,2,5,0.64
7,0,serve,5,395,2,3,0.44
7,0,setting,7,396,2,5,0.72
7,0,seven,5,397,2,3,0.48
7,0,sexy,4,398,2,2,0.44
7,0,shape,5,399,1,4,0.48
7,0,share,5,400,3,2,0.36
7,0,sheer,5,401,2,3,0.44
7,0,shortly,7,402,2,5,0.6
7,0,sibling,7,403,1,6,0.76
7,0,sight,5,404,2,3,0.44
7,0,silver,6,405,2,4,0.52
7,0,sin,3,406,2,1,0.24
7,0,sink,4,407,3,1,0.28
7,0,skirt,5,408,1,4,0.6
7,0,skull,5,409,2,3,0.44
7,0,slam,4,410,1,3,0.4
7,0,slice,5,411,2,3,0.44
7,0,smile,5,412,1,4,0.48
7,0,smoking,7,413,2,5,0.68
7,0,snow,4,414,1,3,0.4
7,0,soap,4,415,1,3,0.4
7,0,some,4,416,2,2,0.32
7,0,somehow,7,417,4,3,0.6
7,0,soup,4,418,2,2,0.4
7,0,south,5,419,3,2,0.48
7,0,space,5,420,1,4,0.48
7,0,spare,5,421,3,2,0.36
7,0,specify,7,422,2,5,0.64
7,0,sphere,6,423,2,4,0.6
7,0,stable,6,424,1,5,0.56
7,0,staff,5,425,3,2,0.36
7,0,stall,5,426,3,2,0.36
7,0,stance,6,427,3,3,0.48
7,0,stay,4,428,3,1,0.28
7,0,steer,5,429,2,3,0.52
7,0,stem,4,430,3,1,0.28
7,0,storage,7,431,2,5,0.6
7,0,strange,7,432,2,5,0.6
7,0,street,6,433,3,3,0.56
7,0,stretch,7,434,4,3,0.52
7,0,strict,6,435,3,3,0.48
7,0,strike,6,436,4,2,0.44
7,0,strong,6,437,3,3,0.48
7,0,study,5,438,2,3,0.52
7,0,stumble,7,439,3,4,0.56
7,0,such,4,440,1,3,0.4
7,0,sudden,6,441,2,4,0.52
7,0,sue,3,442,2,1,0.24
7,0,sugar,5,443,2,3,0.56
7,0,super,5,444,2,3,0.44
7,0,suppose,7,445,3,4,0.56
7,0,sure,4,446,2,2,0.32
7,0,surely,6,447,4,2,0.4
7,0,swallow,7,448,1,6,0.76
7,0,swear,5,449,2,3,0.44
7,0,sweater,7,450,4,3,0.56
7,0,swim,4,451,2,2,0.36
7,0,table,5,452,0,5,0.56
7,0,tale,4,453,2,2,0.44
7,0,talent,6,454,4,2,0.4
7,0,talk,4,455,3,1,0.28
7,0,tap,3,456,2,1,0.24
7,0,taxi,4,457,2,2,0.32
7,0,tempt,5,458,1,4,0.48
7,0,tender,6,459,2,4,0.72
7,0,tension,7,460,3,4,0.56
7,0,terrify,7,461,2,5,0.6
7,0,texture,7,462,2,5,0.6
7,0,ticket,6,463,1,5,0.68
7,0,tidy,4,464,2,2,0.36
7,0,tight,5,465,2,3,0.4
7,0,till,4,466,2,2,0.32
7,0,to,2,467,1,1,0.2
7,0,tonight,7,468,2,5,0.72
7,0,too,3,469,2,1,0.24
7,0,tool,4,470,3,1,0.28
7,0,tour,4,471,2,2,0.32
7,0,tragic,6,472,1,5,0.56
7,0,treat,5,473,2,3,0.4
7,0,tree,4,474,3,1,0.36
7,0,trend,5,475,3,2,0.36
7,0,trial,5,476,2,3,0.44
7,0,tribe,5,477,3,2,0.36
7,0,tribute,7,478,4,3,0.52
7,0,trouble,7,479,2,5,0.72
7,0,truck,5,480,2,3,0.44
7,0,tune,4,481,1,3,0.4
7,0,two,3,482,1,2,0.28
7,0,undergo,7,483,0,7,0.72
7,0,unveil,6,484,2,4,0.64
7,0,upgrade,7,485,1,6,0.68
7,0,usual,5,486,1,4,0.48
7,0,valley,6,487,0,6,0.64
7,0,verify,6,488,1,5,0.72
7,0,viewer,6,489,1,5,0.6
7,0,violent,7,490,2,5,0.6
7,0,virtual,7,491,2,5,0.64
7,0,virtue,6,492,5,1,0.48
7,0,visitor,7,493,2,5,0.64
7,0,visual,6,494,3,3,0.48
7,0,vital,5,495,2,3,0.4
7,0,vocal,5,496,1,4,0.48
7,0,wait,4,497,0,4,0.52
7,0,walk,4,498,2,2,0.32
7,0,war,3,499,2,1,0.24
7,0,washing,7,500,2,5,0.6
7,0,watch,5,501,2,3,0.4
7,0,wealthy,7,502,1,6,0.76
7,0,weapon,6,503,3,3,0.48
7,0,weekend,7,504,2,5,0.64
7,0,weight,6,505,2,4,0.68
7,0,west,4,506,2,2,0.48
7,0,which,5,507,1,4,0.72
7,0,whose,5,508,2,3,0.48
7,0,width,5,509,1,4,0.52
7,0,wind,4,510,2,2,0.36
7,0,window,6,511,4,2,0.44
7,0,wine,4,512,3,1,0.4
7,0,wisdom,6,513,2,4,0.52
7,0,without,7,514,2,5,0.6
7,0,woman,5,515,1,4,0.48
7,0,world,5,516,2,3,0.48
7,0,worry,5,517,3,2,0.48
7,0,wow,3,518,2,1,0.24
7,0,wrap,4,519,1,3,0.4
7,0,yellow,6,520,0,6,0.52
7,0,young,5,521,1,4,0.28
7,1,absence,7,0,0,7,0.32
7,1,absurd,6,1,3,3,0.28
7,1,accept,6,2,1,5,0.24
7,1,acid,4,3,2,2,0.12
7,1,acre,4,4,2,2,0.12
7,1,ad,2,5,1,1,0.08
7,1,add,3,6,2,1,0.12
7,1,address,7,7,3,4,0.32
7,1,adj,3,8,2,1,0.08
7,1,adopt,5,9,2,3,0.16
7,1,again,5,10,1,4,0.2
7,1,against,7,11,5,2,0.2
7,1,ahead,5,12,1,4,0.24
7,1,ancient,7,13,1,6,0.28
7,1,and,3,14,2,1,0.08
7,1,ankle,5,15,2,3,0.16
7,1,annoyed,7,16,2,5,0.24
7,1,anybody,7,17,2,5,0.32
7,1,apology,7,18,1,6,0.28
7,1,applaud,7,19,2,5,0.24
7,1,army,4,20,1,3,0.16
7,1,around,6,21,2,4,0.28
7,1,arrow,5,22,2,3,0.2
7,1,assault,7,23,1,6,0.28
7,1,at,2,24,1,1,0.08
7,1,attract,7,25,2,5,0.28
7,1,auto,4,26,1,3,0.24
7,1,average,7,27,1,6,0.28
7,1,baby,4,28,0,4,0.2
7,1,balance,7,29,2,5,0.28
7,1,banner,6,30,2,4,0.32
7,1,barrel,6,31,2,4,0.2
7,1,bath,4,32,2,2,0.12
7,1,bay,3,33,2,1,0.08
7,1,beat,4,34,1,3,0.16
7,1,beauty,6,35,3,3,0.2
7,1,beer,4,36,2,2,0.2
7,1,behalf,6,37,2,4,0.2
7,1,behave,6,38,4,2,0.16
7,1,belief,6,39,2,4,0.24
7,1,below,5,40,3,2,0.16
7,1,bin,3,41,1,2,0.2
7,1,bishop,6,42,2,4,0.2
7,1,bitter,6,43,2,4,0.2
7,1,bizarre,7,44,2,5,0.24
7,1,blade,5,45,1,4,0.28
7,1,bless,5,46,2,3,0.16
7,1,blind,5,47,2,3,0.16
7,1,blog,4,48,2,2,0.16
7,1,boat,4,49,1,3,0.16
7,1,boil,4,50,2,2,0.12
7,1,bomb,4,51,2,2,0.2
7,1,boom,4,52,2,2,0.12
7,1,boost,5,53,3,2,0.16
7,1,boot,4,54,3,1,0.12
7,1,bound,5,55,2,3,0.16
7,1,box,3,56,2,1,0.12
7,1,break,5,57,1,4,0.28
7,1,breathe,7,58,4,3,0.2
7,1,bride,5,59,2,3,0.2
7,1,bright,6,60,3,3,0.2
7,1,buffer,6,61,1,5,0.24
7,1,burden,6,62,2,4,0.28
7,1,cafe,4,63,0,4,0.16
7,1,cake,4,64,2,2,0.12
7,1,cancer,6,65,2,4,0.24
7,1,capable,7,66,2,5,0.28
7,1,career,6,67,2,4,0.28
7,1,careful,7,68,4,3,0.24
7,1,carpet,6,69,3,3,0.2
7,1,carve,5,70,3,2,0.16
7,1,cd,2,71,1,1,0.08
7,1,ceiling,7,72,1,6,0.36
7,1,century,7,73,2,5,0.24
7,1,chair,5,74,1,4,0.2
7,1,chapter,7,75,3,4,0.24
7,1,charity,7,76,3,4,0.32
7,1,charm,5,77,4,1,0.12
7,1,cheat,5,78,2,3,0.16
7,1,chicken,7,79,2,5,0.24
7,1,choir,5,80,2,3,0.24
7,1,choose,6,81,3,3,0.2
7,1,chronic,7,82,2,5,0.24
7,1,circle,6,83,1,5,0.24
7,1,circuit,7,84,4,3,0.2
7,1,city,4,85,2,2,0.2
7,1,clarity,7,86,1,6,0.28
7,1,clause,6,87,3,3,0.2
7,1,clean,5,88,2,3,0.2
7,1,clearly,7,89,4,3,0.28
7,1,clerk,5,90,3,2,0.16
7,1,closely,7,91,2,5,0.28
7,1,cloud,5,92,3,2,0.16
7,1,club,4,93,2,2,0.12
7,1,coach,5,94,1,4,0.28
7,1,comedy,6,95,2,4,0.24
7,1,comment,7,96,3,4,0.24
7,1,company,7,97,3,4,0.24
7,1,comply,6,98,4,2,0.16
7,1,conceal,7,99,2,5,0.32
7,1,concert,7,100,5,2,0.2
7,1,conduct,7,101,3,4,0.24
7,1,confess,7,102,3,4,0.24
7,1,consent,7,103,3,4,0.32
7,1,consult,7,104,4,3,0.2
7,1,convey,6,105,3,3,0.2
7,1,cooker,6,106,2,4,0.24
7,1,cottage,7,107,2,5,0.32
7,1,coup,4,108,2,2,0.16
7,1,couple,6,109,4,2,0.2
7,1,court,5,110,3,2,0.16
7,1,craft,5,111,1,4,0.2
7,1,create,6,112,2,4,0.28
7,1,cross,5,113,2,3,0.16
7,1,crucial,7,114,2,5,0.24
7,1,crude,5,115,3,2,0.16
7,1,cruel,5,116,3,2,0.16
7,1,cry,3,117,2,1,0.16
7,1,current,7,118,1,6,0.28
7,1,cycle,5,119,1,4,0.2
7,1,dam,3,120,0,3,0.16
7,1,dance,5,121,2,3,0.2
7,1,dare,4,122,2,2,0.2
7,1,day,3,123,2,1,0.08
7,1,death,5,124,1,4,0.2
7,1,decline,7,125,2,5,0.28
7,1,defect,6,126,2,4,0.2
7,1,deposit,7,127,2,5,0.32
7,1,deputy,6,128,3,3,0.24
7,1,desktop,7,129,2,5,0.32
7,1,detect,6,130,2,4,0.24
7,1,dictate,7,131,1,6,0.36
7,1,distant,7,132,2,5,0.28
7,1,distort,7,133,4,3,0.2
7,1,divine,6,134,2,4,0.24
7,1,dollar,6,135,1,5,0.32
7,1,double,6,136,2,4,0.24
7,1,earth,5,137,0,5,0.24
7,1,edit,4,138,1,3,0.16
7,1,edition,7,139,4,3,0.2
7,1,editor,6,140,4,2,0.24
7,1,effort,6,141,1,5,0.24
7,1,either,6,142,1,5,0.24
7,1,embody,6,143,1,5,0.24
7,1,enemy,5,144,1,4,0.28
7,1,enjoy,5,145,2,3,0.2
7,1,enter,5,146,2,3,0.16
7,1,entitle,7,147,3,4,0.24
7,1,erect,5,148,1,4,0.28
7,1,essay,5,149,1,4,0.28
7,1,euro,4,150,1,3,0.16
7,1,event,5,151,1,4,0.2
7,1,evoke,5,152,2,3,0.2
7,1,examine,7,153,1,6,0.28
7,1,excuse,6,154,2,4,0.32
7,1,explode,7,155,2,5,0.32
7,1,eye,3,156,1,2,0.16
7,1,fail,4,157,0,4,0.2
7,1,failed,6,158,4,2,0.2
7,1,failure,7,159,4,3,0.28
7,1,fairly,6,160,3,3,0.2
7,1,famous,6,161,2,4,0.2
7,1,fear,4,162,1,3,0.16
7,1,fiction,7,163,1,6,0.36
7,1,fight,5,164,2,3,0.16
7,1,fix,3,165,2,1,0.08
7,1,flag,4,166,1,3,0.16
7,1,flat,4,167,3,1,0.12
7,1,flavour,7,168,3,4,0.24
7,1,flee,4,169,2,2,0.2
7,1,flower,6,170,2,4,0.24
7,1,flying,6,171,2,4,0.2
7,1,folding,7,172,1,6,0.28
7,1,for,3,173,2,1,0.08
7,1,former,6,174,3,3,0.28
7,1,formula,7,175,4,3,0.2
7,1,forward,7,176,3,4,0.24
7,1,foster,6,177,2,4,0.2
7,1,founder,7,178,2,5,0.32
7,1,fridge,6,179,1,5,0.24
7,1,frog,4,180,2,2,0.12
7,1,front,5,181,3,2,0.16
7,1,fulfil,6,182,1,5,0.24
7,1,funding,7,183,2,5,0.32
7,1,fur,3,184,2,1,0.08
7,1,gallery,7,185,0,7,0.32
7,1,gene,4,186,1,3,0.16
7,1,giant,5,187,1,4,0.48
7,1,give,4,188,2,2,0.44
7,1,glass,5,189,1,4,0.48
7,1,go,2,190,1,1,0.2
7,1,golf,4,191,2,2,0.36
7,1,goodbye,7,192,2,5,0.64
7,1,grey,4,193,1,3,0.4
7,1,grief,5,194,2,3,0.52
7,1,grin,4,195,3,1,0.28
7,1,grind,5,196,4,1,0.32
7,1,guest,5,197,1,4,0.48
7,1,guide,5,198,2,3,0.44
7,1,gym,3,199,1,2,0.4
7,1,handful,7,200,0,7,0.72
7,1,handy,5,201,4,1,0.32
7,1,hat,3,202,2,1,0.24
7,1,hazard,6,203,2,4,0.52
7,1,health,6,204,1,5,0.68
7,1,heat,4,205,3,1,0.28
7,1,her,3,206,2,1,0.24
7,1,herb,4,207,3,1,0.28
7,1,highly,6,208,1,5,0.56
7,1,hint,4,209,2,2,0.32
7,1,holiday,7,210,1,6,0.76
7,1,honesty,7,211,2,5,0.72
7,1,horror,6,212,2,4,0.6
7,1,hotel,5,213,2,3,0.52
7,1,hour,4,214,2,2,0.4
7,1,how,3,215,2,1,0.36
7,1,humour,6,216,1,5,0.6
7,1,hunger,6,217,2,4,0.52
7,1,hunt,4,218,3,1,0.28
7,1,i,1,219,0,1,0.16
7,1,ice,3,220,1,2,0.28
7,1,ideal,5,221,1,4,0.6
7,1,illegal,7,222,1,6,0.68
7,1,incur,5,223,1,4,0.48
7,1,index,5,224,2,3,0.4
7,1,inform,6,225,2,4,0.52
7,1,injure,6,226,2,4,0.64
7,1,injury,6,227,5,1,0.36
7,1,inspect,7,228,2,5,0.6
7,1,intake,6,229,2,4,0.52
7,1,into,4,230,3,1,0.4
7,1,invade,6,231,2,4,0.52
7,1,involve,7,232,3,4,0.56
7,1,job,3,233,0,3,0.36
7,1,june,4,234,1,3,0.4
7,1,just,4,235,2,2,0.32
7,1,kick,4,236,0,4,0.52
7,1,kid,3,237,2,1,0.24
7,1,kidney,6,238,3,3,0.44
7,1,kit,3,239,2,1,0.24
7,1,knife,5,240,1,4,0.48
7,1,know,4,241,2,2,0.32
7,1,lack,4,242,0,4,0.6
7,1,lad,3,243,2,1,0.24
7,1,lake,4,244,2,2,0.32
7,1,laser,5,245,2,3,0.4
7,1,last,4,246,3,1,0.28
7,1,laugh,5,247,2,3,0.4
7,1,law,3,248,2,1,0.36
7,1,leaflet,7,249,1,6,0.72
7,1,left,4,250,2,2,0.36
7,1,legend,6,251,2,4,0.56
7,1,lemon,5,252,2,3,0.48
7,1,lens,4,253,2,2,0.48
7,1,letter,6,254,2,4,0.52
7,1,licence,7,255,1,6,0.64
7,1,license,7,256,5,2,0.48
7,1,lie,3,257,2,1,0.24
7,1,limited,7,258,2,5,0.72
7,1,lion,4,259,2,2,0.36
7,1,liver,5,260,2,3,0.4
7,1,local,5,261,1,4,0.48
7,1,located,7,262,4,3,0.6
7,1,log,3,263,2,1,0.24
7,1,lonely,6,264,2,4,0.52
7,1,loose,5,265,2,3,0.44
7,1,lot,3,266,2,1,0.28
7,1,loudly,6,267,2,4,0.6
7,1,love,4,268,2,2,0.44
7,1,low,3,269,2,1,0.24
7,1,lunch,5,270,1,4,0.48
7,1,map,3,271,0,3,0.32
7,1,marine,6,272,2,4,0.52
7,1,mark,4,273,3,1,0.28
7,1,master,6,274,2,4,0.6
7,1,match,5,275,2,3,0.4
7,1,meal,4,276,1,3,0.36
7,1,media,5,277,2,3,0.4
7,1,mess,4,278,2,2,0.32
7,1,metre,5,279,2,3,0.52
7,1,mind,4,280,1,3,0.4
7,1,money,5,281,1,4,0.48
7,1,month,5,282,3,2,0.36
7,1,monthly,7,283,5,2,0.44
7,1,mother,6,284,2,4,0.64
7,1,mouth,5,285,2,3,0.44
7,1,mum,3,286,1,2,0.28
7,1,my,2,287,1,1,0.2
7,1,naked,5,288,0,5,0.52
7,1,name,4,289,2,2,0.32
7,1,nasty,5,290,2,3,0.44
7,1,nation,6,291,2,4,0.64
7,1,nature,6,292,3,3,0.48
7,1,needle,6,293,1,5,0.64
7,1,neutral,7,294,2,5,0.68
7,1,new,3,295,2,1,0.36
7,1,night,5,296,1,4,0.48
7,1,noise,5,297,1,4,0.48
7,1,noisy,5,298,4,1,0.32
7,1,non,3,299,2,1,0.28
7,1,norm,4,300,2,2,0.36
7,1,normal,6,301,4,2,0.52
7,1,not,3,302,2,1,0.24
7,1,nothing,7,303,3,4,0.56
7,1,notion,6,304,3,3,0.44
7,1,novel,5,305,2,3,0.48
7,1,obesity,7,306,0,7,0.88
7,1,oblige,6,307,2,4,0.6
7,1,obsess,6,308,2,4,0.6
7,1,october,7,309,1,6,0.72
7,1,off,3,310,1,2,0.4
7,1,offence,7,311,3,4,0.6
7,1,offend,6,312,5,1,0.36
7,1,once,4,313,1,3,0.68
7,1,opposed,7,314,1,6,0.68
7,1,option,6,315,2,4,0.64
7,1,other,5,316,1,4,0.48
7,1,ought,5,317,1,4,0.48
7,1,outdoor,7,318,2,5,0.6
7,1,outfit,6,319,3,3,0.64
7,1,outlook,7,320,3,4,0.56
7,1,overall,7,321,1,6,0.68
7,1,oversee,7,322,4,3,0.48
7,1,pace,4,323,0,4,0.44
7,1,page,4,324,2,2,0.44
7,1,painful,7,325,2,5,0.64
7,1,palace,6,326,2,4,0.52
7,1,parade,6,327,2,4,0.52
7,1,park,4,328,3,1,0.28
7,1,partial,7,329,3,4,0.68
7,1,patent,6,330,2,4,0.52
7,1,patron,6,331,3,3,0.52
7,1,pause,5,332,2,3,0.4
7,1,perfect,7,333,1,6,0.76
7,1,perhaps,7,334,3,4,0.56
7,1,photo,5,335,1,4,0.48
7,1,pick,4,336,1,3,0.4
7,1,piece,5,337,2,3,0.4
7,1,pin,3,338,2,1,0.36
7,1,place,5,339,1,4,0.48
7,1,plan,4,340,3,1,0.28
7,1,plane,5,341,4,1,0.32
7,1,pleased,7,342,2,5,0.64
7,1,pledge,6,343,3,3,0.56
7,1,plot,4,344,2,2,0.36
7,1,pond,4,345,1,3,0.44
7,1,portion,7,346,2,5,0.72
7,1,possess,7,347,2,5,0.72
7,1,post,4,348,3,1,0.4
7,1,praise,6,349,1,5,0.6
7,1,prayer,6,350,3,3,0.52
7,1,precise,7,351,2,5,0.64
7,1,predict,7,352,3,4,0.72
7,1,premise,7,353,3,4,0.6
7,1,printer,7,354,2,5,0.64
7,1,punk,4,355,1,3,0.4
7,1,purpose,7,356,2,5,0.64
7,1,push,4,357,2,2,0.44
7,1,put,3,358,2,1,0.24
7,1,puzzle,6,359,2,4,0.52
7,1,quite,5,360,0,5,0.52
7,1,race,4,361,0,4,0.44
7,1,racial,6,362,3,3,0.56
7,1,rail,4,363,2,2,0.36
7,1,raise,5,364,3,2,0.36
7,1,react,5,365,1,4,0.48
7,1,rear,4,366,3,1,0.28
7,1,recall,6,367,2,4,0.52
7,1,refuse,6,368,2,4,0.72
7,1,regard,6,369,2,4,0.6
7,1,region,6,370,3,3,0.56
7,1,relax,5,371,2,3,0.48
7,1,remark,6,372,2,4,0.68
7,1,replace,7,373,2,5,0.64
7,1,reside,6,374,2,4,0.52
7,1,residue,7,375,5,2,0.48
7,1,rest,4,376,3,1,0.28
7,1,retail,6,377,2,4,0.64
7,1,revive,6,378,2,4,0.52
7,1,rifle,5,379,1,4,0.48
7,1,right,5,380,2,3,0.4
7,1,rise,4,381,2,2,0.32
7,1,ritual,6,382,2,4,0.68
7,1,rob,3,383,1,2,0.32
7,1,robbery,7,384,3,4,0.6
7,1,roll,4,385,2,2,0.36
7,1,romance,7,386,2,5,0.68
7,1,rotate,6,387,2,4,0.64
7,1,rough,5,388,2,3,0.44
7,1,routine,7,389,3,4,0.56
7,1,rubbish,7,390,1,6,0.68
7,1,ruin,4,391,2,2,0.44
7,1,safe,4,392,0,4,0.44
7,1,salt,4,393,2,2,0.32
7,1,sample,6,394,2,4,0.52
7,1,satisfy,7,395,2,5,0.6
7,1,scan,4,396,1,3,0.48
7,1,scared,6,397,3,3,0.44
7,1,score,5,398,2,3,0.4
7,1,secure,6,399,1,5,0.56
7,1,seminar,7,400,2,5,0.6
7,1,service,7,401,2,5,0.72
7,1,setting,7,402,2,5,0.64
7,1,settler,7,403,4,3,0.48
7,1,seven,5,404,2,3,0.4
7,1,sexual,6,405,2,4,0.64
7,1,share,5,406,1,4,0.48
7,1,shiny,5,407,2,3,0.44
7,1,ship,4,408,3,1,0.28
7,1,shortly,7,409,2,5,0.64
7,1,sight,5,410,1,4,0.56
7,1,singing,7,411,2,5,0.6
7,1,sit,3,412,2,1,0.24
7,1,six,3,413,2,1,0.24
7,1,slice,5,414,1,4,0.48
7,1,snow,4,415,1,3,0.48
7,1,soap,4,416,1,3,0.4
7,1,solo,4,417,2,2,0.32
7,1,some,4,418,2,2,0.32
7,1,somehow,7,419,4,3,0.6
7,1,someone,7,420,4,3,0.6
7,1,soup,4,421,2,2,0.44
7,1,speak,5,422,1,4,0.52
7,1,speaker,7,423,5,2,0.48
7,1,specify,7,424,3,4,0.64
7,1,sphere,6,425,2,4,0.68
7,1,spine,5,426,2,3,0.44
7,1,spread,6,427,2,4,0.52
7,1,stab,4,428,1,3,0.36
7,1,stable,6,429,4,2,0.4
7,1,stall,5,430,3,2,0.48
7,1,steer,5,431,2,3,0.48
7,1,stick,5,432,2,3,0.48
7,1,storage,7,433,2,5,0.72
7,1,store,5,434,4,1,0.36
7,1,street,6,435,2,4,0.64
7,1,stretch,7,436,4,3,0.52
7,1,stun,4,437,2,2,0.32
7,1,such,4,438,1,3,0.4
7,1,suppose,7,439,2,5,0.64
7,1,supreme,7,440,3,4,0.6
7,1,swallow,7,441,1,6,0.28
7,1,swear,5,442,2,3,0.2
7,1,swim,4,443,2,2,0.16
7,1,talent,6,444,0,6,0.28
7,1,tap,3,445,2,1,0.16
7,1,tape,4,446,3,1,0.12
7,1,task,4,447,2,2,0.16
7,1,taste,5,448,3,2,0.16
7,1,taxi,4,449,2,2,0.16
7,1,tea,3,450,1,2,0.12
7,1,tender,6,451,2,4,0.28
7,1,tension,7,452,3,4,0.24
7,1,terror,6,453,2,4,0.24
7,1,thesis,6,454,1,5,0.24
7,1,this,4,455,2,2,0.12
7,1,thumb,5,456,2,3,0.24
7,1,ticket,6,457,1,5,0.24
7,1,tight,5,458,2,3,0.2
7,1,to,2,459,1,1,0.08
7,1,tonight,7,460,2,5,0.28
7,1,tonne,5,461,3,2,0.24
7,1,tool,4,462,2,2,0.16
7,1,torture,7,463,2,5,0.24
7,1,tour,4,464,2,2,0.16
7,1,tragic,6,465,1,5,0.24
7,1,trainer,7,466,3,4,0.32
7,1,treaty,6,467,2,4,0.2
7,1,tree,4,468,3,1,0.12
7,1,trend,5,469,3,2,0.16
7,1,trial,5,470,2,3,0.16
7,1,tribal,6,471,3,3,0.28
7,1,tribute,7,472,4,3,0.2
7,1,trio,4,473,3,1,0.12
7,1,trouble,7,474,2,5,0.24
7,1,truck,5,475,2,3,0.24
7,1,tune,4,476,1,3,0.16
7,1,unable,6,477,0,6,0.28
7,1,union,5,478,2,3,0.16
7,1,unique,6,479,3,3,0.2
7,1,unveil,6,480,2,4,0.32
7,1,upon,4,481,1,3,0.16
7,1,usage,5,482,1,4,0.2
7,1,usual,5,483,2,3,0.2
7,1,utility,7,484,1,6,0.28
7,1,variety,7,485,0,7,0.36
7,1,vary,4,486,3,1,0.16
7,1,venture,7,487,1,6,0.28
7,1,vessel,6,488,2,4,0.24
7,1,veteran,7,489,2,5,0.32
7,1,viable,6,490,1,5,0.24
7,1,video,5,491,2,3,0.2
7,1,viewer,6,492,2,4,0.2
7,1,virtual,7,493,2,5,0.24
7,1,visitor,7,494,2,5,0.32
7,1,vocal,5,495,1,4,0.2
7,1,voice,5,496,2,3,0.2
7,1,wait,4,497,0,4,0.2
7,1,waiter,6,498,4,2,0.24
7,1,wake,4,499,2,2,0.12
7,1,warrior,7,500,2,5,0.32
7,1,washing,7,501,2,5,0.32
7,1,watch,5,502,2,3,0.2
7,1,water,5,503,3,2,0.24
7,1,wealthy,7,504,1,6,0.28
7,1,weapon,6,505,3,3,0.2
7,1,weave,5,506,3,2,0.16
7,1,weird,5,507,2,3,0.2
7,1,welfare,7,508,2,5,0.32
7,1,west,4,509,2,2,0.12
7,1,which,5,510,1,4,0.2
7,1,whose,5,511,2,3,0.2
7,1,width,5,512,1,4,0.2
7,1,win,3,513,2,1,0.16
7,1,window,6,514,3,3,0.24
7,1,wine,4,515,3,1,0.12
7,1,within,6,516,2,4,0.24
7,1,world,5,517,1,4,0.24
7,1,worry,5,518,3,2,0.2
7,1,wow,3,519,2,1,0.08
7,1,written,7,520,1,6,0.28
7,1,young,5,521,0,5,0.24
7,2,absence,7,0,0,7,0.76
7,2,acid,4,1,1,3,0.52
7,2,actress,7,2,2,5,0.72
7,2,ad,2,3,1,1,0.24
7,2,add,3,4,2,1,0.28
7,2,address,7,5,3,4,0.68
7,2,adj,3,6,2,1,0.28
7,2,adopt,5,7,2,3,0.52
7,2,against,7,8,1,6,0.64
7,2,agree,5,9,2,3,0.4
7,2,ahead,5,10,1,4,0.48
7,2,aids,4,11,1,3,0.36
7,2,alcohol,7,12,1,6,0.76
7,2,amateur,7,13,1,6,0.64
7,2,ancient,7,14,1,6,0.68
7,2,anger,5,15,2,3,0.44
7,2,animal,6,16,2,4,0.68
7,2,ankle,5,17,2,3,0.4
7,2,another,7,18,2,5,0.6
7,2,anxiety,7,19,2,5,0.6
7,2,anyway,6,20,2,4,0.64
7,2,apology,7,21,1,6,0.64
7,2,approve,7,22,2,5,0.6
7,2,argue,5,23,1,4,0.48
7,2,army,4,24,2,2,0.44
7,2,arrow,5,25,2,3,0.44
7,2,artist,6,26,2,4,0.52
7,2,assault,7,27,1,6,0.64
7,2,at,2,28,1,1,0.2
7,2,average,7,29,1,6,0.76
7,2,baby,4,30,0,4,0.44
7,2,banner,6,31,2,4,0.56
7,2,barrel,6,32,2,4,0.52
7,2,bat,3,33,2,1,0.24
7,2,bath,4,34,3,1,0.28
7,2,beast,5,35,1,4,0.56
7,2,beat,4,36,3,1,0.28
7,2,bed,3,37,2,1,0.24
7,2,beer,4,38,2,2,0.36
7,2,beg,3,39,2,1,0.32
7,2,belief,6,40,2,4,0.52
7,2,bell,4,41,3,1,0.4
7,2,belong,6,42,3,3,0.48
7,2,below,5,43,4,1,0.32
7,2,best,4,44,2,2,0.32
7,2,between,7,45,2,5,0.6
7,2,beyond,6,46,2,4,0.64
7,2,bird,4,47,1,3,0.44
7,2,biscuit,7,48,2,5,0.72
7,2,bishop,6,49,3,3,0.6
7,2,bitter,6,50,2,4,0.64
7,2,bizarre,7,51,2,5,0.76
7,2,blank,5,52,1,4,0.48
7,2,blog,4,53,2,2,0.32
7,2,blow,4,54,3,1,0.28
7,2,boat,4,55,1,3,0.56
7,2,boom,4,56,2,2,0.44
7,2,bottle,6,57,2,4,0.52
7,2,bound,5,58,2,3,0.44
7,2,breach,6,59,1,5,0.56
7,2,breathe,7,60,4,3,0.52
7,2,buddy,5,61,1,4,0.6
7,2,butter,6,62,2,4,0.52
7,2,cafe,4,63,0,4,0.44
7,2,cake,4,64,2,2,0.32
7,2,can,3,65,2,1,0.24
7,2,cap,3,66,2,1,0.24
7,2,capable,7,67,3,4,0.68
7,2,card,4,68,2,2,0.32
7,2,career,6,69,3,3,0.48
7,2,cartoon,7,70,3,4,0.56
7,2,carve,5,71,3,2,0.48
7,2,cd,2,72,1,1,0.2
7,2,ceiling,7,73,1,6,0.68
7,2,century,7,74,2,5,0.64
7,2,chair,5,75,1,4,0.56
7,2,charity,7,76,3,4,0.68
7,2,chart,5,77,4,1,0.32
7,2,charter,7,78,5,2,0.44
7,2,cheat,5,79,2,3,0.44
7,2,chicken,7,80,2,5,0.72
7,2,choir,5,81,2,3,0.44
7,2,choose,6,82,3,3,0.44
7,2,chop,4,83,3,1,0.28
7,2,city,4,84,1,3,0.4
7,2,clause,6,85,1,5,0.6
7,2,clean,5,86,2,3,0.52
7,2,clerk,5,87,3,2,0.36
7,2,closely,7,88,2,5,0.6
7,2,cluster,7,89,2,5,0.6
7,2,coach,5,90,1,4,0.6
7,2,coffee,6,91,2,4,0.52
7,2,company,7,92,2,5,0.6
7,2,comply,6,93,4,2,0.4
7,2,conceal,7,94,2,5,0.72
7,2,concept,7,95,5,2,0.44
7,2,concert,7,96,5,2,0.44
7,2,conduct,7,97,3,4,0.56
7,2,confer,6,98,3,3,0.48
7,2,confess,7,99,5,2,0.56
7,2,contend,7,100,3,4,0.56
7,2,convey,6,101,3,3,0.48
7,2,cope,4,102,2,2,0.32
7,2,cost,4,103,2,2,0.32
7,2,cottage,7,104,2,5,0.72
7,2,could,5,105,2,3,0.4
7,2,county,6,106,3,3,0.44
7,2,coup,4,107,3,1,0.28
7,2,court,5,108,3,2,0.36
7,2,craft,5,109,1,4,0.6
7,2,crime,5,110,2,3,0.4
7,2,crisis,6,111,3,3,0.44
7,2,cross,5,112,2,3,0.4
7,2,crowded,7,113,3,4,0.68
7,2,crude,5,114,2,3,0.44
7,2,cry,3,115,2,1,0.28
7,2,cycle,5,116,1,4,0.56
7,2,dam,3,117,0,3,0.36
7,2,dare,4,118,2,2,0.36
7,2,deal,4,119,1,3,0.56
7,2,delight,7,120,2,5,0.6
7,2,demon,5,121,2,3,0.44
7,2,dentist,7,122,2,5,0.6
7,2,deposit,7,123,2,5,0.6
7,2,develop,7,124,2,5,0.72
7,2,devil,5,125,3,2,0.36
7,2,diagram,7,126,1,6,0.68
7,2,dictate,7,127,2,5,0.6
7,2,dig,3,128,2,1,0.36
7,2,dinner,6,129,2,4,0.56
7,2,discuss,7,130,2,5,0.6
7,2,distort,7,131,3,4,0.6
7,2,dollar,6,132,1,5,0.68
7,2,drama,5,133,1,4,0.48
7,2,dust,4,134,1,3,0.36
7,2,earth,5,135,0,5,0.52
7,2,editor,6,136,1,5,0.56
7,2,effort,6,137,1,5,0.68
7,2,eighty,6,138,1,5,0.64
7,2,either,6,139,2,4,0.6
7,2,eleven,6,140,1,5,0.68
7,2,embark,6,141,1,5,0.68
7,2,enemy,5,142,1,4,0.48
7,2,enjoy,5,143,2,3,0.4
7,2,enrich,6,144,2,4,0.52
7,2,entry,5,145,2,3,0.44
7,2,euro,4,146,1,3,0.52
7,2,evoke,5,147,1,4,0.48
7,2,examine,7,148,1,6,0.84
7,2,excited,7,149,2,5,0.6
7,2,exit,4,150,2,2,0.4
7,2,expire,6,151,2,4,0.68
7,2,explain,7,152,3,4,0.64
7,2,explode,7,153,4,3,0.56
7,2,exploit,7,154,5,2,0.44
7,2,eye,3,155,1,2,0.32
7,2,faculty,7,156,0,7,0.88
7,2,fail,4,157,2,2,0.36
7,2,failed,6,158,4,2,0.44
7,2,failure,7,159,4,3,0.52
7,2,fair,4,160,3,1,0.4
7,2,fall,4,161,2,2,0.36
7,2,famous,6,162,2,4,0.32
7,2,fantasy,7,163,2,5,0.28
7,2,fat,3,164,2,1,0.12
7,2,fear,4,165,1,3,0.16
7,2,fee,3,166,2,1,0.16
7,2,feeding,7,167,3,4,0.24
7,2,fellow,6,168,2,4,0.24
7,2,fibre,5,169,1,4,0.2
7,2,fiction,7,170,2,5,0.32
7,2,fifty,5,171,2,3,0.16
7,2,finally,7,172,2,5,0.24
7,2,fixed,5,173,2,3,0.2
7,2,flag,4,174,1,3,0.16
7,2,flat,4,175,3,1,0.12
7,2,flee,4,176,2,2,0.2
7,2,flying,6,177,2,4,0.24
7,2,folding,7,178,1,6,0.28
7,2,force,5,179,2,3,0.16
7,2,foreign,7,180,3,4,0.32
7,2,formula,7,181,3,4,0.24
7,2,fortune,7,182,3,4,0.24
7,2,foster,6,183,2,4,0.24
7,2,founder,7,184,2,5,0.32
7,2,fridge,6,185,1,5,0.24
7,2,front,5,186,2,3,0.16
7,2,full,4,187,1,3,0.16
7,2,funding,7,188,2,5,0.24
7,2,fur,3,189,2,1,0.16
7,2,gallery,7,190,0,7,0.32
7,2,gallon,6,191,4,2,0.16
7,2,game,4,192,2,2,0.16
7,2,gaming,6,193,3,3,0.2
7,2,gender,6,194,1,5,0.32
7,2,gene,4,195,3,1,0.12
7,2,genetic,7,196,4,3,0.2
7,2,giant,5,197,1,4,0.2
7,2,give,4,198,2,2,0.16
7,2,govern,6,199,1,5,0.32
7,2,grace,5,200,1,4,0.2
7,2,gravity,7,201,3,4,0.24
7,2,green,5,202,2,3,0.16
7,2,greet,5,203,4,1,0.12
7,2,grey,4,204,3,1,0.2
7,2,grid,4,205,2,2,0.16
7,2,grief,5,206,3,2,0.16
7,2,grind,5,207,3,2,0.16
7,2,ground,6,208,2,4,0.24
7,2,growth,6,209,3,3,0.28
7,2,guest,5,210,1,4,0.2
7,2,guitar,6,211,2,4,0.24
7,2,happen,6,212,0,6,0.28
7,2,harm,4,213,2,2,0.16
7,2,harsh,5,214,3,2,0.2
7,2,harvest,7,215,3,4,0.24
7,2,hazard,6,216,2,4,0.2
7,2,herb,4,217,1,3,0.16
7,2,highly,6,218,1,5,0.24
7,2,hint,4,219,2,2,0.2
7,2,holiday,7,220,1,6,0.28
7,2,honesty,7,221,2,5,0.24
7,2,how,3,222,2,1,0.12
7,2,however,7,223,3,4,0.24
7,2,humble,6,224,1,5,0.32
7,2,hunger,6,225,2,4,0.24
7,2,hunt,4,226,3,1,0.12
7,2,ice,3,227,0,3,0.16
7,2,icon,4,228,2,2,0.16
7,2,ideal,5,229,1,4,0.28
7,2,ill,3,230,1,2,0.12
7,2,illegal,7,231,3,4,0.24
7,2,image,5,232,1,4,0.2
7,2,imagery,7,233,5,2,0.2
7,2,include,7,234,1,6,0.36
7,2,incur,5,235,3,2,0.16
7,2,index,5,236,2,3,0.2
7,2,inject,6,237,2,4,0.24
7,2,injury,6,238,3,3,0.28
7,2,inspect,7,239,2,5,0.28
7,2,instant,7,240,3,4,0.24
7,2,intake,6,241,2,4,0.24
7,2,intense,7,242,3,4,0.32
7,2,into,4,243,3,1,0.12
7,2,invest,6,244,2,4,0.2
7,2,involve,7,245,3,4,0.28
7,2,january,7,246,0,7,0.32
7,2,jump,4,247,1,3,0.24
7,2,june,4,248,2,2,0.16
7,2,just,4,249,2,2,0.16
7,2,justify,7,250,4,3,0.2
7,2,kick,4,251,0,4,0.2
7,2,kid,3,252,2,1,0.08
7,2,know,4,253,1,3,0.24
7,2,lad,3,254,0,3,0.16
7,2,lake,4,255,2,2,0.16
7,2,lap,3,256,2,1,0.08
7,2,last,4,257,2,2,0.16
7,2,latest,6,258,2,4,0.2
7,2,layer,5,259,2,3,0.24
7,2,leaflet,7,260,1,6,0.28
7,2,legend,6,261,2,4,0.2
7,2,lens,4,262,2,2,0.16
7,2,lesbian,7,263,2,5,0.24
7,2,lesser,6,264,3,3,0.64
7,2,licence,7,265,1,6,0.92
7,2,limb,4,266,2,2,0.52
7,2,litter,6,267,2,4,0.4
7,2,little,6,268,4,2,0.28
7,2,live,4,269,2,2,0.16
7,2,liver,5,270,4,1,0.16
7,2,local,5,271,1,4,0.28
7,2,log,3,272,2,1,0.12
7,2,long,4,273,2,2,0.16
7,2,look,4,274,2,2,0.16
7,2,lot,3,275,2,1,0.12
7,2,loudly,6,276,2,4,0.24
7,2,low,3,277,2,1,0.08
7,2,main,4,278,0,4,0.24
7,2,map,3,279,2,1,0.12
7,2,mask,4,280,2,2,0.16
7,2,match,5,281,2,3,0.2
7,2,melody,6,282,1,5,0.24
7,2,mentor,6,283,2,4,0.32
7,2,merely,6,284,2,4,0.24
7,2,method,6,285,2,4,0.24
7,2,metre,5,286,3,2,0.16
7,2,militia,7,287,1,6,0.28
7,2,mind,4,288,2,2,0.2
7,2,mirror,6,289,2,4,0.2
7,2,missing,7,290,2,5,0.28
7,2,mixed,5,291,2,3,0.16
7,2,model,5,292,1,4,0.2
7,2,month,5,293,2,3,0.24
7,2,most,4,294,2,2,0.16
7,2,movie,5,295,2,3,0.2
7,2,museum,6,296,1,5,0.24
7,2,music,5,297,3,2,0.16
7,2,name,4,298,0,4,0.24
7,2,needle,6,299,1,5,0.24
7,2,new,3,300,2,1,0.12
7,2,non,3,301,1,2,0.12
7,2,norm,4,302,2,2,0.16
7,2,north,5,303,3,2,0.16
7,2,nothing,7,304,2,5,0.32
7,2,notice,6,305,3,3,0.28
7,2,notion,6,306,4,2,0.2
7,2,novel,5,307,2,3,0.2
7,2,nut,3,308,1,2,0.12
7,2,obesity,7,309,0,7,0.36
7,2,oblige,6,310,2,4,0.24
7,2,obsess,6,311,2,4,0.24
7,2,ocean,5,312,1,4,0.2
7,2,offend,6,313,1,5,0.32
7,2,one,3,314,1,2,0.12
7,2,option,6,315,1,5,0.24
7,2,ought,5,316,1,4,0.2
7,2,outfit,6,317,2,4,0.2
7,2,outlet,6,318,3,3,0.24
7,2,overall,7,319,1,6,0.28
7,2,oversee,7,320,4,3,0.2
7,2,owe,3,321,1,2,0.12
7,2,pack,4,322,0,4,0.2
7,2,page,4,323,2,2,0.2
7,2,painful,7,324,2,5,0.24
7,2,paint,5,325,4,1,0.12
7,2,parade,6,326,2,4,0.2
7,2,partial,7,327,3,4,0.28
7,2,partner,7,328,4,3,0.2
7,2,patent,6,329,2,4,0.2
7,2,pause,5,330,2,3,0.16
7,2,peer,4,331,1,3,0.16
7,2,pepper,6,332,2,4,0.28
7,2,perfect,7,333,2,5,0.28
7,2,perhaps,7,334,3,4,0.24
7,2,photo,5,335,1,4,0.2
7,2,picture,7,336,1,6,0.36
7,2,pile,4,337,2,2,0.16
7,2,pioneer,7,338,2,5,0.24
7,2,pipe,4,339,2,2,0.16
7,2,plan,4,340,1,3,0.16
7,2,plastic,7,341,3,4,0.28
7,2,plead,5,342,2,3,0.16
7,2,plot,4,343,2,2,0.16
7,2,pond,4,344,1,3,0.16
7,2,post,4,345,2,2,0.16
7,2,poster,6,346,4,2,0.2
7,2,pot,3,347,2,1,0.16
7,2,prayer,6,348,1,5,0.28
7,2,precise,7,349,2,5,0.28
7,2,predict,7,350,3,4,0.24
7,2,premier,7,351,3,4,0.32
7,2,premise,7,352,5,2,0.2
7,2,printer,7,353,2,5,0.28
7,2,prior,5,354,3,2,0.16
7,2,produce,7,355,2,5,0.24
7,2,profile,7,356,3,4,0.28
7,2,proof,5,357,3,2,0.16
7,2,proper,6,358,3,3,0.2
7,2,pump,4,359,1,3,0.16
7,2,put,3,360,2,1,0.12
7,2,quite,5,361,0,5,0.28
7,2,racial,6,362,0,6,0.28
7,2,racism,6,363,4,2,0.16
7,2,radar,5,364,2,3,0.2
7,2,rally,5,365,2,3,0.2
7,2,rating,6,366,2,4,0.28
7,2,react,5,367,1,4,0.2
7,2,record,6,368,2,4,0.2
7,2,recycle,7,369,3,4,0.24
7,2,refer,5,370,2,3,0.24
7,2,referee,7,371,5,2,0.2
7,2,refuse,6,372,3,3,0.2
7,2,region,6,373,2,4,0.2
7,2,relax,5,374,2,3,0.16
7,2,remark,6,375,2,4,0.28
7,2,remind,6,376,3,3,0.2
7,2,removal,7,377,3,4,0.24
7,2,remove,6,378,5,1,0.16
7,2,repeat,6,379,2,4,0.28
7,2,replace,7,380,3,4,0.24
7,2,resolve,7,381,2,5,0.28
7,2,rest,4,382,3,1,0.12
7,2,retire,6,383,2,4,0.2
7,2,revival,7,384,2,5,0.32
7,2,rival,5,385,1,4,0.2
7,2,roll,4,386,1,3,0.16
7,2,romance,7,387,2,5,0.24
7,2,root,4,388,2,2,0.12
7,2,rotate,6,389,2,4,0.28
7,2,routine,7,390,2,5,0.24
7,2,ruin,4,391,1,3,0.16
7,2,salt,4,392,0,4,0.2
7,2,sample,6,393,2,4,0.28
7,2,scan,4,394,1,3,0.16
7,2,scheme,6,395,2,4,0.2
7,2,second,6,396,1,5,0.24
7,2,secret,6,397,3,3,0.2
7,2,secure,6,398,3,3,0.24
7,2,segment,7,399,2,5,0.28
7,2,seminar,7,400,2,5,0.24
7,2,serious,7,401,2,5,0.24
7,2,servant,7,402,3,4,0.28
7,2,serve,5,403,4,1,0.12
7,2,service,7,404,4,3,0.2
7,2,seven,5,405,2,3,0.16
7,2,sexual,6,406,2,4,0.2
7,2,shape,5,407,1,4,0.24
7,2,share,5,408,3,2,0.16
7,2,sheer,5,409,2,3,0.16
7,2,shell,5,410,3,2,0.16
7,2,shift,5,411,2,3,0.2
7,2,shiny,5,412,3,2,0.2
7,2,shoot,5,413,2,3,0.16
7,2,shore,5,414,3,2,0.16
7,2,sibling,7,415,1,6,0.28
7,2,silver,6,416,2,4,0.2
7,2,sin,3,417,2,1,0.16
7,2,singing,7,418,3,4,0.24
7,2,sink,4,419,3,1,0.12
7,2,skirt,5,420,1,4,0.2
7,2,skull,5,421,2,3,0.2
7,2,smoking,7,422,1,6,0.36
7,2,snow,4,423,1,3,0.16
7,2,somehow,7,424,1,6,0.28
7,2,someone,7,425,4,3,0.2
7,2,soup,4,426,2,2,0.12
7,2,south,5,427,3,2,0.24
7,2,space,5,428,1,4,0.2
7,2,speak,5,429,2,3,0.2
7,2,special,7,430,3,4,0.24
7,2,specify,7,431,5,2,0.24
7,2,spin,4,432,2,2,0.16
7,2,stab,4,433,1,3,0.16
7,2,staff,5,434,3,2,0.16
7,2,stall,5,435,3,2,0.16
7,2,stamp,5,436,3,2,0.16
7,2,stance,6,437,3,3,0.24
7,2,stem,4,438,2,2,0.12
7,2,stick,5,439,2,3,0.2
7,2,sticky,6,440,5,1,0.16
7,2,storage,7,441,2,5,0.24
7,2,street,6,442,2,4,0.28
7,2,strict,6,443,3,3,0.2
7,2,string,6,444,4,2,0.16
7,2,strong,6,445,3,3,0.2
7,2,stun,4,446,2,2,0.16
7,2,subject,7,447,1,6,0.32
7,2,such,4,448,2,2,0.16
7,2,sudden,6,449,2,4,0.2
7,2,sugar,5,450,2,3,0.2
7,2,super,5,451,2,3,0.16
7,2,surely,6,452,2,4,0.28
7,2,swallow,7,453,1,6,0.28
7,2,sweater,7,454,2,5,0.24
7,2,switch,6,455,2,4,0.2
7,2,symptom,7,456,1,6,0.36
7,2,tale,4,457,0,4,0.2
7,2,talent,6,458,4,2,0.16
7,2,tank,4,459,2,2,0.12
7,2,tap,3,460,2,1,0.12
7,2,tape,4,461,3,1,0.16
7,2,task,4,462,2,2,0.16
7,2,taxi,4,463,2,2,0.12
7,2,team,4,464,1,3,0.16
7,2,tender,6,465,2,4,0.2
7,2,terrify,7,466,2,5,0.32
7,2,terror,6,467,4,2,0.16
7,2,thirsty,7,468,1,6,0.28
7,2,ticket,6,469,1,5,0.24
7,2,tidy,4,470,2,2,0.16
7,2,timing,6,471,2,4,0.28
7,2,too,3,472,1,2,0.12
7,2,torture,7,473,2,5,0.28
7,2,tour,4,474,2,2,0.12
7,2,tragic,6,475,1,5,0.24
7,2,treat,5,476,2,3,0.24
7,2,tree,4,477,3,1,0.12
7,2,trend,5,478,3,2,0.16
7,2,tribal,6,479,2,4,0.24
7,2,tribe,5,480,4,1,0.12
7,2,tribute,7,481,4,3,0.28
7,2,truck,5,482,2,3,0.16
7,2,unable,6,483,0,6,0.28
7,2,undergo,7,484,2,5,0.24
7,2,unify,5,485,2,3,0.2
7,2,union,5,486,3,2,0.2
7,2,unusual,7,487,2,5,0.28
7,2,uphold,6,488,1,5,0.24
7,2,usage,5,489,1,4,0.2
7,2,vague,5,490,0,5,0.28
7,2,vein,4,491,1,3,0.16
7,2,viable,6,492,1,5,0.24
7,2,video,5,493,2,3,0.16
7,2,violent,7,494,2,5,0.28
7,2,virtual,7,495,2,5,0.32
7,2,virtue,6,496,5,1,0.16
7,2,virus,5,497,3,2,0.16
7,2,visual,6,498,2,4,0.2
7,2,vital,5,499,2,3,0.16
7,2,vocal,5,500,1,4,0.28
7,2,wake,4,501,0,4,0.2
7,2,walk,4,502,2,2,0.12
7,2,warning,7,503,2,5,0.28
7,2,warrior,7,504,3,4,0.28
7,2,washing,7,505,2,5,0.28
7,2,whereas,7,506,1,6,0.28
7,2,which,5,507,2,3,0.16
7,2,whose,5,508,2,3,0.2
7,2,width,5,509,1,4,0.28
7,2,window,6,510,2,4,0.2
7,2,wine,4,511,3,1,0.12
7,2,within,6,512,2,4,0.24
7,2,without,7,513,4,3,0.2
7,2,woman,5,514,1,4,0.28
7,2,word,4,515,2,2,0.12
7,2,work,4,516,3,1,0.12
7,2,world,5,517,3,2,0.16
7,2,worry,5,518,3,2,0.16
7,2,wow,3,519,2,1,0.12
7,2,written,7,520,1,6,0.32
7,2,young,5,521,0,5,0.24
7,3,a,1,0,0,1,0.16
7,3,absence,7,1,1,6,0.68
7,3,absorb,6,2,3,3,0.48
7,3,accept,6,3,1,5,0.76
7,3,ad,2,4,1,1,0.24
7,3,add,3,5,2,1,0.28
7,3,address,7,6,3,4,0.6
7,3,admit,5,7,2,3,0.4
7,3,adopt,5,8,2,3,0.52
7,3,advice,6,9,2,4,0.52
7,3,again,5,10,1,4,0.48
7,3,ally,4,11,1,3,0.48
7,3,analyse,7,12,1,6,0.72
7,3,and,3,13,2,1,0.36
7,3,ankle,5,14,2,3,0.4
7,3,annoyed,7,15,2,5,0.6
7,3,another,7,16,2,5,0.6
7,3,anxiety,7,17,2,5,0.72
7,3,anyway,6,18,2,4,0.56
7,3,apology,7,19,1,6,0.64
7,3,app,3,20,2,1,0.24
7,3,applaud,7,21,3,4,0.56
7,3,approve,7,22,3,4,0.64
7,3,argue,5,23,1,4,0.48
7,3,arise,5,24,2,3,0.4
7,3,army,4,25,2,2,0.32
7,3,around,6,26,2,4,0.52
7,3,arrow,5,27,2,3,0.52
7,3,artist,6,28,2,4,0.52
7,3,attract,7,29,1,6,0.68
7,3,auction,7,30,1,6,0.68
7,3,backing,7,31,0,7,0.84
7,3,ballet,6,32,2,4,0.52
7,3,banner,6,33,2,4,0.56
7,3,bay,3,34,2,1,0.24
7,3,beat,4,35,1,3,0.36
7,3,bed,3,36,2,1,0.32
7,3,beer,4,37,2,2,0.32
7,3,behalf,6,38,2,4,0.56
7,3,bell,4,39,2,2,0.32
7,3,belong,6,40,3,3,0.44
7,3,below,5,41,4,1,0.32
7,3,bin,3,42,1,2,0.4
7,3,bird,4,43,2,2,0.32
7,3,biscuit,7,44,2,5,0.6
7,3,bite,4,45,2,2,0.56
7,3,bitter,6,46,3,3,0.72
7,3,blade,5,47,1,4,0.6
7,3,boat,4,48,1,3,0.44
7,3,bother,6,49,2,4,0.68
7,3,bottle,6,50,3,3,0.52
7,3,box,3,51,2,1,0.24
7,3,bride,5,52,1,4,0.6
7,3,bridge,6,53,4,2,0.4
7,3,buddy,5,54,1,4,0.48
7,3,buffer,6,55,2,4,0.52
7,3,bug,3,56,2,1,0.24
7,3,build,5,57,2,3,0.4
7,3,burden,6,58,2,4,0.64
7,3,can,3,59,0,3,0.36
7,3,capable,7,60,2,5,0.64
7,3,card,4,61,2,2,0.32
7,3,cartoon,7,62,3,4,0.64
7,3,carve,5,63,3,2,0.36
7,3,cave,4,64,2,2,0.32
7,3,cd,2,65,1,1,0.2
7,3,ceiling,7,66,1,6,0.64
7,3,chair,5,67,1,4,0.48
7,3,chart,5,68,3,2,0.48
7,3,cheat,5,69,2,3,0.4
7,3,chicken,7,70,2,5,0.6
7,3,choose,6,71,2,4,0.52
7,3,chop,4,72,3,1,0.32
7,3,chronic,7,73,2,5,0.8
7,3,circle,6,74,1,5,0.6
7,3,circuit,7,75,4,3,0.52
7,3,city,4,76,2,2,0.4
7,3,clarity,7,77,1,6,0.6
7,3,clause,6,78,3,3,0.24
7,3,clean,5,79,2,3,0.2
7,3,clerk,5,80,3,2,0.16
7,3,coach,5,81,1,4,0.2
7,3,comedy,6,82,2,4,0.28
7,3,comment,7,83,3,4,0.24
7,3,comply,6,84,3,3,0.2
7,3,concern,7,85,2,5,0.28
7,3,confer,6,86,3,3,0.28
7,3,confess,7,87,5,2,0.2
7,3,consent,7,88,3,4,0.24
7,3,cope,4,89,2,2,0.16
7,3,counter,7,90,2,5,0.28
7,3,couple,6,91,3,3,0.28
7,3,create,6,92,1,5,0.24
7,3,creep,5,93,3,2,0.16
7,3,crisis,6,94,2,4,0.24
7,3,crowd,5,95,2,3,0.24
7,3,cruel,5,96,2,3,0.2
7,3,cry,3,97,2,1,0.12
7,3,dam,3,98,0,3,0.16
7,3,dance,5,99,2,3,0.2
7,3,dare,4,100,2,2,0.16
7,3,deal,4,101,1,3,0.24
7,3,death,5,102,3,2,0.16
7,3,decline,7,103,2,5,0.28
7,3,deliver,7,104,2,5,0.28
7,3,dentist,7,105,2,5,0.28
7,3,deputy,6,106,2,4,0.28
7,3,desktop,7,107,2,5,0.24
7,3,despite,7,108,3,4,0.24
7,3,devil,5,109,2,3,0.16
7,3,dictate,7,110,1,6,0.36
7,3,dinner,6,111,2,4,0.2
7,3,dirty,5,112,2,3,0.2
7,3,discuss,7,113,2,5,0.24
7,3,display,7,114,3,4,0.32
7,3,double,6,115,1,5,0.24
7,3,drama,5,116,1,4,0.2
7,3,ear,3,117,0,3,0.16
7,3,edition,7,118,1,6,0.28
7,3,editor,6,119,4,2,0.28
7,3,eight,5,120,1,4,0.2
7,3,either,6,121,2,4,0.24
7,3,elect,5,122,1,4,0.2
7,3,eleven,6,123,3,3,0.28
7,3,embark,6,124,1,5,0.24
7,3,enable,6,125,1,5,0.24
7,3,enrich,6,126,2,4,0.24
7,3,enter,5,127,2,3,0.2
7,3,entitle,7,128,3,4,0.28
7,3,essence,7,129,1,6,0.32
7,3,euro,4,130,1,3,0.2
7,3,event,5,131,1,4,0.24
7,3,evoke,5,132,2,3,0.28
7,3,exceed,6,133,1,5,0.32
7,3,excuse,6,134,3,3,0.24
7,3,expire,6,135,2,4,0.24
7,3,explain,7,136,3,4,0.36
7,3,extend,6,137,2,4,0.32
7,3,eye,3,138,1,2,0.12
7,3,fail,4,139,0,4,0.28
7,3,failed,6,140,4,2,0.2
7,3,fall,4,141,2,2,0.16
7,3,fantasy,7,142,2,5,0.48
7,3,fast,4,143,2,2,0.16
7,3,fat,3,144,2,1,0.16
7,3,feeding,7,145,1,6,0.8
7,3,fiction,7,146,1,6,0.68
7,3,fifty,5,147,2,3,0.32
7,3,fight,5,148,2,3,0.24
7,3,fine,4,149,2,2,0.24
7,3,fix,3,150,2,1,0.2
7,3,fixed,5,151,3,2,0.28
7,3,fixture,7,152,3,4,0.28
7,3,flavour,7,153,1,6,0.44
7,3,flee,4,154,2,2,0.16
7,3,flower,6,155,2,4,0.32
7,3,flu,3,156,2,1,0.2
7,3,flying,6,157,2,4,0.48
7,3,folk,4,158,1,3,0.56
7,3,food,4,159,2,2,0.28
7,3,for,3,160,2,1,0.2
7,3,foreign,7,161,3,4,0.6
7,3,former,6,162,3,3,0.32
7,3,fortune,7,163,3,4,0.56
7,3,forward,7,164,3,4,0.32
7,3,foster,6,165,2,4,0.32
7,3,founder,7,166,2,5,0.28
7,3,freedom,7,167,1,6,0.48
7,3,friday,6,168,2,4,0.32
7,3,fulfil,6,169,1,5,0.32
7,3,funding,7,170,2,5,0.28
7,3,gallery,7,171,0,7,0.44
7,3,garage,6,172,2,4,0.24
7,3,gender,6,173,1,5,0.32
7,3,gene,4,174,3,1,0.12
7,3,genetic,7,175,4,3,0.48
7,3,giant,5,176,1,4,0.24
7,3,give,4,177,2,2,0.2
7,3,glass,5,178,1,4,0.24
7,3,go,2,179,1,1,0.12
7,3,govern,6,180,2,4,0.28
7,3,grade,5,181,1,4,0.32
7,3,green,5,182,2,3,0.2
7,3,greet,5,183,4,1,0.2
7,3,grey,4,184,3,1,0.12
7,3,grid,4,185,2,2,0.16
7,3,grief,5,186,3,2,0.2
7,3,ground,6,187,2,4,0.32
7,3,growth,6,188,3,3,0.2
7,3,guest,5,189,1,4,0.24
7,3,gym,3,190,1,2,0.12
7,3,handy,5,191,0,5,0.28
7,3,happen,6,192,2,4,0.32
7,3,harbour,7,193,2,5,0.28
7,3,harm,4,194,3,1,0.12
7,3,hat,3,195,2,1,0.16
7,3,hazard,6,196,2,4,0.36
7,3,health,6,197,1,5,0.4
7,3,heart,5,198,3,2,0.2
7,3,her,3,199,2,1,0.12
7,3,herb,4,200,3,1,0.12
7,3,hers,4,201,3,1,0.12
7,3,hint,4,202,1,3,0.16
7,3,honesty,7,203,1,6,0.4
7,3,horror,6,204,2,4,0.24
7,3,hotel,5,205,2,3,0.24
7,3,hour,4,206,2,2,0.16
7,3,how,3,207,2,1,0.12
7,3,however,7,208,3,4,0.32
7,3,humble,6,209,1,5,0.28
7,3,hunger,6,210,2,4,0.24
7,3,i,1,211,0,1,0.08
7,3,ice,3,212,1,2,0.12
7,3,ill,3,213,1,2,0.12
7,3,illegal,7,214,3,4,0.32
7,3,imagery,7,215,1,6,0.36
7,3,import,6,216,2,4,0.28
7,3,improve,7,217,3,4,0.28
7,3,incur,5,218,1,4,0.32
7,3,index,5,219,2,3,0.2
7,3,infant,6,220,2,4,0.24
7,3,inform,6,221,3,3,0.24
7,3,inject,6,222,2,4,0.24
7,3,insert,6,223,2,4,0.28
7,3,inspect,7,224,3,4,0.24
7,3,intense,7,225,2,5,0.24
7,3,invade,6,226,2,4,0.24
7,3,invest,6,227,3,3,0.28
7,3,involve,7,228,3,4,0.24
7,3,iron,4,229,1,3,0.2
7,3,island,6,230,1,5,0.28
7,3,issue,5,231,2,3,0.28
7,3,january,7,232,0,7,0.36
7,3,job,3,233,1,2,0.12
7,3,joy,3,234,2,1,0.12
7,3,jump,4,235,1,3,0.16
7,3,just,4,236,2,2,0.16
7,3,kick,4,237,0,4,0.28
7,3,kid,3,238,2,1,0.12
7,3,kidney,6,239,3,3,0.28
7,3,kingdom,7,240,2,5,0.48
7,3,kit,3,241,2,1,0.24
7,3,knife,5,242,1,4,0.28
7,3,know,4,243,2,2,0.24
7,3,lap,3,244,0,3,0.16
7,3,laugh,5,245,2,3,0.2
7,3,law,3,246,2,1,0.12
7,3,layer,5,247,2,3,0.2
7,3,leading,7,248,1,6,0.36
7,3,leaflet,7,249,3,4,0.24
7,3,legend,6,250,2,4,0.32
7,3,lemon,5,251,2,3,0.2
7,3,lesbian,7,252,2,5,0.28
7,3,lethal,6,253,2,4,0.32
7,3,letter,6,254,3,3,0.24
7,3,license,7,255,1,6,0.36
7,3,limited,7,256,2,5,0.36
7,3,link,4,257,2,2,0.24
7,3,live,4,258,2,2,0.16
7,3,load,4,259,1,3,0.2
7,3,located,7,260,2,5,0.28
7,3,log,3,261,2,1,0.12
7,3,lonely,6,262,2,4,0.32
7,3,lot,3,263,2,1,0.12
7,3,low,3,264,2,1,0.12
7,3,main,4,265,0,4,0.2
7,3,marine,6,266,2,4,0.4
7,3,mark,4,267,3,1,0.16
7,3,maximum,7,268,2,5,0.44
7,3,meal,4,269,1,3,0.16
7,3,mean,4,270,3,1,0.12
7,3,melody,6,271,2,4,0.24
7,3,mention,7,272,2,5,0.28
7,3,merely,6,273,2,4,0.32
7,3,mind,4,274,1,3,0.16
7,3,mirror,6,275,2,4,0.24
7,3,missing,7,276,2,5,0.32
7,3,mixed,5,277,2,3,0.2
7,3,model,5,278,1,4,0.32
7,3,modify,6,279,3,3,0.2
7,3,month,5,280,2,3,0.2
7,3,more,4,281,2,2,0.16
7,3,most,4,282,2,2,0.12
7,3,mother,6,283,2,4,0.44
7,3,mouth,5,284,2,3,0.4
7,3,mum,3,285,1,2,0.24
7,3,museum,6,286,2,4,0.32
7,3,must,4,287,3,1,0.12
7,3,my,2,288,1,1,0.08
7,3,nasty,5,289,0,5,0.48
7,3,nation,6,290,2,4,0.32
7,3,neutral,7,291,1,6,0.36
7,3,new,3,292,2,1,0.12
7,3,newly,5,293,3,2,0.2
7,3,night,5,294,1,4,0.32
7,3,north,5,295,1,4,0.24
7,3,not,3,296,2,1,0.12
7,3,nothing,7,297,3,4,0.28
7,3,notice,6,298,3,3,0.24
7,3,novel,5,299,2,3,0.28
7,3,ocean,5,300,0,5,0.24
7,3,october,7,301,2,5,0.4
7,3,off,3,302,1,2,0.32
7,3,offend,6,303,3,3,0.24
7,3,opposed,7,304,1,6,0.36
7,3,option,6,305,2,4,0.2
7,3,ought,5,306,1,4,0.2
7,3,outdoor,7,307,2,5,0.28
7,3,outing,6,308,3,3,0.28
7,3,outlet,6,309,3,3,0.2
7,3,outlook,7,310,4,3,0.2
7,3,overall,7,311,1,6,0.28
7,3,pack,4,312,0,4,0.2
7,3,painful,7,313,2,5,0.36
7,3,park,4,314,2,2,0.16
7,3,partial,7,315,3,4,0.24
7,3,partner,7,316,4,3,0.24
7,3,pause,5,317,2,3,0.24
7,3,peace,5,318,1,4,0.24
7,3,peer,4,319,2,2,0.16
7,3,perfect,7,320,2,5,0.28
7,3,picture,7,321,1,6,0.28
7,3,piece,5,322,2,3,0.24
7,3,pile,4,323,2,2,0.16
7,3,pipe,4,324,2,2,0.16
7,3,place,5,325,1,4,0.2
7,3,plan,4,326,3,1,0.12
7,3,plane,5,327,4,1,0.2
7,3,plastic,7,328,3,4,0.24
7,3,play,4,329,3,1,0.12
7,3,pleased,7,330,2,5,0.28
7,3,pledge,6,331,3,3,0.2
7,3,plot,4,332,2,2,0.2
7,3,point,5,333,1,4,0.2
7,3,pond,4,334,2,2,0.16
7,3,portion,7,335,2,5,0.28
7,3,possess,7,336,2,5,0.28
7,3,post,4,337,3,1,0.2
7,3,poster,6,338,4,2,0.2
7,3,praise,6,339,1,5,0.24
7,3,prayer,6,340,3,3,0.2
7,3,precise,7,341,2,5,0.28
7,3,printer,7,342,2,5,0.36
7,3,process,7,343,2,5,0.32
7,3,produce,7,344,3,4,0.24
7,3,product,7,345,6,1,0.2
7,3,program,7,346,3,4,0.32
7,3,project,7,347,3,4,0.24
7,3,proper,6,348,3,3,0.2
7,3,propose,7,349,4,3,0.2
7,3,protest,7,350,3,4,0.32
7,3,pump,4,351,1,3,0.16
7,3,purpose,7,352,2,5,0.28
7,3,push,4,353,2,2,0.16
7,3,put,3,354,2,1,0.12
7,3,quality,7,355,0,7,0.4
7,3,quest,5,356,2,3,0.16
7,3,race,4,357,0,4,0.2
7,3,racial,6,358,3,3,0.2
7,3,rear,4,359,1,3,0.16
7,3,rebel,5,360,2,3,0.24
7,3,recall,6,361,2,4,0.24
7,3,record,6,362,3,3,0.24
7,3,recount,7,363,4,3,0.24
7,3,recruit,7,364,3,4,0.32
7,3,recycle,7,365,3,4,0.24
7,3,refer,5,366,2,3,0.2
7,3,refuse,6,367,3,3,0.2
7,3,region,6,368,2,4,0.24
7,3,reign,5,369,2,3,0.28
7,3,relax,5,370,2,3,0.16
7,3,relaxed,7,371,5,2,0.2
7,3,remark,6,372,2,4,0.24
7,3,removal,7,373,3,4,0.32
7,3,renew,5,374,2,3,0.2
7,3,repeat,6,375,2,4,0.24
7,3,replace,7,376,3,4,0.24
7,3,resolve,7,377,2,5,0.28
7,3,retire,6,378,2,4,0.28
7,3,reveal,6,379,2,4,0.24
7,3,revenge,7,380,4,3,0.2
7,3,revise,6,381,3,3,0.2
7,3,revival,7,382,4,3,0.28
7,3,rise,4,383,1,3,0.16
7,3,rival,5,384,2,3,0.16
7,3,road,4,385,1,3,0.16
7,3,rob,3,386,2,1,0.08
7,3,roll,4,387,2,2,0.12
7,3,root,4,388,2,2,0.2
7,3,rough,5,389,2,3,0.2
7,3,round,5,390,3,2,0.16
7,3,routine,7,391,3,4,0.24
7,3,rub,3,392,1,2,0.12
7,3,rubber,6,393,3,3,0.28
7,3,rubbish,7,394,4,3,0.2
7,3,sacred,6,395,0,6,0.28
7,3,sailor,6,396,2,4,0.2
7,3,sample,6,397,2,4,0.28
7,3,sand,4,398,2,2,0.16
7,3,satisfy,7,399,2,5,0.24
7,3,seal,4,400,1,3,0.16
7,3,secret,6,401,2,4,0.24
7,3,seem,4,402,2,2,0.12
7,3,serious,7,403,2,5,0.36
7,3,serve,5,404,3,2,0.16
7,3,shallow,7,405,1,6,0.32
7,3,shape,5,406,3,2,0.28
7,3,share,5,407,3,2,0.48
7,3,sheer,5,408,2,3,0.44
7,3,shell,5,409,3,2,0.36
7,3,shoot,5,410,2,3,0.44
7,3,shore,5,411,3,2,0.36
7,3,sibling,7,412,1,6,0.76
7,3,singing,7,413,2,5,0.6
7,3,sister,6,414,2,4,0.52
7,3,sit,3,415,2,1,0.24
7,3,skip,4,416,1,3,0.36
7,3,slam,4,417,1,3,0.48
7,3,slice,5,418,2,3,0.48
7,3,slip,4,419,3,1,0.32
7,3,smile,5,420,1,4,0.48
7,3,smoking,7,421,2,5,0.6
7,3,snow,4,422,1,3,0.36
7,3,solar,5,423,1,4,0.6
7,3,solid,5,424,3,2,0.4
7,3,somehow,7,425,2,5,0.6
7,3,soup,4,426,2,2,0.32
7,3,south,5,427,3,2,0.36
7,3,space,5,428,1,4,0.6
7,3,spare,5,429,3,2,0.36
7,3,spin,4,430,2,2,0.36
7,3,spine,5,431,4,1,0.32
7,3,spread,6,432,2,4,0.52
7,3,stab,4,433,1,3,0.48
7,3,staff,5,434,3,2,0.36
7,3,stall,5,435,3,2,0.36
7,3,stand,5,436,3,2,0.4
7,3,star,4,437,3,1,0.28
7,3,statue,6,438,3,3,0.6
7,3,steer,5,439,2,3,0.48
7,3,stem,4,440,3,1,0.36
7,3,stick,5,441,2,3,0.52
7,3,sticky,6,442,5,1,0.44
7,3,stop,4,443,2,2,0.36
7,3,storage,7,444,3,4,0.72
7,3,street,6,445,2,4,0.52
7,3,stretch,7,446,4,3,0.52
7,3,strike,6,447,3,3,0.48
7,3,study,5,448,2,3,0.52
7,3,stumble,7,449,3,4,0.56
7,3,stun,4,450,3,1,0.28
7,3,such,4,451,1,3,0.4
7,3,super,5,452,2,3,0.44
7,3,sure,4,453,2,2,0.32
7,3,swallow,7,454,1,6,0.8
7,3,sweater,7,455,2,5,0.64
7,3,sweep,5,456,3,2,0.4
7,3,table,5,457,0,5,0.56
7,3,talent,6,458,2,4,0.64
7,3,talk,4,459,3,1,0.28
7,3,tap,3,460,2,1,0.24
7,3,taxi,4,461,2,2,0.32
7,3,tender,6,462,1,5,0.6
7,3,tension,7,463,3,4,0.6
7,3,terrify,7,464,2,5,0.76
7,3,thesis,6,465,1,5,0.64
7,3,thirsty,7,466,2,5,0.68
7,3,tighten,7,467,1,6,0.76
7,3,till,4,468,2,2,0.44
7,3,timing,6,469,2,4,0.56
7,3,to,2,470,1,1,0.2
7,3,tonight,7,471,2,5,0.64
7,3,tool,4,472,2,2,0.4
7,3,tragic,6,473,1,5,0.72
7,3,trainer,7,474,3,4,0.56
7,3,trap,4,475,3,1,0.28
7,3,tree,4,476,2,2,0.32
7,3,trend,5,477,3,2,0.36
7,3,tribute,7,478,2,5,0.76
7,3,trouble,7,479,2,5,0.64
7,3,truck,5,480,2,3,0.44
7,3,tune,4,481,1,3,0.4
7,3,twice,5,482,1,4,0.48
7,3,two,3,483,2,1,0.32
7,3,unable,6,484,0,6,0.68
7,3,undergo,7,485,2,5,0.64
7,3,unify,5,486,2,3,0.44
7,3,union,5,487,3,2,0.36
7,3,unique,6,488,3,3,0.56
7,3,uphold,6,489,1,5,0.6
7,3,urban,5,490,1,4,0.48
7,3,usual,5,491,1,4,0.52
7,3,utilize,7,492,1,6,0.8
7,3,valley,6,493,0,6,0.72
7,3,vary,4,494,2,2,0.36
7,3,video,5,495,1,4,0.56
7,3,virtual,7,496,2,5,0.64
7,3,virtue,6,497,5,1,0.48
7,3,visitor,7,498,2,5,0.64
7,3,visual,6,499,3,3,0.48
7,3,voice,5,500,1,4,0.48
7,3,warrior,7,501,0,7,0.84
7,3,washing,7,502,2,5,0.6
7,3,weekend,7,503,1,6,0.68
7,3,weird,5,504,2,3,0.44
7,3,whereas,7,505,1,6,0.84
7,3,which,5,506,2,3,0.44
7,3,whose,5,507,2,3,0.44
7,3,wind,4,508,1,3,0.4
7,3,wine,4,509,3,1,0.28
7,3,wipe,4,510,2,2,0.32
7,3,wisdom,6,511,2,4,0.64
7,3,within,6,512,2,4,0.56
7,3,without,7,513,4,3,0.52
7,3,word,4,514,1,3,0.36
7,3,worry,5,515,3,2,0.48
7,3,wow,3,516,2,1,0.24
7,3,wrap,4,517,1,3,0.4
7,3,wrist,5,518,2,3,0.44
7,3,written,7,519,3,4,0.56
7,3,yellow,6,520,0,6,0.64
7,3,young,5,521,1,4,0.6
7,4,a,1,0,0,1,0.16
7,4,absurd,6,1,1,5,0.6
7,4,accept,6,2,1,5,0.6
7,4,acre,4,3,2,2,0.4
7,4,ad,2,4,1,1,0.2
7,4,address,7,5,2,5,0.8
7,4,admit,5,6,2,3,0.56
7,4,adopt,5,7,2,3,0.44
7,4,against,7,8,1,6,0.68
7,4,agree,5,9,2,3,0.56
7,4,ahead,5,10,1,4,0.48
7,4,amateur,7,11,1,6,0.72
7,4,amusing,7,12,2,5,0.68
7,4,analyse,7,13,1,6,0.88
7,4,anger,5,14,2,3,0.44
7,4,annoyed,7,15,2,5,0.68
7,4,another,7,16,2,5,0.6
7,4,anxiety,7,17,2,5,0.72
7,4,apology,7,18,1,6,0.64
7,4,applaud,7,19,2,5,0.44
7,4,approve,7,20,3,4,0.28
7,4,argue,5,21,1,4,0.28
7,4,army,4,22,2,2,0.16
7,4,around,6,23,2,4,0.2
7,4,arrest,6,24,2,4,0.24
7,4,arrow,5,25,3,2,0.16
7,4,assault,7,26,1,6,0.36
7,4,at,2,27,1,1,0.12
7,4,attract,7,28,2,5,0.28
7,4,average,7,29,1,6,0.32
7,4,backing,7,30,0,7,0.32
7,4,balance,7,31,2,5,0.32
7,4,ballet,6,32,3,3,0.2
7,4,barrel,6,33,2,4,0.2
7,4,beast,5,34,1,4,0.2
7,4,beat,4,35,3,1,0.2
7,4,beer,4,36,2,2,0.12
7,4,beg,3,37,2,1,0.08
7,4,behave,6,38,2,4,0.24
7,4,bell,4,39,2,2,0.12
7,4,belong,6,40,3,3,0.2
7,4,between,7,41,2,5,0.32
7,4,beyond,6,42,2,4,0.24
7,4,bin,3,43,1,2,0.12
7,4,bite,4,44,2,2,0.12
7,4,bitter,6,45,3,3,0.2
7,4,bizarre,7,46,2,5,0.36
7,4,blade,5,47,1,4,0.24
7,4,blank,5,48,3,2,0.2
7,4,blog,4,49,2,2,0.16
7,4,blow,4,50,3,1,0.12
7,4,boil,4,51,1,3,0.24
7,4,boom,4,52,2,2,0.16
7,4,boost,5,53,3,2,0.16
7,4,boot,4,54,3,1,0.12
7,4,bother,6,55,2,4,0.24
7,4,bound,5,56,2,3,0.2
7,4,breach,6,57,1,5,0.32
7,4,bride,5,58,2,3,0.2
7,4,bunch,5,59,1,4,0.24
7,4,cafe,4,60,0,4,0.2
7,4,cancer,6,61,2,4,0.24
7,4,cap,3,62,2,1,0.16
7,4,capable,7,63,3,4,0.24
7,4,career,6,64,2,4,0.24
7,4,carpet,6,65,3,3,0.2
7,4,cartoon,7,66,3,4,0.32
7,4,carve,5,67,3,2,0.2
7,4,cd,2,68,1,1,0.08
7,4,certain,7,69,1,6,0.32
7,4,charm,5,70,1,4,0.2
7,4,charter,7,71,4,3,0.32
7,4,cheat,5,72,2,3,0.2
7,4,check,5,73,3,2,0.16
7,4,chicken,7,74,2,5,0.28
7,4,choose,6,75,2,4,0.24
7,4,chop,4,76,3,1,0.2
7,4,chunk,5,77,2,3,0.2
7,4,circle,6,78,1,5,0.28
7,4,cite,4,79,2,2,0.16
7,4,city,4,80,3,1,0.12
7,4,civil,5,81,2,3,0.2
7,4,clarity,7,82,1,6,0.36
7,4,clean,5,83,2,3,0.2
7,4,closely,7,84,2,5,0.28
7,4,cloud,5,85,3,2,0.16
7,4,cluster,7,86,2,5,0.36
7,4,coach,5,87,1,4,0.2
7,4,colony,6,88,2,4,0.24
7,4,comedy,6,89,2,4,0.24
7,4,comment,7,90,3,4,0.32
7,4,concert,7,91,2,5,0.28
7,4,confess,7,92,3,4,0.24
7,4,consent,7,93,3,4,0.24
7,4,consult,7,94,4,3,0.28
7,4,cooker,6,95,2,4,0.24
7,4,cope,4,96,2,2,0.16
7,4,correct,7,97,2,5,0.28
7,4,cost,4,98,2,2,0.16
7,4,cottage,7,99,2,5,0.32
7,4,could,5,100,2,3,0.2
7,4,counter,7,101,3,4,0.24
7,4,coup,4,102,3,1,0.12
7,4,couple,6,103,4,2,0.16
7,4,course,6,104,3,3,0.28
7,4,craft,5,105,1,4,0.24
7,4,creep,5,106,2,3,0.2
7,4,crime,5,107,2,3,0.2
7,4,cross,5,108,2,3,0.2
7,4,crowd,5,109,3,2,0.24
7,4,crude,5,110,2,3,0.2
7,4,cruise,6,111,3,3,0.2
7,4,cry,3,112,2,1,0.12
7,4,current,7,113,1,6,0.28
7,4,cycle,5,114,1,4,0.28
7,4,dam,3,115,0,3,0.16
7,4,dare,4,116,2,2,0.16
7,4,day,3,117,2,1,0.12
7,4,death,5,118,1,4,0.2
7,4,declare,7,119,2,5,0.28
7,4,decline,7,120,4,3,0.28
7,4,deed,4,121,2,2,0.12
7,4,default,7,122,2,5,0.28
7,4,defect,6,123,3,3,0.2
7,4,delight,7,124,2,5,0.36
7,4,desktop,7,125,2,5,0.28
7,4,despite,7,126,3,4,0.24
7,4,detect,6,127,2,4,0.24
7,4,develop,7,128,2,5,0.36
7,4,devil,5,129,3,2,0.16
7,4,dig,3,130,1,2,0.12
7,4,dirty,5,131,2,3,0.2
7,4,discuss,7,132,2,5,0.28
7,4,distant,7,133,3,4,0.32
7,4,dot,3,134,1,2,0.12
7,4,double,6,135,2,4,0.24
7,4,drama,5,136,1,4,0.2
7,4,drawing,7,137,3,4,0.24
7,4,drink,5,138,2,3,0.24
7,4,dust,4,139,1,3,0.16
7,4,edition,7,140,0,7,0.32
7,4,effort,6,141,1,5,0.24
7,4,eight,5,142,1,4,0.28
7,4,eighty,6,143,5,1,0.16
7,4,elect,5,144,1,4,0.2
7,4,empower,7,145,1,6,0.36
7,4,enjoy,5,146,1,4,0.2
7,4,enrich,6,147,2,4,0.32
7,4,enter,5,148,2,3,0.16
7,4,entry,5,149,3,2,0.16
7,4,essay,5,150,1,4,0.2
7,4,evening,7,151,1,6,0.28
7,4,examine,7,152,1,6,0.36
7,4,exceed,6,153,2,4,0.24
7,4,exit,4,154,2,2,0.12
7,4,explain,7,155,2,5,0.28
7,4,exploit,7,156,4,3,0.28
7,4,extend,6,157,2,4,0.24
7,4,extent,6,158,5,1,0.16
7,4,faculty,7,159,0,7,0.32
7,4,failed,6,160,2,4,0.28
7,4,fairly,6,161,3,3,0.2
7,4,fall,4,162,2,2,0.16
7,4,fantasy,7,163,2,5,0.28
7,4,fear,4,164,1,3,0.16
7,4,feeding,7,165,2,5,0.36
7,4,fellow,6,166,2,4,0.24
7,4,fiction,7,167,1,6,0.28
7,4,fix,3,168,2,1,0.12
7,4,fixed,5,169,3,2,0.16
7,4,flat,4,170,1,3,0.24
7,4,flee,4,171,2,2,0.16
7,4,floor,5,172,2,3,0.16
7,4,flu,3,173,2,1,0.12
7,4,focus,5,174,1,4,0.2
7,4,formula,7,175,2,5,0.32
7,4,fortune,7,176,3,4,0.24
7,4,forward,7,177,3,4,0.24
7,4,foster,6,178,2,4,0.24
7,4,front,5,179,1,4,0.2
7,4,fulfil,6,180,1,5,0.32
7,4,full,4,181,3,1,0.12
7,4,funding,7,182,2,5,0.28
7,4,fur,3,183,2,1,0.12
7,4,gallery,7,184,0,7,0.32
7,4,game,4,185,2,2,0.16
7,4,gaming,6,186,3,3,0.2
7,4,gender,6,187,1,5,0.24
7,4,genetic,7,188,3,4,0.24
7,4,genre,5,189,3,2,0.24
7,4,glass,5,190,1,4,0.2
7,4,globe,5,191,2,3,0.16
7,4,go,2,192,1,1,0.08
7,4,golf,4,193,2,2,0.16
7,4,govern,6,194,2,4,0.24
7,4,grace,5,195,1,4,0.28
7,4,green,5,196,2,3,0.2
7,4,grid,4,197,2,2,0.16
7,4,grief,5,198,3,2,0.16
7,4,grin,4,199,3,1,0.12
7,4,grind,5,200,4,1,0.24
7,4,ground,6,201,2,4,0.36
7,4,guess,5,202,1,4,0.52
7,4,guitar,6,203,2,4,0.56
7,4,guy,3,204,2,1,0.28
7,4,gym,3,205,1,2,0.4
7,4,happen,6,206,0,6,1
7,4,harbour,7,207,2,5,0.64
7,4,hat,3,208,2,1,0.32
7,4,hate,4,209,3,1,0.32
7,4,health,6,210,1,5,0.6
7,4,heart,5,211,3,2,0.52
7,4,heat,4,212,3,1,0.28
7,4,hers,4,213,2,2,0.32
7,4,holiday,7,214,1,6,0.68
7,4,horror,6,215,2,4,0.52
7,4,hotel,5,216,2,3,0.56
7,4,hour,4,217,2,2,0.36
7,4,humble,6,218,1,5,0.56
7,4,humour,6,219,3,3,0.48
7,4,icon,4,220,0,4,0.44
7,4,ill,3,221,1,2,0.28
7,4,illegal,7,222,3,4,0.68
7,4,image,5,223,1,4,0.48
7,4,imagery,7,224,5,2,0.44
7,4,incur,5,225,1,4,0.48
7,4,index,5,226,2,3,0.52
7,4,info,4,227,2,2,0.32
7,4,inform,6,228,4,2,0.4
7,4,injure,6,229,2,4,0.52
7,4,injury,6,230,5,1,0.36
7,4,instant,7,231,2,5,0.72
7,4,intake,6,232,2,4,0.52
7,4,intense,7,233,3,4,0.56
7,4,invade,6,234,2,4,0.52
7,4,invest,6,235,3,3,0.56
7,4,involve,7,236,3,4,0.56
7,4,iron,4,237,1,3,0.36
7,4,island,6,238,1,5,0.56
7,4,issue,5,239,2,3,0.44
7,4,january,7,240,0,7,0.84
7,4,jump,4,241,1,3,0.36
7,4,june,4,242,2,2,0.32
7,4,key,3,243,0,3,0.32
7,4,kidney,6,244,1,5,0.56
7,4,king,4,245,2,2,0.44
7,4,kit,3,246,2,1,0.24
7,4,lake,4,247,0,4,0.52
7,4,lap,3,248,2,1,0.28
7,4,last,4,249,2,2,0.4
7,4,latest,6,250,2,4,0.6
7,4,leaflet,7,251,1,6,0.84
7,4,league,6,252,3,3,0.44
7,4,left,4,253,2,2,0.32
7,4,lemon,5,254,2,3,0.4
7,4,lens,4,255,2,2,0.32
7,4,license,7,256,1,6,0.76
7,4,limb,4,257,2,2,0.32
7,4,live,4,258,2,2,0.32
7,4,liver,5,259,4,1,0.32
7,4,load,4,260,1,3,0.36
7,4,local,5,261,2,3,0.4
7,4,located,7,262,4,3,0.6
7,4,lonely,6,263,2,4,0.52
7,4,loose,5,264,2,3,0.48
7,4,lot,3,265,2,1,0.28
7,4,loudly,6,266,2,4,0.56
7,4,love,4,267,2,2,0.48
7,4,lunch,5,268,1,4,0.52
7,4,mandate,7,269,0,7,0.76
7,4,map,3,270,2,1,0.24
7,4,marine,6,271,2,4,0.56
7,4,mark,4,272,3,1,0.48
7,4,mask,4,273,2,2,0.32
7,4,master,6,274,3,3,0.48
7,4,maximum,7,275,2,5,0.68
7,4,meal,4,276,1,3,0.4
7,4,mean,4,277,3,1,0.4
7,4,media,5,278,2,3,0.44
7,4,meeting,7,279,2,5,0.64
7,4,memory,6,280,2,4,0.52
7,4,mental,6,281,2,4,0.52
7,4,mentor,6,282,4,2,0.52
7,4,message,7,283,2,5,0.6
7,4,method,6,284,2,4,0.52
7,4,metre,5,285,3,2,0.36
7,4,militia,7,286,1,6,0.8
7,4,mirror,6,287,2,4,0.52
7,4,missing,7,288,2,5,0.6
7,4,mother,6,289,1,5,0.56
7,4,mouth,5,290,2,3,0.4
7,4,movie,5,291,2,3,0.52
7,4,much,4,292,1,3,0.36
7,4,museum,6,293,2,4,0.52
7,4,my,2,294,1,1,0.2
7,4,naked,5,295,0,5,0.52
7,4,neutral,7,296,1,6,0.8
7,4,newly,5,297,2,3,0.4
7,4,night,5,298,1,4,0.76
7,4,north,5,299,1,4,0.48
7,4,nothing,7,300,2,5,0.6
7,4,notice,6,301,3,3,0.6
7,4,oblige,6,302,0,6,0.6
7,4,obsess,6,303,2,4,0.52
7,4,october,7,304,1,6,0.64
7,4,off,3,305,1,2,0.4
7,4,online,6,306,1,5,0.56
7,4,option,6,307,1,5,0.56
7,4,other,5,308,1,4,0.48
7,4,ought,5,309,1,4,0.48
7,4,outdoor,7,310,2,5,0.76
7,4,outfit,6,311,3,3,0.44
7,4,outing,6,312,3,3,0.48
7,4,outlet,6,313,3,3,0.48
7,4,outlook,7,314,4,3,0.64
7,4,overall,7,315,1,6,0.64
7,4,pace,4,316,0,4,0.44
7,4,pack,4,317,3,1,0.28
7,4,pad,3,318,2,1,0.24
7,4,paint,5,319,2,3,0.52
7,4,palace,6,320,2,4,0.52
7,4,pants,5,321,2,3,0.4
7,4,park,4,322,2,2,0.36
7,4,partner,7,323,3,4,0.56
7,4,patent,6,324,2,4,0.64
7,4,pause,5,325,2,3,0.4
7,4,peace,5,326,1,4,0.48
7,4,peer,4,327,2,2,0.32
7,4,perhaps,7,328,2,5,0.6
7,4,phone,5,329,1,4,0.56
7,4,pick,4,330,1,3,0.4
7,4,pig,3,331,2,1,0.24
7,4,pioneer,7,332,2,5,0.6
7,4,pipe,4,333,2,2,0.32
7,4,plan,4,334,1,3,0.4
7,4,plant,5,335,4,1,0.48
7,4,plastic,7,336,3,4,0.68
7,4,plead,5,337,2,3,0.52
7,4,pleased,7,338,4,3,0.56
7,4,point,5,339,1,4,0.64
7,4,possess,7,340,2,5,0.68
7,4,poster,6,341,3,3,0.52
7,4,prayer,6,342,1,5,0.6
7,4,premise,7,343,2,5,0.6
7,4,process,7,344,2,5,0.72
7,4,product,7,345,3,4,0.56
7,4,profile,7,346,3,4,0.56
7,4,pump,4,347,1,3,0.36
7,4,punk,4,348,2,2,0.44
7,4,pupil,5,349,2,3,0.4
7,4,pure,4,350,2,2,0.32
7,4,pursuit,7,351,3,4,0.56
7,4,push,4,352,2,2,0.32
7,4,query,5,353,0,5,0.64
7,4,radar,5,354,0,5,0.52
7,4,rail,4,355,2,2,0.32
7,4,rally,5,356,2,3,0.4
7,4,rating,6,357,2,4,0.52
7,4,react,5,358,1,4,0.6
7,4,rear,4,359,3,1,0.28
7,4,rebel,5,360,2,3,0.44
7,4,recall,6,361,2,4,0.52
7,4,recount,7,362,3,4,0.56
7,4,recruit,7,363,3,4,0.68
7,4,reduce,6,364,2,4,0.52
7,4,refuse,6,365,2,4,0.52
7,4,regard,6,366,2,4,0.4
7,4,regime,6,367,3,3,0.24
7,4,region,6,368,4,2,0.28
7,4,reign,5,369,2,3,0.2
7,4,relax,5,370,2,3,0.2
7,4,relief,6,371,3,3,0.2
7,4,remind,6,372,2,4,0.28
7,4,removal,7,373,3,4,0.28
7,4,renew,5,374,2,3,0.2
7,4,residue,7,375,2,5,0.28
7,4,rest,4,376,3,1,0.12
7,4,retire,6,377,2,4,0.4
7,4,revenge,7,378,2,5,0.28
7,4,revise,6,379,3,3,0.24
7,4,revival,7,380,4,3,0.24
7,4,revive,6,381,5,1,0.24
7,4,rise,4,382,1,3,0.2
7,4,ritual,6,383,2,4,0.24
7,4,rival,5,384,2,3,0.2
7,4,road,4,385,1,3,0.16
7,4,rob,3,386,2,1,0.12
7,4,robust,6,387,3,3,0.28
7,4,romance,7,388,2,5,0.32
7,4,roof,4,389,2,2,0.16
7,4,root,4,390,3,1,0.12
7,4,rough,5,391,2,3,0.16
7,4,routine,7,392,3,4,0.36
7,4,rubbish,7,393,1,6,0.28
7,4,ruin,4,394,2,2,0.16
7,4,sacred,6,395,0,6,0.32
7,4,safe,4,396,2,2,0.16
7,4,sand,4,397,2,2,0.24
7,4,satisfy,7,398,2,5,0.28
7,4,scared,6,399,1,5,0.24
7,4,scholar,7,400,2,5,0.32
7,4,school,6,401,4,2,0.24
7,4,second,6,402,1,5,0.24
7,4,seem,4,403,2,2,0.16
7,4,segment,7,404,2,5,0.28
7,4,seminar,7,405,2,5,0.28
7,4,serious,7,406,2,5,0.36
7,4,setting,7,407,2,5,0.28
7,4,settler,7,408,4,3,0.24
7,4,seven,5,409,2,3,0.2
7,4,sexual,6,410,2,4,0.32
7,4,sexy,4,411,3,1,0.12
7,4,shape,5,412,1,4,0.2
7,4,sibling,7,413,1,6,0.28
7,4,sight,5,414,2,3,0.16
7,4,simply,6,415,2,4,0.28
7,4,sin,3,416,2,1,0.08
7,4,singing,7,417,3,4,0.24
7,4,six,3,418,2,1,0.08
7,4,skull,5,419,1,4,0.2
7,4,slip,4,420,1,3,0.24
7,4,solid,5,421,1,4,0.2
7,4,solo,4,422,3,1,0.12
7,4,somehow,7,423,2,5,0.28
7,4,soup,4,424,2,2,0.12
7,4,special,7,425,1,6,0.36
7,4,sphere,6,426,2,4,0.24
7,4,spine,5,427,2,3,0.16
7,4,spread,6,428,2,4,0.2
7,4,staff,5,429,1,4,0.2
7,4,stall,5,430,3,2,0.24
7,4,stamp,5,431,3,2,0.16
7,4,stance,6,432,3,3,0.2
7,4,stand,5,433,4,1,0.12
7,4,statue,6,434,3,3,0.2
7,4,stay,4,435,3,1,0.2
7,4,stick,5,436,2,3,0.2
7,4,sticky,6,437,5,1,0.16
7,4,stop,4,438,2,2,0.16
7,4,story,5,439,3,2,0.16
7,4,street,6,440,2,4,0.28
7,4,string,6,441,3,3,0.2
7,4,stun,4,442,2,2,0.12
7,4,subject,7,443,1,6,0.28
7,4,sudden,6,444,2,4,0.24
7,4,sue,3,445,2,1,0.16
7,4,sugar,5,446,2,3,0.2
7,4,suppose,7,447,2,5,0.28
7,4,supreme,7,448,3,4,0.24
7,4,surely,6,449,2,4,0.2
7,4,swallow,7,450,1,6,0.36
7,4,swim,4,451,2,2,0.16
7,4,table,5,452,0,5,0.24
7,4,talk,4,453,2,2,0.12
7,4,tap,3,454,2,1,0.08
7,4,tape,4,455,3,1,0.2
7,4,task,4,456,2,2,0.12
7,4,taxi,4,457,2,2,0.16
7,4,tea,3,458,1,2,0.12
7,4,tender,6,459,2,4,0.24
7,4,tension,7,460,3,4,0.24
7,4,terrify,7,461,2,5,0.32
7,4,three,5,462,1,4,0.2
7,4,thumb,5,463,2,3,0.2
7,4,tidy,4,464,1,3,0.16
7,4,timing,6,465,2,4,0.24
7,4,tonight,7,466,1,6,0.36
7,4,too,3,467,2,1,0.12
7,4,tool,4,468,3,1,0.12
7,4,topic,5,469,2,3,0.16
7,4,trainer,7,470,1,6,0.28
7,4,trap,4,471,3,1,0.2
7,4,treat,5,472,2,3,0.2
7,4,treaty,6,473,5,1,0.16
7,4,tree,4,474,3,1,0.12
7,4,tribal,6,475,2,4,0.24
7,4,tribe,5,476,4,1,0.2
7,4,trouble,7,477,2,5,0.28
7,4,truck,5,478,2,3,0.16
7,4,tune,4,479,1,3,0.16
7,4,twice,5,480,1,4,0.2
7,4,two,3,481,2,1,0.16
7,4,unable,6,482,0,6,0.28
7,4,undergo,7,483,2,5,0.28
7,4,union,5,484,2,3,0.2
7,4,until,5,485,2,3,0.16
7,4,unusual,7,486,2,5,0.32
7,4,upgrade,7,487,1,6,0.28
7,4,uphold,6,488,2,4,0.2
7,4,urban,5,489,1,4,0.2
7,4,urgent,6,490,2,4,0.28
7,4,usual,5,491,1,4,0.2
7,4,utilize,7,492,1,6,0.28
7,4,valley,6,493,0,6,0.28
7,4,variety,7,494,2,5,0.36
7,4,vary,4,495,3,1,0.12
7,4,verify,6,496,1,5,0.24
7,4,vessel,6,497,2,4,0.2
7,4,veteran,7,498,2,5,0.24
7,4,viewer,6,499,1,5,0.32
7,4,virtual,7,500,2,5,0.24
7,4,vocal,5,501,1,4,0.2
7,4,wait,4,502,0,4,0.2
7,4,wake,4,503,2,2,0.16
7,4,warning,7,504,2,5,0.32
7,4,watch,5,505,2,3,0.16
7,4,way,3,506,2,1,0.08
7,4,wealthy,7,507,1,6,0.28
7,4,weave,5,508,3,2,0.16
7,4,weight,6,509,2,4,0.28
7,4,weird,5,510,3,2,0.16
7,4,welcome,7,511,2,5,0.28
7,4,welfare,7,512,3,4,0.24
7,4,which,5,513,1,4,0.28
7,4,width,5,514,1,4,0.2
7,4,willing,7,515,2,5,0.24
7,4,win,3,516,2,1,0.12
7,4,world,5,517,1,4,0.2
7,4,wow,3,518,2,1,0.2
7,4,wrap,4,519,1,3,0.16
7,4,wrist,5,520,2,3,0.16
7,4,young,5,521,0,5,0.24
7,5,a,1,0,0,1,0.2
7,5,absurd,6,1,1,5,0.68
7,5,accept,6,2,1,5,0.8
7,5,acid,4,3,2,2,0.4
7,5,acre,4,4,2,2,0.4
7,5,ad,2,5,1,1,0.24
7,5,add,3,6,2,1,0.28
7,5,advice,6,7,2,4,0.8
7,5,again,5,8,1,4,0.68
7,5,against,7,9,5,2,0.52
7,5,agree,5,10,2,3,0.48
7,5,ahead,5,11,1,4,0.56
7,5,ally,4,12,1,3,0.52
7,5,amateur,7,13,1,6,0.84
7,5,amusing,7,14,2,5,0.68
7,5,and,3,15,1,2,0.32
7,5,anger,5,16,2,3,0.48
7,5,animal,6,17,2,4,0.68
7,5,anxiety,7,18,2,5,0.68
7,5,app,3,19,1,2,0.32
7,5,applaud,7,20,3,4,0.76
7,5,approve,7,21,3,4,0.72
7,5,argue,5,22,1,4,0.52
7,5,arms,4,23,2,2,0.36
7,5,army,4,24,3,1,0.32
7,5,ask,3,25,1,2,0.32
7,5,at,2,26,1,1,0.2
7,5,attract,7,27,2,5,0.76
7,5,auction,7,28,1,6,0.84
7,5,auto,4,29,2,2,0.36
7,5,backing,7,30,0,7,0.76
7,5,balance,7,31,2,5,0.8
7,5,bat,3,32,2,1,0.24
7,5,bath,4,33,3,1,0.28
7,5,beast,5,34,1,4,0.52
7,5,bed,3,35,2,1,0.36
7,5,beer,4,36,2,2,0.44
7,5,belief,6,37,2,4,0.52
7,5,between,7,38,2,5,0.64
7,5,bill,4,39,1,3,0.52
7,5,bin,3,40,2,1,0.24
7,5,bird,4,41,2,2,0.4
7,5,bishop,6,42,2,4,0.76
7,5,bite,4,43,2,2,0.36
7,5,bitter,6,44,3,3,0.52
7,5,blank,5,45,1,4,0.56
7,5,bless,5,46,2,3,0.48
7,5,blog,4,47,2,2,0.48
7,5,blow,4,48,3,1,0.32
7,5,boom,4,49,1,3,0.48
7,5,boot,4,50,3,1,0.32
7,5,bottle,6,51,2,4,0.56
7,5,bound,5,52,2,3,0.56
7,5,box,3,53,2,1,0.24
7,5,brand,5,54,1,4,0.52
7,5,breathe,7,55,2,5,0.6
7,5,bride,5,56,2,3,0.44
7,5,build,5,57,1,4,0.48
7,5,burden,6,58,2,4,0.64
7,5,burn,4,59,3,1,0.28
7,5,butter,6,60,2,4,0.56
7,5,cafe,4,61,0,4,0.44
7,5,cake,4,62,2,2,0.32
7,5,cap,3,63,2,1,0.32
7,5,capable,7,64,3,4,0.68
7,5,card,4,65,2,2,0.36
7,5,career,6,66,3,3,0.52
7,5,careful,7,67,4,3,0.56
7,5,carpet,6,68,3,3,0.56
7,5,cave,4,69,2,2,0.36
7,5,cd,2,70,1,1,0.2
7,5,century,7,71,1,6,0.68
7,5,certain,7,72,2,5,0.6
7,5,chair,5,73,1,4,0.64
7,5,chapter,7,74,3,4,0.72
7,5,charm,5,75,3,2,0.48
7,5,chart,5,76,4,1,0.4
7,5,cheat,5,77,2,3,0.32
7,5,chop,4,78,2,2,0.24
7,5,chunk,5,79,2,3,0.2
7,5,circle,6,80,1,5,0.32
7,5,circuit,7,81,4,3,0.24
7,5,cite,4,82,2,2,0.16
7,5,civil,5,83,2,3,0.24
7,5,clause,6,84,1,5,0.28
7,5,closely,7,85,2,5,0.28
7,5,club,4,86,2,2,0.16
7,5,colony,6,87,1,5,0.32
7,5,comment,7,88,2,5,0.24
7,5,company,7,89,3,4,0.24
7,5,conceal,7,90,2,5,0.24
7,5,concern,7,91,5,2,0.28
7,5,concert,7,92,6,1,0.16
7,5,confer,6,93,3,3,0.2
7,5,confess,7,94,5,2,0.2
7,5,consult,7,95,3,4,0.28
7,5,contend,7,96,3,4,0.24
7,5,cope,4,97,2,2,0.12
7,5,cottage,7,98,2,5,0.28
7,5,county,6,99,2,4,0.2
7,5,coup,4,100,3,1,0.16
7,5,couple,6,101,4,2,0.16
7,5,course,6,102,3,3,0.2
7,5,crime,5,103,1,4,0.2
7,5,crisis,6,104,3,3,0.2
7,5,crude,5,105,2,3,0.24
7,5,cruise,6,106,3,3,0.2
7,5,cry,3,107,2,1,0.12
7,5,current,7,108,1,6,0.28
7,5,dare,4,109,0,4,0.2
7,5,day,3,110,2,1,0.08
7,5,deem,4,111,1,3,0.2
7,5,defence,7,112,2,5,0.24
7,5,delight,7,113,2,5,0.24
7,5,dentist,7,114,2,5,0.28
7,5,deposit,7,115,2,5,0.32
7,5,deputy,6,116,3,3,0.2
7,5,desktop,7,117,2,5,0.24
7,5,detect,6,118,2,4,0.28
7,5,develop,7,119,2,5,0.36
7,5,dinner,6,120,1,5,0.24
7,5,discuss,7,121,2,5,0.28
7,5,dot,3,122,1,2,0.12
7,5,double,6,123,2,4,0.28
7,5,drink,5,124,1,4,0.2
7,5,dust,4,125,1,3,0.16
7,5,earth,5,126,0,5,0.24
7,5,edit,4,127,1,3,0.16
7,5,editor,6,128,4,2,0.16
7,5,eight,5,129,1,4,0.28
7,5,either,6,130,2,4,0.2
7,5,embody,6,131,1,5,0.24
7,5,enable,6,132,1,5,0.24
7,5,enjoy,5,133,2,3,0.24
7,5,essence,7,134,1,6,0.28
7,5,euro,4,135,1,3,0.16
7,5,evening,7,136,1,6,0.28
7,5,exact,5,137,1,4,0.2
7,5,examine,7,138,3,4,0.32
7,5,exceed,6,139,2,4,0.24
7,5,excuse,6,140,3,3,0.2
7,5,expire,6,141,2,4,0.24
7,5,explain,7,142,3,4,0.32
7,5,exploit,7,143,4,3,0.24
7,5,eye,3,144,1,2,0.12
7,5,failed,6,145,0,6,0.32
7,5,fairly,6,146,3,3,0.28
7,5,fall,4,147,2,2,0.12
7,5,famous,6,148,2,4,0.24
7,5,fasten,6,149,2,4,0.2
7,5,fee,3,150,1,2,0.12
7,5,feeding,7,151,3,4,0.28
7,5,few,3,152,2,1,0.12
7,5,fifty,5,153,1,4,0.24
7,5,file,4,154,2,2,0.16
7,5,finally,7,155,2,5,0.24
7,5,fixed,5,156,2,3,0.2
7,5,fixture,7,157,3,4,0.32
7,5,flavour,7,158,1,6,0.28
7,5,floor,5,159,2,3,0.2
7,5,flower,6,160,3,3,0.2
7,5,folding,7,161,1,6,0.36
7,5,folk,4,162,3,1,0.12
7,5,fortune,7,163,2,5,0.24
7,5,forward,7,164,3,4,0.28
7,5,foster,6,165,2,4,0.28
7,5,founder,7,166,2,5,0.28
7,5,freedom,7,167,1,6,0.28
7,5,front,5,168,2,3,0.2
7,5,fulfil,6,169,1,5,0.24
7,5,full,4,170,3,1,0.16
7,5,funding,7,171,2,5,0.24
7,5,gallery,7,172,0,7,0.32
7,5,game,4,173,2,2,0.12
7,5,gaming,6,174,3,3,0.24
7,5,gender,6,175,1,5,0.24
7,5,general,7,176,3,4,0.24
7,5,give,4,177,1,3,0.16
7,5,glass,5,178,1,4,0.2
7,5,globe,5,179,2,3,0.24
7,5,god,3,180,1,2,0.12
7,5,gold,4,181,2,2,0.12
7,5,good,4,182,2,2,0.16
7,5,grace,5,183,1,4,0.2
7,5,grade,5,184,3,2,0.16
7,5,gravity,7,185,3,4,0.28
7,5,grey,4,186,2,2,0.2
7,5,grin,4,187,2,2,0.16
7,5,grind,5,188,4,1,0.16
7,5,guess,5,189,1,4,0.2
7,5,guest,5,190,4,1,0.28
7,5,guitar,6,191,2,4,0.72
7,5,guy,3,192,2,1,0.4
7,5,handful,7,193,0,7,0.68
7,5,handy,5,194,4,1,0.2
7,5,happen,6,195,2,4,0.24
7,5,harbour,7,196,2,5,0.36
7,5,harvest,7,197,3,4,0.32
7,5,hate,4,198,2,2,0.16
7,5,hazard,6,199,2,4,0.24
7,5,heart,5,200,1,4,0.24
7,5,heat,4,201,3,1,0.12
7,5,her,3,202,2,1,0.12
7,5,highly,6,203,1,5,0.32
7,5,hint,4,204,2,2,0.12
7,5,horror,6,205,1,5,0.24
7,5,hotel,5,206,2,3,0.2
7,5,however,7,207,2,5,0.32
7,5,hunger,6,208,1,5,0.24
7,5,ice,3,209,0,3,0.16
7,5,icon,4,210,2,2,0.16
7,5,ideal,5,211,1,4,0.2
7,5,illegal,7,212,1,6,0.36
7,5,image,5,213,1,4,0.2
7,5,improve,7,214,2,5,0.28
7,5,include,7,215,1,6,0.28
7,5,incur,5,216,3,2,0.16
7,5,index,5,217,2,3,0.24
7,5,inform,6,218,2,4,0.2
7,5,inject,6,219,2,4,0.2
7,5,insert,6,220,2,4,0.24
7,5,instant,7,221,3,4,0.32
7,5,intake,6,222,2,4,0.24
7,5,intense,7,223,3,4,0.24
7,5,into,4,224,3,1,0.12
7,5,invest,6,225,2,4,0.2
7,5,involve,7,226,3,4,0.32
7,5,iron,4,227,1,3,0.16
7,5,island,6,228,1,5,0.24
7,5,issue,5,229,2,3,0.2
7,5,jet,3,230,0,3,0.16
7,5,joy,3,231,1,2,0.16
7,5,justify,7,232,1,6,0.28
7,5,kid,3,233,0,3,0.16
7,5,king,4,234,2,2,0.16
7,5,kingdom,7,235,4,3,0.2
7,5,kit,3,236,2,1,0.12
7,5,knife,5,237,1,4,0.28
7,5,know,4,238,2,2,0.16
7,5,lap,3,239,0,3,0.16
7,5,last,4,240,2,2,0.12
7,5,laugh,5,241,2,3,0.16
7,5,lawn,4,242,2,2,0.12
7,5,layer,5,243,2,3,0.24
7,5,leaf,4,244,1,3,0.16
7,5,legend,6,245,2,4,0.2
7,5,lesbian,7,246,2,5,0.28
7,5,lethal,6,247,2,4,0.28
7,5,license,7,248,1,6,0.28
7,5,lie,3,249,2,1,0.08
7,5,limb,4,250,2,2,0.16
7,5,limited,7,251,3,4,0.24
7,5,link,4,252,2,2,0.2
7,5,lion,4,253,2,2,0.16
7,5,located,7,254,1,6,0.28
7,5,log,3,255,2,1,0.08
7,5,lonely,6,256,2,4,0.24
7,5,lot,3,257,2,1,0.08
7,5,lunch,5,258,1,4,0.28
7,5,main,4,259,0,4,0.2
7,5,mandate,7,260,2,5,0.28
7,5,map,3,261,2,1,0.08
7,5,married,7,262,2,5,0.24
7,5,mask,4,263,2,2,0.2
7,5,master,6,264,3,3,0.2
7,5,maximum,7,265,2,5,0.28
7,5,meal,4,266,1,3,0.16
7,5,mean,4,267,3,1,0.12
7,5,media,5,268,2,3,0.28
7,5,meeting,7,269,2,5,0.24
7,5,melody,6,270,2,4,0.24
7,5,memory,6,271,2,4,0.2
7,5,mental,6,272,2,4,0.24
7,5,mention,7,273,4,3,0.28
7,5,mentor,6,274,4,2,0.16
7,5,merely,6,275,2,4,0.2
7,5,merger,6,276,3,3,0.2
7,5,mess,4,277,2,2,0.2
7,5,message,7,278,4,3,0.24
7,5,metre,5,279,2,3,0.2
7,5,mind,4,280,1,3,0.16
7,5,mirror,6,281,2,4,0.2
7,5,missing,7,282,2,5,0.32
7,5,model,5,283,1,4,0.2
7,5,mother,6,284,2,4,0.2
7,5,mouth,5,285,2,3,0.2
7,5,movie,5,286,2,3,0.16
7,5,much,4,287,1,3,0.24
7,5,music,5,288,2,3,0.2
7,5,must,4,289,3,1,0.12
7,5,my,2,290,1,1,0.08
7,5,nasty,5,291,0,5,0.24
7,5,neck,4,292,1,3,0.2
7,5,needle,6,293,2,4,0.32
7,5,new,3,294,2,1,0.08
7,5,newly,5,295,3,2,0.16
7,5,night,5,296,1,4,0.2
7,5,noise,5,297,1,4,0.2
7,5,non,3,298,2,1,0.12
7,5,norm,4,299,2,2,0.24
7,5,north,5,300,3,2,0.16
7,5,note,4,301,2,2,0.12
7,5,nothing,7,302,3,4,0.24
7,5,notice,6,303,3,3,0.24
7,5,novel,5,304,2,3,0.24
7,5,nut,3,305,1,2,0.12
7,5,obsess,6,306,0,6,0.28
7,5,ocean,5,307,1,4,0.36
7,5,off,3,308,1,2,0.12
7,5,offence,7,309,3,4,0.28
7,5,once,4,310,1,3,0.16
7,5,one,3,311,2,1,0.08
7,5,online,6,312,2,4,0.24
7,5,option,6,313,1,5,0.24
7,5,organic,7,314,1,6,0.36
7,5,outlet,6,315,1,5,0.24
7,5,outlook,7,316,4,3,0.2
7,5,pad,3,317,0,3,0.16
7,5,painful,7,318,2,5,0.24
7,5,palace,6,319,2,4,0.28
7,5,pants,5,320,2,3,0.16
7,5,park,4,321,2,2,0.16
7,5,partial,7,322,3,4,0.24
7,5,partner,7,323,4,3,0.28
7,5,patent,6,324,2,4,0.2
7,5,pause,5,325,2,3,0.16
7,5,peer,4,326,1,3,0.16
7,5,perfect,7,327,2,5,0.28
7,5,perhaps,7,328,3,4,0.28
7,5,phone,5,329,1,4,0.2
7,5,pick,4,330,1,3,0.16
7,5,piece,5,331,2,3,0.16
7,5,pig,3,332,2,1,0.12
7,5,pile,4,333,2,2,0.2
7,5,pioneer,7,334,2,5,0.24
7,5,pipe,4,335,2,2,0.16
7,5,place,5,336,1,4,0.2
7,5,plan,4,337,3,1,0.12
7,5,plastic,7,338,3,4,0.32
7,5,plead,5,339,2,3,0.2
7,5,pleased,7,340,4,3,0.2
7,5,pledge,6,341,3,3,0.2
7,5,point,5,342,1,4,0.2
7,5,police,6,343,2,4,0.28
7,5,possess,7,344,2,5,0.24
7,5,praise,6,345,1,5,0.24
7,5,predict,7,346,2,5,0.28
7,5,printer,7,347,2,5,0.32
7,5,prior,5,348,3,2,0.16
7,5,process,7,349,2,5,0.28
7,5,produce,7,350,3,4,0.24
7,5,product,7,351,6,1,0.28
7,5,program,7,352,3,4,0.28
7,5,proof,5,353,3,2,0.16
7,5,proper,6,354,3,3,0.2
7,5,pump,4,355,1,3,0.16
7,5,pure,4,356,2,2,0.2
7,5,put,3,357,2,1,0.12
7,5,quality,7,358,0,7,0.32
7,5,racial,6,359,0,6,0.28
7,5,radar,5,360,2,3,0.2
7,5,rail,4,361,2,2,0.16
7,5,rally,5,362,2,3,0.24
7,5,rating,6,363,2,4,0.24
7,5,react,5,364,1,4,0.2
7,5,realm,5,365,3,2,0.16
7,5,rebel,5,366,2,3,0.24
7,5,recall,6,367,2,4,0.24
7,5,referee,7,368,2,5,0.28
7,5,refuse,6,369,3,3,0.2
7,5,regard,6,370,2,4,0.2
7,5,reign,5,371,2,3,0.24
7,5,relax,5,372,2,3,0.2
7,5,remind,6,373,2,4,0.2
7,5,removal,7,374,3,4,0.24
7,5,renew,5,375,2,3,0.2
7,5,reside,6,376,2,4,0.28
7,5,retail,6,377,2,4,0.2
7,5,reveal,6,378,2,4,0.24
7,5,revise,6,379,3,3,0.2
7,5,revival,7,380,4,3,0.28
7,5,right,5,381,1,4,0.2
7,5,rival,5,382,2,3,0.2
7,5,rob,3,383,1,2,0.12
7,5,robbery,7,384,3,4,0.24
7,5,robust,6,385,3,3,0.24
7,5,root,4,386,2,2,0.16
7,5,rubber,6,387,1,5,0.24
7,5,rubbish,7,388,4,3,0.24
7,5,ruin,4,389,2,2,0.12
7,5,sacred,6,390,0,6,0.32
7,5,safe,4,391,2,2,0.16
7,5,sailor,6,392,2,4,0.24
7,5,satisfy,7,393,2,5,0.28
7,5,scan,4,394,1,3,0.16
7,5,scared,6,395,3,3,0.28
7,5,scheme,6,396,2,4,0.2
7,5,scholar,7,397,3,4,0.24
7,5,seal,4,398,1,3,0.16
7,5,second,6,399,2,4,0.28
7,5,secure,6,400,3,3,0.2
7,5,segment,7,401,2,5,0.28
7,5,seminar,7,402,2,5,0.24
7,5,serve,5,403,2,3,0.2
7,5,setting,7,404,2,5,0.32
7,5,settler,7,405,4,3,0.2
7,5,seven,5,406,2,3,0.2
7,5,sexy,4,407,2,2,0.12
7,5,shallow,7,408,1,6,0.36
7,5,shell,5,409,2,3,0.16
7,5,ship,4,410,2,2,0.12
7,5,shore,5,411,2,3,0.16
7,5,shortly,7,412,4,3,0.24
7,5,silver,6,413,1,5,0.32
7,5,simply,6,414,2,4,0.24
7,5,sin,3,415,2,1,0.08
7,5,singing,7,416,3,4,0.24
7,5,ski,3,417,1,2,0.16
7,5,skip,4,418,3,1,0.2
7,5,skirt,5,419,3,2,0.16
7,5,slam,4,420,1,3,0.16
7,5,snow,4,421,1,3,0.16
7,5,soap,4,422,1,3,0.2
7,5,solar,5,423,2,3,0.2
7,5,someone,7,424,2,5,0.36
7,5,song,4,425,2,2,0.16
7,5,soup,4,426,2,2,0.16
7,5,spare,5,427,1,4,0.2
7,5,speaker,7,428,2,5,0.28
7,5,special,7,429,3,4,0.28
7,5,specify,7,430,5,2,0.2
7,5,speech,6,431,3,3,0.2
7,5,sphere,6,432,2,4,0.2
7,5,stab,4,433,1,3,0.24
7,5,staff,5,434,3,2,0.2
7,5,stall,5,435,3,2,0.16
7,5,stamp,5,436,3,2,0.16
7,5,stance,6,437,3,3,0.2
7,5,star,4,438,3,1,0.12
7,5,steer,5,439,2,3,0.24
7,5,stem,4,440,3,1,0.12
7,5,stick,5,441,2,3,0.2
7,5,store,5,442,2,3,0.16
7,5,strange,7,443,2,5,0.24
7,5,street,6,444,3,3,0.24
7,5,stretch,7,445,4,3,0.28
7,5,string,6,446,3,3,0.48
7,5,strong,6,447,3,3,0.44
7,5,studio,6,448,2,4,0.6
7,5,stun,4,449,3,1,0.28
7,5,subject,7,450,1,6,0.64
7,5,super,5,451,2,3,0.44
7,5,swallow,7,452,1,6,0.68
7,5,sweater,7,453,2,5,0.76
7,5,swim,4,454,2,2,0.36
7,5,switch,6,455,3,3,0.48
7,5,talent,6,456,0,6,0.64
7,5,tap,3,457,2,1,0.24
7,5,task,4,458,2,2,0.48
7,5,tea,3,459,1,2,0.28
7,5,tender,6,460,2,4,0.52
7,5,tension,7,461,3,4,0.56
7,5,terrify,7,462,2,5,0.64
7,5,terror,6,463,4,2,0.52
7,5,texture,7,464,2,5,0.68
7,5,thereby,7,465,1,6,0.8
7,5,thesis,6,466,3,3,0.52
7,5,this,4,467,2,2,0.44
7,5,three,5,468,2,3,0.44
7,5,thumb,5,469,2,3,0.44
7,5,ticket,6,470,1,5,0.6
7,5,tight,5,471,2,3,0.52
7,5,till,4,472,2,2,0.52
7,5,timing,6,473,2,4,0.52
7,5,too,3,474,1,2,0.28
7,5,topic,5,475,2,3,0.44
7,5,tour,4,476,2,2,0.4
7,5,trainer,7,477,1,6,0.76
7,5,treat,5,478,2,3,0.52
7,5,tree,4,479,3,1,0.28
7,5,trial,5,480,2,3,0.44
7,5,tribal,6,481,3,3,0.48
7,5,tribe,5,482,4,1,0.32
7,5,tune,4,483,1,3,0.48
7,5,unable,6,484,0,6,0.6
7,5,undergo,7,485,2,5,0.6
7,5,unify,5,486,2,3,0.4
7,5,unique,6,487,3,3,0.48
7,5,until,5,488,2,3,0.56
7,5,unveil,6,489,2,4,0.52
7,5,uphold,6,490,1,5,0.56
7,5,usual,5,491,1,4,0.48
7,5,vague,5,492,0,5,0.64
7,5,vein,4,493,1,3,0.4
7,5,verify,6,494,2,4,0.52
7,5,vessel,6,495,2,4,0.52
7,5,violent,7,496,1,6,0.68
7,5,visual,6,497,2,4,0.64
7,5,vital,5,498,2,3,0.44
7,5,vocal,5,499,1,4,0.48
7,5,voice,5,500,2,3,0.44
7,5,wait,4,501,0,4,0.44
7,5,waiter,6,502,4,2,0.56
7,5,walk,4,503,2,2,0.32
7,5,war,3,504,2,1,0.24
7,5,warrior,7,505,3,4,0.56
7,5,washing,7,506,2,5,0.64
7,5,weird,5,507,1,4,0.6
7,5,welcome,7,508,2,5,0.64
7,5,welfare,7,509,3,4,0.6
7,5,whose,5,510,1,4,0.56
7,5,width,5,511,1,4,0.68
7,5,window,6,512,2,4,0.76
7,5,wisdom,6,513,2,4,0.56
7,5,within,6,514,2,4,0.56
7,5,woman,5,515,1,4,0.48
7,5,word,4,516,2,2,0.44
7,5,work,4,517,3,1,0.28
7,5,world,5,518,3,2,0.36
7,5,wrap,4,519,1,3,0.4
7,5,wrist,5,520,2,3,0.44
7,5,yellow,6,521,0,6,0.76
7,6,absence,7,0,0,7,0.32
7,6,accept,6,1,1,5,0.24
7,6,acid,4,2,2,2,0.12
7,6,acre,4,3,2,2,0.16
7,6,actress,7,4,2,5,0.32
7,6,ad,2,5,1,1,0.08
7,6,add,3,6,2,1,0.08
7,6,adj,3,7,2,1,0.08
7,6,admit,5,8,2,3,0.16
7,6,again,5,9,1,4,0.2
7,6,against,7,10,5,2,0.24
7,6,ahead,5,11,1,4,0.2
7,6,aids,4,12,1,3,0.16
7,6,alcohol,7,13,1,6,0.28
7,6,align,5,14,2,3,0.2
7,6,ally,4,15,2,2,0.28
7,6,analyse,7,16,1,6,0.28
7,6,ancient,7,17,2,5,0.28
7,6,and,3,18,2,1,0.12
7,6,anger,5,19,2,3,0.2
7,6,animal,6,20,2,4,0.32
7,6,anxiety,7,21,2,5,0.24
7,6,anyway,6,22,2,4,0.24
7,6,approve,7,23,1,6,0.28
7,6,argue,5,24,1,4,0.28
7,6,arise,5,25,2,3,0.2
7,6,arms,4,26,2,2,0.12
7,6,artist,6,27,2,4,0.2
7,6,assault,7,28,1,6,0.28
7,6,backing,7,29,0,7,0.36
7,6,balance,7,30,2,5,0.24
7,6,ballet,6,31,3,3,0.2
7,6,banner,6,32,2,4,0.24
7,6,barrel,6,33,2,4,0.28
7,6,bath,4,34,2,2,0.16
7,6,beer,4,35,1,3,0.16
7,6,beg,3,36,2,1,0.08
7,6,behalf,6,37,2,4,0.24
7,6,belief,6,38,2,4,0.28
7,6,bell,4,39,3,1,0.12
7,6,belong,6,40,3,3,0.24
7,6,below,5,41,4,1,0.16
7,6,best,4,42,2,2,0.16
7,6,betray,6,43,2,4,0.24
7,6,between,7,44,3,4,0.28
7,6,beyond,6,45,2,4,0.24
7,6,bill,4,46,1,3,0.16
7,6,bin,3,47,2,1,0.08
7,6,bird,4,48,2,2,0.12
7,6,bishop,6,49,2,4,0.28
7,6,bless,5,50,1,4,0.2
7,6,blind,5,51,2,3,0.16
7,6,blog,4,52,2,2,0.16
7,6,boil,4,53,1,3,0.16
7,6,bomb,4,54,2,2,0.12
7,6,boot,4,55,2,2,0.2
7,6,bother,6,56,2,4,0.2
7,6,bottle,6,57,3,3,0.2
7,6,box,3,58,2,1,0.08
7,6,bride,5,59,1,4,0.2
7,6,bright,6,60,3,3,0.24
7,6,bunch,5,61,1,4,0.2
7,6,burden,6,62,2,4,0.24
7,6,can,3,63,0,3,0.16
7,6,cancer,6,64,3,3,0.2
7,6,cap,3,65,2,1,0.16
7,6,card,4,66,2,2,0.16
7,6,career,6,67,3,3,0.2
7,6,careful,7,68,4,3,0.24
7,6,carpet,6,69,3,3,0.24
7,6,cartoon,7,70,3,4,0.32
7,6,cease,5,71,1,4,0.2
7,6,century,7,72,2,5,0.24
7,6,chapter,7,73,1,6,0.28
7,6,charity,7,74,3,4,0.32
7,6,check,5,75,2,3,0.16
7,6,chicken,7,76,2,5,0.28
7,6,chop,4,77,2,2,0.12
7,6,circuit,7,78,1,6,0.28
7,6,cite,4,79,2,2,0.2
7,6,city,4,80,3,1,0.12
7,6,clean,5,81,1,4,0.2
7,6,clearly,7,82,4,3,0.24
7,6,clerk,5,83,3,2,0.16
7,6,closely,7,84,2,5,0.32
7,6,cloud,5,85,3,2,0.16
7,6,coffee,6,86,1,5,0.24
7,6,compete,7,87,2,5,0.24
7,6,comply,6,88,4,2,0.24
7,6,concern,7,89,2,5,0.28
7,6,confer,6,90,3,3,0.2
7,6,confess,7,91,5,2,0.2
7,6,consult,7,92,3,4,0.32
7,6,contend,7,93,3,4,0.24
7,6,convey,6,94,3,3,0.2
7,6,cooker,6,95,2,4,0.24
7,6,cope,4,96,2,2,0.16
7,6,cottage,7,97,2,5,0.36
7,6,counter,7,98,2,5,0.28
7,6,county,6,99,5,1,0.16
7,6,coup,4,100,3,1,0.12
7,6,course,6,101,3,3,0.24
7,6,create,6,102,1,5,0.28
7,6,creep,5,103,3,2,0.16
7,6,crowded,7,104,2,5,0.24
7,6,crude,5,105,2,3,0.2
7,6,cruel,5,106,3,2,0.2
7,6,cruise,6,107,3,3,0.2
7,6,cycle,5,108,1,4,0.2
7,6,damage,6,109,0,6,0.28
7,6,death,5,110,1,4,0.2
7,6,declare,7,111,2,5,0.32
7,6,deed,4,112,2,2,0.16
7,6,deem,4,113,3,1,0.12
7,6,defence,7,114,2,5,0.28
7,6,delight,7,115,2,5,0.24
7,6,demon,5,116,2,3,0.24
7,6,deputy,6,117,2,4,0.24
7,6,despite,7,118,2,5,0.28
7,6,develop,7,119,2,5,0.28
7,6,dictate,7,120,1,6,0.4
7,6,dig,3,121,2,1,0.12
7,6,dinner,6,122,2,4,0.24
7,6,dirt,4,123,2,2,0.16
7,6,discuss,7,124,2,5,0.28
7,6,distant,7,125,3,4,0.36
7,6,distort,7,126,4,3,0.24
7,6,divine,6,127,2,4,0.24
7,6,dollar,6,128,1,5,0.28
7,6,dot,3,129,2,1,0.16
7,6,double,6,130,2,4,0.24
7,6,dust,4,131,1,3,0.16
7,6,ear,3,132,0,3,0.16
7,6,edition,7,133,1,6,0.28
7,6,editor,6,134,4,2,0.24
7,6,effort,6,135,1,5,0.24
7,6,eighty,6,136,1,5,0.24
7,6,elect,5,137,1,4,0.2
7,6,eleven,6,138,3,3,0.2
7,6,emotion,7,139,1,6,0.36
7,6,empower,7,140,2,5,0.28
7,6,ending,6,141,1,5,0.24
7,6,entitle,7,142,2,5,0.28
7,6,euro,4,143,1,3,0.24
7,6,evening,7,144,1,6,0.28
7,6,evoke,5,145,2,3,0.2
7,6,exact,5,146,1,4,0.24
7,6,excited,7,147,2,5,0.36
7,6,expire,6,148,2,4,0.24
7,6,explain,7,149,3,4,0.24
7,6,exploit,7,150,4,3,0.24
7,6,extend,6,151,2,4,0.28
7,6,extent,6,152,5,1,0.16
7,6,failure,7,153,0,7,0.28
7,6,fairly,6,154,3,3,0.2
7,6,fall,4,155,2,2,0.12
7,6,famous,6,156,2,4,0.28
7,6,fast,4,157,2,2,0.12
7,6,fasten,6,158,4,2,0.2
7,6,fat,3,159,2,1,0.08
7,6,fiction,7,160,1,6,0.28
7,6,fight,5,161,2,3,0.24
7,6,firm,4,162,2,2,0.16
7,6,fixture,7,163,2,5,0.24
7,6,flag,4,164,1,3,0.16
7,6,flat,4,165,3,1,0.12
7,6,flavour,7,166,3,4,0.36
7,6,flee,4,167,2,2,0.16
7,6,flower,6,168,2,4,0.24
7,6,flying,6,169,2,4,0.2
7,6,focus,5,170,1,4,0.2
7,6,folding,7,171,2,5,0.68
7,6,force,5,172,2,3,0.44
7,6,foreign,7,173,3,4,0.56
7,6,formula,7,174,3,4,0.56
7,6,foster,6,175,2,4,0.6
7,6,friday,6,176,1,5,0.64
7,6,fulfil,6,177,1,5,0.6
7,6,fur,3,178,2,1,0.28
7,6,game,4,179,0,4,0.48
7,6,gaming,6,180,3,3,0.48
7,6,gene,4,181,1,3,0.52
7,6,give,4,182,1,3,0.4
7,6,glass,5,183,1,4,0.48
7,6,glimpse,7,184,2,5,0.6
7,6,go,2,185,1,1,0.2
7,6,goodbye,7,186,2,5,0.72
7,6,grace,5,187,1,4,0.48
7,6,grade,5,188,3,2,0.36
7,6,gravity,7,189,3,4,0.56
7,6,growth,6,190,2,4,0.64
7,6,guest,5,191,1,4,0.48
7,6,guide,5,192,2,3,0.4
7,6,guitar,6,193,3,3,0.44
7,6,gym,3,194,1,2,0.28
7,6,hair,4,195,0,4,0.44
7,6,handful,7,196,2,5,0.72
7,6,harbour,7,197,2,5,0.6
7,6,harm,4,198,3,1,0.28
7,6,harvest,7,199,3,4,0.6
7,6,hat,3,200,2,1,0.28
7,6,hate,4,201,3,1,0.4
7,6,hazard,6,202,2,4,0.52
7,6,health,6,203,1,5,0.56
7,6,heat,4,204,3,1,0.28
7,6,herb,4,205,2,2,0.32
7,6,hers,4,206,3,1,0.36
7,6,highly,6,207,1,5,0.56
7,6,hint,4,208,2,2,0.32
7,6,holiday,7,209,1,6,0.68
7,6,horror,6,210,2,4,0.52
7,6,how,3,211,2,1,0.32
7,6,hunt,4,212,1,3,0.36
7,6,i,1,213,0,1,0.16
7,6,ice,3,214,1,2,0.28
7,6,ill,3,215,1,2,0.28
7,6,illegal,7,216,3,4,0.56
7,6,image,5,217,1,4,0.48
7,6,import,6,218,2,4,0.64
7,6,improve,7,219,3,4,0.56
7,6,incur,5,220,1,4,0.48
7,6,inject,6,221,2,4,0.52
7,6,injure,6,222,3,3,0.56
7,6,injury,6,223,5,1,0.4
7,6,insert,6,224,2,4,0.56
7,6,inspect,7,225,3,4,0.56
7,6,intense,7,226,2,5,0.72
7,6,into,4,227,3,1,0.28
7,6,invest,6,228,2,4,0.52
7,6,iron,4,229,1,3,0.4
7,6,island,6,230,1,5,0.68
7,6,january,7,231,0,7,0.88
7,6,joy,3,232,1,2,0.32
7,6,jump,4,233,1,3,0.4
7,6,just,4,234,2,2,0.36
7,6,key,3,235,0,3,0.36
7,6,kick,4,236,1,3,0.44
7,6,king,4,237,2,2,0.48
7,6,kit,3,238,2,1,0.24
7,6,knife,5,239,1,4,0.48
7,6,lake,4,240,0,4,0.44
7,6,lap,3,241,2,1,0.24
7,6,laser,5,242,2,3,0.44
7,6,last,4,243,3,1,0.28
7,6,latest,6,244,2,4,0.64
7,6,laugh,5,245,2,3,0.4
7,6,law,3,246,2,1,0.24
7,6,lawn,4,247,3,1,0.28
7,6,leaf,4,248,1,3,0.36
7,6,league,6,249,3,3,0.56
7,6,left,4,250,2,2,0.32
7,6,legend,6,251,2,4,0.52
7,6,lens,4,252,2,2,0.32
7,6,lesser,6,253,2,4,0.56
7,6,letter,6,254,2,4,0.68
7,6,license,7,255,1,6,0.64
7,6,limited,7,256,2,5,0.6
7,6,link,4,257,2,2,0.32
7,6,lion,4,258,2,2,0.32
7,6,live,4,259,2,2,0.44
7,6,load,4,260,1,3,0.36
7,6,local,5,261,2,3,0.4
7,6,located,7,262,4,3,0.52
7,6,long,4,263,2,2,0.32
7,6,look,4,264,2,2,0.32
7,6,loudly,6,265,2,4,0.6
7,6,love,4,266,2,2,0.32
7,6,low,3,267,2,1,0.24
7,6,lunch,5,268,1,4,0.48
7,6,main,4,269,0,4,0.44
7,6,mandate,7,270,2,5,0.76
7,6,marine,6,271,2,4,0.6
7,6,married,7,272,3,4,0.68
7,6,mask,4,273,2,2,0.4
7,6,match,5,274,2,3,0.48
7,6,maximum,7,275,2,5,0.72
7,6,meal,4,276,1,3,0.36
7,6,memory,6,277,2,4,0.52
7,6,mental,6,278,2,4,0.52
7,6,mentor,6,279,4,2,0.52
7,6,merger,6,280,2,4,0.64
7,6,method,6,281,2,4,0.6
7,6,metre,5,282,3,2,0.4
7,6,militia,7,283,1,6,0.72
7,6,missing,7,284,2,5,0.72
7,6,modify,6,285,1,5,0.56
7,6,moment,6,286,2,4,0.52
7,6,more,4,287,2,2,0.32
7,6,movie,5,288,2,3,0.44
7,6,much,4,289,1,3,0.52
7,6,museum,6,290,2,4,0.52
7,6,must,4,291,3,1,0.28
7,6,naked,5,292,0,5,0.6
7,6,nation,6,293,2,4,0.56
7,6,needle,6,294,1,5,0.68
7,6,neutral,7,295,2,5,0.6
7,6,new,3,296,2,1,0.24
7,6,newly,5,297,3,2,0.36
7,6,non,3,298,1,2,0.28
7,6,norm,4,299,2,2,0.44
7,6,north,5,300,3,2,0.36
7,6,novel,5,301,2,3,0.4
7,6,obesity,7,302,0,7,0.92
7,6,oblige,6,303,2,4,0.64
7,6,obsess,6,304,2,4,0.68
7,6,ocean,5,305,1,4,0.48
7,6,off,3,306,1,2,0.28
7,6,once,4,307,1,3,0.36
7,6,online,6,308,2,4,0.52
7,6,option,6,309,1,5,0.72
7,6,outdoor,7,310,1,6,0.64
7,6,outfit,6,311,3,3,0.44
7,6,outing,6,312,3,3,0.44
7,6,outlet,6,313,3,3,0.56
7,6,outlook,7,314,4,3,0.48
7,6,overall,7,315,1,6,0.68
7,6,oversee,7,316,4,3,0.48
7,6,pace,4,317,0,4,0.44
7,6,pad,3,318,2,1,0.36
7,6,page,4,319,2,2,0.32
7,6,parade,6,320,2,4,0.52
7,6,park,4,321,3,1,0.28
7,6,partner,7,322,3,4,0.56
7,6,patent,6,323,2,4,0.6
7,6,perfect,7,324,1,6,0.64
7,6,pig,3,325,1,2,0.28
7,6,place,5,326,1,4,0.48
7,6,plane,5,327,3,2,0.36
7,6,pleased,7,328,2,5,0.72
7,6,plot,4,329,2,2,0.36
7,6,police,6,330,1,5,0.6
7,6,portion,7,331,2,5,0.64
7,6,post,4,332,2,2,0.36
7,6,pot,3,333,2,1,0.36
7,6,praise,6,334,1,5,0.56
7,6,prayer,6,335,3,3,0.48
7,6,predict,7,336,2,5,0.6
7,6,premise,7,337,3,4,0.68
7,6,prior,5,338,2,3,0.4
7,6,process,7,339,2,5,0.6
7,6,project,7,340,3,4,0.56
7,6,proper,6,341,3,3,0.44
7,6,propose,7,342,4,3,0.6
7,6,pump,4,343,1,3,0.36
7,6,punk,4,344,2,2,0.32
7,6,pupil,5,345,2,3,0.4
7,6,pure,4,346,2,2,0.32
7,6,pursuit,7,347,3,4,0.68
7,6,push,4,348,2,2,0.32
7,6,query,5,349,0,5,0.52
7,6,race,4,350,0,4,0.44
7,6,racism,6,351,3,3,0.48
7,6,radar,5,352,2,3,0.56
7,6,railway,7,353,2,5,0.64
7,6,rating,6,354,2,4,0.52
7,6,realm,5,355,1,4,0.48
7,6,rear,4,356,3,1,0.28
7,6,rebel,5,357,2,3,0.56
7,6,recall,6,358,2,4,0.6
7,6,recount,7,359,3,4,0.64
7,6,reduce,6,360,2,4,0.52
7,6,refer,5,361,2,3,0.4
7,6,regard,6,362,2,4,0.64
7,6,relax,5,363,2,3,0.44
7,6,relaxed,7,364,5,2,0.44
7,6,remind,6,365,2,4,0.52
7,6,repeat,6,366,2,4,0.6
7,6,residue,7,367,2,5,0.6
7,6,rest,4,368,3,1,0.28
7,6,retail,6,369,2,4,0.52
7,6,reveal,6,370,2,4,0.52
7,6,revenge,7,371,4,3,0.6
7,6,revival,7,372,3,4,0.56
7,6,revive,6,373,5,1,0.36
7,6,rip,3,374,1,2,0.28
7,6,ritual,6,375,2,4,0.64
7,6,robust,6,376,1,5,0.64
7,6,roll,4,377,2,2,0.36
7,6,rough,5,378,2,3,0.48
7,6,round,5,379,3,2,0.4
7,6,routine,7,380,3,4,0.68
7,6,rubber,6,381,1,5,0.6
7,6,rubbish,7,382,4,3,0.56
7,6,sacred,6,383,0,6,0.68
7,6,sailor,6,384,2,4,0.6
7,6,salt,4,385,2,2,0.44
7,6,scan,4,386,1,3,0.36
7,6,scared,6,387,3,3,0.44
7,6,scheme,6,388,2,4,0.52
7,6,score,5,389,2,3,0.4
7,6,seal,4,390,1,3,0.48
7,6,second,6,391,2,4,0.6
7,6,secret,6,392,3,3,0.48
7,6,seem,4,393,2,2,0.32
7,6,serious,7,394,2,5,0.64
7,6,serve,5,395,3,2,0.48
7,6,setting,7,396,2,5,0.6
7,6,sexual,6,397,2,4,0.52
7,6,sexy,4,398,3,1,0.28
7,6,shallow,7,399,1,6,0.8
7,6,shape,5,400,3,2,0.44
7,6,shell,5,401,2,3,0.44
7,6,ship,4,402,2,2,0.32
7,6,shortly,7,403,2,5,0.68
7,6,sight,5,404,1,4,0.64
7,6,simply,6,405,2,4,0.52
7,6,singing,7,406,2,5,0.6
7,6,sister,6,407,2,4,0.52
7,6,six,3,408,2,1,0.24
7,6,ski,3,409,1,2,0.4
7,6,slam,4,410,1,3,0.4
7,6,slip,4,411,2,2,0.32
7,6,smile,5,412,1,4,0.48
7,6,snow,4,413,1,3,0.36
7,6,soap,4,414,1,3,0.36
7,6,solar,5,415,2,3,0.52
7,6,solid,5,416,3,2,0.36
7,6,solo,4,417,3,1,0.28
7,6,some,4,418,2,2,0.32
7,6,somehow,7,419,4,3,0.48
7,6,space,5,420,1,4,0.6
7,6,spare,5,421,3,2,0.44
7,6,special,7,422,2,5,0.6
7,6,specify,7,423,5,2,0.28
7,6,speech,6,424,3,3,0.24
7,6,sphere,6,425,2,4,0.28
7,6,spin,4,426,2,2,0.16
7,6,spread,6,427,2,4,0.24
7,6,star,4,428,1,3,0.16
7,6,statue,6,429,3,3,0.24
7,6,steer,5,430,2,3,0.28
7,6,stem,4,431,3,1,0.12
7,6,stick,5,432,2,3,0.2
7,6,sticky,6,433,5,1,0.16
7,6,storage,7,434,2,5,0.28
7,6,store,5,435,4,1,0.2
7,6,story,5,436,4,1,0.16
7,6,strike,6,437,2,4,0.24
7,6,study,5,438,2,3,0.2
7,6,stun,4,439,3,1,0.12
7,6,super,5,440,1,4,0.24
7,6,suppose,7,441,3,4,0.32
7,6,supreme,7,442,3,4,0.24
7,6,surely,6,443,2,4,0.24
7,6,sweater,7,444,1,6,0.28
7,6,swim,4,445,2,2,0.24
7,6,switch,6,446,3,3,0.2
7,6,tail,4,447,0,4,0.2
7,6,talent,6,448,2,4,0.24
7,6,tape,4,449,2,2,0.12
7,6,task,4,450,2,2,0.2
7,6,tea,3,451,1,2,0.12
7,6,team,4,452,3,1,0.12
7,6,terror,6,453,2,4,0.2
7,6,thereby,7,454,1,6,0.28
7,6,thesis,6,455,3,3,0.28
7,6,thirsty,7,456,2,5,0.28
7,6,this,4,457,3,1,0.12
7,6,tighten,7,458,1,6,0.28
7,6,tool,4,459,1,3,0.16
7,6,tragic,6,460,1,5,0.32
7,6,trainer,7,461,3,4,0.24
7,6,trap,4,462,3,1,0.12
7,6,treaty,6,463,2,4,0.24
7,6,tree,4,464,3,1,0.12
7,6,trial,5,465,2,3,0.24
7,6,tribal,6,466,3,3,0.2
7,6,tribe,5,467,4,1,0.12
7,6,truck,5,468,2,3,0.2
7,6,tune,4,469,1,3,0.16
7,6,twice,5,470,1,4,0.28
7,6,two,3,471,2,1,0.12
7,6,unable,6,472,0,6,0.28
7,6,union,5,473,2,3,0.16
7,6,unusual,7,474,2,5,0.28
7,6,upgrade,7,475,1,6,0.36
7,6,upon,4,476,2,2,0.12
7,6,urban,5,477,1,4,0.2
7,6,usage,5,478,1,4,0.2
7,6,utility,7,479,1,6,0.32
7,6,vague,5,480,0,5,0.32
7,6,valley,6,481,2,4,0.2
7,6,variety,7,482,2,5,0.28
7,6,vary,4,483,3,1,0.12
7,6,verify,6,484,1,5,0.32
7,6,vessel,6,485,2,4,0.24
7,6,veteran,7,486,2,5,0.28
7,6,video,5,487,1,4,0.24
7,6,viewer,6,488,2,4,0.24
7,6,virtual,7,489,2,5,0.32
7,6,virtue,6,490,5,1,0.16
7,6,virus,5,491,3,2,0.16
7,6,visitor,7,492,2,5,0.28
7,6,visual,6,493,3,3,0.28
7,6,vocal,5,494,1,4,0.2
7,6,wake,4,495,0,4,0.2
7,6,walk,4,496,2,2,0.16
7,6,war,3,497,2,1,0.12
7,6,washing,7,498,2,5,0.32
7,6,watch,5,499,2,3,0.2
7,6,water,5,500,3,2,0.16
7,6,wealthy,7,501,1,6,0.28
7,6,weapon,6,502,3,3,0.2
7,6,weave,5,503,3,2,0.24
7,6,weekend,7,504,2,5,0.28
7,6,weight,6,505,2,4,0.24
7,6,weird,5,506,3,2,0.16
7,6,welcome,7,507,2,5,0.28
7,6,welfare,7,508,3,4,0.36
7,6,whereas,7,509,1,6,0.32
7,6,width,5,510,1,4,0.2
7,6,willing,7,511,2,5,0.28
7,6,window,6,512,2,4,0.28
7,6,wine,4,513,3,1,0.12
7,6,wisdom,6,514,2,4,0.24
7,6,woman,5,515,1,4,0.2
7,6,word,4,516,2,2,0.16
7,6,work,4,517,3,1,0.2
7,6,world,5,518,3,2,0.16
7,6,worry,5,519,3,2,0.16
7,6,wrap,4,520,1,3,0.16
7,6,wrist,5,521,2,3,0.2
7,7,a,1,0,0,1,0.08
7,7,absence,7,1,1,6,0.28
7,7,absorb,6,2,3,3,0.32
7,7,absurd,6,3,3,3,0.24
7,7,accept,6,4,1,5,0.28
7,7,actress,7,5,2,5,0.28
7,7,acute,5,6,2,3,0.24
7,7,ad,2,7,1,1,0.08
7,7,add,3,8,2,1,0.08
7,7,adj,3,9,2,1,0.08
7,7,admit,5,10,2,3,0.2
7,7,advice,6,11,2,4,0.24
7,7,alcohol,7,12,1,6,0.36
7,7,ally,4,13,2,2,0.16
7,7,amateur,7,14,1,6,0.28
7,7,analyse,7,15,1,6,0.28
7,7,ancient,7,16,2,5,0.36
7,7,anger,5,17,2,3,0.2
7,7,ankle,5,18,2,3,0.16
7,7,another,7,19,2,5,0.24
7,7,apology,7,20,1,6,0.36
7,7,app,3,21,2,1,0.12
7,7,applaud,7,22,3,4,0.24
7,7,argue,5,23,1,4,0.2
7,7,arise,5,24,2,3,0.2
7,7,arms,4,25,2,2,0.16
7,7,army,4,26,3,1,0.2
7,7,around,6,27,2,4,0.24
7,7,artist,6,28,2,4,0.24
7,7,ask,3,29,1,2,0.12
7,7,assault,7,30,2,5,0.28
7,7,at,2,31,1,1,0.16
7,7,auto,4,32,1,3,0.16
7,7,baby,4,33,0,4,0.2
7,7,backing,7,34,2,5,0.28
7,7,banner,6,35,2,4,0.24
7,7,barrel,6,36,2,4,0.32
7,7,base,4,37,2,2,0.16
7,7,bat,3,38,2,1,0.12
7,7,bath,4,39,3,1,0.12
7,7,bay,3,40,2,1,0.08
7,7,bed,3,41,1,2,0.12
7,7,beg,3,42,2,1,0.12
7,7,behalf,6,43,2,4,0.28
7,7,belief,6,44,2,4,0.2
7,7,bell,4,45,3,1,0.12
7,7,belong,6,46,3,3,0.2
7,7,below,5,47,4,1,0.12
7,7,best,4,48,2,2,0.2
7,7,betray,6,49,2,4,0.24
7,7,between,7,50,3,4,0.24
7,7,beyond,6,51,2,4,0.24
7,7,bill,4,52,1,3,0.16
7,7,biscuit,7,53,2,5,0.32
7,7,blade,5,54,1,4,0.2
7,7,blame,5,55,3,2,0.16
7,7,blank,5,56,3,2,0.16
7,7,blow,4,57,2,2,0.16
7,7,boom,4,58,1,3,0.24
7,7,bother,6,59,2,4,0.24
7,7,bottle,6,60,3,3,0.2
7,7,breach,6,61,1,5,0.24
7,7,break,5,62,4,1,0.12
7,7,bridge,6,63,2,4,0.32
7,7,broken,6,64,2,4,0.24
7,7,buffer,6,65,1,5,0.28
7,7,bug,3,66,2,1,0.12
7,7,burden,6,67,2,4,0.24
7,7,burn,4,68,3,1,0.2
7,7,can,3,69,0,3,0.16
7,7,cancer,6,70,3,3,0.2
7,7,carpet,6,71,2,4,0.24
7,7,cartoon,7,72,3,4,0.24
7,7,carve,5,73,3,2,0.24
7,7,cave,4,74,2,2,0.12
7,7,ceiling,7,75,1,6,0.28
7,7,century,7,76,2,5,0.28
7,7,certain,7,77,2,5,0.36
7,7,chair,5,78,1,4,0.24
7,7,chapter,7,79,3,4,0.28
7,7,charity,7,80,3,4,0.24
7,7,charter,7,81,4,3,0.28
7,7,check,5,82,2,3,0.2
7,7,chicken,7,83,2,5,0.28
7,7,choir,5,84,2,3,0.32
7,7,choose,6,85,3,3,0.44
7,7,chop,4,86,3,1,0.4
7,7,circle,6,87,1,5,0.56
7,7,circuit,7,88,4,3,0.48
7,7,cite,4,89,2,2,0.32
7,7,civil,5,90,2,3,0.4
7,7,clarity,7,91,1,6,0.76
7,7,clause,6,92,3,3,0.44
7,7,clean,5,93,2,3,0.4
7,7,clearly,7,94,4,3,0.48
7,7,clerk,5,95,3,2,0.36
7,7,club,4,96,2,2,0.44
7,7,colony,6,97,1,5,0.6
7,7,comfort,7,98,2,5,0.6
7,7,comment,7,99,3,4,0.56
7,7,compete,7,100,3,4,0.68
7,7,conceal,7,101,2,5,0.6
7,7,concept,7,102,5,2,0.48
7,7,concern,7,103,5,2,0.44
7,7,concert,7,104,6,1,0.52
7,7,confer,6,105,3,3,0.48
7,7,consent,7,106,3,4,0.56
7,7,consult,7,107,4,3,0.48
7,7,contend,7,108,3,4,0.68
7,7,could,5,109,2,3,0.4
7,7,county,6,110,3,3,0.48
7,7,court,5,111,3,2,0.4
7,7,craft,5,112,1,4,0.52
7,7,crisis,6,113,2,4,0.72
7,7,crowd,5,114,2,3,0.4
7,7,crowded,7,115,5,2,0.56
7,7,cruel,5,116,2,3,0.52
7,7,curved,6,117,1,5,0.6
7,7,cycle,5,118,1,4,0.56
7,7,dam,3,119,0,3,0.32
7,7,damage,6,120,3,3,0.64
7,7,dance,5,121,2,3,0.64
7,7,day,3,122,2,1,0.28
7,7,deal,4,123,1,3,0.52
7,7,death,5,124,3,2,0.52
7,7,deed,4,125,2,2,0.36
7,7,deem,4,126,3,1,0.36
7,7,defence,7,127,2,5,0.68
7,7,deliver,7,128,2,5,0.64
7,7,deposit,7,129,2,5,0.72
7,7,deputy,6,130,3,3,0.76
7,7,devil,5,131,2,3,0.44
7,7,dirt,4,132,1,3,0.4
7,7,discuss,7,133,2,5,0.76
7,7,display,7,134,3,4,0.56
7,7,dollar,6,135,1,5,0.56
7,7,dot,3,136,2,1,0.24
7,7,double,6,137,2,4,0.52
7,7,drink,5,138,1,4,0.68
7,7,earth,5,139,0,5,0.76
7,7,edit,4,140,1,3,0.44
7,7,edition,7,141,4,3,0.56
7,7,either,6,142,1,5,0.6
7,7,eleven,6,143,1,5,0.76
7,7,embody,6,144,1,5,0.6
7,7,empower,7,145,2,5,0.88
7,7,enable,6,146,1,5,0.68
7,7,endless,7,147,2,5,0.8
7,7,enemy,5,148,2,3,0.44
7,7,enter,5,149,2,3,0.64
7,7,entitle,7,150,3,4,0.76
7,7,entry,5,151,3,2,0.48
7,7,essay,5,152,1,4,0.48
7,7,essence,7,153,3,4,0.72
7,7,event,5,154,1,4,0.48
7,7,evoke,5,155,2,3,0.4
7,7,exact,5,156,1,4,0.56
7,7,examine,7,157,3,4,0.56
7,7,excuse,6,158,2,4,0.52
7,7,expire,6,159,2,4,0.52
7,7,explain,7,160,3,4,0.68
7,7,explode,7,161,4,3,0.52
7,7,exploit,7,162,5,2,0.44
7,7,eye,3,163,1,2,0.28
7,7,faculty,7,164,0,7,0.72
7,7,failed,6,165,2,4,0.64
7,7,fairly,6,166,3,3,0.48
7,7,famous,6,167,2,4,0.52
7,7,fantasy,7,168,2,5,0.6
7,7,fiction,7,169,1,6,0.76
7,7,fifty,5,170,2,3,0.44
7,7,fight,5,171,2,3,0.4
7,7,finally,7,172,2,5,0.6
7,7,fixture,7,173,2,5,0.72
7,7,flag,4,174,1,3,0.4
7,7,flat,4,175,3,1,0.28
7,7,flee,4,176,2,2,0.36
7,7,floor,5,177,2,3,0.4
7,7,flower,6,178,3,3,0.44
7,7,flu,3,179,2,1,0.32
7,7,flying,6,180,2,4,0.52
7,7,focus,5,181,1,4,0.48
7,7,folk,4,182,2,2,0.32
7,7,force,5,183,2,3,0.44
7,7,foreign,7,184,3,4,0.68
7,7,forward,7,185,3,4,0.6
7,7,founder,7,186,2,5,0.6
7,7,frog,4,187,1,3,0.36
7,7,front,5,188,3,2,0.36
7,7,fulfil,6,189,1,5,0.68
7,7,full,4,190,3,1,0.28
7,7,gallon,6,191,0,6,0.64
7,7,game,4,192,2,2,0.32
7,7,gaming,6,193,3,3,0.48
7,7,gene,4,194,1,3,0.52
7,7,general,7,195,4,3,0.56
7,7,genetic,7,196,4,3,0.56
7,7,give,4,197,1,3,0.4
7,7,glass,5,198,1,4,0.48
7,7,glimpse,7,199,2,5,0.76
7,7,golf,4,200,1,3,0.36
7,7,good,4,201,2,2,0.32
7,7,goodbye,7,202,4,3,0.48
7,7,govern,6,203,2,4,0.52
7,7,grace,5,204,1,4,0.6
7,7,grade,5,205,3,2,0.36
7,7,grief,5,206,2,3,0.4
7,7,guest,5,207,1,4,0.48
7,7,guide,5,208,2,3,0.44
7,7,guy,3,209,2,1,0.36
7,7,gym,3,210,1,2,0.32
7,7,handy,5,211,0,5,0.52
7,7,happen,6,212,2,4,0.52
7,7,harm,4,213,2,2,0.32
7,7,harsh,5,214,3,2,0.36
7,7,hat,3,215,2,1,0.36
7,7,hate,4,216,3,1,0.28
7,7,hazard,6,217,2,4,0.52
7,7,health,6,218,1,5,0.64
7,7,her,3,219,2,1,0.24
7,7,herb,4,220,3,1,0.28
7,7,hint,4,221,1,3,0.48
7,7,honesty,7,222,1,6,0.64
7,7,hour,4,223,2,2,0.32
7,7,how,3,224,2,1,0.24
7,7,ice,3,225,0,3,0.32
7,7,icon,4,226,2,2,0.32
7,7,ideal,5,227,1,4,0.56
7,7,ill,3,228,1,2,0.28
7,7,improve,7,229,1,6,0.76
7,7,include,7,230,1,6,0.68
7,7,incur,5,231,3,2,0.52
7,7,infant,6,232,2,4,0.52
7,7,info,4,233,3,1,0.28
7,7,inject,6,234,2,4,0.52
7,7,injure,6,235,3,3,0.44
7,7,injury,6,236,5,1,0.48
7,7,insert,6,237,2,4,0.56
7,7,intake,6,238,2,4,0.56
7,7,into,4,239,3,1,0.32
7,7,invade,6,240,2,4,0.6
7,7,iron,4,241,1,3,0.56
7,7,issue,5,242,1,4,0.48
7,7,job,3,243,0,3,0.32
7,7,joy,3,244,2,1,0.24
7,7,jump,4,245,1,3,0.36
7,7,key,3,246,0,3,0.32
7,7,kick,4,247,1,3,0.36
7,7,kingdom,7,248,2,5,0.72
7,7,knife,5,249,1,4,0.48
7,7,know,4,250,2,2,0.32
7,7,laser,5,251,0,5,0.52
7,7,leading,7,252,1,6,1
7,7,leaf,4,253,3,1,0.32
7,7,leaflet,7,254,4,3,0.52
7,7,league,6,255,3,3,0.6
7,7,left,4,256,2,2,0.44
7,7,lesbian,7,257,2,5,0.88
7,7,lesser,6,258,3,3,0.48
7,7,letter,6,259,2,4,0.56
7,7,licence,7,260,1,6,0.72
7,7,limb,4,261,2,2,0.36
7,7,limited,7,262,3,4,0.68
7,7,lion,4,263,2,2,0.32
7,7,little,6,264,2,4,0.56
7,7,liver,5,265,2,3,0.44
7,7,load,4,266,1,3,0.4
7,7,located,7,267,2,5,0.8
7,7,loose,5,268,2,3,0.44
7,7,low,3,269,2,1,0.24
7,7,lunch,5,270,1,4,0.48
7,7,mark,4,271,0,4,0.44
7,7,master,6,272,2,4,0.64
7,7,match,5,273,2,3,0.44
7,7,meal,4,274,1,3,0.36
7,7,media,5,275,2,3,0.44
7,7,melody,6,276,2,4,0.52
7,7,memory,6,277,2,4,0.64
7,7,mental,6,278,2,4,0.52
7,7,mentor,6,279,4,2,0.4
7,7,merely,6,280,2,4,0.52
7,7,merger,6,281,3,3,0.56
7,7,message,7,282,2,5,0.6
7,7,militia,7,283,1,6,0.68
7,7,missing,7,284,2,5,0.6
7,7,modify,6,285,1,5,0.68
7,7,moment,6,286,2,4,0.52
7,7,mum,3,287,1,2,0.28
7,7,museum,6,288,2,4,0.52
7,7,must,4,289,3,1,0.28
7,7,myth,4,290,1,3,0.36
7,7,naked,5,291,0,5,0.64
7,7,name,4,292,2,2,0.32
7,7,nation,6,293,2,4,0.52
7,7,nature,6,294,3,3,0.44
7,7,needle,6,295,1,5,0.56
7,7,new,3,296,2,1,0.64
7,7,newly,5,297,3,2,0.88
7,7,night,5,298,1,4,1.2
7,7,noise,5,299,1,4,1.36
7,7,non,3,300,2,1,0.36
7,7,not,3,301,2,1,0.32
7,7,note,4,302,3,1,0.4
7,7,nothing,7,303,3,4,0.76
7,7,notice,6,304,3,3,0.48
7,7,novel,5,305,2,3,0.56
7,7,nut,3,306,1,2,0.28
7,7,obesity,7,307,0,7,0.72
7,7,ocean,5,308,1,4,0.68
7,7,october,7,309,2,5,0.6
7,7,off,3,310,1,2,0.4
7,7,offend,6,311,3,3,0.56
7,7,once,4,312,1,3,0.48
7,7,online,6,313,2,4,0.6
7,7,opposed,7,314,1,6,0.76
7,7,organic,7,315,1,6,0.8
7,7,outdoor,7,316,1,6,0.68
7,7,outfit,6,317,3,3,0.48
7,7,outing,6,318,3,3,0.52
7,7,outlet,6,319,3,3,0.48
7,7,outlook,7,320,4,3,0.28
7,7,overall,7,321,1,6,0.36
7,7,owe,3,322,1,2,0.12
7,7,pack,4,323,0,4,0.2
7,7,painful,7,324,2,5,0.32
7,7,palace,6,325,2,4,0.24
7,7,pants,5,326,2,3,0.2
7,7,park,4,327,2,2,0.16
7,7,patent,6,328,2,4,0.24
7,7,patron,6,329,3,3,0.28
7,7,pepper,6,330,1,5,0.24
7,7,pick,4,331,1,3,0.16
7,7,piece,5,332,2,3,0.2
7,7,pig,3,333,2,1,0.12
7,7,pin,3,334,2,1,0.16
7,7,pioneer,7,335,2,5,0.28
7,7,plan,4,336,1,3,0.16
7,7,plastic,7,337,3,4,0.24
7,7,play,4,338,3,1,0.12
7,7,pleased,7,339,2,5,0.32
7,7,plot,4,340,2,2,0.16
7,7,praise,6,341,1,5,0.28
7,7,prayer,6,342,3,3,0.2
7,7,printer,7,343,2,5,0.32
7,7,product,7,344,2,5,0.28
7,7,program,7,345,3,4,0.24
7,7,proper,6,346,3,3,0.2
7,7,protest,7,347,3,4,0.24
7,7,pump,4,348,1,3,0.24
7,7,punk,4,349,2,2,0.16
7,7,pupil,5,350,2,3,0.16
7,7,pure,4,351,2,2,0.16
7,7,pursuit,7,352,3,4,0.28
7,7,push,4,353,2,2,0.2
7,7,query,5,354,0,5,0.24
7,7,quest,5,355,3,2,0.16
7,7,quite,5,356,2,3,0.2
7,7,race,4,357,0,4,0.2
7,7,racial,6,358,3,3,0.24
7,7,rail,4,359,2,2,0.12
7,7,rear,4,360,1,3,0.16
7,7,recall,6,361,2,4,0.2
7,7,record,6,362,3,3,0.2
7,7,recruit,7,363,3,4,0.32
7,7,regard,6,364,2,4,0.2
7,7,regime,6,365,3,3,0.2
7,7,region,6,366,4,2,0.16
7,7,relax,5,367,2,3,0.16
7,7,remark,6,368,2,4,0.28
7,7,remind,6,369,3,3,0.2
7,7,revenge,7,370,2,5,0.24
7,7,revive,6,371,3,3,0.2
7,7,rip,3,372,1,2,0.12
7,7,rise,4,373,2,2,0.2
7,7,ritual,6,374,2,4,0.24
7,7,rival,5,375,2,3,0.16
7,7,rob,3,376,1,2,0.12
7,7,robbery,7,377,3,4,0.24
7,7,roll,4,378,2,2,0.2
7,7,romance,7,379,2,5,0.24
7,7,roof,4,380,2,2,0.12
7,7,rough,5,381,2,3,0.16
7,7,round,5,382,3,2,0.16
7,7,rub,3,383,1,2,0.12
7,7,rubber,6,384,3,3,0.24
7,7,sacred,6,385,0,6,0.28
7,7,sale,4,386,2,2,0.16
7,7,scan,4,387,1,3,0.16
7,7,scared,6,388,3,3,0.2
7,7,scheme,6,389,2,4,0.28
7,7,school,6,390,3,3,0.2
7,7,second,6,391,1,5,0.24
7,7,secret,6,392,3,3,0.2
7,7,seeker,6,393,2,4,0.28
7,7,seem,4,394,3,1,0.12
7,7,segment,7,395,2,5,0.28
7,7,service,7,396,2,5,0.24
7,7,setting,7,397,2,5,0.32
7,7,sexual,6,398,2,4,0.24
7,7,sexy,4,399,3,1,0.12
7,7,sheer,5,400,1,4,0.2
7,7,shore,5,401,2,3,0.2
7,7,sibling,7,402,1,6,0.36
7,7,sight,5,403,2,3,0.2
7,7,simply,6,404,2,4,0.24
7,7,sin,3,405,2,1,0.08
7,7,sit,3,406,2,1,0.08
7,7,ski,3,407,1,2,0.12
7,7,slice,5,408,1,4,0.28
7,7,slip,4,409,3,1,0.12
7,7,smile,5,410,1,4,0.2
7,7,solar,5,411,1,4,0.2
7,7,solid,5,412,3,2,0.16
7,7,some,4,413,2,2,0.12
7,7,somehow,7,414,4,3,0.28
7,7,someone,7,415,4,3,0.2
7,7,song,4,416,2,2,0.12
7,7,south,5,417,2,3,0.16
7,7,space,5,418,1,4,0.28
7,7,spare,5,419,3,2,0.16
7,7,speaker,7,420,2,5,0.28
7,7,sphere,6,421,2,4,0.2
7,7,spin,4,422,2,2,0.12
7,7,spread,6,423,2,4,0.28
7,7,stab,4,424,1,3,0.16
7,7,staff,5,425,3,2,0.16
7,7,stamp,5,426,3,2,0.16
7,7,star,4,427,3,1,0.12
7,7,statue,6,428,3,3,0.2
7,7,stick,5,429,2,3,0.24
7,7,stop,4,430,2,2,0.12
7,7,street,6,431,2,4,0.24
7,7,stretch,7,432,4,3,0.2
7,7,strict,6,433,3,3,0.2
7,7,strike,6,434,4,2,0.24
7,7,studio,6,435,2,4,0.24
7,7,study,5,436,4,1,0.12
7,7,stumble,7,437,3,4,0.24
7,7,stun,4,438,3,1,0.16
7,7,subject,7,439,1,6,0.32
7,7,sue,3,440,2,1,0.12
7,7,sugar,5,441,2,3,0.24
7,7,super,5,442,2,3,0.24
7,7,surely,6,443,2,4,0.24
7,7,swear,5,444,1,4,0.28
7,7,sweater,7,445,4,3,0.2
7,7,switch,6,446,2,4,0.24
7,7,symptom,7,447,1,6,0.28
7,7,tale,4,448,0,4,0.24
7,7,talent,6,449,4,2,0.16
7,7,talk,4,450,3,1,0.12
7,7,tap,3,451,2,1,0.12
7,7,task,4,452,2,2,0.16
7,7,team,4,453,1,3,0.16
7,7,tender,6,454,2,4,0.28
7,7,tension,7,455,3,4,0.28
7,7,terror,6,456,2,4,0.24
7,7,thirsty,7,457,1,6,0.32
7,7,this,4,458,3,1,0.2
7,7,thumb,5,459,2,3,0.16
7,7,ticket,6,460,1,5,0.24
7,7,tidy,4,461,2,2,0.12
7,7,tight,5,462,2,3,0.16
7,7,tighten,7,463,5,2,0.24
7,7,till,4,464,2,2,0.16
7,7,timing,6,465,2,4,0.28
7,7,tonight,7,466,1,6,0.32
7,7,too,3,467,2,1,0.12
7,7,tour,4,468,2,2,0.12
7,7,treaty,6,469,1,5,0.32
7,7,tree,4,470,3,1,0.12
7,7,trial,5,471,2,3,0.2
7,7,tribe,5,472,3,2,0.16
7,7,trouble,7,473,2,5,0.28
7,7,two,3,474,1,2,0.16
7,7,unable,6,475,0,6,0.28
7,7,undergo,7,476,2,5,0.24
7,7,unify,5,477,2,3,0.2
7,7,union,5,478,3,2,0.16
7,7,until,5,479,2,3,0.24
7,7,unveil,6,480,2,4,0.2
7,7,upgrade,7,481,1,6,0.28
7,7,usage,5,482,1,4,0.2
7,7,utilize,7,483,1,6,0.36
7,7,vague,5,484,0,5,0.24
7,7,vary,4,485,2,2,0.16
7,7,vein,4,486,1,3,0.16
7,7,venture,7,487,2,5,0.32
7,7,vessel,6,488,2,4,0.28
7,7,veteran,7,489,2,5,0.24
7,7,viable,6,490,1,5,0.24
7,7,video,5,491,2,3,0.16
7,7,viewer,6,492,2,4,0.28
7,7,violent,7,493,2,5,0.24
7,7,virtue,6,494,2,4,0.24
7,7,visitor,7,495,2,5,0.28
7,7,visual,6,496,3,3,0.28
7,7,wake,4,497,0,4,0.2
7,7,walk,4,498,2,2,0.16
7,7,war,3,499,2,1,0.08
7,7,warning,7,500,3,4,0.24
7,7,warrior,7,501,3,4,0.28
7,7,washing,7,502,2,5,0.28
7,7,watch,5,503,2,3,0.16
7,7,way,3,504,2,1,0.12
7,7,wealthy,7,505,1,6,0.28
7,7,weapon,6,506,3,3,0.28
7,7,weight,6,507,2,4,0.2
7,7,welcome,7,508,2,5,0.28
7,7,whereas,7,509,1,6,0.44
7,7,which,5,510,2,3,0.52
7,7,whose,5,511,2,3,0.52
7,7,width,5,512,1,4,0.52
7,7,willing,7,513,2,5,0.76
7,7,win,3,514,2,1,0.24
7,7,woman,5,515,1,4,0.48
7,7,world,5,516,2,3,0.52
7,7,worry,5,517,3,2,0.36
7,7,wrap,4,518,1,3,0.4
7,7,wrist,5,519,2,3,0.44
7,7,yellow,6,520,0,6,0.6
7,7,young,5,521,1,4,0.56
7,8,a,1,0,0,1,0.16
7,8,absorb,6,1,1,5,0.56
7,8,accept,6,2,1,5,0.56
7,8,acid,4,3,2,2,0.32
7,8,acute,5,4,2,3,0.52
7,8,add,3,5,1,2,0.32
7,8,address,7,6,3,4,0.56
7,8,admit,5,7,2,3,0.44
7,8,advice,6,8,2,4,0.56
7,8,again,5,9,1,4,0.6
7,8,against,7,10,5,2,0.44
7,8,align,5,11,1,4,0.48
7,8,ally,4,12,2,2,0.32
7,8,ankle,5,13,1,4,0.48
7,8,annoyed,7,14,2,5,0.72
7,8,anxiety,7,15,2,5,0.6
7,8,anybody,7,16,2,5,0.6
7,8,apology,7,17,1,6,0.68
7,8,approve,7,18,2,5,0.68
7,8,army,4,19,1,3,0.36
7,8,ask,3,20,1,2,0.28
7,8,backing,7,21,0,7,0.72
7,8,balance,7,22,2,5,0.72
7,8,banner,6,23,2,4,0.52
7,8,barrel,6,24,2,4,0.6
7,8,bat,3,25,2,1,0.24
7,8,bath,4,26,3,1,0.28
7,8,beast,5,27,1,4,0.48
7,8,beat,4,28,3,1,0.4
7,8,behalf,6,29,2,4,0.52
7,8,bell,4,30,2,2,0.32
7,8,belong,6,31,3,3,0.48
7,8,below,5,32,4,1,0.32
7,8,bin,3,33,1,2,0.36
7,8,bishop,6,34,2,4,0.52
7,8,bite,4,35,2,2,0.32
7,8,bizarre,7,36,2,5,0.6
7,8,blade,5,37,1,4,0.48
7,8,bless,5,38,2,3,0.52
7,8,blind,5,39,2,3,0.44
7,8,blow,4,40,2,2,0.32
7,8,boat,4,41,1,3,0.36
7,8,boil,4,42,2,2,0.4
7,8,boom,4,43,2,2,0.32
7,8,bottle,6,44,2,4,0.6
7,8,box,3,45,2,1,0.24
7,8,breach,6,46,1,5,0.6
7,8,break,5,47,4,1,0.36
7,8,bride,5,48,2,3,0.44
7,8,bridge,6,49,4,2,0.56
7,8,buffer,6,50,1,5,0.32
7,8,bug,3,51,2,1,0.12
7,8,build,5,52,2,3,0.2
7,8,burden,6,53,2,4,0.44
7,8,cap,3,54,0,3,0.16
7,8,capable,7,55,3,4,0.32
7,8,card,4,56,2,2,0.12
7,8,career,6,57,3,3,0.2
7,8,carve,5,58,3,2,0.16
7,8,cave,4,59,2,2,0.12
7,8,cd,2,60,1,1,0.12
7,8,cease,5,61,1,4,0.2
7,8,central,7,62,2,5,0.28
7,8,century,7,63,4,3,0.2
7,8,chapter,7,64,1,6,0.28
7,8,charm,5,65,3,2,0.2
7,8,cheat,5,66,2,3,0.16
7,8,choir,5,67,2,3,0.16
7,8,choose,6,68,3,3,0.2
7,8,chop,4,69,3,1,0.12
7,8,circle,6,70,1,5,0.32
7,8,clerk,5,71,1,4,0.24
7,8,club,4,72,2,2,0.16
7,8,cluster,7,73,3,4,0.28
7,8,coffee,6,74,1,5,0.24
7,8,colony,6,75,2,4,0.28
7,8,comedy,6,76,2,4,0.24
7,8,comment,7,77,3,4,0.24
7,8,company,7,78,3,4,0.28
7,8,comply,6,79,4,2,0.24
7,8,concept,7,80,2,5,0.24
7,8,concern,7,81,5,2,0.2
7,8,confer,6,82,3,3,0.2
7,8,confess,7,83,5,2,0.24
7,8,consent,7,84,3,4,0.24
7,8,consult,7,85,4,3,0.2
7,8,contend,7,86,3,4,0.24
7,8,cooker,6,87,2,4,0.28
7,8,cottage,7,88,2,5,0.28
7,8,county,6,89,2,4,0.2
7,8,coup,4,90,3,1,0.12
7,8,course,6,91,3,3,0.2
7,8,court,5,92,4,1,0.2
7,8,craft,5,93,1,4,0.2
7,8,creep,5,94,2,3,0.2
7,8,crime,5,95,2,3,0.16
7,8,crowded,7,96,2,5,0.28
7,8,crucial,7,97,2,5,0.32
7,8,cruise,6,98,3,3,0.2
7,8,cry,3,99,2,1,0.08
7,8,curved,6,100,1,5,0.24
7,8,dam,3,101,0,3,0.16
7,8,dance,5,102,2,3,0.24
7,8,day,3,103,2,1,0.08
7,8,deal,4,104,1,3,0.16
7,8,death,5,105,3,2,0.16
7,8,deed,4,106,2,2,0.12
7,8,defect,6,107,2,4,0.2
7,8,defence,7,108,4,3,0.28
7,8,delight,7,109,2,5,0.28
7,8,demon,5,110,2,3,0.16
7,8,dentist,7,111,2,5,0.24
7,8,desktop,7,112,2,5,0.32
7,8,develop,7,113,2,5,0.28
7,8,devil,5,114,3,2,0.16
7,8,dictate,7,115,1,6,0.28
7,8,digital,7,116,2,5,0.32
7,8,dinner,6,117,2,4,0.2
7,8,dirt,4,118,2,2,0.16
7,8,discuss,7,119,2,5,0.24
7,8,distort,7,120,3,4,0.32
7,8,domain,6,121,1,5,0.24
7,8,dot,3,122,2,1,0.08
7,8,double,6,123,2,4,0.2
7,8,drama,5,124,1,4,0.2
7,8,drawing,7,125,3,4,0.32
7,8,drink,5,126,2,3,0.16
7,8,edit,4,127,0,4,0.2
7,8,eight,5,128,1,4,0.2
7,8,eighty,6,129,5,1,0.16
7,8,eleven,6,130,1,5,0.32
7,8,embody,6,131,1,5,0.24
7,8,enable,6,132,1,5,0.24
7,8,ending,6,133,2,4,0.2
7,8,enemy,5,134,2,3,0.16
7,8,enter,5,135,2,3,0.24
7,8,entry,5,136,3,2,0.16
7,8,erect,5,137,1,4,0.2
7,8,evening,7,138,1,6,0.28
7,8,event,5,139,4,1,0.2
7,8,excited,7,140,1,6,0.28
7,8,excuse,6,141,3,3,0.2
7,8,exit,4,142,2,2,0.12
7,8,expire,6,143,2,4,0.24
7,8,explain,7,144,3,4,0.32
7,8,explode,7,145,4,3,0.2
7,8,exploit,7,146,5,2,0.2
7,8,extend,6,147,2,4,0.24
7,8,extent,6,148,5,1,0.2
7,8,eye,3,149,1,2,0.12
7,8,faculty,7,150,0,7,0.32
7,8,fall,4,151,2,2,0.16
7,8,famous,6,152,2,4,0.32
7,8,fast,4,153,2,2,0.16
7,8,fasten,6,154,4,2,0.24
7,8,feeding,7,155,1,6,0.28
7,8,fibre,5,156,1,4,0.2
7,8,fiction,7,157,2,5,0.24
7,8,fifty,5,158,2,3,0.24
7,8,file,4,159,2,2,0.12
7,8,finally,7,160,2,5,0.28
7,8,firm,4,161,2,2,0.12
7,8,flag,4,162,1,3,0.16
7,8,flat,4,163,3,1,0.2
7,8,flee,4,164,2,2,0.16
7,8,flower,6,165,2,4,0.24
7,8,flying,6,166,2,4,0.24
7,8,focus,5,167,1,4,0.24
7,8,folk,4,168,2,2,0.16
7,8,food,4,169,2,2,0.2
7,8,for,3,170,2,1,0.08
7,8,former,6,171,3,3,0.2
7,8,foster,6,172,2,4,0.2
7,8,freedom,7,173,1,6,0.28
7,8,friday,6,174,2,4,0.28
7,8,fridge,6,175,4,2,0.16
7,8,frog,4,176,2,2,0.12
7,8,front,5,177,3,2,0.16
7,8,fulfil,6,178,1,5,0.24
7,8,fur,3,179,2,1,0.16
7,8,gallery,7,180,0,7,0.32
7,8,garage,6,181,2,4,0.24
7,8,gender,6,182,1,5,0.24
7,8,gene,4,183,3,1,0.12
7,8,genre,5,184,3,2,0.24
7,8,giant,5,185,1,4,0.2
7,8,glass,5,186,1,4,0.2
7,8,glimpse,7,187,2,5,0.24
7,8,globe,5,188,2,3,0.24
7,8,go,2,189,1,1,0.08
7,8,god,3,190,2,1,0.08
7,8,golf,4,191,2,2,0.12
7,8,good,4,192,2,2,0.12
7,8,govern,6,193,2,4,0.24
7,8,grace,5,194,1,4,0.2
7,8,grade,5,195,3,2,0.2
7,8,green,5,196,2,3,0.16
7,8,greet,5,197,4,1,0.16
7,8,grey,4,198,3,1,0.12
7,8,grid,4,199,2,2,0.12
7,8,grief,5,200,3,2,0.2
7,8,grin,4,201,3,1,0.12
7,8,grind,5,202,4,1,0.16
7,8,growth,6,203,2,4,0.24
7,8,guest,5,204,1,4,0.24
7,8,guide,5,205,2,3,0.2
7,8,harsh,5,206,0,5,0.28
7,8,harvest,7,207,3,4,0.24
7,8,hat,3,208,2,1,0.12
7,8,hate,4,209,3,1,0.12
7,8,health,6,210,1,5,0.24
7,8,heart,5,211,3,2,0.24
7,8,herb,4,212,2,2,0.12
7,8,hers,4,213,3,1,0.12
7,8,highly,6,214,1,5,0.24
7,8,hint,4,215,2,2,0.16
7,8,honesty,7,216,1,6,0.32
7,8,hotel,5,217,2,3,0.2
7,8,hour,4,218,2,2,0.12
7,8,however,7,219,2,5,0.24
7,8,humour,6,220,1,5,0.24
7,8,hunt,4,221,2,2,0.2
7,8,i,1,222,0,1,0.08
7,8,ideal,5,223,1,4,0.2
7,8,image,5,224,1,4,0.2
7,8,imagery,7,225,5,2,0.2
7,8,include,7,226,1,6,0.36
7,8,index,5,227,2,3,0.16
7,8,infant,6,228,2,4,0.24
7,8,info,4,229,3,1,0.12
7,8,inform,6,230,4,2,0.2
7,8,injure,6,231,2,4,0.32
7,8,inspect,7,232,2,5,0.24
7,8,instant,7,233,3,4,0.24
7,8,intake,6,234,2,4,0.2
7,8,intense,7,235,3,4,0.32
7,8,into,4,236,3,1,0.12
7,8,invade,6,237,2,4,0.24
7,8,island,6,238,1,5,0.24
7,8,jet,3,239,0,3,0.16
7,8,job,3,240,1,2,0.12
7,8,jump,4,241,1,3,0.24
7,8,june,4,242,2,2,0.12
7,8,just,4,243,2,2,0.12
7,8,justify,7,244,4,3,0.2
7,8,kid,3,245,0,3,0.16
7,8,kidney,6,246,3,3,0.24
7,8,know,4,247,1,3,0.16
7,8,latest,6,248,0,6,0.28
7,8,laugh,5,249,2,3,0.16
7,8,law,3,250,2,1,0.08
7,8,lawn,4,251,3,1,0.12
7,8,legend,6,252,1,5,0.32
7,8,lens,4,253,2,2,0.12
7,8,lethal,6,254,2,4,0.2
7,8,license,7,255,1,6,0.32
7,8,lie,3,256,2,1,0.12
7,8,limited,7,257,2,5,0.36
7,8,litter,6,258,2,4,0.24
7,8,liver,5,259,2,3,0.16
7,8,local,5,260,1,4,0.2
7,8,located,7,261,4,3,0.28
7,8,loose,5,262,2,3,0.2
7,8,mail,4,263,0,4,0.2
7,8,mandate,7,264,2,5,0.28
7,8,map,3,265,2,1,0.08
7,8,married,7,266,2,5,0.32
7,8,mask,4,267,2,2,0.16
7,8,master,6,268,3,3,0.2
7,8,meal,4,269,1,3,0.2
7,8,mean,4,270,3,1,0.12
7,8,media,5,271,2,3,0.2
7,8,meeting,7,272,2,5,0.36
7,8,melody,6,273,2,4,0.24
7,8,mental,6,274,2,4,0.24
7,8,merger,6,275,2,4,0.24
7,8,message,7,276,2,5,0.32
7,8,metre,5,277,2,3,0.2
7,8,militia,7,278,1,6,0.28
7,8,mixed,5,279,2,3,0.2
7,8,model,5,280,1,4,0.2
7,8,modify,6,281,3,3,0.28
7,8,month,5,282,2,3,0.2
7,8,more,4,283,2,2,0.12
7,8,movie,5,284,2,3,0.24
7,8,mum,3,285,1,2,0.12
7,8,museum,6,286,2,4,0.28
7,8,music,5,287,3,2,0.16
7,8,my,2,288,1,1,0.08
7,8,myth,4,289,2,2,0.12
7,8,naked,5,290,0,5,0.24
7,8,nasty,5,291,2,3,0.2
7,8,newly,5,292,1,4,0.28
7,8,night,5,293,1,4,0.2
7,8,non,3,294,1,2,0.12
7,8,norm,4,295,2,2,0.16
7,8,note,4,296,2,2,0.12
7,8,nothing,7,297,3,4,0.32
7,8,notice,6,298,3,3,0.2
7,8,novel,5,299,2,3,0.2
7,8,nut,3,300,1,2,0.12
7,8,oblige,6,301,0,6,0.28
7,8,october,7,302,1,6,0.36
7,8,off,3,303,1,2,0.12
7,8,offence,7,304,3,4,0.24
7,8,offend,6,305,5,1,0.16
7,8,once,4,306,1,3,0.16
7,8,online,6,307,2,4,0.28
7,8,opposed,7,308,1,6,0.28
7,8,other,5,309,1,4,0.2
7,8,ought,5,310,1,4,0.2
7,8,outfit,6,311,2,4,0.2
7,8,outlet,6,312,3,3,0.28
7,8,pack,4,313,0,4,0.36
7,8,pad,3,314,2,1,0.08
7,8,page,4,315,2,2,0.12
7,8,paint,5,316,2,3,0.2
7,8,palace,6,317,2,4,0.32
7,8,park,4,318,2,2,0.12
7,8,partial,7,319,3,4,0.24
7,8,pause,5,320,2,3,0.16
7,8,peer,4,321,1,3,0.16
7,8,perfect,7,322,2,5,0.32
7,8,phone,5,323,1,4,0.2
7,8,photo,5,324,3,2,0.16
7,8,piece,5,325,1,4,0.2
7,8,pig,3,326,2,1,0.08
7,8,pile,4,327,2,2,0.12
7,8,pipe,4,328,2,2,0.2
7,8,plane,5,329,1,4,0.2
7,8,plastic,7,330,3,4,0.24
7,8,plead,5,331,2,3,0.16
7,8,pleased,7,332,4,3,0.24
7,8,pledge,6,333,3,3,0.24
7,8,plot,4,334,2,2,0.16
7,8,point,5,335,1,4,0.2
7,8,pond,4,336,2,2,0.16
7,8,pot,3,337,2,1,0.08
7,8,praise,6,338,1,5,0.32
7,8,precise,7,339,2,5,0.24
7,8,predict,7,340,3,4,0.24
7,8,process,7,341,2,5,0.28
7,8,product,7,342,3,4,0.32
7,8,profile,7,343,3,4,0.24
7,8,program,7,344,3,4,0.24
7,8,punk,4,345,1,3,0.16
7,8,pure,4,346,2,2,0.12
7,8,put,3,347,2,1,0.16
7,8,quality,7,348,0,7,0.32
7,8,query,5,349,2,3,0.2
7,8,quest,5,350,3,2,0.16
7,8,race,4,351,0,4,0.2
7,8,racism,6,352,3,3,0.28
7,8,rally,5,353,2,3,0.16
7,8,rear,4,354,1,3,0.16
7,8,recall,6,355,2,4,0.2
7,8,record,6,356,3,3,0.2
7,8,recount,7,357,4,3,0.32
7,8,recycle,7,358,3,4,0.24
7,8,refuse,6,359,2,4,0.24
7,8,region,6,360,2,4,0.2
7,8,relax,5,361,2,3,0.24
7,8,relaxed,7,362,5,2,0.2
7,8,relief,6,363,3,3,0.2
7,8,remark,6,364,2,4,0.24
7,8,remind,6,365,3,3,0.24
7,8,removal,7,366,3,4,0.32
7,8,remove,6,367,5,1,0.16
7,8,renew,5,368,2,3,0.16
7,8,residue,7,369,2,5,0.28
7,8,rest,4,370,3,1,0.12
7,8,retire,6,371,2,4,0.28
7,8,revenge,7,372,2,5,0.28
7,8,revise,6,373,3,3,0.2
7,8,rifle,5,374,1,4,0.2
7,8,rip,3,375,2,1,0.12
7,8,ritual,6,376,2,4,0.28
7,8,rival,5,377,2,3,0.16
7,8,rob,3,378,1,2,0.12
7,8,robbery,7,379,3,4,0.24
7,8,roll,4,380,2,2,0.12
7,8,romance,7,381,2,5,0.32
7,8,round,5,382,2,3,0.2
7,8,routine,7,383,3,4,0.24
7,8,sailor,6,384,0,6,0.24
7,8,sale,4,385,2,2,0.24
7,8,satisfy,7,386,2,5,0.24
7,8,scan,4,387,1,3,0.16
7,8,scared,6,388,3,3,0.2
7,8,scheme,6,389,2,4,0.24
7,8,scholar,7,390,3,4,0.32
7,8,school,6,391,4,2,0.2
7,8,score,5,392,2,3,0.2
7,8,seal,4,393,1,3,0.16
7,8,second,6,394,2,4,0.24
7,8,seem,4,395,2,2,0.2
7,8,serious,7,396,2,5,0.28
7,8,servant,7,397,3,4,0.24
7,8,serve,5,398,4,1,0.12
7,8,service,7,399,4,3,0.28
7,8,setting,7,400,2,5,0.28
7,8,seven,5,401,2,3,0.16
7,8,sexual,6,402,2,4,0.24
7,8,sheer,5,403,1,4,0.2
7,8,shell,5,404,3,2,0.24
7,8,shift,5,405,2,3,0.16
7,8,ship,4,406,3,1,0.12
7,8,shore,5,407,2,3,0.16
7,8,sight,5,408,1,4,0.2
7,8,singing,7,409,2,5,0.32
7,8,sink,4,410,3,1,0.12
7,8,six,3,411,2,1,0.08
7,8,ski,3,412,1,2,0.12
7,8,skirt,5,413,3,2,0.16
7,8,slam,4,414,1,3,0.16
7,8,smile,5,415,1,4,0.28
7,8,smoking,7,416,2,5,0.32
7,8,snow,4,417,1,3,0.2
7,8,soap,4,418,1,3,0.16
7,8,solar,5,419,2,3,0.2
7,8,song,4,420,2,2,0.12
7,8,soup,4,421,2,2,0.2
7,8,spare,5,422,1,4,0.24
7,8,special,7,423,2,5,0.28
7,8,spin,4,424,2,2,0.12
7,8,spread,6,425,2,4,0.24
7,8,stab,4,426,1,3,0.24
7,8,stable,6,427,4,2,0.16
7,8,stall,5,428,3,2,0.16
7,8,stand,5,429,3,2,0.16
7,8,stay,4,430,3,1,0.12
7,8,stem,4,431,2,2,0.2
7,8,stop,4,432,2,2,0.12
7,8,storage,7,433,3,4,0.24
7,8,store,5,434,4,1,0.12
7,8,story,5,435,4,1,0.12
7,8,strict,6,436,2,4,0.28
7,8,string,6,437,4,2,0.32
7,8,studio,6,438,2,4,0.56
7,8,subject,7,439,1,6,0.72
7,8,sugar,5,440,2,3,0.44
7,8,super,5,441,2,3,0.56
7,8,suppose,7,442,3,4,0.56
7,8,supreme,7,443,3,4,0.56
7,8,surely,6,444,2,4,0.52
7,8,swim,4,445,1,3,0.48
7,8,symptom,7,446,1,6,0.64
7,8,tale,4,447,0,4,0.44
7,8,talk,4,448,3,1,0.28
7,8,tank,4,449,2,2,0.32
7,8,tap,3,450,2,1,0.24
7,8,task,4,451,2,2,0.44
7,8,taste,5,452,3,2,0.36
7,8,tea,3,453,1,2,0.28
7,8,team,4,454,3,1,0.28
7,8,tempt,5,455,2,3,0.4
7,8,tender,6,456,2,4,0.52
7,8,terrify,7,457,2,5,0.72
7,8,terror,6,458,4,2,0.4
7,8,texture,7,459,2,5,0.64
7,8,thesis,6,460,1,5,0.56
7,8,this,4,461,2,2,0.44
7,8,ticket,6,462,1,5,0.56
7,8,tight,5,463,2,3,0.44
7,8,tighten,7,464,5,2,0.44
7,8,to,2,465,1,1,0.2
7,8,tonight,7,466,2,5,0.72
7,8,tonne,5,467,3,2,0.36
7,8,too,3,468,2,1,0.24
7,8,tool,4,469,3,1,0.28
7,8,tour,4,470,2,2,0.32
7,8,tree,4,471,1,3,0.36
7,8,trend,5,472,3,2,0.48
7,8,trial,5,473,2,3,0.44
7,8,tribal,6,474,3,3,0.44
7,8,tribute,7,475,4,3,0.48
7,8,truck,5,476,2,3,0.4
7,8,tune,4,477,1,3,0.48
7,8,twice,5,478,1,4,0.48
7,8,unable,6,479,0,6,0.6
7,8,unfair,6,480,2,4,0.52
7,8,unify,5,481,2,3,0.44
7,8,upgrade,7,482,1,6,0.76
7,8,urban,5,483,1,4,0.48
7,8,urgent,6,484,2,4,0.52
7,8,utilize,7,485,1,6,0.68
7,8,vary,4,486,0,4,0.56
7,8,verify,6,487,1,5,0.56
7,8,viable,6,488,1,5,0.56
7,8,violent,7,489,2,5,0.68
7,8,virtual,7,490,2,5,0.76
7,8,virtue,6,491,5,1,0.36
7,8,virus,5,492,3,2,0.36
7,8,vocal,5,493,1,4,0.48
7,8,wait,4,494,0,4,0.44
7,8,wake,4,495,2,2,0.32
7,8,warning,7,496,2,5,0.72
7,8,washing,7,497,2,5,0.6
7,8,watch,5,498,2,3,0.48
7,8,water,5,499,3,2,0.36
7,8,way,3,500,2,1,0.24
7,8,wealthy,7,501,1,6,0.76
7,8,weapon,6,502,3,3,0.44
7,8,weekend,7,503,2,5,0.6
7,8,weight,6,504,2,4,0.6
7,8,weird,5,505,3,2,0.48
7,8,welcome,7,506,2,5,0.6
7,8,whereas,7,507,1,6,0.68
7,8,which,5,508,2,3,0.4
7,8,whose,5,509,2,3,0.52
7,8,willing,7,510,1,6,0.68
7,8,win,3,511,2,1,0.28
7,8,window,6,512,3,3,0.56
7,8,wine,4,513,3,1,0.28
7,8,wipe,4,514,2,2,0.32
7,8,wisdom,6,515,2,4,0.64
7,8,without,7,516,2,5,0.6
7,8,woman,5,517,1,4,0.48
7,8,world,5,518,2,3,0.4
7,8,wrist,5,519,1,4,0.48
7,8,yellow,6,520,0,6,0.76
7,8,young,5,521,1,4,0.48
7,9,a,1,0,0,1,0.08
7,9,absurd,6,1,1,5,0.24
7,9,accept,6,2,1,5,0.24
7,9,acid,4,3,2,2,0.2
7,9,acre,4,4,2,2,0.16
7,9,actress,7,5,2,5,0.28
7,9,acute,5,6,2,3,0.2
7,9,ad,2,7,1,1,0.08
7,9,admit,5,8,2,3,0.24
7,9,adopt,5,9,2,3,0.2
7,9,against,7,10,1,6,0.28
7,9,agree,5,11,2,3,0.16
7,9,ahead,5,12,1,4,0.2
7,9,alcohol,7,13,1,6,0.36
7,9,align,5,14,2,3,0.2
7,9,amateur,7,15,1,6,0.28
7,9,analyse,7,16,1,6,0.28
7,9,and,3,17,2,1,0.16
7,9,anger,5,18,2,3,0.2
7,9,annoyed,7,19,2,5,0.28
7,9,another,7,20,2,5,0.24
7,9,anxiety,7,21,2,5,0.32
7,9,app,3,22,1,2,0.12
7,9,approve,7,23,3,4,0.24
7,9,arrow,5,24,1,4,0.2
7,9,artist,6,25,2,4,0.2
7,9,ask,3,26,1,2,0.12
7,9,assault,7,27,2,5,0.36
7,9,at,2,28,1,1,0.08
7,9,auction,7,29,1,6,0.32
7,9,auto,4,30,2,2,0.16
7,9,average,7,31,1,6,0.32
7,9,baby,4,32,0,4,0.28
7,9,balance,7,33,2,5,0.28
7,9,ballet,6,34,3,3,0.2
7,9,barrel,6,35,2,4,0.24
7,9,base,4,36,2,2,0.2
7,9,bat,3,37,2,1,0.08
7,9,bath,4,38,3,1,0.12
7,9,bay,3,39,2,1,0.08
7,9,beast,5,40,1,4,0.2
7,9,beat,4,41,3,1,0.12
7,9,beauty,6,42,3,3,0.24
7,9,bed,3,43,2,1,0.12
7,9,beer,4,44,2,2,0.12
7,9,behave,6,45,2,4,0.2
7,9,bell,4,46,2,2,0.12
7,9,belong,6,47,3,3,0.2
7,9,betray,6,48,2,4,0.28
7,9,between,7,49,3,4,0.24
7,9,bill,4,50,1,3,0.16
7,9,biscuit,7,51,2,5,0.24
7,9,bishop,6,52,3,3,0.24
7,9,bite,4,53,2,2,0.2
7,9,blade,5,54,1,4,0.2
7,9,blame,5,55,3,2,0.16
7,9,blank,5,56,3,2,0.16
7,9,boat,4,57,1,3,0.16
7,9,boil,4,58,2,2,0.2
7,9,boot,4,59,2,2,0.12
7,9,bottle,6,60,2,4,0.24
7,9,brand,5,61,1,4,0.2
7,9,bright,6,62,2,4,0.2
7,9,bug,3,63,1,2,0.12
7,9,build,5,64,2,3,0.24
7,9,bunch,5,65,2,3,0.16
7,9,burden,6,66,2,4,0.24
7,9,burn,4,67,3,1,0.12
7,9,cake,4,68,0,4,0.2
7,9,cap,3,69,2,1,0.16
7,9,card,4,70,2,2,0.12
7,9,career,6,71,3,3,0.2
7,9,carpet,6,72,3,3,0.2
7,9,cartoon,7,73,3,4,0.24
7,9,carve,5,74,3,2,0.24
7,9,cd,2,75,1,1,0.08
7,9,century,7,76,1,6,0.28
7,9,chair,5,77,1,4,0.2
7,9,chapter,7,78,3,4,0.24
7,9,charity,7,79,3,4,0.32
7,9,charter,7,80,4,3,0.2
7,9,cheat,5,81,2,3,0.16
7,9,check,5,82,3,2,0.16
7,9,chicken,7,83,2,5,0.32
7,9,choir,5,84,2,3,0.2
7,9,chop,4,85,3,1,0.12
7,9,city,4,86,1,3,0.16
7,9,civil,5,87,2,3,0.16
7,9,clause,6,88,1,5,0.24
7,9,clean,5,89,2,3,0.24
7,9,clerk,5,90,3,2,0.16
7,9,club,4,91,2,2,0.12
7,9,cluster,7,92,3,4,0.24
7,9,comfort,7,93,1,6,0.36
7,9,company,7,94,3,4,0.24
7,9,conceal,7,95,2,5,0.32
7,9,conduct,7,96,3,4,0.28
7,9,consent,7,97,3,4,0.32
7,9,consult,7,98,4,3,0.32
7,9,contend,7,99,3,4,0.48
7,9,cope,4,100,2,2,0.2
7,9,cost,4,101,2,2,0.12
7,9,cottage,7,102,2,5,0.32
7,9,course,6,103,2,4,0.24
7,9,court,5,104,4,1,0.12
7,9,craft,5,105,1,4,0.2
7,9,create,6,106,2,4,0.24
7,9,crime,5,107,2,3,0.24
7,9,crisis,6,108,3,3,0.2
7,9,crowd,5,109,2,3,0.2
7,9,crucial,7,110,2,5,0.24
7,9,cry,3,111,2,1,0.08
7,9,curved,6,112,1,5,0.32
7,9,cycle,5,113,1,4,0.2
7,9,dam,3,114,0,3,0.16
7,9,dare,4,115,2,2,0.16
7,9,day,3,116,2,1,0.12
7,9,deal,4,117,1,3,0.2
7,9,death,5,118,3,2,0.24
7,9,decline,7,119,2,5,0.28
7,9,dentist,7,120,2,5,0.28
7,9,deposit,7,121,2,5,0.28
7,9,deputy,6,122,3,3,0.28
7,9,desktop,7,123,2,5,0.24
7,9,despite,7,124,3,4,0.24
7,9,detect,6,125,2,4,0.24
7,9,dictate,7,126,1,6,0.4
7,9,digital,7,127,2,5,0.24
7,9,dirt,4,128,2,2,0.16
7,9,discuss,7,129,2,5,0.24
7,9,display,7,130,3,4,0.32
7,9,dollar,6,131,1,5,0.24
7,9,domain,6,132,2,4,0.28
7,9,double,6,133,2,4,0.24
7,9,drawing,7,134,1,6,0.36
7,9,drink,5,135,2,3,0.16
7,9,ear,3,136,0,3,0.16
7,9,earth,5,137,3,2,0.16
7,9,edition,7,138,1,6,0.28
7,9,eight,5,139,1,4,0.2
7,9,either,6,140,2,4,0.28
7,9,elect,5,141,1,4,0.2
7,9,embark,6,142,1,5,0.24
7,9,embody,6,143,3,3,0.2
7,9,emotion,7,144,2,5,0.32
7,9,empower,7,145,2,5,0.24
7,9,enable,6,146,1,5,0.24
7,9,endless,7,147,2,5,0.28
7,9,enjoy,5,148,2,3,0.28
7,9,enrich,6,149,2,4,0.2
7,9,enter,5,150,2,3,0.2
7,9,entitle,7,151,3,4,0.24
7,9,entry,5,152,3,2,0.16
7,9,erect,5,153,1,4,0.28
7,9,euro,4,154,1,3,0.16
7,9,event,5,155,1,4,0.2
7,9,examine,7,156,1,6,0.28
7,9,exceed,6,157,2,4,0.24
7,9,expire,6,158,2,4,0.28
7,9,extend,6,159,2,4,0.2
7,9,extent,6,160,5,1,0.16
7,9,eye,3,161,1,2,0.12
7,9,fail,4,162,0,4,0.2
7,9,failed,6,163,4,2,0.24
7,9,failure,7,164,4,3,0.24
7,9,fair,4,165,3,1,0.12
7,9,fairly,6,166,4,2,0.2
7,9,fast,4,167,2,2,0.16
7,9,fasten,6,168,4,2,0.24
7,9,fat,3,169,2,1,0.12
7,9,fear,4,170,1,3,0.28
7,9,fee,3,171,2,1,0.24
7,9,feeding,7,172,3,4,0.56
7,9,fellow,6,173,2,4,0.6
7,9,few,3,174,2,1,0.24
7,9,fibre,5,175,1,4,0.48
7,9,fifty,5,176,2,3,0.4
7,9,fight,5,177,2,3,0.4
7,9,finally,7,178,2,5,0.6
7,9,firm,4,179,2,2,0.44
7,9,fix,3,180,2,1,0.24
7,9,fixture,7,181,3,4,0.56
7,9,flag,4,182,1,3,0.4
7,9,flavour,7,183,3,4,0.56
7,9,flee,4,184,2,2,0.44
7,9,floor,5,185,2,3,0.4
7,9,flower,6,186,3,3,0.48
7,9,flying,6,187,2,4,0.52
7,9,folding,7,188,1,6,0.64
7,9,folk,4,189,3,1,0.36
7,9,food,4,190,2,2,0.32
7,9,for,3,191,2,1,0.24
7,9,force,5,192,3,2,0.36
7,9,foreign,7,193,3,4,0.56
7,9,former,6,194,3,3,0.56
7,9,fortune,7,195,3,4,0.56
7,9,foster,6,196,2,4,0.52
7,9,founder,7,197,2,5,0.6
7,9,freedom,7,198,1,6,0.76
7,9,fridge,6,199,2,4,0.52
7,9,front,5,200,2,3,0.4
7,9,full,4,201,1,3,0.36
7,9,fur,3,202,2,1,0.24
7,9,gallery,7,203,0,7,0.84
7,9,gallon,6,204,4,2,0.4
7,9,game,4,205,2,2,0.32
7,9,gaming,6,206,3,3,0.44
7,9,gene,4,207,1,3,0.36
7,9,genetic,7,208,4,3,0.6
7,9,give,4,209,1,3,0.36
7,9,glimpse,7,210,1,6,0.64
7,9,globe,5,211,2,3,0.4
7,9,go,2,212,1,1,0.2
7,9,god,3,213,2,1,0.24
7,9,gold,4,214,2,2,0.44
7,9,golf,4,215,3,1,0.28
7,9,good,4,216,2,2,0.32
7,9,govern,6,217,2,4,0.52
7,9,grade,5,218,1,4,0.48
7,9,green,5,219,2,3,0.4
7,9,growth,6,220,2,4,0.6
7,9,guest,5,221,1,4,0.48
7,9,handful,7,222,0,7,0.72
7,9,happen,6,223,2,4,0.52
7,9,harsh,5,224,2,3,0.52
7,9,hazard,6,225,2,4,0.52
7,9,health,6,226,1,5,0.56
7,9,heat,4,227,3,1,0.28
7,9,her,3,228,2,1,0.24
7,9,hers,4,229,3,1,0.28
7,9,hint,4,230,1,3,0.52
7,9,horror,6,231,1,5,0.56
7,9,how,3,232,2,1,0.24
7,9,humble,6,233,1,5,0.56
7,9,humour,6,234,3,3,0.44
7,9,i,1,235,0,1,0.24
7,9,icon,4,236,1,3,0.44
7,9,imagery,7,237,1,6,0.76
7,9,import,6,238,2,4,0.6
7,9,include,7,239,1,6,0.64
7,9,infant,6,240,2,4,0.64
7,9,inject,6,241,2,4,0.52
7,9,insert,6,242,2,4,0.52
7,9,intense,7,243,2,5,0.6
7,9,into,4,244,3,1,0.36
7,9,invest,6,245,2,4,0.52
7,9,involve,7,246,3,4,0.56
7,9,issue,5,247,1,4,0.48
7,9,job,3,248,0,3,0.36
7,9,jump,4,249,1,3,0.48
7,9,june,4,250,2,2,0.32
7,9,just,4,251,2,2,0.32
7,9,justify,7,252,4,3,0.48
7,9,key,3,253,0,3,0.32
7,9,kid,3,254,1,2,0.28
7,9,kidney,6,255,3,3,0.56
7,9,king,4,256,2,2,0.32
7,9,knife,5,257,1,4,0.48
7,9,lack,4,258,0,4,0.44
7,9,lake,4,259,2,2,0.32
7,9,last,4,260,2,2,0.32
7,9,latest,6,261,2,4,0.64
7,9,leaflet,7,262,1,6,0.64
7,9,lethal,6,263,2,4,0.52
7,9,letter,6,264,3,3,0.44
7,9,license,7,265,1,6,0.76
7,9,lie,3,266,2,1,0.24
7,9,liver,5,267,2,3,0.4
7,9,local,5,268,1,4,0.48
7,9,located,7,269,4,3,0.48
7,9,long,4,270,2,2,0.44
7,9,look,4,271,2,2,0.32
7,9,loose,5,272,3,2,0.36
7,9,lot,3,273,2,1,0.24
7,9,loudly,6,274,2,4,0.52
7,9,low,3,275,2,1,0.24
7,9,lunch,5,276,1,4,0.56
7,9,mandate,7,277,0,7,0.72
7,9,map,3,278,2,1,0.28
7,9,married,7,279,2,5,0.6
7,9,match,5,280,2,3,0.4
7,9,mean,4,281,1,3,0.48
7,9,media,5,282,2,3,0.4
7,9,melody,6,283,2,4,0.52
7,9,memory,6,284,2,4,0.52
7,9,merger,6,285,2,4,0.52
7,9,mess,4,286,2,2,0.48
7,9,message,7,287,4,3,0.52
7,9,method,6,288,2,4,0.52
7,9,metre,5,289,3,2,0.36
7,9,mind,4,290,1,3,0.4
7,9,missing,7,291,2,5,0.72
7,9,model,5,292,1,4,0.48
7,9,modify,6,293,3,3,0.44
7,9,moment,6,294,2,4,0.52
7,9,monthly,7,295,2,5,0.72
7,9,mouth,5,296,2,3,0.4
7,9,much,4,297,1,3,0.4
7,9,mum,3,298,2,1,0.28
7,9,music,5,299,2,3,0.4
7,9,my,2,300,1,1,0.2
7,9,naked,5,301,0,5,0.64
7,9,neutral,7,302,1,6,0.64
7,9,newly,5,303,2,3,0.48
7,9,non,3,304,1,2,0.28
7,9,normal,6,305,2,4,0.52
7,9,not,3,306,2,1,0.24
7,9,nothing,7,307,3,4,0.68
7,9,novel,5,308,2,3,0.64
7,9,nut,3,309,1,2,0.4
7,9,obesity,7,310,0,7,0.76
7,9,oblige,6,311,2,4,0.68
7,9,ocean,5,312,1,4,0.48
7,9,october,7,313,2,5,0.6
7,9,one,3,314,1,2,0.28
7,9,opposed,7,315,1,6,0.64
7,9,organic,7,316,1,6,0.8
7,9,other,5,317,1,4,0.48
7,9,outdoor,7,318,1,6,0.64
7,9,outfit,6,319,3,3,0.44
7,9,outing,6,320,3,3,0.56
7,9,outlet,6,321,3,3,0.44
7,9,outlook,7,322,4,3,0.48
7,9,page,4,323,0,4,0.44
7,9,paint,5,324,2,3,0.4
7,9,park,4,325,2,2,0.44
7,9,partial,7,326,3,4,0.56
7,9,patent,6,327,2,4,0.52
7,9,pause,5,328,2,3,0.4
7,9,peer,4,329,1,3,0.36
7,9,perfect,7,330,2,5,0.72
7,9,photo,5,331,1,4,0.48
7,9,piece,5,332,1,4,0.48
7,9,pig,3,333,2,1,0.24
7,9,pin,3,334,2,1,0.24
7,9,pioneer,7,335,2,5,0.84
7,9,plan,4,336,1,3,0.44
7,9,plane,5,337,4,1,0.36
7,9,plastic,7,338,3,4,0.6
7,9,plead,5,339,2,3,0.44
7,9,plot,4,340,2,2,0.44
7,9,portion,7,341,1,6,0.64
7,9,possess,7,342,2,5,0.6
7,9,post,4,343,3,1,0.28
7,9,praise,6,344,1,5,0.56
7,9,prayer,6,345,3,3,0.56
7,9,predict,7,346,2,5,0.6
7,9,printer,7,347,2,5,0.6
7,9,prior,5,348,3,2,0.36
7,9,produce,7,349,2,5,0.72
7,9,product,7,350,6,1,0.4
7,9,proof,5,351,3,2,0.36
7,9,propose,7,352,3,4,0.56
7,9,protest,7,353,3,4,0.68
7,9,pump,4,354,1,3,0.36
7,9,purpose,7,355,2,5,0.64
7,9,pursuit,7,356,3,4,0.56
7,9,racism,6,357,0,6,0.64
7,9,radar,5,358,2,3,0.52
7,9,rail,4,359,2,2,0.32
7,9,rally,5,360,2,3,0.4
7,9,rather,6,361,2,4,0.52
7,9,rating,6,362,3,3,0.44
7,9,rear,4,363,1,3,0.48
7,9,recall,6,364,2,4,0.52
7,9,recruit,7,365,3,4,0.56
7,9,refuse,6,366,2,4,0.52
7,9,regime,6,367,2,4,0.6
7,9,region,6,368,4,2,0.4
7,9,reign,5,369,2,3,0.4
7,9,relax,5,370,2,3,0.4
7,9,removal,7,371,2,5,0.6
7,9,remove,6,372,5,1,0.48
7,9,repeat,6,373,2,4,0.52
7,9,reside,6,374,2,4,0.52
7,9,resolve,7,375,3,4,0.56
7,9,revise,6,376,2,4,0.6
7,9,revival,7,377,4,3,0.52
7,9,rifle,5,378,1,4,0.48
7,9,right,5,379,2,3,0.4
7,9,rise,4,380,2,2,0.32
7,9,roll,4,381,1,3,0.36
7,9,rough,5,382,2,3,0.56
7,9,rubbish,7,383,1,6,0.68
7,9,ruin,4,384,2,2,0.32
7,9,sailor,6,385,0,6,0.64
7,9,sample,6,386,2,4,0.64
7,9,sand,4,387,2,2,0.36
7,9,satisfy,7,388,2,5,0.64
7,9,scan,4,389,1,3,0.4
7,9,scared,6,390,3,3,0.48
7,9,scheme,6,391,2,4,0.68
7,9,scholar,7,392,3,4,0.6
7,9,seal,4,393,1,3,0.4
7,9,secret,6,394,2,4,0.56
7,9,seeker,6,395,2,4,0.56
7,9,segment,7,396,2,5,0.72
7,9,seminar,7,397,2,5,0.6
7,9,servant,7,398,2,5,0.6
7,9,service,7,399,4,3,0.6
7,9,settler,7,400,2,5,0.6
7,9,sexy,4,401,2,2,0.32
7,9,shallow,7,402,1,6,0.64
7,9,shape,5,403,3,2,0.36
7,9,sheer,5,404,2,3,0.52
7,9,shell,5,405,3,2,0.36
7,9,shift,5,406,2,3,0.4
7,9,shiny,5,407,3,2,0.36
7,9,ship,4,408,3,1,0.28
7,9,sibling,7,409,1,6,0.76
7,9,sight,5,410,2,3,0.4
7,9,simply,6,411,2,4,0.52
7,9,sin,3,412,2,1,0.24
7,9,singing,7,413,3,4,0.56
7,9,sister,6,414,2,4,0.6
7,9,ski,3,415,1,2,0.28
7,9,skip,4,416,3,1,0.28
7,9,slam,4,417,1,3,0.36
7,9,slice,5,418,2,3,0.4
7,9,slip,4,419,3,1,0.28
7,9,smile,5,420,1,4,0.6
7,9,smoking,7,421,2,5,0.6
7,9,snow,4,422,1,3,0.36
7,9,solar,5,423,1,4,0.48
7,9,solid,5,424,3,2,0.36
7,9,some,4,425,2,2,0.4
7,9,song,4,426,2,2,0.2
7,9,space,5,427,1,4,0.2
7,9,speak,5,428,2,3,0.2
7,9,special,7,429,3,4,0.24
7,9,speech,6,430,3,3,0.28
7,9,sphere,6,431,2,4,0.24
7,9,spin,4,432,2,2,0.16
7,9,spread,6,433,2,4,0.24
7,9,stab,4,434,1,3,0.16
7,9,staff,5,435,3,2,0.16
7,9,stamp,5,436,3,2,0.24
7,9,stance,6,437,3,3,0.2
7,9,stand,5,438,4,1,0.12
7,9,stay,4,439,3,1,0.12
7,9,sticky,6,440,2,4,0.24
7,9,storage,7,441,2,5,0.32
7,9,store,5,442,4,1,0.12
7,9,strange,7,443,2,5,0.28
7,9,street,6,444,3,3,0.2
7,9,string,6,445,3,3,0.28
7,9,strong,6,446,3,3,0.2
7,9,stumble,7,447,2,5,0.24
7,9,stun,4,448,3,1,0.12
7,9,sudden,6,449,1,5,0.24
7,9,sue,3,450,2,1,0.16
7,9,super,5,451,2,3,0.2
7,9,swallow,7,452,1,6,0.28
7,9,swim,4,453,2,2,0.16
7,9,switch,6,454,3,3,0.2
7,9,table,5,455,0,5,0.32
7,9,tail,4,456,2,2,0.12
7,9,tale,4,457,2,2,0.12
7,9,tank,4,458,2,2,0.12
7,9,tap,3,459,2,1,0.08
7,9,tape,4,460,3,1,0.12
7,9,tea,3,461,1,2,0.12
7,9,team,4,462,3,1,0.2
7,9,tension,7,463,2,5,0.24
7,9,terror,6,464,2,4,0.24
7,9,thesis,6,465,1,5,0.24
7,9,three,5,466,2,3,0.24
7,9,thumb,5,467,2,3,0.16
7,9,tight,5,468,1,4,0.2
7,9,till,4,469,2,2,0.12
7,9,to,2,470,1,1,0.08
7,9,tonight,7,471,2,5,0.24
7,9,too,3,472,2,1,0.16
7,9,torture,7,473,2,5,0.24
7,9,tragic,6,474,1,5,0.24
7,9,trap,4,475,3,1,0.12
7,9,treaty,6,476,2,4,0.2
7,9,trial,5,477,2,3,0.24
7,9,tribal,6,478,3,3,0.2
7,9,trouble,7,479,2,5,0.28
7,9,truck,5,480,2,3,0.16
7,9,unfair,6,481,0,6,0.32
7,9,until,5,482,2,3,0.16
7,9,unusual,7,483,2,5,0.24
7,9,unveil,6,484,2,4,0.2
7,9,upon,4,485,1,3,0.16
7,9,urban,5,486,1,4,0.28
7,9,urgent,6,487,2,4,0.2
7,9,usage,5,488,1,4,0.2
7,9,utility,7,489,1,6,0.28
7,9,utilize,7,490,5,2,0.2
7,9,venture,7,491,0,7,0.4
7,9,vessel,6,492,2,4,0.24
7,9,viable,6,493,1,5,0.24
7,9,video,5,494,2,3,0.2
7,9,viewer,6,495,2,4,0.28
7,9,virtue,6,496,2,4,0.2
7,9,virus,5,497,3,2,0.16
7,9,visitor,7,498,2,5,0.24
7,9,visual,6,499,3,3,0.28
7,9,vital,5,500,2,3,0.16
7,9,vocal,5,501,1,4,0.2
7,9,wait,4,502,0,4,0.2
7,9,war,3,503,2,1,0.08
7,9,warning,7,504,3,4,0.24
7,9,washing,7,505,2,5,0.32
7,9,water,5,506,2,3,0.2
7,9,welfare,7,507,1,6,0.28
7,9,which,5,508,1,4,0.2
7,9,whose,5,509,2,3,0.24
7,9,width,5,510,1,4,0.2
7,9,win,3,511,2,1,0.08
7,9,wine,4,512,3,1,0.12
7,9,wisdom,6,513,2,4,0.2
7,9,within,6,514,2,4,0.28
7,9,without,7,515,4,3,0.24
7,9,work,4,516,1,3,0.16
7,9,world,5,517,3,2,0.16
7,9,wrist,5,518,1,4,0.2
7,9,written,7,519,3,4,0.32
7,9,yellow,6,520,0,6,0.28
7,9,young,5,521,1,4,0.2
8,0,a,1,0,0,1,0.08
8,0,absorb,6,1,1,5,0.24
8,0,absurd,6,2,3,3,0.28
8,0,academic,8,3,1,7,0.32
8,0,accurate,8,4,2,6,0.28
8,0,acid,4,5,2,2,0.16
8,0,actress,7,6,2,5,0.36
8,0,acute,5,7,2,3,0.16
8,0,ad,2,8,1,1,0.08
8,0,adj,3,9,2,1,0.08
8,0,adjacent,8,10,3,5,0.28
8,0,admit,5,11,2,3,0.16
8,0,adoption,8,12,2,6,0.4
8,0,advice,6,13,2,4,0.24
8,0,against,7,14,1,6,0.28
8,0,agree,5,15,2,3,0.2
8,0,aids,4,16,1,3,0.24
8,0,alcohol,7,17,1,6,0.28
8,0,allocate,8,18,2,6,0.32
8,0,ally,4,19,3,1,0.12
8,0,amateur,7,20,1,6,0.36
8,0,analyse,7,21,1,6,0.28
8,0,ancient,7,22,2,5,0.28
8,0,and,3,23,2,1,0.12
8,0,annoyed,7,24,2,5,0.28
8,0,annoying,8,25,5,3,0.32
8,0,another,7,26,2,5,0.24
8,0,anybody,7,27,2,5,0.24
8,0,approach,8,28,1,7,0.4
8,0,arguably,8,29,1,7,0.32
8,0,arise,5,30,2,3,0.2
8,0,arms,4,31,2,2,0.12
8,0,army,4,32,3,1,0.12
8,0,around,6,33,2,4,0.28
8,0,arrow,5,34,2,3,0.2
8,0,artistic,8,35,2,6,0.28
8,0,assault,7,36,1,6,0.28
8,0,atrocity,8,37,1,7,0.4
8,0,auction,7,38,1,6,0.32
8,0,baby,4,39,0,4,0.2
8,0,ballet,6,40,2,4,0.24
8,0,base,4,41,2,2,0.2
8,0,bay,3,42,2,1,0.08
8,0,beast,5,43,1,4,0.2
8,0,bed,3,44,2,1,0.08
8,0,beer,4,45,2,2,0.16
8,0,belief,6,46,2,4,0.2
8,0,belong,6,47,3,3,0.28
8,0,below,5,48,4,1,0.12
8,0,best,4,49,2,2,0.12
8,0,beyond,6,50,2,4,0.2
8,0,bill,4,51,1,3,0.16
8,0,bird,4,52,2,2,0.12
8,0,birthday,8,53,3,5,0.36
8,0,biscuit,7,54,2,5,0.24
8,0,bizarre,7,55,2,5,0.28
8,0,blade,5,56,1,4,0.2
8,0,bless,5,57,2,3,0.24
8,0,boom,4,58,1,3,0.16
8,0,boost,5,59,3,2,0.16
8,0,boot,4,60,3,1,0.12
8,0,bottle,6,61,2,4,0.24
8,0,bound,5,62,2,3,0.24
8,0,brand,5,63,1,4,0.2
8,0,break,5,64,2,3,0.16
8,0,breathe,7,65,4,3,0.2
8,0,bride,5,66,2,3,0.16
8,0,bridge,6,67,4,2,0.24
8,0,broken,6,68,2,4,0.24
8,0,buffer,6,69,1,5,0.24
8,0,bunch,5,70,2,3,0.16
8,0,burn,4,71,2,2,0.16
8,0,business,8,72,2,6,0.36
8,0,cafe,4,73,0,4,0.2
8,0,cancer,6,74,2,4,0.2
8,0,cap,3,75,2,1,0.08
8,0,carpet,6,76,2,4,0.24
8,0,carve,5,77,3,2,0.24
8,0,category,8,78,2,6,0.28
8,0,cave,4,79,2,2,0.12
8,0,ceiling,7,80,1,6,0.28
8,0,cemetery,8,81,2,6,0.4
8,0,ceremony,8,82,2,6,0.28
8,0,certain,7,83,3,4,0.24
8,0,chair,5,84,1,4,0.2
8,0,charming,8,85,3,5,0.36
8,0,charter,7,86,4,3,0.2
8,0,cheat,5,87,2,3,0.2
8,0,cheerful,8,88,3,5,0.28
8,0,chicken,7,89,2,5,0.32
8,0,choir,5,90,2,3,0.4
8,0,chronic,7,91,2,5,0.6
8,0,chunk,5,92,2,3,0.4
8,0,cite,4,93,1,3,0.36
8,0,civil,5,94,2,3,0.52
8,0,clarity,7,95,1,6,0.64
8,0,clause,6,96,3,3,0.44
8,0,clearly,7,97,2,5,0.64
8,0,clerk,5,98,3,2,0.48
8,0,clinical,8,99,2,6,0.72
8,0,closely,7,100,2,5,0.6
8,0,cloud,5,101,3,2,0.36
8,0,club,4,102,2,2,0.44
8,0,coach,5,103,1,4,0.48
8,0,coffee,6,104,2,4,0.52
8,0,comedy,6,105,2,4,0.52
8,0,comment,7,106,3,4,0.56
8,0,commonly,8,107,4,4,0.72
8,0,comply,6,108,3,3,0.44
8,0,conceive,8,109,2,6,0.72
8,0,concern,7,110,5,2,0.44
8,0,concert,7,111,6,1,0.52
8,0,conduct,7,112,3,4,0.6
8,0,confess,7,113,3,4,0.6
8,0,confused,8,114,4,4,0.64
8,0,contend,7,115,3,4,0.68
8,0,convey,6,116,3,3,0.48
8,0,correct,7,117,2,5,0.64
8,0,cost,4,118,2,2,0.6
8,0,cottage,7,119,2,5,1.12
8,0,coup,4,120,2,2,0.32
8,0,couple,6,121,4,2,0.64
8,0,court,5,122,3,2,0.44
8,0,coverage,8,123,2,6,0.8
8,0,crime,5,124,1,4,0.6
8,0,criminal,8,125,4,4,0.6
8,0,crisis,6,126,3,3,0.44
8,0,current,7,127,1,6,0.8
8,0,curved,6,128,3,3,0.6
8,0,deal,4,129,0,4,0.44
8,0,death,5,130,3,2,0.36
8,0,declare,7,131,2,5,0.6
8,0,decrease,8,132,3,5,0.8
8,0,deem,4,133,2,2,0.32
8,0,default,7,134,2,5,0.6
8,0,defect,6,135,3,3,0.56
8,0,defender,8,136,4,4,0.68
8,0,definite,8,137,3,5,0.84
8,0,delight,7,138,2,5,0.76
8,0,demon,5,139,2,3,0.48
8,0,deposit,7,140,2,5,0.68
8,0,deputy,6,141,3,3,0.56
8,0,despite,7,142,2,5,0.6
8,0,develop,7,143,2,5,0.6
8,0,dictate,7,144,1,6,0.72
8,0,digital,7,145,2,5,0.76
8,0,diminish,8,146,2,6,0.72
8,0,diplomat,8,147,2,6,0.72
8,0,dirt,4,148,2,2,0.32
8,0,dirty,5,149,4,1,0.44
8,0,disabled,8,150,2,6,0.72
8,0,discuss,7,151,3,4,0.68
8,0,display,7,152,3,4,0.68
8,0,distant,7,153,3,4,0.76
8,0,divorced,8,154,2,6,0.72
8,0,dollar,6,155,1,5,0.56
8,0,domain,6,156,2,4,0.52
8,0,dominant,8,157,3,5,0.8
8,0,donation,8,158,2,6,0.76
8,0,drama,5,159,1,4,0.56
8,0,dust,4,160,1,3,0.4
8,0,ear,3,161,0,3,0.48
8,0,earnings,8,162,3,5,0.68
8,0,earth,5,163,3,2,0.36
8,0,effort,6,164,1,5,0.56
8,0,eight,5,165,1,4,0.48
8,0,elect,5,166,1,4,1.16
8,0,eleven,6,167,3,3,1.48
8,0,emotion,7,168,1,6,1.8
8,0,employer,8,169,2,6,1.4000000000000001
8,0,ending,6,170,1,5,0.64
8,0,engineer,8,171,2,6,0.68
8,0,enjoy,5,172,2,3,0.52
8,0,enormous,8,173,2,6,0.68
8,0,enrich,6,174,2,4,0.52
8,0,entry,5,175,2,3,0.48
8,0,equality,8,176,1,7,0.96
8,0,erect,5,177,1,4,0.56
8,0,essay,5,178,1,4,0.48
8,0,evening,7,179,1,6,0.72
8,0,evidence,8,180,2,6,0.84
8,0,evoke,5,181,2,3,0.44
8,0,exact,5,182,1,4,0.48
8,0,examine,7,183,3,4,0.64
8,0,exceed,6,184,2,4,0.64
8,0,exciting,8,185,3,5,0.64
8,0,exercise,8,186,2,6,0.72
8,0,exit,4,187,2,2,0.32
8,0,explain,7,188,2,5,0.72
8,0,faculty,7,189,0,7,0.76
8,0,failed,6,190,2,4,0.64
8,0,failure,7,191,4,3,0.64
8,0,fair,4,192,3,1,0.36
8,0,fairly,6,193,4,2,0.56
8,0,fall,4,194,2,2,0.32
8,0,famous,6,195,2,4,0.56
8,0,fast,4,196,2,2,0.36
8,0,fat,3,197,2,1,0.28
8,0,fear,4,198,1,3,0.56
8,0,few,3,199,2,1,0.24
8,0,fiction,7,200,1,6,0.68
8,0,firm,4,201,2,2,0.32
8,0,flag,4,202,1,3,0.36
8,0,flavour,7,203,3,4,0.56
8,0,flexible,8,204,2,6,0.8
8,0,flower,6,205,2,4,0.52
8,0,flu,3,206,2,1,0.28
8,0,flying,6,207,2,4,0.6
8,0,folding,7,208,1,6,0.8
8,0,for,3,209,2,1,0.24
8,0,former,6,210,3,3,0.44
8,0,formerly,8,211,6,2,0.48
8,0,fortune,7,212,3,4,0.56
8,0,founder,7,213,2,5,0.72
8,0,fourteen,8,214,3,5,0.64
8,0,frighten,8,215,1,7,0.76
8,0,fulfil,6,216,1,5,0.64
8,0,funding,7,217,2,5,0.72
8,0,game,4,218,0,4,0.52
8,0,gaming,6,219,3,3,0.52
8,0,gene,4,220,1,3,0.44
8,0,general,7,221,4,3,0.6
8,0,giant,5,222,1,4,0.48
8,0,glass,5,223,1,4,0.48
8,0,glimpse,7,224,2,5,0.6
8,0,globe,5,225,2,3,0.4
8,0,go,2,226,1,1,0.28
8,0,golf,4,227,2,2,0.36
8,0,goodbye,7,228,2,5,0.68
8,0,govern,6,229,2,4,0.56
8,0,grade,5,230,1,4,0.52
8,0,graphics,8,231,3,5,0.88
8,0,grey,4,232,2,2,0.36
8,0,grid,4,233,2,2,0.36
8,0,grind,5,234,3,2,0.36
8,0,ground,6,235,2,4,0.56
8,0,growth,6,236,3,3,0.6
8,0,guest,5,237,1,4,0.52
8,0,handy,5,238,0,5,0.56
8,0,happen,6,239,2,4,0.56
8,0,harm,4,240,2,2,0.36
8,0,harsh,5,241,3,2,0.48
8,0,hat,3,242,2,1,0.24
8,0,headline,8,243,1,7,0.84
8,0,hesitate,8,244,2,6,0.8
8,0,highly,6,245,1,5,0.72
8,0,hint,4,246,2,2,0.32
8,0,historic,8,247,2,6,0.72
8,0,homeland,8,248,1,7,0.8
8,0,horror,6,249,2,4,0.64
8,0,hotel,5,250,2,3,0.52
8,0,however,7,251,2,5,0.76
8,0,humanity,8,252,1,7,0.92
8,0,humble,6,253,3,3,0.64
8,0,humour,6,254,3,3,0.48
8,0,hunger,6,255,2,4,0.56
8,0,hydrogen,8,256,1,7,0.8
8,0,ice,3,257,0,3,0.36
8,0,icon,4,258,2,2,0.48
8,0,identity,8,259,1,7,0.92
8,0,ill,3,260,1,2,0.36
8,0,imagery,7,261,1,6,0.76
8,0,improve,7,262,2,5,0.92
8,0,indicate,8,263,1,7,0.76
8,0,indirect,8,264,4,4,0.6
8,0,info,4,265,2,2,0.32
8,0,inform,6,266,4,2,0.4
8,0,informal,8,267,6,2,0.6
8,0,inherent,8,268,2,6,0.72
8,0,insert,6,269,2,4,0.52
8,0,inspect,7,270,3,4,0.64
8,0,instant,7,271,3,4,0.56
8,0,instruct,8,272,4,4,0.6
8,0,intake,6,273,2,4,0.52
8,0,integral,8,274,3,5,0.76
8,0,intended,8,275,4,4,0.6
8,0,interior,8,276,4,4,0.6
8,0,invest,6,277,2,4,0.52
8,0,iron,4,278,1,3,0.48
8,0,island,6,279,1,5,0.56
8,0,issue,5,280,2,3,0.44
8,0,jet,3,281,0,3,0.36
8,0,job,3,282,1,2,0.28
8,0,judicial,8,283,1,7,0.88
8,0,june,4,284,2,2,0.4
8,0,just,4,285,2,2,0.4
8,0,justify,7,286,4,3,0.6
8,0,keyboard,8,287,0,8,0.96
8,0,kit,3,288,1,2,0.4
8,0,lad,3,289,0,3,0.32
8,0,lake,4,290,2,2,0.36
8,0,landmark,8,291,2,6,0.8
8,0,lap,3,292,2,1,0.24
8,0,laugh,5,293,2,3,0.48
8,0,law,3,294,2,1,0.32
8,0,lawn,4,295,3,1,0.28
8,0,layer,5,296,2,3,0.44
8,0,leading,7,297,1,6,0.68
8,0,league,6,298,3,3,0.4
8,0,learning,8,299,3,5,0.44
8,0,left,4,300,2,2,0.16
8,0,legend,6,301,2,4,0.24
8,0,lesbian,7,302,2,5,0.28
8,0,lethal,6,303,2,4,0.28
8,0,license,7,304,1,6,0.28
8,0,lion,4,305,2,2,0.12
8,0,load,4,306,1,3,0.16
8,0,local,5,307,2,3,0.2
8,0,located,7,308,4,3,0.28
8,0,long,4,309,2,2,0.16
8,0,lot,3,310,2,1,0.08
8,0,low,3,311,2,1,0.08
8,0,lunch,5,312,1,4,0.2
8,0,mainland,8,313,0,8,0.4
8,0,map,3,314,2,1,0.16
8,0,marine,6,315,2,4,0.2
8,0,mark,4,316,3,1,0.12
8,0,married,7,317,3,4,0.24
8,0,mask,4,318,2,2,0.16
8,0,maximum,7,319,2,5,0.32
8,0,media,5,320,1,4,0.2
8,0,melody,6,321,2,4,0.2
8,0,memory,6,322,2,4,0.24
8,0,mention,7,323,2,5,0.32
8,0,method,6,324,2,4,0.2
8,0,metre,5,325,3,2,0.16
8,0,midnight,8,326,1,7,0.4
8,0,militia,7,327,2,5,0.36
8,0,mind,4,328,2,2,0.12
8,0,minister,8,329,3,5,0.28
8,0,mirror,6,330,2,4,0.2
8,0,missing,7,331,2,5,0.24
8,0,mixed,5,332,2,3,0.24
8,0,mobilize,8,333,1,7,0.32
8,0,model,5,334,2,3,0.2
8,0,money,5,335,2,3,0.2
8,0,month,5,336,3,2,0.2
8,0,monument,8,337,3,5,0.28
8,0,more,4,338,2,2,0.16
8,0,mother,6,339,2,4,0.2
8,0,much,4,340,1,3,0.16
8,0,mum,3,341,2,1,0.08
8,0,my,2,342,1,1,0.16
8,0,myth,4,343,2,2,0.16
8,0,neck,4,344,0,4,0.2
8,0,needle,6,345,2,4,0.24
8,0,neutral,7,346,2,5,0.28
8,0,newly,5,347,2,3,0.24
8,0,night,5,348,1,4,0.2
8,0,noise,5,349,1,4,0.2
8,0,noisy,5,350,4,1,0.12
8,0,nominate,8,351,2,6,0.32
8,0,non,3,352,2,1,0.16
8,0,norm,4,353,2,2,0.16
8,0,northern,8,354,3,5,0.28
8,0,notion,6,355,2,4,0.2
8,0,numerous,8,356,1,7,0.36
8,0,nut,3,357,2,1,0.12
8,0,obesity,7,358,0,7,0.32
8,0,offend,6,359,1,5,0.24
8,0,once,4,360,1,3,0.16
8,0,one,3,361,2,1,0.08
8,0,online,6,362,2,4,0.28
8,0,opposed,7,363,1,6,0.28
8,0,organic,7,364,1,6,0.28
8,0,ought,5,365,1,4,0.2
8,0,outdoors,8,366,2,6,0.36
8,0,outfit,6,367,3,3,0.2
8,0,outing,6,368,3,3,0.2
8,0,outlet,6,369,3,3,0.2
8,0,outlook,7,370,4,3,0.28
8,0,owe,3,371,1,2,0.12
8,0,pack,4,372,0,4,0.2
8,0,page,4,373,2,2,0.16
8,0,paint,5,374,2,3,0.2
8,0,pants,5,375,2,3,0.2
8,0,parallel,8,376,2,6,0.36
8,0,passport,8,377,2,6,0.28
8,0,patent,6,378,2,4,0.2
8,0,patron,6,379,3,3,0.24
8,0,peaceful,8,380,1,7,0.32
8,0,peer,4,381,2,2,0.12
8,0,phone,5,382,1,4,0.2
8,0,pick,4,383,1,3,0.16
8,0,piece,5,384,2,3,0.24
8,0,pig,3,385,2,1,0.12
8,0,pin,3,386,2,1,0.08
8,0,place,5,387,1,4,0.2
8,0,plastic,7,388,3,4,0.24
8,0,play,4,389,3,1,0.12
8,0,pond,4,390,1,3,0.2
8,0,portion,7,391,2,5,0.28
8,0,position,8,392,2,6,0.32
8,0,possess,7,393,3,4,0.24
8,0,possible,8,394,4,4,0.32
8,0,post,4,395,3,1,0.12
8,0,poster,6,396,4,2,0.16
8,0,pot,3,397,2,1,0.12
8,0,predict,7,398,1,6,0.28
8,0,pregnant,8,399,3,5,0.32
8,0,premise,7,400,3,4,0.24
8,0,printer,7,401,2,5,0.24
8,0,printing,8,402,5,3,0.24
8,0,priority,8,403,3,5,0.32
8,0,process,7,404,2,5,0.24
8,0,profound,8,405,3,5,0.28
8,0,project,7,406,3,4,0.28
8,0,proper,6,407,3,3,0.2
8,0,properly,8,408,6,2,0.2
8,0,proposal,8,409,4,4,0.24
8,0,protest,7,410,3,4,0.28
8,0,pump,4,411,1,3,0.16
8,0,pure,4,412,2,2,0.16
8,0,pursuit,7,413,3,4,0.24
8,0,puzzle,6,414,2,4,0.24
8,0,quality,7,415,0,7,0.36
8,0,query,5,416,2,3,0.16
8,0,race,4,417,0,4,0.2
8,0,railway,7,418,2,5,0.24
8,0,rather,6,419,2,4,0.2
8,0,rating,6,420,3,3,0.24
8,0,rational,8,421,4,4,0.24
8,0,realm,5,422,1,4,0.2
8,0,rebel,5,423,2,3,0.16
8,0,recall,6,424,2,4,0.28
8,0,recount,7,425,3,4,0.24
8,0,recruit,7,426,3,4,0.24
8,0,refer,5,427,2,3,0.16
8,0,referee,7,428,5,2,0.24
8,0,regard,6,429,2,4,0.24
8,0,regime,6,430,3,3,0.2
8,0,regional,8,431,4,4,0.28
8,0,reign,5,432,2,3,0.2
8,0,relative,8,433,2,6,0.36
8,0,relax,5,434,4,1,0.12
8,0,renew,5,435,2,3,0.16
8,0,republic,8,436,2,6,0.32
8,0,research,8,437,2,6,0.4
8,0,rest,4,438,3,1,0.12
8,0,retire,6,439,2,4,0.24
8,0,reveal,6,440,2,4,0.24
8,0,revenge,7,441,4,3,0.28
8,0,revise,6,442,3,3,0.2
8,0,revision,8,443,5,3,0.24
8,0,revive,6,444,4,2,0.16
8,0,rifle,5,445,1,4,0.2
8,0,right,5,446,2,3,0.24
8,0,rise,4,447,2,2,0.12
8,0,ritual,6,448,2,4,0.24
8,0,rival,5,449,2,3,0.16
8,0,robbery,7,450,1,6,0.28
8,0,romance,7,451,2,5,0.32
8,0,roof,4,452,2,2,0.12
8,0,rotate,6,453,2,4,0.2
8,0,round,5,454,2,3,0.16
8,0,routine,7,455,3,4,0.32
8,0,rub,3,456,1,2,0.12
8,0,rubber,6,457,3,3,0.2
8,0,rubbish,7,458,4,3,0.2
8,0,sacred,6,459,0,6,0.24
8,0,sale,4,460,2,2,0.2
8,0,sample,6,461,2,4,0.24
8,0,scan,4,462,1,3,0.16
8,0,schedule,8,463,2,6,0.32
8,0,scheme,6,464,4,2,0.16
8,0,score,5,465,2,3,0.24
8,0,second,6,466,1,5,0.24
8,0,secure,6,467,3,3,0.2
8,0,security,8,468,5,3,0.24
8,0,seeker,6,469,2,4,0.28
8,0,seem,4,470,3,1,0.12
8,0,seminar,7,471,2,5,0.28
8,0,serious,7,472,2,5,0.28
8,0,service,7,473,3,4,0.32
8,0,settler,7,474,2,5,0.28
8,0,seven,5,475,2,3,0.16
8,0,sexual,6,476,2,4,0.24
8,0,sexy,4,477,3,1,0.24
8,0,shape,5,478,1,4,0.6
8,0,sheer,5,479,2,3,0.4
8,0,shiny,5,480,2,3,0.4
8,0,shoot,5,481,2,3,0.4
8,0,shopping,8,482,3,5,0.64
8,0,shortage,8,483,3,5,0.76
8,0,silver,6,484,1,5,0.56
8,0,simply,6,485,2,4,0.52
8,0,situated,8,486,2,6,0.72
8,0,ski,3,487,1,2,0.4
8,0,skirt,5,488,3,2,0.36
8,0,slam,4,489,1,3,0.36
8,0,slip,4,490,2,2,0.32
8,0,smoking,7,491,1,6,0.64
8,0,soap,4,492,1,3,0.48
8,0,some,4,493,2,2,0.32
8,0,somehow,7,494,4,3,0.52
8,0,soup,4,495,2,2,0.32
8,0,south,5,496,3,2,0.36
8,0,space,5,497,1,4,0.48
8,0,speak,5,498,2,3,0.52
8,0,specify,7,499,3,4,0.56
8,0,speech,6,500,3,3,0.44
8,0,sphere,6,501,2,4,0.52
8,0,spine,5,502,2,3,0.52
8,0,spread,6,503,2,4,0.6
8,0,stab,4,504,1,3,0.44
8,0,stable,6,505,4,2,0.44
8,0,standing,8,506,3,5,0.72
8,0,star,4,507,3,1,0.4
8,0,statue,6,508,3,3,0.44
8,0,stay,4,509,3,1,0.28
8,0,steadily,8,510,2,6,0.68
8,0,stem,4,511,3,1,0.28
8,0,stop,4,512,2,2,0.44
8,0,story,5,513,3,2,0.36
8,0,street,6,514,2,4,0.52
8,0,strike,6,515,3,3,0.48
8,0,string,6,516,4,2,0.44
8,0,strong,6,517,3,3,0.6
8,0,studio,6,518,2,4,0.52
8,0,stumble,7,519,3,4,0.56
8,0,stun,4,520,3,1,0.28
8,0,such,4,521,1,3,0.44
8,0,super,5,522,2,3,0.52
8,0,supreme,7,523,3,4,0.56
8,0,sure,4,524,2,2,0.36
8,0,swallow,7,525,1,6,0.64
8,0,sweater,7,526,2,5,0.72
8,0,sweep,5,527,3,2,0.36
8,0,swim,4,528,2,2,0.32
8,0,sympathy,8,529,1,7,0.76
8,0,symptom,7,530,4,3,0.52
8,0,tactical,8,531,0,8,0.92
8,0,talent,6,532,2,4,0.56
8,0,talk,4,533,3,1,0.28
8,0,tank,4,534,2,2,0.32
8,0,tap,3,535,2,1,0.24
8,0,taste,5,536,2,3,0.52
8,0,taxi,4,537,2,2,0.32
8,0,tea,3,538,1,2,0.28
8,0,team,4,539,3,1,0.32
8,0,tempt,5,540,2,3,0.4
8,0,tendency,8,541,2,6,0.68
8,0,terrific,8,542,2,6,0.8
8,0,terrify,7,543,6,1,0.4
8,0,terror,6,544,4,2,0.4
8,0,thesis,6,545,1,5,0.56
8,0,thirsty,7,546,2,5,0.72
8,0,this,4,547,3,1,0.28
8,0,thorough,8,548,2,6,0.68
8,0,three,5,549,2,3,0.4
8,0,ticket,6,550,1,5,0.68
8,0,tidy,4,551,2,2,0.32
8,0,tighten,7,552,2,5,1.32
8,0,to,2,553,1,1,0.2
8,0,together,8,554,2,6,0.68
8,0,tonne,5,555,2,3,0.52
8,0,too,3,556,2,1,0.24
8,0,topic,5,557,2,3,0.4
8,0,torture,7,558,2,5,0.64
8,0,tour,4,559,2,2,0.36
8,0,tragic,6,560,1,5,0.68
8,0,trap,4,561,3,1,0.28
8,0,trial,5,562,2,3,0.44
8,0,tribute,7,563,3,4,0.56
8,0,trio,4,564,3,1,0.28
8,0,tropical,8,565,2,6,0.8
8,0,trousers,8,566,3,5,0.64
8,0,twice,5,567,1,4,0.48
8,0,two,3,568,2,1,0.24
8,0,unable,6,569,0,6,0.6
8,0,unfair,6,570,2,4,0.64
8,0,unify,5,571,2,3,0.4
8,0,until,5,572,2,3,0.4
8,0,unusual,7,573,2,5,0.6
8,0,unveil,6,574,2,4,0.64
8,0,upgrade,7,575,1,6,0.68
8,0,urgent,6,576,1,5,0.56
8,0,usage,5,577,1,4,0.48
8,0,utility,7,578,1,6,0.68
8,0,vague,5,579,0,5,0.64
8,0,valley,6,580,2,4,0.56
8,0,valuable,8,581,3,5,0.76
8,0,venture,7,582,1,6,0.76
8,0,verify,6,583,2,4,0.64
8,0,veteran,7,584,2,5,0.6
8,0,video,5,585,1,4,0.48
8,0,vocal,5,586,1,4,0.48
8,0,voice,5,587,2,3,0.52
8,0,wake,4,588,0,4,0.44
8,0,walk,4,589,2,2,0.32
8,0,war,3,590,2,1,0.24
8,0,warning,7,591,3,4,0.56
8,0,watch,5,592,2,3,0.44
8,0,water,5,593,3,2,0.48
8,0,wealthy,7,594,1,6,0.68
8,0,weave,5,595,3,2,0.4
8,0,weekend,7,596,2,5,0.64
8,0,weight,6,597,2,4,0.64
8,0,weird,5,598,3,2,0.36
8,0,whatever,8,599,1,7,0.76
8,0,whenever,8,600,2,6,0.68
8,0,which,5,601,2,3,0.52
8,0,whose,5,602,2,3,0.44
8,0,wildlife,8,603,1,7,0.76
8,0,wipe,4,604,2,2,0.32
8,0,within,6,605,2,4,0.52
8,0,without,7,606,4,3,0.6
8,0,woman,5,607,1,4,0.48
8,0,word,4,608,2,2,0.32
8,0,work,4,609,3,1,0.28
8,0,wow,3,610,2,1,0.24
8,0,wrist,5,611,1,4,0.56
8,1,academic,8,0,0,8,0.36
8,1,accept,6,1,2,4,0.2
8,1,accurate,8,2,3,5,0.28
8,1,acid,4,3,2,2,0.12
8,1,add,3,4,1,2,0.2
8,1,adjacent,8,5,2,6,0.28
8,1,admit,5,6,2,3,0.2
8,1,adopt,5,7,2,3,0.16
8,1,again,5,8,1,4,0.28
8,1,against,7,9,5,2,0.2
8,1,agree,5,10,2,3,0.16
8,1,ahead,5,11,1,4,0.2
8,1,alcohol,7,12,1,6,0.28
8,1,allocate,8,13,2,6,0.36
8,1,ally,4,14,3,1,0.12
8,1,analyse,7,15,1,6,0.28
8,1,analysis,8,16,6,2,0.2
8,1,ancient,7,17,2,5,0.32
8,1,and,3,18,2,1,0.08
8,1,anyway,6,19,2,4,0.2
8,1,app,3,20,1,2,0.12
8,1,applaud,7,21,3,4,0.24
8,1,approach,8,22,3,5,0.32
8,1,argue,5,23,1,4,0.2
8,1,arms,4,24,2,2,0.12
8,1,army,4,25,3,1,0.12
8,1,arrest,6,26,2,4,0.24
8,1,arrow,5,27,3,2,0.2
8,1,artistic,8,28,2,6,0.28
8,1,at,2,29,1,1,0.08
8,1,atrocity,8,30,2,6,0.28
8,1,auto,4,31,1,3,0.16
8,1,average,7,32,1,6,0.36
8,1,baby,4,33,0,4,0.2
8,1,backing,7,34,2,5,0.28
8,1,bacteria,8,35,3,5,0.32
8,1,balance,7,36,2,5,0.32
8,1,ballet,6,37,3,3,0.2
8,1,bat,3,38,2,1,0.12
8,1,bath,4,39,3,1,0.12
8,1,bay,3,40,2,1,0.08
8,1,beast,5,41,1,4,0.28
8,1,beat,4,42,3,1,0.12
8,1,beauty,6,43,3,3,0.2
8,1,beg,3,44,2,1,0.08
8,1,behalf,6,45,2,4,0.2
8,1,bell,4,46,2,2,0.12
8,1,between,7,47,2,5,0.32
8,1,birthday,8,48,1,7,0.32
8,1,bishop,6,49,2,4,0.24
8,1,bizarre,7,50,2,5,0.24
8,1,blade,5,51,1,4,0.28
8,1,bless,5,52,2,3,0.16
8,1,blind,5,53,2,3,0.2
8,1,blog,4,54,2,2,0.12
8,1,boil,4,55,1,3,0.16
8,1,bomb,4,56,2,2,0.12
8,1,boost,5,57,2,3,0.24
8,1,boundary,8,58,2,6,0.28
8,1,box,3,59,2,1,0.08
8,1,bridge,6,60,1,5,0.24
8,1,bright,6,61,3,3,0.24
8,1,broken,6,62,2,4,0.24
8,1,buffer,6,63,1,5,0.24
8,1,build,5,64,2,3,0.2
8,1,burden,6,65,2,4,0.2
8,1,burn,4,66,3,1,0.16
8,1,can,3,67,0,3,0.12
8,1,capable,7,68,2,5,0.28
8,1,careful,7,69,2,5,0.24
8,1,carpet,6,70,3,3,0.2
8,1,category,8,71,2,6,0.4
8,1,cave,4,72,2,2,0.12
8,1,cd,2,73,1,1,0.08
8,1,ceiling,7,74,1,6,0.28
8,1,cemetery,8,75,2,6,0.36
8,1,certain,7,76,2,5,0.24
8,1,chair,5,77,1,4,0.2
8,1,chapter,7,78,3,4,0.24
8,1,charter,7,79,3,4,0.32
8,1,cheat,5,80,2,3,0.16
8,1,check,5,81,3,2,0.16
8,1,cheerful,8,82,3,5,0.28
8,1,chemical,8,83,3,5,0.32
8,1,chicken,7,84,2,5,0.28
8,1,chop,4,85,2,2,0.16
8,1,circle,6,86,1,5,0.24
8,1,civil,5,87,2,3,0.2
8,1,clause,6,88,1,5,0.32
8,1,clearly,7,89,2,5,0.24
8,1,clinical,8,90,2,6,0.32
8,1,coach,5,91,1,4,0.2
8,1,coffee,6,92,2,4,0.28
8,1,coincide,8,93,2,6,0.32
8,1,colony,6,94,2,4,0.2
8,1,company,7,95,2,5,0.28
8,1,comply,6,96,4,2,0.24
8,1,conceive,8,97,2,6,0.28
8,1,conduct,7,98,3,4,0.24
8,1,confer,6,99,3,3,0.2
8,1,confess,7,100,5,2,0.24
8,1,consent,7,101,3,4,0.24
8,1,consult,7,102,4,3,0.2
8,1,contempt,8,103,3,5,0.28
8,1,contrast,8,104,4,4,0.32
8,1,convey,6,105,3,3,0.2
8,1,cooker,6,106,2,4,0.24
8,1,cope,4,107,2,2,0.12
8,1,correct,7,108,2,5,0.24
8,1,cost,4,109,2,2,0.2
8,1,cottage,7,110,2,5,0.24
8,1,could,5,111,2,3,0.16
8,1,coup,4,112,3,1,0.12
8,1,court,5,113,3,2,0.16
8,1,credible,8,114,1,7,0.4
8,1,crime,5,115,2,3,0.16
8,1,crowd,5,116,2,3,0.2
8,1,crowded,7,117,5,2,0.2
8,1,cruise,6,118,2,4,0.44
8,1,cycle,5,119,1,4,0.48
8,1,dam,3,120,0,3,0.32
8,1,damage,6,121,3,3,0.44
8,1,day,3,122,2,1,0.28
8,1,deal,4,123,1,3,0.44
8,1,declare,7,124,2,5,0.76
8,1,decline,7,125,4,3,0.52
8,1,deed,4,126,2,2,0.32
8,1,deem,4,127,3,1,0.28
8,1,definite,8,128,2,6,0.8
8,1,deliver,7,129,2,5,0.6
8,1,demon,5,130,2,3,0.44
8,1,deputy,6,131,2,4,0.52
8,1,desktop,7,132,2,5,0.6
8,1,diagram,7,133,1,6,0.84
8,1,dictate,7,134,2,5,0.64
8,1,dictator,8,135,6,2,0.48
8,1,dig,3,136,2,1,0.24
8,1,diminish,8,137,2,6,0.84
8,1,diplomat,8,138,2,6,1
8,1,director,8,139,2,6,0.72
8,1,disabled,8,140,2,6,1.16
8,1,discount,8,141,3,5,0.64
8,1,distant,7,142,3,4,0.68
8,1,divine,6,143,2,4,0.64
8,1,dollar,6,144,1,5,0.72
8,1,domain,6,145,2,4,0.68
8,1,dominant,8,146,3,5,0.68
8,1,donation,8,147,2,6,0.68
8,1,dot,3,148,2,1,0.24
8,1,double,6,149,2,4,0.6
8,1,drama,5,150,1,4,0.48
8,1,drawing,7,151,3,4,0.56
8,1,duration,8,152,1,7,0.76
8,1,ear,3,153,0,3,0.44
8,1,earnings,8,154,3,5,0.64
8,1,editor,6,155,1,5,0.56
8,1,effort,6,156,1,5,0.68
8,1,eight,5,157,1,4,0.64
8,1,either,6,158,2,4,0.52
8,1,elect,5,159,1,4,0.48
8,1,eleven,6,160,3,3,0.48
8,1,embody,6,161,1,5,0.56
8,1,emission,8,162,2,6,0.84
8,1,employer,8,163,2,6,0.68
8,1,empower,7,164,3,4,0.56
8,1,enable,6,165,1,5,0.68
8,1,enemy,5,166,2,3,0.4
8,1,enormous,8,167,2,6,0.72
8,1,enrich,6,168,2,4,0.52
8,1,entrance,8,169,2,6,0.8
8,1,equality,8,170,1,7,0.84
8,1,erect,5,171,1,4,0.52
8,1,essence,7,172,1,6,0.72
8,1,event,5,173,1,4,0.6
8,1,evidence,8,174,2,6,0.76
8,1,examine,7,175,1,6,0.72
8,1,exchange,8,176,2,6,0.8
8,1,exercise,8,177,2,6,0.84
8,1,exploit,7,178,2,5,0.64
8,1,extend,6,179,2,4,0.52
8,1,extent,6,180,5,1,0.36
8,1,eye,3,181,1,2,0.4
8,1,fail,4,182,0,4,0.44
8,1,failed,6,183,4,2,0.4
8,1,failure,7,184,4,3,0.48
8,1,fairly,6,185,3,3,0.44
8,1,fall,4,186,2,2,0.4
8,1,fast,4,187,2,2,0.32
8,1,fear,4,188,1,3,0.36
8,1,fee,3,189,2,1,0.24
8,1,feeding,7,190,3,4,0.56
8,1,fellow,6,191,2,4,0.52
8,1,few,3,192,2,1,0.32
8,1,fibre,5,193,1,4,0.48
8,1,fight,5,194,2,3,0.4
8,1,firm,4,195,2,2,0.32
8,1,fixture,7,196,2,5,0.6
8,1,flat,4,197,1,3,0.48
8,1,flavour,7,198,3,4,0.56
8,1,flower,6,199,2,4,0.52
8,1,flying,6,200,2,4,0.52
8,1,focus,5,201,1,4,0.48
8,1,folding,7,202,2,5,0.76
8,1,for,3,203,2,1,0.28
8,1,force,5,204,3,2,0.44
8,1,fortune,7,205,3,4,0.64
8,1,fourteen,8,206,2,6,0.84
8,1,friday,6,207,1,5,0.56
8,1,fridge,6,208,4,2,0.4
8,1,friendly,8,209,3,5,0.64
8,1,frighten,8,210,3,5,0.76
8,1,front,5,211,2,3,0.4
8,1,fulfil,6,212,1,5,0.56
8,1,funding,7,213,2,5,0.6
8,1,fur,3,214,2,1,0.24
8,1,game,4,215,0,4,0.56
8,1,gaming,6,216,3,3,0.44
8,1,gene,4,217,1,3,0.36
8,1,glass,5,218,1,4,0.48
8,1,go,2,219,1,1,0.2
8,1,god,3,220,2,1,0.24
8,1,golf,4,221,2,2,0.48
8,1,good,4,222,2,2,0.36
8,1,grade,5,223,1,4,0.52
8,1,graphics,8,224,3,5,0.64
8,1,green,5,225,2,3,0.44
8,1,greet,5,226,4,1,0.4
8,1,grey,4,227,3,1,0.28
8,1,grief,5,228,2,3,0.4
8,1,grin,4,229,3,1,0.28
8,1,ground,6,230,2,4,0.52
8,1,guess,5,231,1,4,0.48
8,1,guest,5,232,4,1,0.4
8,1,guidance,8,233,2,6,0.68
8,1,guitar,6,234,3,3,0.44
8,1,guy,3,235,2,1,0.24
8,1,gym,3,236,1,2,0.28
8,1,handful,7,237,0,7,0.8
8,1,happen,6,238,2,4,0.52
8,1,harm,4,239,2,2,0.32
8,1,harvest,7,240,3,4,0.56
8,1,hate,4,241,2,2,0.32
8,1,hazard,6,242,2,4,0.6
8,1,health,6,243,1,5,0.56
8,1,heart,5,244,3,2,0.36
8,1,heat,4,245,3,1,0.28
8,1,hers,4,246,2,2,0.32
8,1,hesitate,8,247,2,6,0.88
8,1,highly,6,248,1,5,0.68
8,1,holiday,7,249,1,6,0.8
8,1,homeland,8,250,2,6,0.8
8,1,horrible,8,251,2,6,0.88
8,1,horror,6,252,4,2,0.44
8,1,hotel,5,253,2,3,0.48
8,1,hour,4,254,2,2,0.36
8,1,how,3,255,2,1,0.28
8,1,humble,6,256,1,5,0.72
8,1,hunger,6,257,2,4,0.52
8,1,hunt,4,258,3,1,0.28
8,1,icon,4,259,0,4,0.44
8,1,ideal,5,260,1,4,0.48
8,1,identity,8,261,3,5,0.76
8,1,image,5,262,1,4,0.48
8,1,imagery,7,263,5,2,0.44
8,1,improve,7,264,2,5,0.6
8,1,include,7,265,1,6,0.76
8,1,incur,5,266,3,2,0.36
8,1,indicate,8,267,2,6,0.68
8,1,indirect,8,268,4,4,0.6
8,1,infant,6,269,2,4,0.6
8,1,info,4,270,3,1,0.28
8,1,inherent,8,271,2,6,0.72
8,1,instant,7,272,2,5,0.64
8,1,instruct,8,273,4,4,1
8,1,intended,8,274,2,6,0.68
8,1,intense,7,275,5,2,0.44
8,1,interior,8,276,4,4,0.6
8,1,involved,8,277,2,6,0.8
8,1,isolated,8,278,1,7,0.76
8,1,issue,5,279,2,3,0.4
8,1,january,7,280,0,7,0.8
8,1,job,3,281,1,2,0.28
8,1,joy,3,282,2,1,0.24
8,1,judicial,8,283,1,7,0.76
8,1,june,4,284,2,2,0.32
8,1,key,3,285,0,3,0.32
8,1,keyboard,8,286,3,5,0.76
8,1,kick,4,287,1,3,0.4
8,1,kidney,6,288,2,4,0.52
8,1,kit,3,289,2,1,0.24
8,1,knife,5,290,1,4,0.48
8,1,know,4,291,2,2,0.44
8,1,lack,4,292,0,4,0.44
8,1,last,4,293,2,2,0.32
8,1,laugh,5,294,2,3,0.4
8,1,law,3,295,2,1,0.24
8,1,layer,5,296,2,3,0.4
8,1,leaflet,7,297,1,6,0.76
8,1,learning,8,298,3,5,0.64
8,1,legend,6,299,2,4,0.56
8,1,lens,4,300,2,2,0.32
8,1,lesbian,7,301,2,5,0.72
8,1,lesser,6,302,3,3,0.52
8,1,limb,4,303,1,3,0.4
8,1,link,4,304,2,2,0.32
8,1,little,6,305,2,4,0.52
8,1,liver,5,306,2,3,0.52
8,1,local,5,307,1,4,0.48
8,1,located,7,308,4,3,0.48
8,1,location,8,309,5,3,0.52
8,1,lonely,6,310,2,4,0.6
8,1,long,4,311,3,1,0.28
8,1,loose,5,312,2,3,0.4
8,1,lot,3,313,2,1,0.24
8,1,loudly,6,314,2,4,0.52
8,1,low,3,315,2,1,0.24
8,1,main,4,316,0,4,0.44
8,1,marine,6,317,2,4,0.6
8,1,mark,4,318,3,1,0.28
8,1,married,7,319,3,4,0.56
8,1,meal,4,320,1,3,0.36
8,1,media,5,321,2,3,0.4
8,1,meeting,7,322,2,5,0.72
8,1,memory,6,323,2,4,0.52
8,1,mention,7,324,2,5,0.6
8,1,mentor,6,325,4,2,0.4
8,1,merely,6,326,2,4,0.6
8,1,mess,4,327,2,2,0.32
8,1,message,7,328,4,3,0.48
8,1,method,6,329,2,4,0.52
8,1,militia,7,330,1,6,0.76
8,1,mirror,6,331,2,4,0.52
8,1,mixed,5,332,2,3,0.44
8,1,mobilize,8,333,1,7,0.76
8,1,modify,6,334,2,4,0.52
8,1,moment,6,335,2,4,0.64
8,1,monument,8,336,2,6,0.68
8,1,most,4,337,2,2,0.32
8,1,mouth,5,338,2,3,0.44
8,1,multiple,8,339,1,7,0.88
8,1,music,5,340,2,3,0.4
8,1,nation,6,341,0,6,0.6
8,1,nature,6,342,3,3,0.44
8,1,neck,4,343,1,3,0.36
8,1,needle,6,344,2,4,0.64
8,1,negative,8,345,2,6,0.68
8,1,night,5,346,1,4,0.48
8,1,nominate,8,347,1,7,0.88
8,1,normal,6,348,2,4,0.44
8,1,northern,8,349,3,5,0.36
8,1,note,4,350,2,2,0.16
8,1,nothing,7,351,3,4,0.24
8,1,notice,6,352,3,3,0.28
8,1,numerous,8,353,1,7,0.32
8,1,obesity,7,354,0,7,0.32
8,1,obsess,6,355,2,4,0.2
8,1,ocean,5,356,1,4,0.28
8,1,off,3,357,1,2,0.12
8,1,offend,6,358,3,3,0.2
8,1,official,8,359,3,5,0.28
8,1,once,4,360,1,3,0.16
8,1,one,3,361,2,1,0.16
8,1,opponent,8,362,1,7,0.32
8,1,option,6,363,2,4,0.2
8,1,other,5,364,1,4,0.2
8,1,outdoors,8,365,1,7,0.44
8,1,outfit,6,366,3,3,0.24
8,1,outlet,6,367,3,3,0.2
8,1,oversee,7,368,1,6,0.32
8,1,pack,4,369,0,4,0.2
8,1,pad,3,370,2,1,0.16
8,1,page,4,371,2,2,0.12
8,1,park,4,372,2,2,0.12
8,1,partial,7,373,3,4,0.24
8,1,passport,8,374,2,6,0.28
8,1,patience,8,375,2,6,0.36
8,1,patron,6,376,3,3,0.2
8,1,peaceful,8,377,1,7,0.32
8,1,peer,4,378,2,2,0.16
8,1,pepper,6,379,2,4,0.28
8,1,perfect,7,380,2,5,0.28
8,1,phone,5,381,1,4,0.2
8,1,pick,4,382,1,3,0.16
8,1,pioneer,7,383,2,5,0.32
8,1,place,5,384,1,4,0.2
8,1,plastic,7,385,3,4,0.24
8,1,plead,5,386,2,3,0.16
8,1,pledge,6,387,3,3,0.2
8,1,plot,4,388,2,2,0.2
8,1,police,6,389,1,5,0.24
8,1,pond,4,390,2,2,0.12
8,1,position,8,391,2,6,0.28
8,1,possess,7,392,3,4,0.32
8,1,possible,8,393,4,4,0.24
8,1,pot,3,394,2,1,0.12
8,1,predict,7,395,1,6,0.28
8,1,presence,8,396,3,5,0.28
8,1,printing,8,397,2,6,0.4
8,1,prior,5,398,3,2,0.16
8,1,priority,8,399,5,3,0.24
8,1,process,7,400,2,5,0.32
8,1,produce,7,401,3,4,0.24
8,1,program,7,402,3,4,0.24
8,1,project,7,403,3,4,0.24
8,1,proper,6,404,3,3,0.2
8,1,protest,7,405,3,4,0.28
8,1,pump,4,406,1,3,0.16
8,1,punk,4,407,2,2,0.12
8,1,pure,4,408,2,2,0.12
8,1,purpose,7,409,3,4,0.24
8,1,puzzle,6,410,2,4,0.28
8,1,quest,5,411,0,5,0.2
8,1,quite,5,412,2,3,0.24
8,1,racial,6,413,0,6,0.36
8,1,racism,6,414,4,2,0.24
8,1,radar,5,415,2,3,0.2
8,1,railway,7,416,2,5,0.24
8,1,raise,5,417,3,2,0.16
8,1,rally,5,418,2,3,0.2
8,1,rational,8,419,2,6,0.36
8,1,realm,5,420,1,4,0.2
8,1,recruit,7,421,2,5,0.24
8,1,refer,5,422,2,3,0.2
8,1,referee,7,423,5,2,0.24
8,1,regard,6,424,2,4,0.2
8,1,region,6,425,3,3,0.2
8,1,reign,5,426,2,3,0.2
8,1,remark,6,427,2,4,0.24
8,1,removal,7,428,3,4,0.32
8,1,remove,6,429,5,1,0.16
8,1,renew,5,430,2,3,0.16
8,1,replace,7,431,2,5,0.24
8,1,republic,8,432,3,5,0.36
8,1,research,8,433,2,6,0.28
8,1,retail,6,434,2,4,0.24
8,1,revise,6,435,2,4,0.24
8,1,revision,8,436,5,3,0.28
8,1,rise,4,437,1,3,0.16
8,1,ritual,6,438,2,4,0.24
8,1,rival,5,439,2,3,0.16
8,1,road,4,440,1,3,0.16
8,1,rob,3,441,2,1,0.12
8,1,roll,4,442,2,2,0.2
8,1,romance,7,443,2,5,0.24
8,1,rotate,6,444,2,4,0.2
8,1,rough,5,445,2,3,0.2
8,1,routine,7,446,3,4,0.32
8,1,rubbish,7,447,1,6,0.28
8,1,ruin,4,448,2,2,0.16
8,1,sacred,6,449,0,6,0.24
8,1,sale,4,450,2,2,0.16
8,1,sample,6,451,2,4,0.28
8,1,sand,4,452,2,2,0.16
8,1,scared,6,453,1,5,0.24
8,1,scholar,7,454,2,5,0.28
8,1,score,5,455,2,3,0.16
8,1,second,6,456,1,5,0.32
8,1,secret,6,457,3,3,0.2
8,1,seeker,6,458,2,4,0.24
8,1,segment,7,459,2,5,0.28
8,1,sensible,8,460,2,6,0.36
8,1,serious,7,461,2,5,0.24
8,1,serve,5,462,3,2,0.16
8,1,service,7,463,4,3,0.2
8,1,setting,7,464,2,5,0.32
8,1,seven,5,465,2,3,0.16
8,1,sexual,6,466,2,4,0.24
8,1,share,5,467,1,4,0.24
8,1,sheer,5,468,2,3,0.2
8,1,shell,5,469,3,2,0.24
8,1,shiny,5,470,2,3,0.2
8,1,ship,4,471,3,1,0.12
8,1,shipping,8,472,4,4,0.24
8,1,shoot,5,473,2,3,0.16
8,1,shopping,8,474,3,5,0.36
8,1,shore,5,475,3,2,0.16
8,1,shortage,8,476,4,4,0.24
8,1,simply,6,477,1,5,0.24
8,1,sister,6,478,2,4,0.28
8,1,sit,3,479,2,1,0.08
8,1,ski,3,480,1,2,0.12
8,1,skip,4,481,3,1,0.12
8,1,skull,5,482,2,3,0.16
8,1,slam,4,483,1,3,0.16
8,1,snow,4,484,1,3,0.24
8,1,solo,4,485,1,3,0.16
8,1,somehow,7,486,2,5,0.24
8,1,someone,7,487,4,3,0.24
8,1,song,4,488,2,2,0.12
8,1,soup,4,489,2,2,0.2
8,1,space,5,490,1,4,0.2
8,1,spare,5,491,3,2,0.16
8,1,special,7,492,2,5,0.32
8,1,specify,7,493,5,2,0.2
8,1,spin,4,494,2,2,0.2
8,1,spine,5,495,4,1,0.12
8,1,spread,6,496,2,4,0.2
8,1,stab,4,497,1,3,0.16
8,1,stall,5,498,3,2,0.16
8,1,stamp,5,499,3,2,0.2
8,1,stance,6,500,3,3,0.2
8,1,stand,5,501,4,1,0.16
8,1,star,4,502,3,1,0.12
8,1,stay,4,503,3,1,0.12
8,1,steadily,8,504,2,6,0.36
8,1,stem,4,505,3,1,0.12
8,1,store,5,506,2,3,0.2
8,1,straight,8,507,2,6,0.28
8,1,street,6,508,3,3,0.2
8,1,stretch,7,509,4,3,0.28
8,1,strict,6,510,3,3,0.2
8,1,strike,6,511,4,2,0.16
8,1,striking,8,512,5,3,0.24
8,1,studio,6,513,2,4,0.28
8,1,stumble,7,514,3,4,0.24
8,1,subject,7,515,1,6,0.28
8,1,such,4,516,2,2,0.16
8,1,sudden,6,517,2,4,0.2
8,1,sue,3,518,2,1,0.16
8,1,sugar,5,519,2,3,0.16
8,1,suppose,7,520,2,5,0.28
8,1,sure,4,521,2,2,0.12
8,1,surely,6,522,4,2,0.2
8,1,surgical,8,523,3,5,0.36
8,1,swallow,7,524,1,6,0.28
8,1,sweep,5,525,2,3,0.2
8,1,swim,4,526,2,2,0.12
8,1,symbolic,8,527,1,7,0.64
8,1,tactical,8,528,0,8,0.8
8,1,tail,4,529,2,2,0.32
8,1,tale,4,530,2,2,0.32
8,1,talent,6,531,4,2,0.48
8,1,talk,4,532,3,1,0.4
8,1,tape,4,533,2,2,0.32
8,1,taste,5,534,2,3,0.44
8,1,taxi,4,535,2,2,0.32
8,1,team,4,536,1,3,0.36
8,1,tempt,5,537,2,3,0.4
8,1,tendency,8,538,2,6,0.84
8,1,terrify,7,539,2,5,0.6
8,1,terror,6,540,4,2,0.4
8,1,textbook,8,541,2,6,0.72
8,1,thereby,7,542,1,6,0.8
8,1,thesis,6,543,3,3,0.48
8,1,thirsty,7,544,2,5,0.68
8,1,thumb,5,545,2,3,0.44
8,1,tight,5,546,1,4,0.6
8,1,timing,6,547,2,4,0.56
8,1,to,2,548,1,1,0.2
8,1,tonight,7,549,2,5,0.64
8,1,too,3,550,2,1,0.28
8,1,tour,4,551,2,2,0.44
8,1,tragic,6,552,1,5,0.56
8,1,trainer,7,553,3,4,0.56
8,1,trap,4,554,3,1,0.28
8,1,treasure,8,555,2,6,0.68
8,1,trial,5,556,2,3,0.52
8,1,tribal,6,557,3,3,0.48
8,1,tribe,5,558,4,1,0.32
8,1,tribute,7,559,4,3,0.52
8,1,trio,4,560,3,1,0.68
8,1,tropical,8,561,2,6,1.44
8,1,trouble,7,562,3,4,1.68
8,1,trousers,8,563,4,4,1.4000000000000001
8,1,truck,5,564,2,3,0.88
8,1,two,3,565,1,2,0.96
8,1,ultimate,8,566,0,8,1.8
8,1,unable,6,567,1,5,0.72
8,1,unfair,6,568,2,4,0.64
8,1,unify,5,569,2,3,0.56
8,1,union,5,570,3,2,0.64
8,1,unique,6,571,3,3,0.48
8,1,universe,8,572,3,5,0.64
8,1,unveil,6,573,2,4,0.52
8,1,upgrade,7,574,1,6,0.88
8,1,uphold,6,575,2,4,0.52
8,1,urgent,6,576,1,5,0.56
8,1,usage,5,577,1,4,0.48
8,1,usual,5,578,2,3,0.44
8,1,utility,7,579,1,6,0.8
8,1,utilize,7,580,5,2,0.44
8,1,variety,7,581,0,7,0.72
8,1,vein,4,582,1,3,0.4
8,1,veteran,7,583,2,5,0.8
8,1,viable,6,584,1,5,0.56
8,1,viewer,6,585,2,4,0.52
8,1,virtue,6,586,2,4,0.6
8,1,virus,5,587,3,2,0.48
8,1,visitor,7,588,2,5,0.76
8,1,vocal,5,589,1,4,0.48
8,1,wait,4,590,0,4,0.44
8,1,waiter,6,591,4,2,0.4
8,1,war,3,592,2,1,0.24
8,1,way,3,593,2,1,0.36
8,1,wealthy,7,594,1,6,0.68
8,1,weapon,6,595,3,3,0.48
8,1,welcome,7,596,2,5,0.68
8,1,welfare,7,597,3,4,0.64
8,1,whatever,8,598,1,7,0.92
8,1,whenever,8,599,2,6,0.88
8,1,width,5,600,1,4,0.6
8,1,wildlife,8,601,2,6,0.92
8,1,willing,7,602,3,4,0.56
8,1,wind,4,603,2,2,0.32
8,1,wine,4,604,3,1,0.28
8,1,wipe,4,605,2,2,0.36
8,1,without,7,606,2,5,0.72
8,1,woman,5,607,1,4,0.48
8,1,word,4,608,2,2,0.32
8,1,wrap,4,609,1,3,0.4
8,1,yellow,6,610,0,6,0.6
8,1,young,5,611,1,4,0.6
8,2,absence,7,0,0,7,0.32
8,2,accident,8,1,1,7,0.36
8,2,accurate,8,2,3,5,0.28
8,2,acid,4,3,2,2,0.2
8,2,acre,4,4,2,2,0.16
8,2,actress,7,5,2,5,0.24
8,2,acute,5,6,2,3,0.2
8,2,ad,2,7,1,1,0.08
8,2,adj,3,8,2,1,0.08
8,2,adjacent,8,9,3,5,0.36
8,2,adoption,8,10,2,6,0.32
8,2,against,7,11,1,6,0.28
8,2,alcohol,7,12,1,6,0.36
8,2,align,5,13,2,3,0.2
8,2,amateur,7,14,1,6,0.28
8,2,amusing,7,15,2,5,0.28
8,2,ancient,7,16,1,6,0.36
8,2,and,3,17,2,1,0.12
8,2,anger,5,18,2,3,0.2
8,2,ankle,5,19,2,3,0.2
8,2,announce,8,20,2,6,0.36
8,2,annoyed,7,21,4,3,0.28
8,2,anybody,7,22,2,5,0.24
8,2,anyway,6,23,3,3,0.2
8,2,approach,8,24,1,7,0.32
8,2,approve,7,25,5,2,0.28
8,2,arise,5,26,1,4,0.2
8,2,army,4,27,2,2,0.12
8,2,artist,6,28,2,4,0.2
8,2,ask,3,29,1,2,0.12
8,2,assault,7,30,2,5,0.32
8,2,at,2,31,1,1,0.08
8,2,attract,7,32,2,5,0.28
8,2,auction,7,33,1,6,0.28
8,2,average,7,34,1,6,0.36
8,2,backing,7,35,0,7,0.32
8,2,bacteria,8,36,3,5,0.28
8,2,balance,7,37,2,5,0.24
8,2,ballet,6,38,3,3,0.28
8,2,base,4,39,2,2,0.12
8,2,bat,3,40,2,1,0.08
8,2,bath,4,41,3,1,0.12
8,2,beast,5,42,1,4,0.2
8,2,beauty,6,43,3,3,0.2
8,2,beer,4,44,2,2,0.2
8,2,behalf,6,45,2,4,0.24
8,2,behave,6,46,4,2,0.16
8,2,belong,6,47,2,4,0.24
8,2,betray,6,48,2,4,0.2
8,2,beyond,6,49,2,4,0.28
8,2,bill,4,50,1,3,0.16
8,2,bird,4,51,2,2,0.16
8,2,birthday,8,52,3,5,0.28
8,2,biscuit,7,53,2,5,0.32
8,2,bitter,6,54,2,4,0.24
8,2,bless,5,55,1,4,0.2
8,2,blog,4,56,2,2,0.12
8,2,boom,4,57,1,3,0.16
8,2,boot,4,58,3,1,0.12
8,2,bother,6,59,2,4,0.28
8,2,bottle,6,60,3,3,0.2
8,2,box,3,61,2,1,0.08
8,2,brand,5,62,1,4,0.2
8,2,breach,6,63,2,4,0.2
8,2,breathe,7,64,4,3,0.28
8,2,bride,5,65,2,3,0.16
8,2,bridge,6,66,4,2,0.2
8,2,broken,6,67,2,4,0.24
8,2,buffer,6,68,1,5,0.32
8,2,bug,3,69,2,1,0.08
8,2,burden,6,70,2,4,0.24
8,2,burn,4,71,3,1,0.12
8,2,cake,4,72,0,4,0.2
8,2,can,3,73,2,1,0.08
8,2,cancer,6,74,3,3,0.28
8,2,capable,7,75,2,5,0.28
8,2,card,4,76,2,2,0.16
8,2,career,6,77,3,3,0.2
8,2,careful,7,78,4,3,0.2
8,2,carpet,6,79,3,3,0.28
8,2,cartoon,7,80,3,4,0.24
8,2,category,8,81,2,6,0.28
8,2,central,7,82,1,6,0.28
8,2,century,7,83,4,3,0.28
8,2,certain,7,84,2,5,0.24
8,2,charter,7,85,1,6,0.28
8,2,check,5,86,2,3,0.2
8,2,cheerful,8,87,3,5,0.32
8,2,chemical,8,88,3,5,0.28
8,2,chicken,7,89,2,5,0.28
8,2,chunk,5,90,2,3,0.16
8,2,cite,4,91,1,3,0.24
8,2,city,4,92,3,1,0.12
8,2,clause,6,93,1,5,0.24
8,2,clinical,8,94,2,6,0.32
8,2,closely,7,95,2,5,0.32
8,2,coach,5,96,1,4,0.2
8,2,comfort,7,97,2,5,0.28
8,2,commonly,8,98,3,5,0.28
8,2,company,7,99,3,4,0.32
8,2,comply,6,100,4,2,0.16
8,2,conceive,8,101,2,6,0.28
8,2,concern,7,102,5,2,0.2
8,2,confess,7,103,3,4,0.28
8,2,confused,8,104,4,4,0.24
8,2,consent,7,105,3,4,0.24
8,2,contempt,8,106,3,5,0.28
8,2,contend,7,107,5,2,0.24
8,2,cooker,6,108,2,4,0.24
8,2,cope,4,109,2,2,0.12
8,2,correct,7,110,2,5,0.28
8,2,cottage,7,111,2,5,0.36
8,2,could,5,112,2,3,0.16
8,2,county,6,113,3,3,0.2
8,2,coup,4,114,3,1,0.12
8,2,course,6,115,3,3,0.2
8,2,court,5,116,4,1,0.2
8,2,coverage,8,117,2,6,0.28
8,2,creature,8,118,1,7,0.32
8,2,credible,8,119,3,5,0.28
8,2,creep,5,120,3,2,0.2
8,2,crisis,6,121,2,4,0.2
8,2,cruel,5,122,2,3,0.16
8,2,cruise,6,123,3,3,0.2
8,2,cry,3,124,2,1,0.08
8,2,currency,8,125,1,7,0.36
8,2,current,7,126,6,1,0.16
8,2,curved,6,127,3,3,0.2
8,2,cycle,5,128,1,4,0.2
8,2,darkness,8,129,0,8,0.4
8,2,december,8,130,1,7,0.32
8,2,decline,7,131,3,4,0.28
8,2,deem,4,132,2,2,0.16
8,2,default,7,133,2,5,0.36
8,2,defect,6,134,3,3,0.24
8,2,definite,8,135,3,5,0.32
8,2,deposit,7,136,2,5,0.28
8,2,desktop,7,137,2,5,0.32
8,2,despite,7,138,3,4,0.28
8,2,dictator,8,139,1,7,0.36
8,2,diminish,8,140,2,6,0.32
8,2,disabled,8,141,2,6,0.36
8,2,distant,7,142,3,4,0.24
8,2,divorced,8,143,2,6,0.32
8,2,domain,6,144,1,5,0.32
8,2,donation,8,145,2,6,0.32
8,2,download,8,146,2,6,0.28
8,2,drama,5,147,1,4,0.2
8,2,drawing,7,148,3,4,0.32
8,2,duration,8,149,1,7,0.32
8,2,earnings,8,150,0,8,0.36
8,2,earth,5,151,3,2,0.16
8,2,editor,6,152,1,5,0.32
8,2,eight,5,153,1,4,0.24
8,2,eighty,6,154,5,1,0.16
8,2,either,6,155,2,4,0.28
8,2,elect,5,156,1,4,0.24
8,2,embody,6,157,1,5,0.32
8,2,employer,8,158,2,6,0.28
8,2,empower,7,159,3,4,0.24
8,2,ending,6,160,1,5,0.24
8,2,endless,7,161,3,4,0.32
8,2,engineer,8,162,2,6,0.32
8,2,enrich,6,163,2,4,0.2
8,2,enter,5,164,2,3,0.2
8,2,entitle,7,165,3,4,0.32
8,2,equality,8,166,1,7,0.32
8,2,essay,5,167,1,4,0.2
8,2,evening,7,168,1,6,0.28
8,2,evidence,8,169,2,6,0.36
8,2,evoke,5,170,2,3,0.2
8,2,exact,5,171,1,4,0.2
8,2,examine,7,172,3,4,0.24
8,2,exceed,6,173,2,4,0.28
8,2,exciting,8,174,3,5,0.28
8,2,excuse,6,175,3,3,0.2
8,2,exploit,7,176,2,5,0.24
8,2,faculty,7,177,0,7,0.4
8,2,fairly,6,178,2,4,0.24
8,2,famous,6,179,2,4,0.2
8,2,fantasy,7,180,2,5,0.28
8,2,fast,4,181,2,2,0.2
8,2,fat,3,182,2,1,0.08
8,2,fear,4,183,1,3,0.16
8,2,fee,3,184,2,1,0.08
8,2,feeding,7,185,3,4,0.24
8,2,few,3,186,2,1,0.08
8,2,fifty,5,187,1,4,0.28
8,2,fight,5,188,2,3,0.2
8,2,finally,7,189,2,5,0.28
8,2,fine,4,190,3,1,0.12
8,2,firm,4,191,2,2,0.16
8,2,fixture,7,192,2,5,0.36
8,2,flag,4,193,1,3,0.16
8,2,flat,4,194,3,1,0.12
8,2,floor,5,195,2,3,0.16
8,2,flower,6,196,3,3,0.2
8,2,flu,3,197,2,1,0.08
8,2,flying,6,198,2,4,0.28
8,2,food,4,199,1,3,0.16
8,2,for,3,200,2,1,0.08
8,2,foreign,7,201,3,4,0.24
8,2,former,6,202,3,3,0.2
8,2,formerly,8,203,6,2,0.28
8,2,formula,7,204,4,3,0.2
8,2,forward,7,205,3,4,0.24
8,2,founder,7,206,2,5,0.28
8,2,fragment,8,207,1,7,0.4
8,2,freedom,7,208,2,5,0.28
8,2,frequent,8,209,3,5,0.28
8,2,friday,6,210,2,4,0.2
8,2,fridge,6,211,4,2,0.24
8,2,friendly,8,212,3,5,0.44
8,2,frighten,8,213,3,5,0.8
8,2,fur,3,214,1,2,0.32
8,2,gaming,6,215,0,6,0.76
8,2,garage,6,216,2,4,0.52
8,2,gender,6,217,1,5,0.56
8,2,generate,8,218,3,5,0.64
8,2,genetic,7,219,4,3,0.6
8,2,genre,5,220,3,2,0.36
8,2,giant,5,221,1,4,0.48
8,2,give,4,222,2,2,0.32
8,2,glass,5,223,1,4,0.48
8,2,glimpse,7,224,2,5,0.72
8,2,go,2,225,1,1,0.2
8,2,god,3,226,2,1,0.24
8,2,gold,4,227,2,2,0.32
8,2,good,4,228,2,2,0.36
8,2,goodbye,7,229,4,3,0.52
8,2,govern,6,230,2,4,0.64
8,2,grace,5,231,1,4,0.48
8,2,gravity,7,232,3,4,0.56
8,2,green,5,233,2,3,0.44
8,2,greet,5,234,4,1,0.32
8,2,grey,4,235,3,1,0.36
8,2,grid,4,236,2,2,0.32
8,2,grind,5,237,3,2,0.36
8,2,ground,6,238,2,4,0.52
8,2,growth,6,239,3,3,0.56
8,2,guest,5,240,1,4,0.64
8,2,guitar,6,241,2,4,0.52
8,2,handy,5,242,0,5,0.52
8,2,harm,4,243,2,2,0.4
8,2,heighten,8,244,1,7,0.84
8,2,her,3,245,2,1,0.32
8,2,herb,4,246,3,1,0.28
8,2,historic,8,247,1,7,0.88
8,2,homeland,8,248,1,7,0.88
8,2,honesty,7,249,2,5,0.8
8,2,horrible,8,250,2,6,0.76
8,2,horror,6,251,4,2,0.44
8,2,hotel,5,252,2,3,0.44
8,2,hunt,4,253,1,3,0.4
8,2,icon,4,254,0,4,0.56
8,2,ideal,5,255,1,4,0.48
8,2,identity,8,256,3,5,0.64
8,2,imagery,7,257,1,6,0.68
8,2,improve,7,258,2,5,0.72
8,2,incur,5,259,1,4,0.48
8,2,info,4,260,2,2,0.32
8,2,inform,6,261,4,2,0.4
8,2,informal,8,262,6,2,0.6
8,2,initiate,8,263,2,6,0.76
8,2,inspect,7,264,2,5,0.72
8,2,instruct,8,265,3,5,0.72
8,2,intake,6,266,2,4,0.64
8,2,intended,8,267,3,5,1.04
8,2,intense,7,268,5,2,0.48
8,2,interior,8,269,4,4,0.64
8,2,invade,6,270,2,4,0.64
8,2,involve,7,271,3,4,0.56
8,2,involved,8,272,7,1,0.44
8,2,iron,4,273,1,3,0.4
8,2,island,6,274,1,5,0.68
8,2,january,7,275,0,7,0.72
8,2,joy,3,276,1,2,0.28
8,2,jump,4,277,1,3,0.36
8,2,june,4,278,2,2,0.32
8,2,just,4,279,2,2,0.32
8,2,kid,3,280,0,3,0.44
8,2,kidney,6,281,3,3,0.56
8,2,king,4,282,2,2,0.4
8,2,kingdom,7,283,4,3,0.64
8,2,know,4,284,1,3,0.48
8,2,lad,3,285,0,3,0.4
8,2,landmark,8,286,2,6,0.84
8,2,laser,5,287,2,3,0.44
8,2,laugh,5,288,2,3,0.48
8,2,lawn,4,289,2,2,0.36
8,2,leading,7,290,1,6,0.8
8,2,leaf,4,291,3,1,0.28
8,2,leaflet,7,292,4,3,0.52
8,2,legend,6,293,2,4,0.52
8,2,lemon,5,294,2,3,0.44
8,2,lesbian,7,295,2,5,0.72
8,2,lesser,6,296,3,3,0.48
8,2,letter,6,297,2,4,0.52
8,2,litter,6,298,1,5,0.56
8,2,little,6,299,4,2,0.52
8,2,live,4,300,2,2,0.36
8,2,liver,5,301,4,1,0.36
8,2,load,4,302,1,3,0.4
8,2,log,3,303,2,1,0.28
8,2,lonely,6,304,2,4,0.6
8,2,long,4,305,3,1,0.4
8,2,lot,3,306,2,1,0.24
8,2,loudly,6,307,2,4,0.56
8,2,love,4,308,2,2,0.36
8,2,lunch,5,309,1,4,0.48
8,2,mail,4,310,0,4,0.44
8,2,mainland,8,311,3,5,0.76
8,2,map,3,312,2,1,0.24
8,2,marine,6,313,2,4,0.52
8,2,mark,4,314,3,1,0.28
8,2,married,7,315,3,4,0.56
8,2,mask,4,316,2,2,0.44
8,2,master,6,317,3,3,0.48
8,2,match,5,318,2,3,0.44
8,2,mean,4,319,1,3,0.36
8,2,melody,6,320,2,4,0.52
8,2,memory,6,321,2,4,0.64
8,2,mental,6,322,2,4,0.52
8,2,mention,7,323,4,3,0.48
8,2,mentor,6,324,4,2,0.4
8,2,mess,4,325,2,2,0.32
8,2,message,7,326,4,3,0.6
8,2,metre,5,327,2,3,0.4
8,2,mirror,6,328,1,5,0.56
8,2,missing,7,329,2,5,0.6
8,2,mobilize,8,330,1,7,0.88
8,2,model,5,331,2,3,0.44
8,2,money,5,332,2,3,0.44
8,2,month,5,333,3,2,0.36
8,2,monument,8,334,3,5,0.76
8,2,most,4,335,2,2,0.32
8,2,mum,3,336,1,2,0.28
8,2,museum,6,337,2,4,0.52
8,2,my,2,338,1,1,0.2
8,2,naked,5,339,0,5,0.56
8,2,name,4,340,2,2,0.44
8,2,nasty,5,341,2,3,0.44
8,2,neck,4,342,1,3,0.36
8,2,negative,8,343,2,6,0.68
8,2,newly,5,344,2,3,0.48
8,2,noisy,5,345,1,4,0.64
8,2,nominate,8,346,2,6,0.72
8,2,non,3,347,2,1,0.24
8,2,normal,6,348,2,4,0.52
8,2,note,4,349,2,2,0.32
8,2,notice,6,350,3,3,0.6
8,2,notion,6,351,4,2,0.4
8,2,novel,5,352,2,3,0.44
8,2,nut,3,353,1,2,0.28
8,2,offence,7,354,0,7,0.76
8,2,offend,6,355,5,1,0.52
8,2,once,4,356,1,3,0.36
8,2,online,6,357,2,4,0.52
8,2,opponent,8,358,1,7,0.76
8,2,organic,7,359,1,6,0.76
8,2,outdoors,8,360,1,7,0.76
8,2,outfit,6,361,3,3,0.48
8,2,outing,6,362,3,3,0.44
8,2,outlet,6,363,3,3,0.52
8,2,overall,7,364,1,6,0.8
8,2,palace,6,365,0,6,0.64
8,2,pants,5,366,2,3,0.44
8,2,parade,6,367,2,4,0.52
8,2,parallel,8,368,4,4,0.72
8,2,partial,7,369,3,4,0.56
8,2,partner,7,370,4,3,0.52
8,2,password,8,371,2,6,0.84
8,2,patent,6,372,2,4,0.52
8,2,patron,6,373,3,3,0.44
8,2,pepper,6,374,1,5,0.56
8,2,perceive,8,375,2,6,0.72
8,2,pick,4,376,1,3,0.52
8,2,piece,5,377,2,3,0.44
8,2,pig,3,378,2,1,0.24
8,2,pile,4,379,2,2,0.32
8,2,pin,3,380,2,1,0.24
8,2,pioneer,7,381,2,5,0.72
8,2,plan,4,382,1,3,0.4
8,2,plane,5,383,4,1,0.32
8,2,planning,8,384,4,4,0.72
8,2,plant,5,385,4,1,0.36
8,2,plastic,7,386,3,4,0.76
8,2,play,4,387,3,1,0.28
8,2,pleased,7,388,2,5,0.64
8,2,point,5,389,1,4,0.56
8,2,police,6,390,2,4,0.56
8,2,position,8,391,2,6,0.84
8,2,possess,7,392,3,4,0.68
8,2,possible,8,393,4,4,0.6
8,2,post,4,394,3,1,0.28
8,2,poster,6,395,4,2,0.52
8,2,praise,6,396,1,5,0.64
8,2,prayer,6,397,3,3,0.48
8,2,precise,7,398,2,5,0.68
8,2,predict,7,399,3,4,0.76
8,2,pregnant,8,400,3,5,0.68
8,2,premier,7,401,3,4,0.6
8,2,premise,7,402,5,2,0.48
8,2,presence,8,403,3,5,0.8
8,2,prior,5,404,2,3,0.44
8,2,produce,7,405,2,5,0.64
8,2,profound,8,406,3,5,0.68
8,2,program,7,407,3,4,0.68
8,2,project,7,408,3,4,0.56
8,2,proof,5,409,3,2,0.36
8,2,proper,6,410,3,3,0.44
8,2,protest,7,411,3,4,0.56
8,2,pump,4,412,1,3,0.48
8,2,pupil,5,413,2,3,0.44
8,2,pure,4,414,2,2,0.32
8,2,pursuit,7,415,3,4,0.56
8,2,quest,5,416,0,5,0.52
8,2,radar,5,417,0,5,0.64
8,2,rail,4,418,2,2,0.32
8,2,railway,7,419,4,3,0.52
8,2,rather,6,420,2,4,0.56
8,2,rating,6,421,3,3,0.64
8,2,react,5,422,1,4,0.52
8,2,realm,5,423,3,2,0.36
8,2,recount,7,424,2,5,0.64
8,2,refer,5,425,2,3,0.44
8,2,regard,6,426,2,4,0.68
8,2,regime,6,427,3,3,0.48
8,2,region,6,428,4,2,0.4
8,2,reign,5,429,2,3,0.44
8,2,relief,6,430,2,4,0.52
8,2,relieved,8,431,5,3,0.68
8,2,remark,6,432,2,4,0.52
8,2,repeat,6,433,2,4,0.52
8,2,republic,8,434,3,5,0.68
8,2,research,8,435,2,6,0.8
8,2,reside,6,436,3,3,0.48
8,2,resolve,7,437,3,4,0.6
8,2,retire,6,438,2,4,0.6
8,2,reveal,6,439,2,4,0.68
8,2,revise,6,440,3,3,0.48
8,2,revival,7,441,4,3,0.48
8,2,revive,6,442,5,1,0.36
8,2,right,5,443,1,4,0.56
8,2,rise,4,444,2,2,0.32
8,2,ritual,6,445,2,4,0.4
8,2,rival,5,446,2,3,0.24
8,2,road,4,447,1,3,0.2
8,2,rotate,6,448,2,4,0.24
8,2,round,5,449,2,3,0.24
8,2,rub,3,450,1,2,0.12
8,2,rubber,6,451,3,3,0.2
8,2,sailor,6,452,0,6,0.28
8,2,sale,4,453,2,2,0.16
8,2,salt,4,454,3,1,0.16
8,2,sand,4,455,2,2,0.16
8,2,scared,6,456,1,5,0.24
8,2,schedule,8,457,2,6,0.32
8,2,scheme,6,458,4,2,0.16
8,2,school,6,459,3,3,0.28
8,2,score,5,460,2,3,0.2
8,2,secret,6,461,1,5,0.24
8,2,seeker,6,462,2,4,0.24
8,2,seminar,7,463,2,5,0.32
8,2,sensible,8,464,2,6,0.32
8,2,serious,7,465,2,5,0.28
8,2,servant,7,466,3,4,0.24
8,2,serve,5,467,4,1,0.2
8,2,service,7,468,4,3,0.28
8,2,settler,7,469,2,5,0.32
8,2,severely,8,470,2,6,0.32
8,2,sexual,6,471,2,4,0.32
8,2,sexy,4,472,3,1,0.12
8,2,sheer,5,473,1,4,0.2
8,2,shift,5,474,2,3,0.16
8,2,shopping,8,475,2,6,0.32
8,2,sibling,7,476,1,6,0.36
8,2,sight,5,477,2,3,0.2
8,2,silver,6,478,2,4,0.24
8,2,simply,6,479,2,4,0.24
8,2,singing,7,480,2,5,0.32
8,2,sister,6,481,2,4,0.24
8,2,sit,3,482,2,1,0.08
8,2,situated,8,483,3,5,0.28
8,2,six,3,484,2,1,0.08
8,2,skip,4,485,1,3,0.24
8,2,skull,5,486,2,3,0.16
8,2,slam,4,487,1,3,0.16
8,2,slice,5,488,2,3,0.2
8,2,smile,5,489,1,4,0.2
8,2,snow,4,490,1,3,0.16
8,2,soap,4,491,1,3,0.24
8,2,solar,5,492,2,3,0.2
8,2,solid,5,493,3,2,0.16
8,2,some,4,494,2,2,0.16
8,2,someone,7,495,4,3,0.2
8,2,song,4,496,2,2,0.2
8,2,soup,4,497,2,2,0.16
8,2,speak,5,498,1,4,0.24
8,2,special,7,499,3,4,0.28
8,2,specify,7,500,5,2,0.2
8,2,speech,6,501,3,3,0.28
8,2,spin,4,502,2,2,0.12
8,2,spine,5,503,4,1,0.12
8,2,stab,4,504,1,3,0.16
8,2,stable,6,505,4,2,0.2
8,2,staff,5,506,3,2,0.24
8,2,stall,5,507,3,2,0.16
8,2,stance,6,508,3,3,0.2
8,2,stand,5,509,4,1,0.12
8,2,standing,8,510,5,3,0.24
8,2,star,4,511,3,1,0.16
8,2,statue,6,512,3,3,0.2
8,2,stay,4,513,3,1,0.12
8,2,steer,5,514,2,3,0.2
8,2,stick,5,515,2,3,0.2
8,2,straight,8,516,2,6,0.36
8,2,strange,7,517,4,3,0.24
8,2,street,6,518,3,3,0.2
8,2,stretch,7,519,4,3,0.2
8,2,strict,6,520,3,3,0.2
8,2,string,6,521,4,2,0.24
8,2,super,5,522,1,4,0.2
8,2,supreme,7,523,3,4,0.24
8,2,sure,4,524,2,2,0.12
8,2,surely,6,525,4,2,0.24
8,2,surgical,8,526,3,5,0.28
8,2,survival,8,527,3,5,0.28
8,2,sweater,7,528,1,6,0.28
8,2,symbolic,8,529,1,7,0.4
8,2,table,5,530,0,5,0.24
8,2,talent,6,531,2,4,0.24
8,2,talk,4,532,3,1,0.12
8,2,tank,4,533,2,2,0.16
8,2,tap,3,534,2,1,0.16
8,2,tape,4,535,3,1,0.12
8,2,taste,5,536,2,3,0.2
8,2,taxi,4,537,2,2,0.16
8,2,tea,3,538,1,2,0.12
8,2,team,4,539,3,1,0.12
8,2,tempt,5,540,2,3,0.2
8,2,tendency,8,541,2,6,0.36
8,2,tender,6,542,5,1,0.16
8,2,terrific,8,543,2,6,0.32
8,2,thirsty,7,544,1,6,0.36
8,2,thorough,8,545,2,6,0.32
8,2,three,5,546,2,3,0.2
8,2,thumb,5,547,2,3,0.16
8,2,tighten,7,548,1,6,0.28
8,2,till,4,549,2,2,0.2
8,2,tonne,5,550,1,4,0.2
8,2,too,3,551,2,1,0.08
8,2,tragic,6,552,1,5,0.24
8,2,trainer,7,553,3,4,0.24
8,2,trap,4,554,3,1,0.2
8,2,treasure,8,555,2,6,0.32
8,2,treat,5,556,4,1,0.16
8,2,tree,4,557,3,1,0.12
8,2,tribal,6,558,2,4,0.24
8,2,tropical,8,559,2,6,0.36
8,2,trouble,7,560,3,4,0.24
8,2,truck,5,561,2,3,0.2
8,2,two,3,562,1,2,0.12
8,2,ultimate,8,563,0,8,0.44
8,2,unable,6,564,1,5,0.24
8,2,union,5,565,2,3,0.2
8,2,universe,8,566,3,5,0.28
8,2,upgrade,7,567,1,6,0.56
8,2,uphold,6,568,2,4,0.36
8,2,upon,4,569,2,2,0.12
8,2,urgent,6,570,1,5,0.24
8,2,usage,5,571,1,4,0.2
8,2,usual,5,572,2,3,0.24
8,2,utility,7,573,1,6,0.28
8,2,vague,5,574,0,5,0.24
8,2,valuable,8,575,2,6,0.32
8,2,veteran,7,576,1,6,0.36
8,2,viable,6,577,1,5,0.24
8,2,video,5,578,2,3,0.2
8,2,virtual,7,579,2,5,0.24
8,2,visitor,7,580,2,5,0.36
8,2,visual,6,581,3,3,0.2
8,2,vital,5,582,2,3,0.2
8,2,vocal,5,583,1,4,0.2
8,2,wake,4,584,0,4,0.2
8,2,war,3,585,2,1,0.16
8,2,warning,7,586,3,4,0.24
8,2,washing,7,587,2,5,0.24
8,2,watch,5,588,2,3,0.16
8,2,water,5,589,3,2,0.16
8,2,weave,5,590,1,4,0.28
8,2,whatever,8,591,1,7,0.32
8,2,whenever,8,592,2,6,0.28
8,2,whereas,7,593,3,4,0.24
8,2,which,5,594,2,3,0.24
8,2,whose,5,595,2,3,0.16
8,2,width,5,596,1,4,0.2
8,2,wildlife,8,597,2,6,0.28
8,2,willing,7,598,3,4,0.32
8,2,win,3,599,2,1,0.08
8,2,wind,4,600,3,1,0.12
8,2,wine,4,601,3,1,0.12
8,2,wipe,4,602,2,2,0.16
8,2,wisdom,6,603,2,4,0.28
8,2,within,6,604,2,4,0.28
8,2,without,7,605,4,3,0.2
8,2,woman,5,606,1,4,0.2
8,2,word,4,607,2,2,0.16
8,2,wrap,4,608,1,3,0.16
8,2,wrist,5,609,2,3,0.24
8,2,yellow,6,610,0,6,0.28
8,2,young,5,611,1,4,0.2
8,3,a,1,0,0,1,0.08
8,3,accept,6,1,1,5,0.24
8,3,actress,7,2,2,5,0.32
8,3,add,3,3,1,2,0.12
8,3,adj,3,4,2,1,0.08
8,3,admit,5,5,2,3,0.16
8,3,adopt,5,6,2,3,0.2
8,3,against,7,7,1,6,0.28
8,3,ahead,5,8,1,4,0.28
8,3,ally,4,9,1,3,0.16
8,3,analyse,7,10,1,6,0.28
8,3,analysis,8,11,6,2,0.2
8,3,ancient,7,12,2,5,0.32
8,3,anger,5,13,2,3,0.2
8,3,ankle,5,14,2,3,0.24
8,3,announce,8,15,2,6,0.36
8,3,annoyed,7,16,4,3,0.32
8,3,another,7,17,2,5,0.28
8,3,anyway,6,18,2,4,0.2
8,3,apology,7,19,1,6,0.28
8,3,approve,7,20,2,5,0.32
8,3,army,4,21,1,3,0.16
8,3,arrow,5,22,2,3,0.16
8,3,artistic,8,23,2,6,0.28
8,3,assault,7,24,1,6,0.28
8,3,at,2,25,1,1,0.16
8,3,attract,7,26,2,5,0.28
8,3,auto,4,27,1,3,0.16
8,3,average,7,28,1,6,0.28
8,3,baby,4,29,0,4,0.2
8,3,bacteria,8,30,2,6,0.4
8,3,banner,6,31,2,4,0.24
8,3,barrel,6,32,2,4,0.2
8,3,belief,6,33,1,5,0.24
8,3,bell,4,34,3,1,0.2
8,3,best,4,35,2,2,0.16
8,3,betray,6,36,2,4,0.2
8,3,biscuit,7,37,1,6,0.28
8,3,bite,4,38,2,2,0.12
8,3,blame,5,39,1,4,0.28
8,3,bless,5,40,2,3,0.2
8,3,blind,5,41,2,3,0.2
8,3,blog,4,42,2,2,0.12
8,3,blow,4,43,3,1,0.12
8,3,boat,4,44,1,3,0.16
8,3,boil,4,45,2,2,0.2
8,3,boom,4,46,2,2,0.16
8,3,boost,5,47,3,2,0.16
8,3,boot,4,48,3,1,0.12
8,3,bottle,6,49,2,4,0.2
8,3,bound,5,50,2,3,0.24
8,3,boundary,8,51,5,3,0.24
8,3,box,3,52,2,1,0.08
8,3,brand,5,53,1,4,0.2
8,3,breach,6,54,2,4,0.24
8,3,break,5,55,4,1,0.2
8,3,breathe,7,56,4,3,0.2
8,3,bride,5,57,2,3,0.2
8,3,build,5,58,1,4,0.2
8,3,business,8,59,2,6,0.28
8,3,cafe,4,60,0,4,0.28
8,3,card,4,61,2,2,0.12
8,3,career,6,62,3,3,0.2
8,3,careful,7,63,4,3,0.2
8,3,carpet,6,64,3,3,0.24
8,3,carve,5,65,3,2,0.24
8,3,cave,4,66,2,2,0.16
8,3,ceiling,7,67,1,6,0.28
8,3,cemetery,8,68,2,6,0.32
8,3,central,7,69,2,5,0.36
8,3,century,7,70,4,3,0.2
8,3,chart,5,71,1,4,0.2
8,3,charter,7,72,5,2,0.24
8,3,cheerful,8,73,2,6,0.36
8,3,chemical,8,74,3,5,0.28
8,3,chronic,7,75,2,5,0.28
8,3,chunk,5,76,2,3,0.2
8,3,circle,6,77,1,5,0.32
8,3,clause,6,78,1,5,0.24
8,3,clerk,5,79,2,3,0.2
8,3,clinical,8,80,2,6,0.32
8,3,cloud,5,81,2,3,0.2
8,3,cluster,7,82,2,5,0.32
8,3,colony,6,83,1,5,0.24
8,3,comedy,6,84,2,4,0.2
8,3,comfort,7,85,3,4,0.24
8,3,commonly,8,86,3,5,0.36
8,3,compete,7,87,3,4,0.24
8,3,concept,7,88,2,5,0.24
8,3,concern,7,89,5,2,0.28
8,3,confess,7,90,3,4,0.24
8,3,consent,7,91,3,4,0.24
8,3,consult,7,92,4,3,0.2
8,3,contempt,8,93,3,5,0.36
8,3,cope,4,94,2,2,0.12
8,3,correct,7,95,2,5,0.28
8,3,cottage,7,96,2,5,0.24
8,3,could,5,97,2,3,0.16
8,3,county,6,98,3,3,0.28
8,3,couple,6,99,3,3,0.2
8,3,course,6,100,3,3,0.2
8,3,create,6,101,1,5,0.4
8,3,creature,8,102,5,3,0.76
8,3,crime,5,103,2,3,0.4
8,3,criminal,8,104,4,4,0.4
8,3,cross,5,105,2,3,0.24
8,3,crowd,5,106,3,2,0.16
8,3,cruel,5,107,2,3,0.24
8,3,cry,3,108,2,1,0.12
8,3,currency,8,109,1,7,0.32
8,3,cycle,5,110,1,4,0.2
8,3,dam,3,111,0,3,0.16
8,3,damage,6,112,3,3,0.28
8,3,dance,5,113,2,3,0.2
8,3,dare,4,114,2,2,0.16
8,3,day,3,115,2,1,0.08
8,3,deal,4,116,1,3,0.16
8,3,death,5,117,3,2,0.16
8,3,declare,7,118,2,5,0.36
8,3,decline,7,119,4,3,0.24
8,3,deed,4,120,2,2,0.16
8,3,default,7,121,2,5,0.32
8,3,defect,6,122,3,3,0.28
8,3,dentist,7,123,2,5,0.28
8,3,deposit,7,124,2,5,0.28
8,3,deputy,6,125,3,3,0.2
8,3,desktop,7,126,2,5,0.32
8,3,detect,6,127,2,4,0.2
8,3,develop,7,128,2,5,0.28
8,3,devil,5,129,3,2,0.16
8,3,diagram,7,130,1,6,0.36
8,3,digital,7,131,2,5,0.28
8,3,dinner,6,132,2,4,0.2
8,3,director,8,133,2,6,0.32
8,3,disabled,8,134,2,6,0.4
8,3,discount,8,135,3,5,0.32
8,3,discuss,7,136,4,3,0.2
8,3,display,7,137,3,4,0.24
8,3,divine,6,138,2,4,0.36
8,3,dollar,6,139,1,5,0.24
8,3,drama,5,140,1,4,0.2
8,3,drawing,7,141,3,4,0.24
8,3,earth,5,142,0,5,0.24
8,3,edit,4,143,1,3,0.24
8,3,eight,5,144,1,4,0.2
8,3,eighty,6,145,5,1,0.16
8,3,either,6,146,2,4,0.24
8,3,elect,5,147,1,4,0.2
8,3,embark,6,148,1,5,0.32
8,3,emission,8,149,2,6,0.32
8,3,empower,7,150,2,5,0.24
8,3,enable,6,151,1,5,0.32
8,3,ending,6,152,2,4,0.24
8,3,enemy,5,153,2,3,0.16
8,3,enjoy,5,154,2,3,0.16
8,3,enormous,8,155,2,6,0.32
8,3,entrance,8,156,2,6,0.36
8,3,erect,5,157,1,4,0.2
8,3,evidence,8,158,1,7,0.36
8,3,exceed,6,159,1,5,0.28
8,3,excited,7,160,3,4,0.32
8,3,exciting,8,161,5,3,0.24
8,3,excuse,6,162,3,3,0.2
8,3,exit,4,163,2,2,0.12
8,3,expire,6,164,2,4,0.28
8,3,exploit,7,165,3,4,0.24
8,3,extend,6,166,2,4,0.24
8,3,fairly,6,167,0,6,0.28
8,3,fall,4,168,2,2,0.12
8,3,famous,6,169,2,4,0.28
8,3,fast,4,170,2,2,0.12
8,3,fasten,6,171,4,2,0.2
8,3,fear,4,172,1,3,0.16
8,3,feeding,7,173,2,5,0.28
8,3,fellow,6,174,2,4,0.28
8,3,few,3,175,2,1,0.12
8,3,fiction,7,176,1,6,0.28
8,3,fifty,5,177,2,3,0.2
8,3,firm,4,178,2,2,0.12
8,3,fixed,5,179,2,3,0.24
8,3,fixture,7,180,3,4,0.24
8,3,floor,5,181,1,4,0.2
8,3,flying,6,182,2,4,0.24
8,3,focus,5,183,1,4,0.28
8,3,folding,7,184,2,5,0.28
8,3,food,4,185,2,2,0.12
8,3,for,3,186,2,1,0.08
8,3,force,5,187,3,2,0.16
8,3,former,6,188,3,3,0.2
8,3,formerly,8,189,6,2,0.28
8,3,formula,7,190,4,3,0.2
8,3,forward,7,191,3,4,0.24
8,3,friday,6,192,1,5,0.24
8,3,fridge,6,193,4,2,0.24
8,3,front,5,194,2,3,0.16
8,3,fulfil,6,195,1,5,0.24
8,3,full,4,196,3,1,0.12
8,3,funding,7,197,2,5,0.24
8,3,fur,3,198,2,1,0.2
8,3,gender,6,199,0,6,0.28
8,3,gene,4,200,3,1,0.12
8,3,generate,8,201,4,4,0.28
8,3,genetic,7,202,4,3,0.28
8,3,genre,5,203,3,2,0.16
8,3,giant,5,204,1,4,0.24
8,3,glass,5,205,1,4,0.24
8,3,glimpse,7,206,2,5,0.32
8,3,globe,5,207,2,3,0.28
8,3,go,2,208,1,1,0.08
8,3,gold,4,209,2,2,0.12
8,3,golf,4,210,3,1,0.12
8,3,goodbye,7,211,2,5,0.28
8,3,govern,6,212,2,4,0.2
8,3,grace,5,213,1,4,0.28
8,3,graphics,8,214,3,5,0.28
8,3,gravity,7,215,3,4,0.24
8,3,greet,5,216,2,3,0.2
8,3,ground,6,217,2,4,0.28
8,3,guest,5,218,1,4,0.2
8,3,guidance,8,219,2,6,0.28
8,3,guitar,6,220,3,3,0.2
8,3,hair,4,221,0,4,0.2
8,3,handful,7,222,2,5,0.32
8,3,happen,6,223,2,4,0.24
8,3,harm,4,224,2,2,0.16
8,3,harsh,5,225,3,2,0.16
8,3,harvest,7,226,3,4,0.32
8,3,hazard,6,227,2,4,0.2
8,3,headline,8,228,1,7,0.32
8,3,heat,4,229,3,1,0.12
8,3,heighten,8,230,2,6,0.36
8,3,hint,4,231,1,3,0.16
8,3,historic,8,232,2,6,0.32
8,3,homeland,8,233,1,7,0.36
8,3,honesty,7,234,2,5,0.36
8,3,horror,6,235,2,4,0.24
8,3,hotel,5,236,2,3,0.2
8,3,how,3,237,2,1,0.08
8,3,however,7,238,3,4,0.24
8,3,humour,6,239,1,5,0.32
8,3,hunger,6,240,2,4,0.2
8,3,hydrogen,8,241,1,7,0.32
8,3,i,1,242,0,1,0.08
8,3,ice,3,243,1,2,0.12
8,3,icon,4,244,2,2,0.12
8,3,ideal,5,245,1,4,0.28
8,3,ill,3,246,1,2,0.12
8,3,imagery,7,247,1,6,0.28
8,3,import,6,248,2,4,0.2
8,3,improve,7,249,3,4,0.32
8,3,include,7,250,1,6,0.28
8,3,incur,5,251,3,2,0.16
8,3,index,5,252,2,3,0.2
8,3,indirect,8,253,3,5,0.36
8,3,infant,6,254,2,4,0.24
8,3,inform,6,255,3,3,0.2
8,3,inject,6,256,2,4,0.2
8,3,injure,6,257,3,3,0.2
8,3,insert,6,258,2,4,0.28
8,3,instant,7,259,3,4,0.24
8,3,intake,6,260,2,4,0.2
8,3,integral,8,261,3,5,0.28
8,3,iron,4,262,1,3,0.24
8,3,island,6,263,1,5,0.24
8,3,isolated,8,264,2,6,0.32
8,3,january,7,265,0,7,0.32
8,3,june,4,266,1,3,0.24
8,3,justify,7,267,2,5,0.28
8,3,key,3,268,0,3,0.16
8,3,keyboard,8,269,3,5,0.28
8,3,knife,5,270,1,4,0.2
8,3,landmark,8,271,0,8,0.44
8,3,lap,3,272,2,1,0.08
8,3,laser,5,273,2,3,0.32
8,3,last,4,274,3,1,0.12
8,3,laugh,5,275,2,3,0.2
8,3,law,3,276,2,1,0.16
8,3,lawn,4,277,3,1,0.12
8,3,layer,5,278,2,3,0.16
8,3,leading,7,279,1,6,0.28
8,3,leaflet,7,280,3,4,0.24
8,3,league,6,281,3,3,0.28
8,3,learning,8,282,3,5,0.28
8,3,legend,6,283,2,4,0.24
8,3,lemon,5,284,2,3,0.2
8,3,lesbian,7,285,2,5,0.32
8,3,lesser,6,286,3,3,0.2
8,3,letter,6,287,2,4,0.2
8,3,license,7,288,1,6,0.28
8,3,lie,3,289,2,1,0.08
8,3,link,4,290,2,2,0.2
8,3,lion,4,291,2,2,0.12
8,3,little,6,292,2,4,0.24
8,3,live,4,293,2,2,0.12
8,3,liver,5,294,4,1,0.12
8,3,load,4,295,1,3,0.16
8,3,local,5,296,2,3,0.28
8,3,log,3,297,2,1,0.08
8,3,lot,3,298,2,1,0.08
8,3,loudly,6,299,2,4,0.24
8,3,low,3,300,2,1,0.08
8,3,lunch,5,301,1,4,0.2
8,3,mainland,8,302,0,8,0.44
8,3,marine,6,303,2,4,0.24
8,3,mark,4,304,3,1,0.12
8,3,mask,4,305,2,2,0.16
8,3,master,6,306,3,3,0.2
8,3,match,5,307,2,3,0.28
8,3,maximum,7,308,2,5,0.28
8,3,mean,4,309,1,3,0.16
8,3,media,5,310,2,3,0.16
8,3,meeting,7,311,2,5,0.32
8,3,melody,6,312,2,4,0.24
8,3,memory,6,313,2,4,0.2
8,3,mental,6,314,2,4,0.24
8,3,merely,6,315,2,4,0.24
8,3,merger,6,316,3,3,0.28
8,3,mind,4,317,1,3,0.16
8,3,ministry,8,318,3,5,0.28
8,3,mirror,6,319,2,4,0.2
8,3,missing,7,320,2,5,0.36
8,3,mixed,5,321,2,3,0.2
8,3,model,5,322,1,4,0.2
8,3,modify,6,323,3,3,0.2
8,3,moment,6,324,2,4,0.2
8,3,monthly,7,325,2,5,0.36
8,3,monument,8,326,3,5,0.28
8,3,mother,6,327,2,4,0.2
8,3,mouth,5,328,2,3,0.16
8,3,mum,3,329,1,2,0.2
8,3,musician,8,330,2,6,0.32
8,3,must,4,331,3,1,0.12
8,3,nation,6,332,0,6,0.28
8,3,nature,6,333,3,3,0.2
8,3,neck,4,334,1,3,0.24
8,3,negative,8,335,2,6,0.4
8,3,neutral,7,336,2,5,0.6
8,3,night,5,337,1,4,0.48
8,3,noise,5,338,1,4,0.6
8,3,noisy,5,339,4,1,0.32
8,3,nominate,8,340,2,6,0.68
8,3,norm,4,341,2,2,0.32
8,3,normal,6,342,4,2,0.4
8,3,not,3,343,2,1,0.36
8,3,nothing,7,344,3,4,0.56
8,3,novel,5,345,2,3,0.4
8,3,nut,3,346,1,2,0.28
8,3,obsess,6,347,0,6,0.64
8,3,ocean,5,348,1,4,0.6
8,3,october,7,349,2,5,0.6
8,3,official,8,350,1,7,0.84
8,3,once,4,351,1,3,0.44
8,3,one,3,352,2,1,0.28
8,3,opposed,7,353,1,6,0.84
8,3,option,6,354,2,4,0.52
8,3,organic,7,355,1,6,0.72
8,3,outbreak,8,356,1,7,0.84
8,3,outdoor,7,357,3,4,0.72
8,3,outfit,6,358,3,3,0.52
8,3,pack,4,359,0,4,0.48
8,3,page,4,360,2,2,0.36
8,3,painful,7,361,2,5,0.8
8,3,pants,5,362,2,3,0.44
8,3,parade,6,363,2,4,0.56
8,3,passport,8,364,2,6,0.76
8,3,patent,6,365,2,4,0.52
8,3,patience,8,366,3,5,0.8
8,3,pause,5,367,2,3,0.44
8,3,peace,5,368,1,4,0.48
8,3,peculiar,8,369,2,6,0.72
8,3,peer,4,370,2,2,0.44
8,3,pepper,6,371,2,4,0.52
8,3,perfect,7,372,2,5,0.64
8,3,pick,4,373,1,3,0.36
8,3,pipe,4,374,2,2,0.32
8,3,plan,4,375,1,3,0.48
8,3,plane,5,376,4,1,0.32
8,3,plot,4,377,2,2,0.32
8,3,point,5,378,1,4,0.48
8,3,position,8,379,2,6,0.72
8,3,possess,7,380,3,4,0.68
8,3,post,4,381,3,1,0.28
8,3,pot,3,382,2,1,0.24
8,3,praise,6,383,1,5,0.6
8,3,prayer,6,384,3,3,0.48
8,3,pregnant,8,385,2,6,0.84
8,3,premier,7,386,3,4,0.56
8,3,premise,7,387,5,2,0.44
8,3,presence,8,388,3,5,0.68
8,3,printer,7,389,2,5,0.76
8,3,printing,8,390,5,3,0.56
8,3,priority,8,391,3,5,0.64
8,3,process,7,392,2,5,0.72
8,3,produce,7,393,3,4,0.64
8,3,product,7,394,6,1,0.44
8,3,project,7,395,3,4,0.6
8,3,properly,8,396,3,5,0.8
8,3,proposal,8,397,4,4,0.6
8,3,propose,7,398,6,1,0.4
8,3,protest,7,399,3,4,0.56
8,3,pump,4,400,1,3,0.36
8,3,pupil,5,401,2,3,0.52
8,3,pure,4,402,2,2,0.32
8,3,put,3,403,2,1,0.28
8,3,puzzle,6,404,2,4,0.6
8,3,quantity,8,405,0,8,0.92
8,3,query,5,406,2,3,0.56
8,3,quest,5,407,3,2,0.36
8,3,quite,5,408,2,3,0.4
8,3,race,4,409,0,4,0.44
8,3,radar,5,410,2,3,0.4
8,3,rail,4,411,2,2,0.44
8,3,railway,7,412,4,3,0.48
8,3,raise,5,413,3,2,0.4
8,3,rally,5,414,2,3,0.44
8,3,rather,6,415,2,4,0.52
8,3,rating,6,416,3,3,0.56
8,3,rational,8,417,4,4,0.68
8,3,realm,5,418,1,4,0.48
8,3,rear,4,419,3,1,0.28
8,3,rebel,5,420,2,3,0.44
8,3,recall,6,421,2,4,0.68
8,3,record,6,422,3,3,0.52
8,3,recruit,7,423,3,4,0.56
8,3,recycle,7,424,3,4,0.56
8,3,referee,7,425,2,5,0.76
8,3,refuse,6,426,3,3,0.48
8,3,regime,6,427,2,4,0.52
8,3,region,6,428,4,2,0.52
8,3,regional,8,429,6,2,0.64
8,3,relax,5,430,2,3,0.4
8,3,relieved,8,431,3,5,0.64
8,3,remark,6,432,2,4,0.52
8,3,renew,5,433,2,3,0.4
8,3,repeat,6,434,2,4,0.64
8,3,replace,7,435,3,4,0.56
8,3,research,8,436,2,6,0.76
8,3,reside,6,437,3,3,0.52
8,3,residue,7,438,5,2,0.56
8,3,rest,4,439,3,1,0.28
8,3,retire,6,440,2,4,0.52
8,3,revenge,7,441,2,5,0.68
8,3,revision,8,442,3,5,0.8
8,3,revive,6,443,4,2,0.4
8,3,rifle,5,444,1,4,0.48
8,3,rip,3,445,2,1,0.24
8,3,rise,4,446,2,2,0.32
8,3,ritual,6,447,2,4,0.64
8,3,road,4,448,1,3,0.44
8,3,robbery,7,449,2,5,0.64
8,3,robust,6,450,3,3,0.48
8,3,romance,7,451,2,5,0.64
8,3,roof,4,452,2,2,0.44
8,3,rough,5,453,2,3,0.4
8,3,rubbish,7,454,1,6,0.64
8,3,ruin,4,455,2,2,0.32
8,3,safe,4,456,0,4,0.44
8,3,satisfy,7,457,2,5,0.76
8,3,scan,4,458,1,3,0.36
8,3,scared,6,459,3,3,0.48
8,3,schedule,8,460,2,6,0.72
8,3,scheme,6,461,4,2,0.56
8,3,seal,4,462,1,3,0.36
8,3,secure,6,463,2,4,0.52
8,3,security,8,464,5,3,0.52
8,3,seem,4,465,2,2,0.32
8,3,segment,7,466,2,5,0.72
8,3,seminar,7,467,2,5,0.6
8,3,sensible,8,468,2,6,0.72
8,3,serious,7,469,2,5,0.6
8,3,serve,5,470,3,2,0.48
8,3,service,7,471,4,3,0.6
8,3,severely,8,472,2,6,0.76
8,3,sexual,6,473,2,4,0.52
8,3,shape,5,474,1,4,0.6
8,3,sheer,5,475,2,3,0.4
8,3,shell,5,476,3,2,0.36
8,3,shift,5,477,2,3,0.4
8,3,shiny,5,478,3,2,0.36
8,3,shipping,8,479,3,5,0.8
8,3,shoot,5,480,2,3,0.4
8,3,shopping,8,481,3,5,0.64
8,3,shortage,8,482,3,5,0.72
8,3,sibling,7,483,1,6,0.8
8,3,sight,5,484,2,3,0.4
8,3,silver,6,485,2,4,0.52
8,3,simply,6,486,2,4,0.52
8,3,sin,3,487,2,1,0.24
8,3,singing,7,488,3,4,0.56
8,3,sit,3,489,2,1,0.12
8,3,six,3,490,2,1,0.12
8,3,ski,3,491,1,2,0.12
8,3,skirt,5,492,3,2,0.16
8,3,skull,5,493,2,3,0.24
8,3,slip,4,494,1,3,0.24
8,3,smile,5,495,1,4,0.2
8,3,smoking,7,496,2,5,0.28
8,3,soap,4,497,1,3,0.16
8,3,solo,4,498,2,2,0.16
8,3,some,4,499,2,2,0.2
8,3,somehow,7,500,4,3,0.2
8,3,soup,4,501,2,2,0.12
8,3,south,5,502,3,2,0.16
8,3,space,5,503,1,4,0.2
8,3,spare,5,504,3,2,0.16
8,3,spin,4,505,2,2,0.2
8,3,stable,6,506,1,5,0.44
8,3,stall,5,507,3,2,0.4
8,3,stamp,5,508,3,2,0.4
8,3,standing,8,509,3,5,0.64
8,3,star,4,510,3,1,0.2
8,3,statue,6,511,3,3,0.28
8,3,steadily,8,512,2,6,0.36
8,3,steer,5,513,3,2,0.16
8,3,stick,5,514,2,3,0.24
8,3,sticky,6,515,5,1,0.16
8,3,stop,4,516,2,2,0.12
8,3,storage,7,517,3,4,0.24
8,3,straight,8,518,2,6,0.28
8,3,strength,8,519,3,5,0.36
8,3,stretch,7,520,4,3,0.2
8,3,string,6,521,3,3,0.2
8,3,studio,6,522,2,4,0.24
8,3,stumble,7,523,3,4,0.32
8,3,stun,4,524,3,1,0.12
8,3,subject,7,525,1,6,0.28
8,3,such,4,526,2,2,0.16
8,3,sudden,6,527,2,4,0.2
8,3,super,5,528,2,3,0.24
8,3,supreme,7,529,3,4,0.24
8,3,surgical,8,530,2,6,0.28
8,3,swear,5,531,1,4,0.2
8,3,switch,6,532,2,4,0.28
8,3,symptom,7,533,1,6,0.28
8,3,table,5,534,0,5,0.24
8,3,tail,4,535,2,2,0.12
8,3,tale,4,536,2,2,0.12
8,3,talent,6,537,4,2,0.24
8,3,tank,4,538,2,2,0.12
8,3,taste,5,539,2,3,0.16
8,3,taxi,4,540,2,2,0.12
8,3,team,4,541,1,3,0.16
8,3,tendency,8,542,2,6,0.36
8,3,texture,7,543,2,5,0.24
8,3,thesis,6,544,1,5,0.24
8,3,thorough,8,545,2,6,0.32
8,3,three,5,546,2,3,0.24
8,3,thumb,5,547,2,3,0.16
8,3,ticket,6,548,1,5,0.24
8,3,tight,5,549,2,3,0.2
8,3,torture,7,550,1,6,0.28
8,3,tour,4,551,2,2,0.24
8,3,trainer,7,552,1,6,0.28
8,3,trap,4,553,3,1,0.12
8,3,treasure,8,554,2,6,0.32
8,3,treaty,6,555,4,2,0.24
8,3,tree,4,556,3,1,0.12
8,3,tribe,5,557,2,3,0.16
8,3,trio,4,558,3,1,0.12
8,3,trousers,8,559,2,6,0.28
8,3,truck,5,560,2,3,0.24
8,3,tune,4,561,1,3,0.16
8,3,two,3,562,1,2,0.12
8,3,ultimate,8,563,0,8,0.36
8,3,unable,6,564,1,5,0.24
8,3,unify,5,565,2,3,0.44
8,3,unique,6,566,3,3,0.32
8,3,until,5,567,2,3,0.16
8,3,unusual,7,568,2,5,0.28
8,3,unveil,6,569,2,4,0.24
8,3,uphold,6,570,1,5,0.32
8,3,urban,5,571,1,4,0.2
8,3,usual,5,572,1,4,0.2
8,3,utility,7,573,1,6,0.28
8,3,vague,5,574,0,5,0.32
8,3,validity,8,575,2,6,0.28
8,3,valley,6,576,3,3,0.2
8,3,variety,7,577,2,5,0.28
8,3,vary,4,578,3,1,0.2
8,3,vein,4,579,1,3,0.16
8,3,vessel,6,580,2,4,0.2
8,3,video,5,581,1,4,0.2
8,3,violent,7,582,2,5,0.24
8,3,virtual,7,583,2,5,0.36
8,3,visitor,7,584,2,5,0.28
8,3,voice,5,585,1,4,0.2
8,3,wait,4,586,0,4,0.2
8,3,waiter,6,587,4,2,0.16
8,3,wake,4,588,2,2,0.24
8,3,war,3,589,2,1,0.08
8,3,warning,7,590,3,4,0.24
8,3,warrior,7,591,3,4,0.24
8,3,washing,7,592,2,5,0.36
8,3,way,3,593,2,1,0.08
8,3,weakness,8,594,1,7,0.32
8,3,weapon,6,595,3,3,0.2
8,3,weave,5,596,3,2,0.16
8,3,weight,6,597,2,4,0.28
8,3,welfare,7,598,2,5,0.24
8,3,whatever,8,599,1,7,0.32
8,3,whenever,8,600,2,6,0.32
8,3,width,5,601,1,4,0.28
8,3,willing,7,602,2,5,0.28
8,3,win,3,603,2,1,0.08
8,3,wind,4,604,3,1,0.12
8,3,wipe,4,605,2,2,0.12
8,3,within,6,606,2,4,0.32
8,3,work,4,607,1,3,0.16
8,3,wrap,4,608,1,3,0.16
8,3,wrist,5,609,2,3,0.16
8,3,yellow,6,610,0,6,0.28
8,3,young,5,611,1,4,0.28
8,4,a,1,0,0,1,0.16
8,4,absurd,6,1,1,5,0.56
8,4,accurate,8,2,1,7,0.76
8,4,acid,4,3,2,2,0.4
8,4,acre,4,4,2,2,0.4
8,4,ad,2,5,1,1,0.32
8,4,adjacent,8,6,2,6,0.72
8,4,admit,5,7,2,3,0.44
8,4,adoption,8,8,2,6,0.88
8,4,advice,6,9,2,4,0.68
8,4,agree,5,10,1,4,0.52
8,4,alcohol,7,11,1,6,0.72
8,4,amateur,7,12,1,6,0.76
8,4,amusing,7,13,2,5,0.8
8,4,analyse,7,14,1,6,0.76
8,4,ancient,7,15,2,5,0.64
8,4,and,3,16,2,1,0.24
8,4,ankle,5,17,2,3,0.48
8,4,announce,8,18,2,6,0.88
8,4,another,7,19,2,5,0.64
8,4,anxiety,7,20,2,5,0.68
8,4,anyway,6,21,2,4,0.56
8,4,app,3,22,1,2,0.44
8,4,applaud,7,23,3,4,0.6
8,4,arguably,8,24,1,7,0.8
8,4,arms,4,25,2,2,0.32
8,4,army,4,26,3,1,0.28
8,4,arrow,5,27,2,3,0.64
8,4,artist,6,28,2,4,0.52
8,4,at,2,29,1,1,0.12
8,4,atrocity,8,30,2,6,0.44
8,4,auto,4,31,1,3,0.2
8,4,average,7,32,1,6,0.4
8,4,baby,4,33,0,4,0.2
8,4,bacteria,8,34,2,6,0.36
8,4,balance,7,35,2,5,0.28
8,4,banner,6,36,2,4,0.32
8,4,bat,3,37,2,1,0.12
8,4,bed,3,38,1,2,0.12
8,4,behave,6,39,2,4,0.24
8,4,belong,6,40,2,4,0.24
8,4,betray,6,41,2,4,0.32
8,4,between,7,42,3,4,0.24
8,4,bird,4,43,1,3,0.16
8,4,bizarre,7,44,2,5,0.32
8,4,blame,5,45,1,4,0.2
8,4,bless,5,46,2,3,0.24
8,4,blind,5,47,2,3,0.2
8,4,blog,4,48,2,2,0.16
8,4,boom,4,49,1,3,0.16
8,4,boost,5,50,3,2,0.16
8,4,boot,4,51,3,1,0.2
8,4,bother,6,52,2,4,0.24
8,4,bottle,6,53,3,3,0.2
8,4,boundary,8,54,2,6,0.36
8,4,box,3,55,2,1,0.12
8,4,break,5,56,1,4,0.36
8,4,breathe,7,57,4,3,0.24
8,4,bride,5,58,2,3,0.24
8,4,bridge,6,59,4,2,0.2
8,4,build,5,60,1,4,0.2
8,4,bunch,5,61,2,3,0.28
8,4,business,8,62,2,6,0.36
8,4,butter,6,63,2,4,0.24
8,4,cafe,4,64,0,4,0.2
8,4,cake,4,65,2,2,0.16
8,4,can,3,66,2,1,0.2
8,4,career,6,67,2,4,0.24
8,4,careful,7,68,4,3,0.24
8,4,carpet,6,69,3,3,0.24
8,4,cave,4,70,2,2,0.16
8,4,cemetery,8,71,1,7,0.44
8,4,ceremony,8,72,2,6,0.32
8,4,certain,7,73,3,4,0.24
8,4,chair,5,74,1,4,0.2
8,4,chapter,7,75,3,4,0.32
8,4,charm,5,76,3,2,0.16
8,4,charming,8,77,5,3,0.24
8,4,chart,5,78,4,1,0.12
8,4,cheat,5,79,2,3,0.28
8,4,check,5,80,3,2,0.16
8,4,cheerful,8,81,3,5,0.28
8,4,chemical,8,82,3,5,0.32
8,4,choir,5,83,2,3,0.28
8,4,chronic,7,84,2,5,0.28
8,4,circle,6,85,1,5,0.28
8,4,cite,4,86,2,2,0.16
8,4,city,4,87,3,1,0.12
8,4,civil,5,88,2,3,0.28
8,4,clarity,7,89,1,6,0.32
8,4,clause,6,90,3,3,0.2
8,4,clerk,5,91,2,3,0.2
8,4,closely,7,92,2,5,0.28
8,4,cloud,5,93,3,2,0.24
8,4,coach,5,94,1,4,0.24
8,4,coffee,6,95,2,4,0.24
8,4,coincide,8,96,2,6,0.32
8,4,colony,6,97,2,4,0.32
8,4,comedy,6,98,2,4,0.24
8,4,comment,7,99,3,4,0.28
8,4,commonly,8,100,4,4,0.28
8,4,company,7,101,3,4,0.36
8,4,compete,7,102,4,3,0.24
8,4,conceive,8,103,2,6,0.32
8,4,concern,7,104,5,2,0.2
8,4,concert,7,105,6,1,0.24
8,4,confer,6,106,3,3,0.2
8,4,consent,7,107,3,4,0.24
8,4,contrast,8,108,3,5,0.28
8,4,convey,6,109,3,3,0.28
8,4,cooker,6,110,2,4,0.24
8,4,cope,4,111,2,2,0.16
8,4,cost,4,112,2,2,0.16
8,4,cottage,7,113,2,5,0.28
8,4,could,5,114,2,3,0.28
8,4,counter,7,115,3,4,0.24
8,4,county,6,116,5,1,0.16
8,4,course,6,117,3,3,0.2
8,4,court,5,118,4,1,0.16
8,4,coverage,8,119,2,6,0.4
8,4,craft,5,120,1,4,0.2
8,4,create,6,121,2,4,0.24
8,4,creep,5,122,3,2,0.16
8,4,criminal,8,123,2,6,0.4
8,4,crowd,5,124,2,3,0.2
8,4,crowded,7,125,5,2,0.2
8,4,crude,5,126,2,3,0.2
8,4,cruel,5,127,3,2,0.16
8,4,cruise,6,128,3,3,0.28
8,4,current,7,129,1,6,0.32
8,4,curved,6,130,3,3,0.2
8,4,cycle,5,131,1,4,0.24
8,4,dam,3,132,0,3,0.16
8,4,dare,4,133,2,2,0.2
8,4,darkness,8,134,3,5,0.28
8,4,day,3,135,2,1,0.08
8,4,death,5,136,1,4,0.24
8,4,declare,7,137,2,5,0.36
8,4,decline,7,138,4,3,0.24
8,4,decrease,8,139,3,5,0.28
8,4,default,7,140,2,5,0.28
8,4,defence,7,141,3,4,0.4
8,4,delight,7,142,2,5,0.28
8,4,demon,5,143,2,3,0.2
8,4,dentist,7,144,2,5,0.32
8,4,deputy,6,145,2,4,0.28
8,4,desktop,7,146,2,5,0.36
8,4,despite,7,147,3,4,0.24
8,4,detect,6,148,2,4,0.24
8,4,devil,5,149,2,3,0.2
8,4,diagram,7,150,1,6,0.4
8,4,dictator,8,151,2,6,0.32
8,4,diminish,8,152,2,6,0.32
8,4,director,8,153,2,6,0.4
8,4,dirt,4,154,3,1,0.12
8,4,dirty,5,155,4,1,0.12
8,4,disabled,8,156,2,6,0.36
8,4,discount,8,157,3,5,0.32
8,4,discuss,7,158,4,3,0.32
8,4,display,7,159,3,4,0.24
8,4,distort,7,160,3,4,0.24
8,4,dominant,8,161,1,7,0.44
8,4,dot,3,162,2,1,0.12
8,4,double,6,163,2,4,0.24
8,4,drama,5,164,1,4,0.2
8,4,drawing,7,165,3,4,0.24
8,4,dust,4,166,1,3,0.16
8,4,earnings,8,167,0,8,0.44
8,4,earth,5,168,3,2,0.16
8,4,edit,4,169,1,3,0.16
8,4,edition,7,170,4,3,0.24
8,4,effort,6,171,1,5,0.36
8,4,eight,5,172,1,4,0.2
8,4,eighty,6,173,5,1,0.16
8,4,either,6,174,2,4,0.24
8,4,elect,5,175,1,4,0.24
8,4,eleven,6,176,3,3,0.28
8,4,embark,6,177,1,5,0.28
8,4,emission,8,178,2,6,0.32
8,4,employer,8,179,2,6,0.4
8,4,enable,6,180,1,5,0.24
8,4,ending,6,181,2,4,0.24
8,4,endless,7,182,3,4,0.24
8,4,enemy,5,183,2,3,0.2
8,4,enrich,6,184,2,4,0.32
8,4,entitle,7,185,2,5,0.28
8,4,equality,8,186,1,7,0.36
8,4,essay,5,187,1,4,0.2
8,4,euro,4,188,1,3,0.24
8,4,event,5,189,1,4,0.2
8,4,evoke,5,190,2,3,0.2
8,4,exact,5,191,1,4,0.24
8,4,exceed,6,192,2,4,0.24
8,4,excited,7,193,3,4,0.36
8,4,excuse,6,194,3,3,0.2
8,4,exercise,8,195,2,6,0.36
8,4,exit,4,196,2,2,0.16
8,4,expire,6,197,2,4,0.32
8,4,explode,7,198,3,4,0.28
8,4,extend,6,199,2,4,0.28
8,4,extent,6,200,5,1,0.16
8,4,failure,7,201,0,7,0.44
8,4,fair,4,202,3,1,0.12
8,4,famous,6,203,2,4,0.24
8,4,fast,4,204,2,2,0.16
8,4,fasten,6,205,4,2,0.2
8,4,fat,3,206,2,1,0.12
8,4,fear,4,207,1,3,0.24
8,4,feeding,7,208,2,5,0.28
8,4,fibre,5,209,1,4,0.2
8,4,fifty,5,210,2,3,0.2
8,4,finally,7,211,2,5,0.28
8,4,fine,4,212,3,1,0.2
8,4,fix,3,213,2,1,0.08
8,4,folding,7,214,1,6,0.32
8,4,folk,4,215,3,1,0.12
8,4,food,4,216,2,2,0.16
8,4,force,5,217,2,3,0.2
8,4,foreign,7,218,3,4,0.36
8,4,former,6,219,3,3,0.2
8,4,formerly,8,220,6,2,0.2
8,4,forward,7,221,3,4,0.24
8,4,founder,7,222,2,5,0.36
8,4,fragment,8,223,1,7,0.32
8,4,frequent,8,224,2,6,0.32
8,4,friday,6,225,2,4,0.32
8,4,frog,4,226,2,2,0.16
8,4,fulfil,6,227,1,5,0.28
8,4,gallon,6,228,0,6,0.28
8,4,game,4,229,2,2,0.16
8,4,gene,4,230,1,3,0.24
8,4,generate,8,231,4,4,0.32
8,4,genre,5,232,3,2,0.2
8,4,give,4,233,1,3,0.2
8,4,glass,5,234,1,4,0.24
8,4,glimpse,7,235,2,5,0.4
8,4,globe,5,236,2,3,0.2
8,4,gold,4,237,1,3,0.16
8,4,golf,4,238,3,1,0.12
8,4,good,4,239,2,2,0.16
8,4,governor,8,240,2,6,0.44
8,4,grade,5,241,1,4,0.2
8,4,gravity,7,242,3,4,0.28
8,4,green,5,243,2,3,0.2
8,4,greet,5,244,4,1,0.12
8,4,grid,4,245,2,2,0.2
8,4,grin,4,246,3,1,0.12
8,4,grind,5,247,4,1,0.12
8,4,guitar,6,248,1,5,0.28
8,4,guy,3,249,2,1,0.12
8,4,hair,4,250,0,4,0.2
8,4,handful,7,251,2,5,0.36
8,4,handy,5,252,4,1,0.16
8,4,harm,4,253,2,2,0.16
8,4,hat,3,254,2,1,0.08
8,4,hazard,6,255,2,4,0.24
8,4,headline,8,256,1,7,0.44
8,4,health,6,257,3,3,0.2
8,4,hers,4,258,2,2,0.16
8,4,hesitate,8,259,2,6,0.32
8,4,highly,6,260,1,5,0.32
8,4,historic,8,261,2,6,0.32
8,4,homeland,8,262,1,7,0.4
8,4,honesty,7,263,2,5,0.32
8,4,horrible,8,264,2,6,0.44
8,4,hour,4,265,2,2,0.16
8,4,how,3,266,2,1,0.08
8,4,humanity,8,267,1,7,0.36
8,4,hunger,6,268,2,4,0.24
8,4,hydrogen,8,269,1,7,0.44
8,4,identity,8,270,0,8,0.36
8,4,image,5,271,1,4,0.24
8,4,import,6,272,2,4,0.32
8,4,include,7,273,1,6,0.28
8,4,index,5,274,2,3,0.2
8,4,info,4,275,2,2,0.28
8,4,informal,8,276,4,4,0.32
8,4,inherent,8,277,2,6,0.44
8,4,initiate,8,278,2,6,0.32
8,4,inject,6,279,2,4,0.24
8,4,injury,6,280,3,3,0.2
8,4,insert,6,281,2,4,0.32
8,4,intended,8,282,2,6,0.32
8,4,interior,8,283,4,4,0.28
8,4,invade,6,284,2,4,0.32
8,4,invest,6,285,3,3,0.2
8,4,involve,7,286,3,4,0.24
8,4,involved,8,287,7,1,0.2
8,4,island,6,288,1,5,0.28
8,4,january,7,289,0,7,0.4
8,4,job,3,290,1,2,0.12
8,4,joy,3,291,2,1,0.12
8,4,jump,4,292,1,3,0.16
8,4,key,3,293,0,3,0.16
8,4,kick,4,294,1,3,0.2
8,4,kidney,6,295,2,4,0.32
8,4,king,4,296,2,2,0.16
8,4,know,4,297,1,3,0.16
8,4,lack,4,298,0,4,0.2
8,4,lake,4,299,2,2,0.16
8,4,landmark,8,300,2,6,0.44
8,4,lap,3,301,2,1,0.12
8,4,laser,5,302,2,3,0.2
8,4,latest,6,303,2,4,0.28
8,4,law,3,304,2,1,0.08
8,4,lawn,4,305,3,1,0.12
8,4,layer,5,306,2,3,0.28
8,4,leaflet,7,307,1,6,0.28
8,4,league,6,308,3,3,0.2
8,4,lemon,5,309,2,3,0.2
8,4,lesbian,7,310,2,5,0.36
8,4,letter,6,311,2,4,0.24
8,4,lie,3,312,1,2,0.12
8,4,limited,7,313,2,5,0.28
8,4,link,4,314,2,2,0.16
8,4,lion,4,315,2,2,0.24
8,4,little,6,316,2,4,0.24
8,4,load,4,317,1,3,0.2
8,4,local,5,318,2,3,0.24
8,4,log,3,319,2,1,0.12
8,4,lot,3,320,2,1,0.12
8,4,low,3,321,2,1,0.12
8,4,main,4,322,0,4,0.28
8,4,mandate,7,323,2,5,0.28
8,4,mark,4,324,2,2,0.16
8,4,married,7,325,3,4,0.24
8,4,mask,4,326,2,2,0.16
8,4,master,6,327,3,3,0.28
8,4,maximum,7,328,2,5,0.28
8,4,mean,4,329,1,3,0.16
8,4,media,5,330,2,3,0.2
8,4,meeting,7,331,2,5,0.36
8,4,melody,6,332,2,4,0.24
8,4,mental,6,333,2,4,0.24
8,4,mentor,6,334,4,2,0.2
8,4,merely,6,335,2,4,0.24
8,4,mess,4,336,2,2,0.24
8,4,method,6,337,2,4,0.24
8,4,militia,7,338,1,6,0.32
8,4,mind,4,339,2,2,0.16
8,4,mirror,6,340,2,4,0.24
8,4,missing,7,341,2,5,0.36
8,4,mixed,5,342,2,3,0.2
8,4,model,5,343,1,4,0.2
8,4,modify,6,344,3,3,0.2
8,4,moment,6,345,2,4,0.32
8,4,month,5,346,2,3,0.2
8,4,more,4,347,2,2,0.16
8,4,most,4,348,2,2,0.16
8,4,mother,6,349,2,4,0.24
8,4,mouth,5,350,2,3,0.28
8,4,movie,5,351,2,3,0.2
8,4,much,4,352,1,3,0.16
8,4,mum,3,353,2,1,0.12
8,4,museum,6,354,2,4,0.24
8,4,my,2,355,1,1,0.08
8,4,name,4,356,0,4,0.2
8,4,nasty,5,357,2,3,0.28
8,4,negative,8,358,1,7,0.36
8,4,new,3,359,2,1,0.12
8,4,night,5,360,1,4,0.2
8,4,noise,5,361,1,4,0.2
8,4,noisy,5,362,4,1,0.2
8,4,normal,6,363,2,4,0.4
8,4,north,5,364,3,2,0.4
8,4,not,3,365,2,1,0.28
8,4,note,4,366,3,1,0.32
8,4,nothing,7,367,3,4,0.76
8,4,notion,6,368,3,3,0.48
8,4,numerous,8,369,1,7,0.84
8,4,nut,3,370,2,1,0.28
8,4,obesity,7,371,0,7,0.88
8,4,oblige,6,372,2,4,0.56
8,4,obsess,6,373,2,4,0.56
8,4,october,7,374,1,6,1
8,4,one,3,375,1,2,0.36
8,4,online,6,376,2,4,0.72
8,4,opposed,7,377,1,6,0.72
8,4,option,6,378,2,4,0.64
8,4,ought,5,379,1,4,0.68
8,4,outdoor,7,380,2,5,1.04
8,4,outlet,6,381,3,3,0.68
8,4,outlook,7,382,4,3,0.68
8,4,owe,3,383,1,2,0.4
8,4,pace,4,384,0,4,0.56
8,4,page,4,385,2,2,0.52
8,4,painful,7,386,2,5,0.96
8,4,paint,5,387,4,1,0.32
8,4,palace,6,388,2,4,0.56
8,4,pants,5,389,2,3,0.44
8,4,parade,6,390,2,4,0.68
8,4,park,4,391,3,1,0.28
8,4,partial,7,392,3,4,0.56
8,4,passport,8,393,2,6,0.72
8,4,patent,6,394,2,4,0.6
8,4,peaceful,8,395,1,7,1
8,4,peculiar,8,396,2,6,0.84
8,4,peer,4,397,2,2,0.36
8,4,perfect,7,398,2,5,0.84
8,4,perhaps,7,399,3,4,0.6
8,4,phone,5,400,1,4,0.52
8,4,photo,5,401,3,2,0.4
8,4,pick,4,402,1,3,0.4
8,4,picture,7,403,3,4,0.72
8,4,piece,5,404,2,3,0.44
8,4,pig,3,405,2,1,0.24
8,4,pile,4,406,2,2,0.36
8,4,pin,3,407,2,1,0.28
8,4,pipe,4,408,2,2,0.4
8,4,place,5,409,1,4,0.72
8,4,plan,4,410,3,1,0.28
8,4,plane,5,411,4,1,0.32
8,4,plant,5,412,4,1,0.32
8,4,plastic,7,413,3,4,0.6
8,4,play,4,414,3,1,0.28
8,4,pleased,7,415,2,5,0.76
8,4,point,5,416,1,4,0.48
8,4,police,6,417,2,4,0.56
8,4,possess,7,418,2,5,0.64
8,4,possible,8,419,4,4,0.76
8,4,post,4,420,3,1,0.28
8,4,predict,7,421,1,6,0.68
8,4,premier,7,422,3,4,0.6
8,4,prior,5,423,2,3,0.64
8,4,priority,8,424,5,3,0.56
8,4,produce,7,425,2,5,0.64
8,4,profile,7,426,3,4,0.6
8,4,proof,5,427,3,2,0.4
8,4,proposal,8,428,3,5,0.8
8,4,propose,7,429,6,1,0.4
8,4,pure,4,430,1,3,0.4
8,4,purpose,7,431,3,4,0.56
8,4,pursuit,7,432,3,4,0.72
8,4,put,3,433,2,1,0.24
8,4,quantity,8,434,0,8,0.84
8,4,quite,5,435,2,3,0.44
8,4,race,4,436,0,4,0.48
8,4,racial,6,437,3,3,0.6
8,4,radar,5,438,2,3,0.44
8,4,rail,4,439,2,2,0.32
8,4,rating,6,440,2,4,0.52
8,4,realm,5,441,1,4,0.48
8,4,recount,7,442,2,5,0.76
8,4,recruit,7,443,3,4,0.6
8,4,reduce,6,444,2,4,0.56
8,4,refer,5,445,2,3,0.44
8,4,regime,6,446,2,4,0.72
8,4,regional,8,447,4,4,0.6
8,4,reign,5,448,2,3,0.44
8,4,relative,8,449,2,6,0.76
8,4,relieved,8,450,3,5,0.84
8,4,remark,6,451,2,4,0.56
8,4,remind,6,452,3,3,0.48
8,4,removal,7,453,3,4,0.56
8,4,remove,6,454,5,1,0.48
8,4,renew,5,455,2,3,0.44
8,4,repeat,6,456,2,4,0.56
8,4,replace,7,457,3,4,0.6
8,4,research,8,458,2,6,0.92
8,4,retail,6,459,2,4,0.56
8,4,retire,6,460,3,3,0.48
8,4,retrieve,8,461,3,5,0.72
8,4,reveal,6,462,2,4,0.56
8,4,revenge,7,463,4,3,0.68
8,4,revise,6,464,3,3,0.48
8,4,revive,6,465,4,2,0.44
8,4,rifle,5,466,1,4,0.48
8,4,right,5,467,2,3,0.56
8,4,ritual,6,468,2,4,0.52
8,4,rival,5,469,2,3,0.44
8,4,road,4,470,1,3,0.4
8,4,rob,3,471,2,1,0.24
8,4,robust,6,472,3,3,0.48
8,4,roll,4,473,2,2,0.48
8,4,root,4,474,2,2,0.32
8,4,rough,5,475,2,3,0.44
8,4,routine,7,476,3,4,0.6
8,4,rub,3,477,1,2,0.28
8,4,rubber,6,478,3,3,0.6
8,4,rubbish,7,479,4,3,0.52
8,4,safe,4,480,0,4,0.48
8,4,sale,4,481,2,2,0.32
8,4,schedule,8,482,1,7,0.96
8,4,scheme,6,483,4,2,0.56
8,4,score,5,484,2,3,0.44
8,4,second,6,485,1,5,0.6
8,4,secret,6,486,3,3,0.56
8,4,secure,6,487,3,3,0.68
8,4,seminar,7,488,2,5,0.64
8,4,sensible,8,489,2,6,0.72
8,4,serious,7,490,2,5,0.64
8,4,serve,5,491,3,2,0.52
8,4,service,7,492,4,3,0.6
8,4,settler,7,493,2,5,0.76
8,4,sexy,4,494,2,2,0.4
8,4,shallow,7,495,1,6,0.8
8,4,sheer,5,496,2,3,0.56
8,4,shell,5,497,3,2,0.36
8,4,shiny,5,498,2,3,0.44
8,4,ship,4,499,3,1,0.28
8,4,shipping,8,500,4,4,0.6
8,4,shortage,8,501,2,6,0.88
8,4,sibling,7,502,1,6,0.72
8,4,sight,5,503,2,3,0.44
8,4,silver,6,504,2,4,0.52
8,4,simply,6,505,2,4,0.68
8,4,sin,3,506,2,1,0.24
8,4,singing,7,507,3,4,0.6
8,4,sister,6,508,2,4,0.52
8,4,sit,3,509,2,1,0.16
8,4,situated,8,510,3,5,0.4
8,4,six,3,511,2,1,0.12
8,4,skirt,5,512,1,4,0.24
8,4,slam,4,513,1,3,0.2
8,4,slice,5,514,2,3,0.2
8,4,smile,5,515,1,4,0.32
8,4,soap,4,516,1,3,0.16
8,4,solid,5,517,2,3,0.2
8,4,special,7,518,1,6,0.32
8,4,specify,7,519,5,2,0.2
8,4,spin,4,520,2,2,0.24
8,4,staff,5,521,1,4,0.2
8,4,stamp,5,522,3,2,0.16
8,4,stand,5,523,3,2,0.16
8,4,statue,6,524,3,3,0.2
8,4,stay,4,525,3,1,0.12
8,4,sticky,6,526,2,4,0.32
8,4,stop,4,527,2,2,0.16
8,4,store,5,528,3,2,0.16
8,4,straight,8,529,2,6,0.32
8,4,strange,7,530,4,3,0.32
8,4,strategy,8,531,4,4,0.24
8,4,street,6,532,3,3,0.28
8,4,stretch,7,533,4,3,0.24
8,4,strict,6,534,3,3,0.28
8,4,striking,8,535,4,4,0.28
8,4,string,6,536,4,2,0.2
8,4,strong,6,537,3,3,0.2
8,4,stumble,7,538,2,5,0.36
8,4,stun,4,539,3,1,0.12
8,4,subject,7,540,1,6,0.32
8,4,such,4,541,2,2,0.16
8,4,sudden,6,542,2,4,0.24
8,4,sue,3,543,2,1,0.12
8,4,sugar,5,544,2,3,0.28
8,4,supreme,7,545,2,5,0.28
8,4,surely,6,546,2,4,0.24
8,4,surgical,8,547,3,5,0.28
8,4,survival,8,548,3,5,0.36
8,4,tactical,8,549,0,8,0.36
8,4,tale,4,550,2,2,0.16
8,4,talk,4,551,3,1,0.12
8,4,tempt,5,552,1,4,0.28
8,4,terribly,8,553,2,6,0.32
8,4,texture,7,554,2,5,0.28
8,4,thesis,6,555,1,5,0.24
8,4,thirsty,7,556,2,5,0.36
8,4,thorough,8,557,2,6,0.32
8,4,tighten,7,558,1,6,0.32
8,4,till,4,559,2,2,0.16
8,4,timing,6,560,2,4,0.32
8,4,tonne,5,561,1,4,0.24
8,4,too,3,562,2,1,0.12
8,4,treat,5,563,1,4,0.2
8,4,trend,5,564,3,2,0.16
8,4,tropical,8,565,2,6,0.4
8,4,trousers,8,566,3,5,0.28
8,4,twice,5,567,1,4,0.2
8,4,ultimate,8,568,0,8,0.36
8,4,unable,6,569,1,5,0.36
8,4,unique,6,570,2,4,0.56
8,4,unusual,7,571,2,5,0.28
8,4,urgent,6,572,1,5,0.28
8,4,utility,7,573,1,6,0.44
8,4,validity,8,574,0,8,0.36
8,4,valley,6,575,3,3,0.2
8,4,venture,7,576,1,6,0.32
8,4,vessel,6,577,2,4,0.36
8,4,video,5,578,1,4,0.24
8,4,viewer,6,579,2,4,0.24
8,4,violent,7,580,2,5,0.28
8,4,virtual,7,581,2,5,0.4
8,4,virus,5,582,3,2,0.16
8,4,visitor,7,583,2,5,0.28
8,4,visual,6,584,3,3,0.2
8,4,vital,5,585,2,3,0.2
8,4,vocal,5,586,1,4,0.28
8,4,voice,5,587,2,3,0.2
8,4,wait,4,588,0,4,0.2
8,4,waiter,6,589,4,2,0.16
8,4,wake,4,590,2,2,0.16
8,4,walk,4,591,2,2,0.16
8,4,warrior,7,592,2,5,0.36
8,4,water,5,593,2,3,0.2
8,4,way,3,594,2,1,0.12
8,4,wealthy,7,595,1,6,0.32
8,4,weave,5,596,3,2,0.2
8,4,weekend,7,597,2,5,0.36
8,4,weird,5,598,2,3,0.2
8,4,west,4,599,2,2,0.16
8,4,whatever,8,600,1,7,0.32
8,4,whenever,8,601,2,6,0.4
8,4,whereas,7,602,3,4,0.24
8,4,which,5,603,2,3,0.2
8,4,willing,7,604,1,6,0.28
8,4,win,3,605,2,1,0.2
8,4,within,6,606,2,4,0.24
8,4,woman,5,607,1,4,0.2
8,4,word,4,608,2,2,0.16
8,4,work,4,609,3,1,0.12
8,4,written,7,610,1,6,0.4
8,4,young,5,611,0,5,0.24
8,5,absence,7,0,0,7,1.12
8,5,absorb,6,1,3,3,0.68
8,5,absurd,6,2,3,3,0.52
8,5,accept,6,3,1,5,1.04
8,5,acid,4,4,2,2,0.44
8,5,adj,3,5,1,2,0.4
8,5,adopt,5,6,2,3,0.68
8,5,adoption,8,7,5,3,0.72
8,5,against,7,8,1,6,1.24
8,5,align,5,9,1,4,0.72
8,5,amateur,7,10,1,6,1.36
8,5,and,3,11,1,2,0.4
8,5,anger,5,12,2,3,0.6
8,5,annoyed,7,13,2,5,1.16
8,5,another,7,14,2,5,0.64
8,5,anxiety,7,15,2,5,0.72
8,5,anybody,7,16,2,5,0.84
8,5,apology,7,17,1,6,0.84
8,5,arguably,8,18,1,7,1.2
8,5,argue,5,19,4,1,0.52
8,5,arise,5,20,2,3,0.48
8,5,arrow,5,21,2,3,0.68
8,5,ask,3,22,1,2,0.44
8,5,atrocity,8,23,1,7,0.84
8,5,auction,7,24,1,6,1.12
8,5,baby,4,25,0,4,0.52
8,5,backing,7,26,2,5,0.48
8,5,bath,4,27,2,2,0.28
8,5,beat,4,28,1,3,0.4
8,5,beg,3,29,2,1,0.2
8,5,behave,6,30,2,4,0.4
8,5,belief,6,31,2,4,0.56
8,5,bell,4,32,3,1,0.16
8,5,belong,6,33,3,3,0.24
8,5,below,5,34,4,1,0.16
8,5,best,4,35,2,2,0.16
8,5,beyond,6,36,2,4,0.48
8,5,bill,4,37,1,3,0.2
8,5,bin,3,38,2,1,0.16
8,5,bird,4,39,2,2,0.16
8,5,birthday,8,40,3,5,0.32
8,5,biscuit,7,41,2,5,0.4
8,5,bishop,6,42,3,3,0.24
8,5,bite,4,43,2,2,0.2
8,5,bitter,6,44,3,3,0.24
8,5,bizarre,7,45,2,5,0.32
8,5,blade,5,46,1,4,0.64
8,5,blame,5,47,3,2,0.32
8,5,blank,5,48,3,2,0.2
8,5,blog,4,49,2,2,0.16
8,5,blow,4,50,3,1,0.12
8,5,boat,4,51,1,3,0.28
8,5,boom,4,52,2,2,0.16
8,5,boost,5,53,3,2,0.2
8,5,bound,5,54,2,3,0.24
8,5,brand,5,55,1,4,0.24
8,5,breathe,7,56,2,5,0.4
8,5,broken,6,57,2,4,0.32
8,5,buddy,5,58,1,4,0.24
8,5,buffer,6,59,2,4,0.24
8,5,bug,3,60,2,1,0.12
8,5,build,5,61,2,3,0.2
8,5,business,8,62,2,6,0.72
8,5,cake,4,63,0,4,0.2
8,5,can,3,64,2,1,0.12
8,5,cancer,6,65,3,3,0.24
8,5,cap,3,66,2,1,0.12
8,5,capable,7,67,3,4,0.36
8,5,card,4,68,2,2,0.16
8,5,career,6,69,3,3,0.24
8,5,careful,7,70,4,3,0.24
8,5,carpet,6,71,3,3,0.32
8,5,carve,5,72,3,2,0.2
8,5,category,8,73,2,6,0.56
8,5,cease,5,74,1,4,0.24
8,5,ceremony,8,75,2,6,0.36
8,5,chair,5,76,1,4,0.32
8,5,chapter,7,77,3,4,0.28
8,5,charity,7,78,3,4,0.28
8,5,charming,8,79,4,4,0.48
8,5,chart,5,80,4,1,0.32
8,5,check,5,81,2,3,0.2
8,5,cheerful,8,82,3,5,0.32
8,5,chemical,8,83,3,5,0.6
8,5,choose,6,84,2,4,0.48
8,5,chop,4,85,3,1,0.16
8,5,city,4,86,1,3,0.2
8,5,clause,6,87,1,5,0.32
8,5,clean,5,88,2,3,0.2
8,5,clearly,7,89,4,3,0.48
8,5,clinical,8,90,2,6,0.32
8,5,club,4,91,2,2,0.16
8,5,cluster,7,92,3,4,0.24
8,5,coach,5,93,1,4,0.32
8,5,colony,6,94,2,4,0.24
8,5,comfort,7,95,2,5,0.52
8,5,commonly,8,96,3,5,0.48
8,5,compete,7,97,3,4,0.36
8,5,comply,6,98,4,2,0.4
8,5,conceal,7,99,2,5,0.6
8,5,conduct,7,100,3,4,0.28
8,5,consent,7,101,3,4,0.32
8,5,consult,7,102,4,3,0.24
8,5,contrast,8,103,3,5,0.32
8,5,cooker,6,104,2,4,0.36
8,5,cope,4,105,2,2,0.16
8,5,cost,4,106,2,2,0.24
8,5,cottage,7,107,2,5,0.28
8,5,could,5,108,2,3,0.2
8,5,county,6,109,3,3,0.2
8,5,couple,6,110,3,3,0.2
8,5,court,5,111,3,2,0.44
8,5,craft,5,112,1,4,0.24
8,5,create,6,113,2,4,0.24
8,5,credible,8,114,3,5,0.32
8,5,creep,5,115,3,2,0.24
8,5,crime,5,116,2,3,0.2
8,5,cross,5,117,2,3,0.36
8,5,crowded,7,118,3,4,0.44
8,5,crucial,7,119,2,5,0.28
8,5,cruise,6,120,3,3,0.32
8,5,currency,8,121,1,7,0.36
8,5,current,7,122,6,1,0.16
8,5,cycle,5,123,1,4,0.2
8,5,dam,3,124,0,3,0.24
8,5,damage,6,125,3,3,0.2
8,5,dare,4,126,2,2,0.16
8,5,day,3,127,2,1,0.12
8,5,deal,4,128,1,3,0.16
8,5,deed,4,129,2,2,0.16
8,5,deem,4,130,3,1,0.24
8,5,defect,6,131,2,4,0.24
8,5,defence,7,132,4,3,0.24
8,5,definite,8,133,3,5,0.28
8,5,delight,7,134,2,5,0.36
8,5,deliver,7,135,4,3,0.24
8,5,demon,5,136,2,3,0.2
8,5,deposit,7,137,2,5,0.32
8,5,detect,6,138,2,4,0.4
8,5,develop,7,139,2,5,0.36
8,5,devil,5,140,3,2,0.16
8,5,diagram,7,141,1,6,0.28
8,5,dictate,7,142,2,5,0.28
8,5,dictator,8,143,6,2,0.32
8,5,dig,3,144,2,1,0.12
8,5,digital,7,145,3,4,0.24
8,5,diminish,8,146,2,6,0.4
8,5,dinner,6,147,2,4,0.32
8,5,diplomat,8,148,2,6,0.32
8,5,director,8,149,2,6,0.32
8,5,dirt,4,150,3,1,0.12
8,5,dirty,5,151,4,1,0.16
8,5,disabled,8,152,2,6,0.44
8,5,discount,8,153,3,5,0.32
8,5,discuss,7,154,4,3,0.24
8,5,display,7,155,3,4,0.36
8,5,distort,7,156,3,4,0.24
8,5,domain,6,157,1,5,0.4
8,5,donation,8,158,2,6,0.32
8,5,drink,5,159,1,4,0.32
8,5,ear,3,160,0,3,0.16
8,5,earnings,8,161,3,5,0.44
8,5,earth,5,162,3,2,0.24
8,5,edit,4,163,1,3,0.16
8,5,effort,6,164,1,5,0.36
8,5,eight,5,165,1,4,0.24
8,5,either,6,166,2,4,0.24
8,5,elect,5,167,1,4,0.2
8,5,embark,6,168,1,5,0.24
8,5,emission,8,169,2,6,0.4
8,5,empower,7,170,2,5,0.32
8,5,ending,6,171,1,5,0.24
8,5,enemy,5,172,2,3,0.2
8,5,engineer,8,173,2,6,0.44
8,5,enjoy,5,174,2,3,0.24
8,5,enormous,8,175,2,6,0.56
8,5,enter,5,176,2,3,0.2
8,5,entitle,7,177,3,4,0.4
8,5,entry,5,178,3,2,0.2
8,5,erect,5,179,1,4,0.2
8,5,essence,7,180,1,6,0.28
8,5,evening,7,181,1,6,0.4
8,5,evidence,8,182,2,6,0.32
8,5,evoke,5,183,2,3,0.2
8,5,exchange,8,184,1,7,0.36
8,5,exercise,8,185,2,6,0.4
8,5,expire,6,186,2,4,0.24
8,5,explain,7,187,3,4,0.24
8,5,extend,6,188,2,4,0.24
8,5,eye,3,189,1,2,0.12
8,5,failed,6,190,0,6,0.36
8,5,failure,7,191,4,3,0.24
8,5,fairly,6,192,3,3,0.44
8,5,fall,4,193,2,2,0.16
8,5,famous,6,194,2,4,0.32
8,5,fasten,6,195,2,4,0.24
8,5,fear,4,196,1,3,0.16
8,5,feeding,7,197,2,5,0.28
8,5,few,3,198,2,1,0.12
8,5,fight,5,199,1,4,0.32
8,5,flag,4,200,1,3,0.16
8,5,flavour,7,201,3,4,0.24
8,5,flee,4,202,2,2,0.16
8,5,flexible,8,203,3,5,0.28
8,5,floor,5,204,2,3,0.28
8,5,focus,5,205,1,4,0.2
8,5,folk,4,206,2,2,0.16
8,5,formerly,8,207,2,6,0.32
8,5,forward,7,208,3,4,0.24
8,5,foster,6,209,2,4,0.4
8,5,founder,7,210,2,5,0.28
8,5,fragment,8,211,1,7,0.36
8,5,frequent,8,212,2,6,0.4
8,5,friday,6,213,2,4,0.24
8,5,fridge,6,214,4,2,0.2
8,5,frighten,8,215,3,5,0.28
8,5,frog,4,216,2,2,0.24
8,5,front,5,217,3,2,0.28
8,5,fulfil,6,218,1,5,0.24
8,5,full,4,219,3,1,0.12
8,5,fur,3,220,2,1,0.12
8,5,gallery,7,221,0,7,0.32
8,5,game,4,222,2,2,0.24
8,5,gaming,6,223,3,3,0.24
8,5,garage,6,224,2,4,0.24
8,5,giant,5,225,1,4,0.24
8,5,glass,5,226,1,4,0.24
8,5,go,2,227,1,1,0.2
8,5,god,3,228,2,1,0.12
8,5,golf,4,229,2,2,0.16
8,5,goodbye,7,230,2,5,0.28
8,5,govern,6,231,2,4,0.24
8,5,grace,5,232,1,4,0.32
8,5,gravity,7,233,3,4,0.56
8,5,green,5,234,2,3,0.24
8,5,guest,5,235,1,4,0.24
8,5,guidance,8,236,2,6,0.32
8,5,guitar,6,237,3,3,0.32
8,5,guy,3,238,2,1,0.12
8,5,gym,3,239,1,2,0.12
8,5,hair,4,240,0,4,0.2
8,5,handful,7,241,2,5,0.28
8,5,happen,6,242,2,4,0.32
8,5,harm,4,243,2,2,0.16
8,5,harsh,5,244,3,2,0.16
8,5,harvest,7,245,3,4,0.24
8,5,hate,4,246,2,2,0.16
8,5,heighten,8,247,1,7,0.44
8,5,hesitate,8,248,2,6,0.32
8,5,highly,6,249,1,5,0.44
8,5,historic,8,250,2,6,0.32
8,5,homeland,8,251,1,7,0.44
8,5,horrible,8,252,2,6,0.56
8,5,horror,6,253,4,2,0.2
8,5,hydrogen,8,254,1,7,0.44
8,5,i,1,255,0,1,0.08
8,5,ice,3,256,1,2,0.24
8,5,import,6,257,1,5,0.4
8,5,improve,7,258,3,4,0.24
8,5,index,5,259,1,4,0.2
8,5,indirect,8,260,3,5,0.4
8,5,infant,6,261,2,4,0.24
8,5,info,4,262,3,1,0.12
8,5,informal,8,263,4,4,0.28
8,5,inherent,8,264,2,6,0.44
8,5,initiate,8,265,2,6,0.32
8,5,injure,6,266,2,4,0.24
8,5,injury,6,267,5,1,0.16
8,5,inspect,7,268,2,5,0.84
8,5,intake,6,269,2,4,0.8
8,5,integral,8,270,3,5,1.16
8,5,intended,8,271,4,4,0.84
8,5,intense,7,272,5,2,0.56
8,5,into,4,273,3,1,0.36
8,5,invest,6,274,2,4,0.76
8,5,involve,7,275,3,4,0.48
8,5,involved,8,276,7,1,0.2
8,5,island,6,277,1,5,0.4
8,5,isolated,8,278,2,6,0.36
8,5,january,7,279,0,7,0.4
8,5,jet,3,280,1,2,0.12
8,5,job,3,281,1,2,0.12
8,5,jump,4,282,1,3,0.2
8,5,key,3,283,0,3,0.16
8,5,keyboard,8,284,3,5,0.4
8,5,kid,3,285,1,2,0.16
8,5,king,4,286,2,2,0.16
8,5,kit,3,287,2,1,0.12
8,5,know,4,288,1,3,0.2
8,5,lack,4,289,0,4,0.36
8,5,lad,3,290,2,1,0.12
8,5,lap,3,291,2,1,0.2
8,5,laser,5,292,2,3,0.2
8,5,last,4,293,3,1,0.12
8,5,latest,6,294,2,4,0.24
8,5,laugh,5,295,2,3,0.24
8,5,leaf,4,296,1,3,0.24
8,5,left,4,297,2,2,0.16
8,5,legend,6,298,2,4,0.24
8,5,lens,4,299,2,2,0.16
8,5,letter,6,300,2,4,0.24
8,5,lie,3,301,1,2,0.16
8,5,lion,4,302,2,2,0.24
8,5,little,6,303,2,4,0.24
8,5,live,4,304,2,2,0.16
8,5,liver,5,305,4,1,0.12
8,5,local,5,306,1,4,0.2
8,5,log,3,307,2,1,0.12
8,5,lonely,6,308,2,4,0.52
8,5,lot,3,309,2,1,0.44
8,5,loudly,6,310,2,4,0.56
8,5,marine,6,311,0,6,1.04
8,5,mark,4,312,3,1,0.28
8,5,married,7,313,3,4,0.68
8,5,maximum,7,314,2,5,0.64
8,5,meal,4,315,1,3,0.36
8,5,mean,4,316,3,1,0.28
8,5,melody,6,317,2,4,0.72
8,5,mental,6,318,2,4,1.16
8,5,mention,7,319,4,3,0.64
8,5,mentor,6,320,4,2,0.4
8,5,method,6,321,2,4,0.52
8,5,militia,7,322,1,6,0.76
8,5,mirror,6,323,2,4,0.52
8,5,mobilize,8,324,1,7,0.76
8,5,model,5,325,2,3,0.44
8,5,money,5,326,2,3,0.52
8,5,monthly,7,327,3,4,0.56
8,5,more,4,328,2,2,0.4
8,5,most,4,329,2,2,0.36
8,5,much,4,330,1,3,0.4
8,5,mum,3,331,2,1,0.24
8,5,museum,6,332,2,4,0.6
8,5,music,5,333,3,2,0.44
8,5,musician,8,334,5,3,0.56
8,5,naked,5,335,0,5,0.56
8,5,name,4,336,2,2,0.76
8,5,nature,6,337,2,4,0.76
8,5,neck,4,338,1,3,0.56
8,5,new,3,339,2,1,0.24
8,5,newly,5,340,3,2,0.36
8,5,night,5,341,1,4,0.76
8,5,noise,5,342,1,4,0.88
8,5,noisy,5,343,4,1,0.32
8,5,nominate,8,344,2,6,0.72
8,5,non,3,345,2,1,0.24
8,5,north,5,346,2,3,0.4
8,5,northern,8,347,5,3,0.64
8,5,not,3,348,2,1,0.24
8,5,nothing,7,349,3,4,0.56
8,5,novel,5,350,2,3,0.4
8,5,numerous,8,351,1,7,0.76
8,5,obesity,7,352,0,7,0.84
8,5,oblige,6,353,2,4,0.56
8,5,off,3,354,1,2,0.28
8,5,offence,7,355,3,4,0.56
8,5,offend,6,356,5,1,0.44
8,5,once,4,357,1,3,0.4
8,5,one,3,358,2,1,0.4
8,5,opposed,7,359,1,6,1.08
8,5,option,6,360,2,4,0.52
8,5,organic,7,361,1,6,0.76
8,5,other,5,362,1,4,0.52
8,5,ought,5,363,1,4,0.48
8,5,outdoor,7,364,2,5,0.6
8,5,outdoors,8,365,7,1,0.56
8,5,outlet,6,366,3,3,0.44
8,5,oversee,7,367,1,6,0.68
8,5,pack,4,368,0,4,0.44
8,5,pad,3,369,2,1,0.24
8,5,page,4,370,2,2,0.32
8,5,painful,7,371,2,5,0.72
8,5,paint,5,372,4,1,0.32
8,5,palace,6,373,2,4,0.96
8,5,parade,6,374,2,4,0.56
8,5,passport,8,375,2,6,1.04
8,5,password,8,376,4,4,1.04
8,5,patron,6,377,2,4,0.52
8,5,pause,5,378,2,3,0.44
8,5,peace,5,379,1,4,0.6
8,5,peaceful,8,380,5,3,0.52
8,5,peculiar,8,381,2,6,0.72
8,5,perceive,8,382,2,6,0.72
8,5,perfect,7,383,3,4,0.64
8,5,photo,5,384,1,4,0.48
8,5,picture,7,385,1,6,0.68
8,5,piece,5,386,2,3,0.4
8,5,pig,3,387,2,1,0.24
8,5,pile,4,388,2,2,0.44
8,5,pin,3,389,2,1,0.24
8,5,pioneer,7,390,2,5,0.6
8,5,pipe,4,391,2,2,0.32
8,5,plan,4,392,1,3,0.36
8,5,plane,5,393,4,1,0.4
8,5,pledge,6,394,2,4,0.52
8,5,plot,4,395,2,2,0.32
8,5,point,5,396,1,4,0.48
8,5,police,6,397,2,4,0.52
8,5,possess,7,398,2,5,0.72
8,5,possible,8,399,4,4,0.6
8,5,post,4,400,3,1,0.32
8,5,pot,3,401,2,1,0.24
8,5,precise,7,402,1,6,0.72
8,5,predict,7,403,3,4,0.68
8,5,pregnant,8,404,3,5,0.76
8,5,premise,7,405,3,4,0.92
8,5,presence,8,406,3,5,0.64
8,5,printer,7,407,2,5,0.72
8,5,printing,8,408,5,3,0.56
8,5,product,7,409,2,5,0.6
8,5,profile,7,410,3,4,0.64
8,5,program,7,411,3,4,0.56
8,5,project,7,412,3,4,0.6
8,5,proof,5,413,3,2,0.36
8,5,properly,8,414,3,5,0.64
8,5,protest,7,415,3,4,0.64
8,5,pursuit,7,416,1,6,0.68
8,5,push,4,417,2,2,0.32
8,5,quality,7,418,0,7,0.8
8,5,racial,6,419,0,6,0.72
8,5,rail,4,420,2,2,0.32
8,5,rating,6,421,2,4,0.52
8,5,realm,5,422,1,4,0.48
8,5,recount,7,423,2,5,0.72
8,5,reduce,6,424,2,4,0.52
8,5,refer,5,425,2,3,0.44
8,5,regard,6,426,2,4,0.52
8,5,regional,8,427,3,5,0.64
8,5,reign,5,428,2,3,0.52
8,5,relief,6,429,2,4,0.88
8,5,remark,6,430,2,4,0.52
8,5,remind,6,431,3,3,0.48
8,5,remove,6,432,3,3,0.56
8,5,republic,8,433,2,6,0.84
8,5,research,8,434,2,6,0.68
8,5,reside,6,435,3,3,0.48
8,5,resolve,7,436,3,4,0.72
8,5,rest,4,437,3,1,0.52
8,5,retire,6,438,2,4,0.52
8,5,revenge,7,439,2,5,0.72
8,5,rifle,5,440,1,4,0.88
8,5,rip,3,441,2,1,0.48
8,5,rival,5,442,2,3,0.52
8,5,roll,4,443,1,3,0.76
8,5,roof,4,444,2,2,0.44
8,5,root,4,445,3,1,0.28
8,5,round,5,446,2,3,0.4
8,5,routine,7,447,3,4,0.64
8,5,sailor,6,448,0,6,0.6
8,5,scan,4,449,1,3,0.36
8,5,scared,6,450,3,3,0.44
8,5,schedule,8,451,2,6,0.92
8,5,scheme,6,452,4,2,0.4
8,5,scholar,7,453,3,4,0.56
8,5,score,5,454,2,3,0.4
8,5,seal,4,455,1,3,0.36
8,5,second,6,456,2,4,0.84
8,5,seminar,7,457,2,5,0.6
8,5,serve,5,458,2,3,0.4
8,5,service,7,459,4,3,0.6
8,5,settler,7,460,2,5,0.72
8,5,sexual,6,461,2,4,0.52
8,5,shift,5,462,1,4,0.48
8,5,shoot,5,463,2,3,0.44
8,5,shopping,8,464,3,5,0.76
8,5,shore,5,465,3,2,0.48
8,5,shortly,7,466,4,3,0.52
8,5,silver,6,467,1,5,0.56
8,5,sin,3,468,2,1,0.24
8,5,singing,7,469,3,4,0.72
8,5,sink,4,470,3,1,0.28
8,5,sister,6,471,2,4,0.52
8,5,sit,3,472,2,1,0.24
8,5,situated,8,473,3,5,0.64
8,5,six,3,474,2,1,0.24
8,5,ski,3,475,1,2,0.4
8,5,skip,4,476,3,1,0.28
8,5,skirt,5,477,3,2,0.36
8,5,skull,5,478,2,3,0.4
8,5,slam,4,479,1,3,0.36
8,5,slice,5,480,2,3,0.44
8,5,slip,4,481,3,1,0.36
8,5,smoking,7,482,1,6,0.64
8,5,solo,4,483,1,3,0.36
8,5,some,4,484,2,2,0.32
8,5,somehow,7,485,4,3,0.48
8,5,soup,4,486,2,2,0.44
8,5,south,5,487,3,2,0.36
8,5,space,5,488,1,4,0.48
8,5,speaker,7,489,2,5,0.6
8,5,speech,6,490,3,3,0.64
8,5,sphere,6,491,2,4,0.8
8,5,stall,5,492,1,4,0.48
8,5,stamp,5,493,3,2,0.36
8,5,stance,6,494,3,3,0.44
8,5,stand,5,495,4,1,0.32
8,5,star,4,496,3,1,0.48
8,5,statue,6,497,3,3,0.6
8,5,stick,5,498,2,3,0.52
8,5,stop,4,499,2,2,0.44
8,5,story,5,500,3,2,0.44
8,5,straight,8,501,2,6,0.8
8,5,strategy,8,502,4,4,0.6
8,5,street,6,503,3,3,0.48
8,5,strike,6,504,3,3,0.44
8,5,string,6,505,4,2,0.52
8,5,strong,6,506,3,3,0.56
8,5,study,5,507,2,3,0.52
8,5,subject,7,508,1,6,0.76
8,5,sue,3,509,2,1,0.28
8,5,super,5,510,2,3,0.56
8,5,suppose,7,511,3,4,0.56
8,5,supreme,7,512,3,4,0.56
8,5,surgical,8,513,2,6,0.68
8,5,survival,8,514,3,5,0.76
8,5,swallow,7,515,1,6,0.68
8,5,sweep,5,516,2,3,0.44
8,5,swim,4,517,2,2,0.32
8,5,symbolic,8,518,1,7,0.92
8,5,sympathy,8,519,3,5,0.68
8,5,tail,4,520,0,4,0.44
8,5,talent,6,521,2,4,0.52
8,5,tap,3,522,2,1,0.24
8,5,tape,4,523,3,1,0.36
8,5,taste,5,524,2,3,0.44
8,5,taxi,4,525,2,2,0.32
8,5,tea,3,526,1,2,0.28
8,5,team,4,527,3,1,0.28
8,5,tempt,5,528,2,3,0.48
8,5,tender,6,529,2,4,0.64
8,5,tension,7,530,3,4,0.56
8,5,terribly,8,531,2,6,0.68
8,5,terrific,8,532,5,3,0.8
8,5,terror,6,533,4,2,0.48
8,5,textbook,8,534,2,6,0.36
8,5,thereby,7,535,1,6,0.28
8,5,this,4,536,2,2,0.16
8,5,three,5,537,2,3,0.2
8,5,thrilled,8,538,3,5,0.36
8,5,tight,5,539,1,4,0.2
8,5,tighten,7,540,5,2,0.2
8,5,timing,6,541,2,4,0.24
8,5,to,2,542,1,1,0.16
8,5,together,8,543,2,6,0.32
8,5,tonight,7,544,2,5,0.28
8,5,tonne,5,545,3,2,0.16
8,5,too,3,546,2,1,0.12
8,5,tool,4,547,3,1,0.2
8,5,topic,5,548,2,3,0.2
8,5,trap,4,549,1,3,0.24
8,5,treasure,8,550,2,6,0.32
8,5,treat,5,551,4,1,0.16
8,5,treaty,6,552,5,1,0.24
8,5,trend,5,553,3,2,0.16
8,5,trial,5,554,2,3,0.2
8,5,tribe,5,555,3,2,0.16
8,5,tribute,7,556,4,3,0.24
8,5,tropical,8,557,2,6,0.36
8,5,trousers,8,558,3,5,0.28
8,5,truck,5,559,2,3,0.2
8,5,tune,4,560,1,3,0.16
8,5,ultimate,8,561,0,8,0.44
8,5,unable,6,562,1,5,0.28
8,5,unfair,6,563,2,4,0.24
8,5,unify,5,564,2,3,0.2
8,5,union,5,565,3,2,0.16
8,5,unveil,6,566,2,4,0.32
8,5,upgrade,7,567,1,6,0.28
8,5,upon,4,568,2,2,0.16
8,5,usage,5,569,1,4,0.2
8,5,usual,5,570,2,3,0.24
8,5,utility,7,571,1,6,0.32
8,5,utilize,7,572,5,2,0.2
8,5,validity,8,573,0,8,0.4
8,5,valley,6,574,3,3,0.32
8,5,valuable,8,575,3,5,0.28
8,5,variety,7,576,2,5,0.28
8,5,venture,7,577,1,6,0.6
8,5,verify,6,578,2,4,0.32
8,5,vessel,6,579,2,4,0.24
8,5,viable,6,580,1,5,0.24
8,5,video,5,581,2,3,0.2
8,5,viewer,6,582,2,4,0.24
8,5,villager,8,583,2,6,0.4
8,5,violent,7,584,2,5,0.28
8,5,virtue,6,585,2,4,0.24
8,5,voice,5,586,1,4,0.2
8,5,waiter,6,587,0,6,0.36
8,5,wake,4,588,2,2,0.16
8,5,war,3,589,2,1,0.12
8,5,warrior,7,590,3,4,0.24
8,5,water,5,591,2,3,0.2
8,5,way,3,592,2,1,0.2
8,5,weave,5,593,1,4,0.24
8,5,weekend,7,594,2,5,0.28
8,5,weight,6,595,2,4,0.24
8,5,welcome,7,596,2,5,0.28
8,5,whose,5,597,1,4,0.28
8,5,width,5,598,1,4,0.2
8,5,wildlife,8,599,2,6,0.32
8,5,willing,7,600,3,4,0.24
8,5,wind,4,601,2,2,0.2
8,5,window,6,602,4,2,0.2
8,5,wine,4,603,3,1,0.12
8,5,wipe,4,604,2,2,0.16
8,5,without,7,605,2,5,0.28
8,5,woman,5,606,1,4,0.28
8,5,work,4,607,2,2,0.16
8,5,world,5,608,3,2,0.16
8,5,worry,5,609,3,2,0.2
8,5,wrap,4,610,1,3,0.16
8,5,written,7,611,2,5,0.36
8,6,a,1,0,0,1,0.16
8,6,absence,7,1,1,6,0.64
8,6,accept,6,2,1,5,0.56
8,6,accident,8,3,3,5,0.64
8,6,acre,4,4,2,2,0.48
8,6,activate,8,5,2,6,0.68
8,6,actress,7,6,3,4,0.56
8,6,acute,5,7,2,3,0.4
8,6,ad,2,8,1,1,0.2
8,6,admit,5,9,2,3,0.52
8,6,adoption,8,10,2,6,0.72
8,6,against,7,11,1,6,0.64
8,6,aids,4,12,1,3,0.36
8,6,alcohol,7,13,1,6,0.92
8,6,align,5,14,2,3,0.4
8,6,ally,4,15,2,2,0.32
8,6,amateur,7,16,1,6,0.68
8,6,amusing,7,17,2,5,0.6
8,6,annoying,8,18,1,7,0.88
8,6,anxiety,7,19,2,5,0.6
8,6,anybody,7,20,2,5,0.6
8,6,apology,7,21,1,6,0.76
8,6,approach,8,22,2,6,0.72
8,6,approve,7,23,5,2,0.44
8,6,arguably,8,24,1,7,0.76
8,6,arms,4,25,2,2,0.44
8,6,army,4,26,3,1,0.28
8,6,arrest,6,27,2,4,0.52
8,6,artistic,8,28,2,6,0.72
8,6,atrocity,8,29,1,7,0.92
8,6,auction,7,30,1,6,0.64
8,6,average,7,31,1,6,0.76
8,6,baby,4,32,0,4,0.48
8,6,backing,7,33,2,5,0.64
8,6,bacteria,8,34,3,5,0.76
8,6,ballet,6,35,2,4,0.6
8,6,base,4,36,2,2,0.32
8,6,bath,4,37,2,2,0.32
8,6,beat,4,38,1,3,0.44
8,6,beauty,6,39,3,3,0.56
8,6,bed,3,40,2,1,0.24
8,6,belief,6,41,2,4,0.52
8,6,bell,4,42,3,1,0.28
8,6,belong,6,43,3,3,0.64
8,6,best,4,44,2,2,0.48
8,6,betray,6,45,2,4,0.76
8,6,biscuit,7,46,1,6,0.92
8,6,bitter,6,47,2,4,0.68
8,6,bizarre,7,48,2,5,0.76
8,6,blade,5,49,1,4,0.48
8,6,blank,5,50,3,2,0.36
8,6,bless,5,51,2,3,0.8
8,6,blog,4,52,2,2,0.32
8,6,blow,4,53,3,1,0.28
8,6,bomb,4,54,1,3,0.64
8,6,boom,4,55,2,2,0.48
8,6,boost,5,56,3,2,0.76
8,6,bother,6,57,2,4,0.52
8,6,bottle,6,58,3,3,0.52
8,6,bright,6,59,1,5,0.96
8,6,buddy,5,60,1,4,0.48
8,6,build,5,61,2,3,0.68
8,6,burden,6,62,2,4,0.6
8,6,cafe,4,63,0,4,0.44
8,6,cake,4,64,2,2,0.44
8,6,cancer,6,65,2,4,0.52
8,6,capable,7,66,2,5,0.76
8,6,card,4,67,2,2,0.32
8,6,careful,7,68,3,4,0.96
8,6,carve,5,69,3,2,0.6
8,6,category,8,70,2,6,0.96
8,6,cave,4,71,2,2,0.32
8,6,central,7,72,1,6,0.64
8,6,ceremony,8,73,2,6,1.16
8,6,chapter,7,74,1,6,0.96
8,6,charming,8,75,3,5,1.12
8,6,cheerful,8,76,2,6,0.96
8,6,chicken,7,77,2,5,0.64
8,6,chronic,7,78,2,5,0.6
8,6,circuit,7,79,1,6,0.88
8,6,cite,4,80,2,2,0.32
8,6,civil,5,81,2,3,0.52
8,6,clarity,7,82,1,6,0.92
8,6,clause,6,83,3,3,0.44
8,6,clean,5,84,2,3,0.44
8,6,club,4,85,2,2,0.44
8,6,coach,5,86,1,4,0.48
8,6,coffee,6,87,2,4,0.52
8,6,colony,6,88,2,4,0.52
8,6,comedy,6,89,2,4,0.52
8,6,comfort,7,90,3,4,0.72
8,6,comment,7,91,3,4,0.56
8,6,commonly,8,92,4,4,0.6
8,6,comply,6,93,3,3,0.44
8,6,conceal,7,94,2,5,0.76
8,6,conceive,8,95,5,3,0.52
8,6,concept,7,96,5,2,0.64
8,6,concern,7,97,5,2,0.76
8,6,conduct,7,98,3,4,0.84
8,6,confer,6,99,3,3,0.44
8,6,confess,7,100,5,2,0.48
8,6,consent,7,101,3,4,0.6
8,6,contempt,8,102,3,5,0.8
8,6,contend,7,103,5,2,0.44
8,6,contrast,8,104,4,4,0.6
8,6,convey,6,105,3,3,0.48
8,6,cooker,6,106,2,4,0.64
8,6,cope,4,107,2,2,0.52
8,6,correct,7,108,2,5,0.6
8,6,cost,4,109,2,2,0.32
8,6,counter,7,110,2,5,0.6
8,6,coup,4,111,3,1,0.36
8,6,course,6,112,3,3,0.64
8,6,court,5,113,4,1,0.32
8,6,creep,5,114,1,4,0.48
8,6,crime,5,115,2,3,0.44
8,6,crisis,6,116,3,3,0.56
8,6,cross,5,117,2,3,0.44
8,6,crude,5,118,2,3,0.4
8,6,cruel,5,119,3,2,0.36
8,6,cruise,6,120,3,3,0.48
8,6,currency,8,121,1,7,0.88
8,6,curved,6,122,3,3,0.44
8,6,cycle,5,123,1,4,0.48
8,6,dam,3,124,0,3,0.36
8,6,december,8,125,1,7,1.2
8,6,deem,4,126,2,2,0.32
8,6,deliver,7,127,2,5,0.6
8,6,deputy,6,128,2,4,0.52
8,6,desktop,7,129,2,5,0.64
8,6,despite,7,130,3,4,0.68
8,6,detect,6,131,2,4,0.52
8,6,develop,7,132,2,5,0.6
8,6,devil,5,133,3,2,0.36
8,6,dinner,6,134,1,5,0.96
8,6,dirt,4,135,2,2,0.52
8,6,disabled,8,136,2,6,0.76
8,6,discount,8,137,3,5,0.76
8,6,display,7,138,3,4,0.8
8,6,distant,7,139,3,4,0.64
8,6,divine,6,140,2,4,0.28
8,6,divorced,8,141,3,5,0.32
8,6,dollar,6,142,1,5,0.4
8,6,domain,6,143,2,4,0.28
8,6,dominant,8,144,3,5,0.6
8,6,dot,3,145,2,1,0.24
8,6,double,6,146,2,4,0.28
8,6,download,8,147,2,6,0.4
8,6,duration,8,148,1,7,0.36
8,6,ear,3,149,0,3,0.16
8,6,earnings,8,150,3,5,0.32
8,6,edition,7,151,1,6,0.36
8,6,editor,6,152,4,2,0.2
8,6,embark,6,153,1,5,0.24
8,6,emission,8,154,2,6,0.32
8,6,emotion,7,155,2,5,0.32
8,6,empower,7,156,2,5,0.28
8,6,endless,7,157,1,6,0.28
8,6,engineer,8,158,2,6,0.36
8,6,enjoy,5,159,2,3,0.2
8,6,enter,5,160,2,3,0.2
8,6,entitle,7,161,3,4,0.24
8,6,entrance,8,162,3,5,0.28
8,6,entry,5,163,4,1,0.2
8,6,equality,8,164,1,7,0.32
8,6,essay,5,165,1,4,0.2
8,6,essence,7,166,3,4,0.24
8,6,euro,4,167,1,3,0.24
8,6,evening,7,168,1,6,0.28
8,6,evoke,5,169,2,3,0.16
8,6,examine,7,170,1,6,0.28
8,6,exceed,6,171,2,4,0.28
8,6,exciting,8,172,3,5,0.28
8,6,excuse,6,173,3,3,0.2
8,6,exploit,7,174,2,5,0.24
8,6,extend,6,175,2,4,0.28
8,6,eye,3,176,1,2,0.12
8,6,faculty,7,177,0,7,0.28
8,6,fail,4,178,2,2,0.16
8,6,fairly,6,179,3,3,0.2
8,6,fall,4,180,2,2,0.12
8,6,fasten,6,181,2,4,0.28
8,6,fear,4,182,1,3,0.16
8,6,fee,3,183,2,1,0.12
8,6,feeding,7,184,3,4,0.24
8,6,few,3,185,2,1,0.12
8,6,fibre,5,186,1,4,0.28
8,6,file,4,187,2,2,0.16
8,6,finally,7,188,2,5,0.24
8,6,fine,4,189,3,1,0.12
8,6,fixed,5,190,2,3,0.16
8,6,flat,4,191,1,3,0.16
8,6,flee,4,192,2,2,0.2
8,6,floor,5,193,2,3,0.16
8,6,flu,3,194,2,1,0.08
8,6,flying,6,195,2,4,0.2
8,6,focus,5,196,1,4,0.2
8,6,folding,7,197,2,5,0.32
8,6,folk,4,198,3,1,0.12
8,6,for,3,199,2,1,0.08
8,6,foreign,7,200,3,4,0.24
8,6,formula,7,201,3,4,0.24
8,6,fortune,7,202,3,4,0.28
8,6,forward,7,203,3,4,0.24
8,6,founder,7,204,2,5,0.24
8,6,freedom,7,205,1,6,0.28
8,6,friday,6,206,2,4,0.28
8,6,fridge,6,207,4,2,0.16
8,6,friendly,8,208,3,5,0.28
8,6,frighten,8,209,3,5,0.28
8,6,front,5,210,2,3,0.24
8,6,funding,7,211,1,6,0.28
8,6,gaming,6,212,0,6,0.28
8,6,garage,6,213,2,4,0.24
8,6,gender,6,214,1,5,0.32
8,6,generate,8,215,3,5,0.28
8,6,genre,5,216,3,2,0.16
8,6,glass,5,217,1,4,0.2
8,6,glimpse,7,218,2,5,0.32
8,6,globe,5,219,2,3,0.16
8,6,go,2,220,1,1,0.08
8,6,gold,4,221,2,2,0.12
8,6,golf,4,222,3,1,0.12
8,6,goodbye,7,223,2,5,0.24
8,6,governor,8,224,2,6,0.36
8,6,grade,5,225,1,4,0.2
8,6,grey,4,226,2,2,0.12
8,6,grid,4,227,2,2,0.12
8,6,grief,5,228,3,2,0.16
8,6,grind,5,229,3,2,0.24
8,6,ground,6,230,2,4,0.2
8,6,guess,5,231,1,4,0.2
8,6,guest,5,232,4,1,0.16
8,6,guidance,8,233,2,6,0.36
8,6,guide,5,234,4,1,0.2
8,6,guitar,6,235,3,3,0.2
8,6,guy,3,236,2,1,0.12
8,6,gym,3,237,1,2,0.12
8,6,hair,4,238,0,4,0.2
8,6,handy,5,239,2,3,0.24
8,6,happen,6,240,2,4,0.24
8,6,harbour,7,241,2,5,0.24
8,6,harm,4,242,3,1,0.12
8,6,harsh,5,243,3,2,0.16
8,6,hazard,6,244,2,4,0.28
8,6,headline,8,245,1,7,0.32
8,6,health,6,246,3,3,0.2
8,6,her,3,247,2,1,0.08
8,6,herb,4,248,3,1,0.12
8,6,horror,6,249,1,5,0.28
8,6,hotel,5,250,2,3,0.2
8,6,how,3,251,2,1,0.08
8,6,humanity,8,252,1,7,0.32
8,6,humour,6,253,3,3,0.2
8,6,hydrogen,8,254,1,7,0.36
8,6,icon,4,255,0,4,0.2
8,6,ideal,5,256,1,4,0.2
8,6,identity,8,257,3,5,0.28
8,6,illegal,7,258,1,6,0.36
8,6,image,5,259,1,4,0.2
8,6,imagery,7,260,5,2,0.2
8,6,improve,7,261,2,5,0.24
8,6,incur,5,262,1,4,0.28
8,6,indicate,8,263,2,6,0.32
8,6,indirect,8,264,4,4,0.24
8,6,inject,6,265,2,4,0.2
8,6,insert,6,266,2,4,0.28
8,6,inspect,7,267,3,4,0.24
8,6,instant,7,268,3,4,0.24
8,6,instruct,8,269,4,4,0.24
8,6,integral,8,270,2,6,0.52
8,6,into,4,271,3,1,0.12
8,6,invade,6,272,2,4,0.2
8,6,involved,8,273,3,5,0.28
8,6,iron,4,274,1,3,0.16
8,6,issue,5,275,1,4,0.28
8,6,january,7,276,0,7,0.32
8,6,jet,3,277,1,2,0.12
8,6,june,4,278,1,3,0.16
8,6,king,4,279,0,4,0.2
8,6,knife,5,280,1,4,0.28
8,6,know,4,281,2,2,0.12
8,6,lack,4,282,0,4,0.2
8,6,lap,3,283,2,1,0.08
8,6,laser,5,284,2,3,0.2
8,6,layer,5,285,2,3,0.2
8,6,leading,7,286,1,6,0.36
8,6,leaf,4,287,3,1,0.12
8,6,learning,8,288,3,5,0.28
8,6,legend,6,289,2,4,0.2
8,6,lesbian,7,290,2,5,0.36
8,6,lethal,6,291,2,4,0.24
8,6,letter,6,292,3,3,0.2
8,6,limb,4,293,1,3,0.16
8,6,limited,7,294,3,4,0.32
8,6,link,4,295,2,2,0.16
8,6,lion,4,296,2,2,0.12
8,6,little,6,297,2,4,0.24
8,6,live,4,298,2,2,0.16
8,6,load,4,299,1,3,0.16
8,6,local,5,300,2,3,0.24
8,6,located,7,301,4,3,0.2
8,6,location,8,302,5,3,0.24
8,6,long,4,303,2,2,0.16
8,6,look,4,304,2,2,0.12
8,6,loose,5,305,3,2,0.2
8,6,loudly,6,306,2,4,0.2
8,6,love,4,307,2,2,0.16
8,6,low,3,308,2,1,0.08
8,6,lunch,5,309,1,4,0.2
8,6,mail,4,310,0,4,0.2
8,6,map,3,311,2,1,0.16
8,6,marine,6,312,2,4,0.2
8,6,married,7,313,3,4,0.24
8,6,mask,4,314,2,2,0.12
8,6,maximum,7,315,2,5,0.24
8,6,mean,4,316,1,3,0.24
8,6,meeting,7,317,2,5,0.28
8,6,melody,6,318,2,4,0.2
8,6,memory,6,319,2,4,0.24
8,6,merely,6,320,2,4,0.28
8,6,mess,4,321,2,2,0.16
8,6,method,6,322,2,4,0.24
8,6,metre,5,323,3,2,0.16
8,6,midnight,8,324,1,7,0.36
8,6,minister,8,325,2,6,0.4
8,6,missing,7,326,2,5,0.32
8,6,model,5,327,1,4,0.2
8,6,moment,6,328,2,4,0.24
8,6,monthly,7,329,2,5,0.32
8,6,monument,8,330,3,5,0.28
8,6,more,4,331,2,2,0.16
8,6,most,4,332,2,2,0.16
8,6,multiple,8,333,1,7,0.4
8,6,museum,6,334,2,4,0.24
8,6,music,5,335,3,2,0.16
8,6,musician,8,336,5,3,0.24
8,6,my,2,337,1,1,0.08
8,6,naked,5,338,0,5,0.28
8,6,name,4,339,2,2,0.12
8,6,nasty,5,340,2,3,0.16
8,6,nation,6,341,2,4,0.24
8,6,nature,6,342,3,3,0.2
8,6,needle,6,343,1,5,0.32
8,6,new,3,344,2,1,0.08
8,6,newly,5,345,3,2,0.16
8,6,nominate,8,346,1,7,0.36
8,6,normal,6,347,2,4,0.24
8,6,not,3,348,2,1,0.16
8,6,nothing,7,349,3,4,0.24
8,6,notice,6,350,3,3,0.2
8,6,notion,6,351,4,2,0.16
8,6,numerous,8,352,1,7,0.4
8,6,nut,3,353,2,1,0.08
8,6,oblige,6,354,0,6,0.28
8,6,ocean,5,355,1,4,0.2
8,6,off,3,356,1,2,0.12
8,6,official,8,357,3,5,0.36
8,6,once,4,358,1,3,0.16
8,6,online,6,359,2,4,0.2
8,6,opponent,8,360,1,7,0.32
8,6,opposed,7,361,4,3,0.2
8,6,option,6,362,2,4,0.28
8,6,organic,7,363,1,6,0.28
8,6,ought,5,364,1,4,0.2
8,6,outing,6,365,2,4,0.24
8,6,overall,7,366,1,6,0.36
8,6,owe,3,367,1,2,0.12
8,6,pack,4,368,0,4,0.2
8,6,paint,5,369,2,3,0.2
8,6,pants,5,370,2,3,0.16
8,6,parade,6,371,2,4,0.32
8,6,parallel,8,372,4,4,0.24
8,6,partner,7,373,3,4,0.24
8,6,patron,6,374,2,4,0.24
8,6,pause,5,375,2,3,0.24
8,6,peace,5,376,1,4,0.2
8,6,peaceful,8,377,5,3,0.24
8,6,peculiar,8,378,2,6,0.28
8,6,peer,4,379,2,2,0.12
8,6,perhaps,7,380,2,5,0.32
8,6,phone,5,381,1,4,0.2
8,6,photo,5,382,3,2,0.16
8,6,picture,7,383,1,6,0.32
8,6,piece,5,384,2,3,0.24
8,6,pig,3,385,2,1,0.12
8,6,pin,3,386,2,1,0.08
8,6,pioneer,7,387,2,5,0.28
8,6,pipe,4,388,2,2,0.12
8,6,place,5,389,1,4,0.2
8,6,planning,8,390,3,5,0.36
8,6,plant,5,391,4,1,0.12
8,6,pleased,7,392,2,5,0.24
8,6,pledge,6,393,3,3,0.2
8,6,plot,4,394,2,2,0.2
8,6,pond,4,395,1,3,0.16
8,6,possess,7,396,2,5,0.24
8,6,precise,7,397,1,6,0.28
8,6,predict,7,398,3,4,0.24
8,6,process,7,399,2,5,0.32
8,6,product,7,400,3,4,0.24
8,6,profound,8,401,3,5,0.28
8,6,project,7,402,3,4,0.32
8,6,pupil,5,403,1,4,0.2
8,6,pure,4,404,2,2,0.12
8,6,purpose,7,405,3,4,0.24
8,6,put,3,406,2,1,0.12
8,6,puzzle,6,407,2,4,0.24
8,6,quality,7,408,0,7,0.36
8,6,quantity,8,409,3,5,0.28
8,6,query,5,410,2,3,0.16
8,6,racism,6,411,0,6,0.28
8,6,raise,5,412,2,3,0.24
8,6,rally,5,413,2,3,0.2
8,6,rather,6,414,2,4,0.2
8,6,rating,6,415,3,3,0.2
8,6,realm,5,416,1,4,0.28
8,6,rear,4,417,3,1,0.12
8,6,recount,7,418,2,5,0.24
8,6,recycle,7,419,3,4,0.24
8,6,reduce,6,420,2,4,0.2
8,6,refer,5,421,2,3,0.24
8,6,referee,7,422,5,2,0.2
8,6,refuse,6,423,3,3,0.2
8,6,regime,6,424,2,4,0.2
8,6,reign,5,425,2,3,0.2
8,6,relative,8,426,2,6,0.36
8,6,relax,5,427,4,1,0.12
8,6,relaxed,7,428,5,2,0.2
8,6,relief,6,429,3,3,0.2
8,6,remind,6,430,2,4,0.28
8,6,remove,6,431,3,3,0.2
8,6,repeat,6,432,2,4,0.2
8,6,replace,7,433,3,4,0.24
8,6,republic,8,434,3,5,0.32
8,6,research,8,435,2,6,0.28
8,6,reside,6,436,3,3,0.2
8,6,residue,7,437,5,2,0.2
8,6,rest,4,438,3,1,0.16
8,6,retail,6,439,2,4,0.2
8,6,retire,6,440,3,3,0.2
8,6,retrieve,8,441,3,5,0.28
8,6,reveal,6,442,2,4,0.24
8,6,revise,6,443,3,3,0.24
8,6,revision,8,444,5,3,0.24
8,6,revival,7,445,4,3,0.2
8,6,rifle,5,446,1,4,0.2
8,6,right,5,447,2,3,0.24
8,6,rise,4,448,2,2,0.12
8,6,ritual,6,449,2,4,0.2
8,6,rival,5,450,2,3,0.16
8,6,rob,3,451,1,2,0.12
8,6,robbery,7,452,3,4,0.32
8,6,romance,7,453,2,5,0.28
8,6,root,4,454,2,2,0.16
8,6,rough,5,455,2,3,0.2
8,6,routine,7,456,3,4,0.24
8,6,rub,3,457,1,2,0.2
8,6,rubbish,7,458,3,4,0.24
8,6,ruin,4,459,2,2,0.16
8,6,sacred,6,460,0,6,0.28
8,6,salt,4,461,2,2,0.16
8,6,sample,6,462,2,4,0.28
8,6,sand,4,463,2,2,0.16
8,6,scan,4,464,1,3,0.16
8,6,scared,6,465,3,3,0.2
8,6,schedule,8,466,2,6,0.28
8,6,scheme,6,467,4,2,0.24
8,6,scholar,7,468,3,4,0.24
8,6,school,6,469,4,2,0.16
8,6,seem,4,470,1,3,0.16
8,6,segment,7,471,2,5,0.32
8,6,serious,7,472,2,5,0.28
8,6,service,7,473,3,4,0.24
8,6,settler,7,474,2,5,0.24
8,6,seven,5,475,2,3,0.2
8,6,sexy,4,476,2,2,0.2
8,6,shape,5,477,1,4,0.24
8,6,share,5,478,3,2,0.2
8,6,shell,5,479,2,3,0.2
8,6,ship,4,480,2,2,0.12
8,6,shipping,8,481,4,4,0.32
8,6,shopping,8,482,2,6,0.28
8,6,shortage,8,483,3,5,0.28
8,6,shortly,7,484,5,2,0.2
8,6,silver,6,485,1,5,0.32
8,6,simply,6,486,2,4,0.2
8,6,sin,3,487,2,1,0.08
8,6,singing,7,488,3,4,0.24
8,6,sink,4,489,3,1,0.12
8,6,sister,6,490,2,4,0.28
8,6,sit,3,491,2,1,0.08
8,6,situated,8,492,3,5,0.28
8,6,six,3,493,2,1,0.08
8,6,ski,3,494,1,2,0.12
8,6,skull,5,495,2,3,0.24
8,6,slice,5,496,1,4,0.4
8,6,smoking,7,497,1,6,0.68
8,6,snow,4,498,1,3,0.4
8,6,some,4,499,1,3,0.36
8,6,song,4,500,2,2,0.32
8,6,south,5,501,2,3,0.52
8,6,space,5,502,1,4,0.48
8,6,specify,7,503,2,5,0.6
8,6,sphere,6,504,2,4,0.52
8,6,stab,4,505,1,3,0.52
8,6,staff,5,506,3,2,0.36
8,6,stamp,5,507,3,2,0.36
8,6,stance,6,508,3,3,0.44
8,6,stand,5,509,4,1,0.32
8,6,star,4,510,3,1,0.28
8,6,steadily,8,511,2,6,0.88
8,6,steer,5,512,3,2,0.44
8,6,stem,4,513,3,1,0.32
8,6,stick,5,514,2,3,0.48
8,6,sticky,6,515,5,1,0.44
8,6,stop,4,516,2,2,0.44
8,6,straight,8,517,2,6,0.72
8,6,strategy,8,518,4,4,0.64
8,6,strength,8,519,3,5,0.64
8,6,stretch,7,520,4,3,0.6
8,6,strict,6,521,3,3,0.44
8,6,strike,6,522,4,2,0.4
8,6,striking,8,523,5,3,0.52
8,6,studio,6,524,2,4,0.64
8,6,study,5,525,4,1,0.36
8,6,stumble,7,526,3,4,0.64
8,6,stun,4,527,3,1,0.32
8,6,sue,3,528,1,2,0.32
8,6,sugar,5,529,2,3,0.56
8,6,suppose,7,530,2,5,0.64
8,6,sure,4,531,2,2,0.32
8,6,surely,6,532,4,2,0.44
8,6,survival,8,533,3,5,0.68
8,6,swallow,7,534,1,6,0.76
8,6,sweater,7,535,2,5,0.6
8,6,switch,6,536,2,4,0.52
8,6,sympathy,8,537,1,7,0.76
8,6,table,5,538,0,5,0.64
8,6,tail,4,539,2,2,0.32
8,6,talk,4,540,2,2,0.32
8,6,tank,4,541,2,2,0.32
8,6,tap,3,542,2,1,0.24
8,6,tape,4,543,3,1,0.28
8,6,task,4,544,2,2,0.44
8,6,tea,3,545,1,2,0.28
8,6,team,4,546,3,1,0.28
8,6,tempt,5,547,2,3,0.44
8,6,tendency,8,548,2,6,0.72
8,6,tension,7,549,3,4,0.64
8,6,terribly,8,550,2,6,0.72
8,6,thesis,6,551,1,5,0.56
8,6,thirsty,7,552,2,5,0.6
8,6,this,4,553,3,1,0.36
8,6,thorough,8,554,2,6,0.72
8,6,three,5,555,2,3,0.44
8,6,thrilled,8,556,3,5,0.72
8,6,thumb,5,557,2,3,0.6
8,6,ticket,6,558,1,5,0.6
8,6,timing,6,559,2,4,0.52
8,6,to,2,560,1,1,0.2
8,6,together,8,561,2,6,0.72
8,6,tool,4,562,2,2,0.44
8,6,torture,7,563,2,5,0.64
8,6,tour,4,564,2,2,0.32
8,6,tragic,6,565,1,5,1.04
8,6,trap,4,566,3,1,0.52
8,6,treat,5,567,2,3,0.52
8,6,treaty,6,568,5,1,0.36
8,6,tribal,6,569,2,4,0.52
8,6,tribute,7,570,4,3,0.48
8,6,tropical,8,571,2,6,0.72
8,6,trouble,7,572,3,4,0.76
8,6,truck,5,573,2,3,0.52
8,6,twice,5,574,1,4,0.6
8,6,two,3,575,2,1,0.28
8,6,ultimate,8,576,0,8,0.96
8,6,unable,6,577,1,5,0.6
8,6,undergo,7,578,2,5,0.64
8,6,unify,5,579,2,3,0.44
8,6,unusual,7,580,2,5,0.76
8,6,upgrade,7,581,1,6,0.68
8,6,uphold,6,582,2,4,0.52
8,6,upon,4,583,2,2,0.32
8,6,urban,5,584,1,4,0.48
8,6,usage,5,585,1,4,0.6
8,6,usual,5,586,2,3,0.44
8,6,utility,7,587,1,6,0.76
8,6,utilize,7,588,5,2,0.48
8,6,validity,8,589,0,8,1.12
8,6,vary,4,590,2,2,0.32
8,6,vessel,6,591,1,5,0.56
8,6,video,5,592,1,4,0.48
8,6,virus,5,593,2,3,0.44
8,6,visitor,7,594,2,5,0.76
8,6,vital,5,595,2,3,0.48
8,6,waiter,6,596,0,6,0.76
8,6,walk,4,597,2,2,0.36
8,6,water,5,598,2,3,0.44
8,6,weave,5,599,1,4,0.64
8,6,welcome,7,600,2,5,0.64
8,6,welfare,7,601,3,4,0.6
8,6,whenever,8,602,1,7,0.76
8,6,willing,7,603,1,6,0.8
8,6,window,6,604,2,4,0.52
8,6,within,6,605,2,4,0.56
8,6,woman,5,606,1,4,0.56
8,6,word,4,607,2,2,0.36
8,6,world,5,608,3,2,0.48
8,6,wow,3,609,2,1,0.24
8,6,wrap,4,610,1,3,0.4
8,6,written,7,611,2,5,0.6
8,7,absorb,6,0,0,6,0.28
8,7,academic,8,1,1,7,0.4
8,7,accept,6,2,2,4,0.2
8,7,accident,8,3,3,5,0.28
8,7,accurate,8,4,3,5,0.28
8,7,acid,4,5,2,2,0.2
8,7,actress,7,6,2,5,0.24
8,7,add,3,7,1,2,0.12
8,7,adj,3,8,2,1,0.08
8,7,adopt,5,9,2,3,0.2
8,7,advice,6,10,2,4,0.28
8,7,agree,5,11,1,4,0.2
8,7,aids,4,12,1,3,0.16
8,7,align,5,13,1,4,0.2
8,7,analysis,8,14,1,7,0.32
8,7,ancient,7,15,2,5,0.36
8,7,and,3,16,2,1,0.12
8,7,anger,5,17,2,3,0.2
8,7,annoyed,7,18,2,5,0.28
8,7,annoying,8,19,5,3,0.32
8,7,anxiety,7,20,2,5,0.24
8,7,anyway,6,21,2,4,0.24
8,7,applaud,7,22,1,6,0.28
8,7,approach,8,23,3,5,0.36
8,7,arise,5,24,1,4,0.2
8,7,arms,4,25,2,2,0.12
8,7,army,4,26,3,1,0.12
8,7,arrow,5,27,2,3,0.44
8,7,artistic,8,28,2,6,0.88
8,7,ask,3,29,1,2,0.28
8,7,at,2,30,1,1,0.2
8,7,average,7,31,1,6,0.68
8,7,backing,7,32,0,7,0.76
8,7,bacteria,8,33,3,5,0.8
8,7,ballet,6,34,2,4,0.52
8,7,banner,6,35,2,4,0.52
8,7,barrel,6,36,2,4,0.52
8,7,bath,4,37,2,2,0.44
8,7,bay,3,38,2,1,0.24
8,7,beast,5,39,1,4,0.48
8,7,beauty,6,40,3,3,0.52
8,7,bed,3,41,2,1,0.24
8,7,beer,4,42,2,2,0.32
8,7,bell,4,43,2,2,0.44
8,7,belong,6,44,3,3,0.48
8,7,best,4,45,2,2,0.32
8,7,betray,6,46,2,4,0.52
8,7,between,7,47,3,4,0.56
8,7,beyond,6,48,2,4,0.64
8,7,bin,3,49,1,2,0.28
8,7,bird,4,50,2,2,0.32
8,7,biscuit,7,51,2,5,0.6
8,7,blade,5,52,1,4,0.48
8,7,blank,5,53,3,2,0.52
8,7,blind,5,54,2,3,0.4
8,7,blow,4,55,2,2,0.32
8,7,boat,4,56,1,3,0.4
8,7,boot,4,57,2,2,0.32
8,7,bound,5,58,2,3,0.4
8,7,boundary,8,59,5,3,0.72
8,7,box,3,60,2,1,0.24
8,7,breach,6,61,1,5,0.64
8,7,break,5,62,4,1,0.36
8,7,bright,6,63,2,4,0.6
8,7,broken,6,64,2,4,0.64
8,7,buddy,5,65,1,4,0.48
8,7,bug,3,66,2,1,0.24
8,7,build,5,67,2,3,0.44
8,7,cake,4,68,0,4,0.48
8,7,cap,3,69,2,1,0.28
8,7,capable,7,70,3,4,0.68
8,7,careful,7,71,2,5,0.6
8,7,cartoon,7,72,3,4,0.56
8,7,cd,2,73,1,1,0.2
8,7,cease,5,74,1,4,0.68
8,7,ceiling,7,75,2,5,0.64
8,7,century,7,76,2,5,0.6
8,7,chapter,7,77,1,6,0.68
8,7,charm,5,78,3,2,0.36
8,7,charter,7,79,4,3,0.64
8,7,cheat,5,80,2,3,0.6
8,7,check,5,81,3,2,0.64
8,7,cheerful,8,82,3,5,0.72
8,7,chronic,7,83,2,5,0.96
8,7,chunk,5,84,2,3,0.44
8,7,circle,6,85,1,5,0.56
8,7,circuit,7,86,4,3,0.48
8,7,cite,4,87,2,2,0.32
8,7,city,4,88,3,1,0.4
8,7,clearly,7,89,1,6,0.68
8,7,coffee,6,90,1,5,0.6
8,7,coincide,8,91,2,6,0.84
8,7,comedy,6,92,2,4,0.68
8,7,comfort,7,93,3,4,0.56
8,7,comment,7,94,3,4,0.56
8,7,conceal,7,95,2,5,0.64
8,7,conceive,8,96,5,3,0.68
8,7,concept,7,97,5,2,0.44
8,7,concern,7,98,5,2,0.52
8,7,conduct,7,99,3,4,0.6
8,7,confer,6,100,3,3,0.6
8,7,confused,8,101,4,4,0.64
8,7,contrast,8,102,3,5,0.76
8,7,correct,7,103,2,5,0.64
8,7,cost,4,104,2,2,0.44
8,7,cottage,7,105,2,5,0.64
8,7,could,5,106,2,3,0.44
8,7,couple,6,107,3,3,0.48
8,7,court,5,108,3,2,0.36
8,7,create,6,109,1,5,0.68
8,7,creature,8,110,5,3,0.56
8,7,creep,5,111,3,2,0.36
8,7,crisis,6,112,2,4,0.52
8,7,cross,5,113,2,3,0.52
8,7,crowd,5,114,3,2,0.36
8,7,crucial,7,115,2,5,0.6
8,7,cruel,5,116,3,2,0.36
8,7,cruise,6,117,3,3,0.48
8,7,currency,8,118,1,7,0.88
8,7,current,7,119,6,1,0.4
8,7,curved,6,120,3,3,0.52
8,7,dam,3,121,0,3,0.36
8,7,damage,6,122,3,3,0.6
8,7,dance,5,123,2,3,0.48
8,7,dare,4,124,2,2,0.36
8,7,day,3,125,2,1,0.24
8,7,death,5,126,1,4,0.52
8,7,deed,4,127,2,2,0.32
8,7,defect,6,128,2,4,0.68
8,7,defence,7,129,4,3,0.52
8,7,dentist,7,130,2,5,0.64
8,7,desktop,7,131,2,5,0.64
8,7,despite,7,132,3,4,0.68
8,7,devil,5,133,2,3,0.44
8,7,dictate,7,134,1,6,0.68
8,7,dictator,8,135,6,2,0.48
8,7,digital,7,136,2,5,0.8
8,7,dinner,6,137,2,4,0.52
8,7,dirt,4,138,2,2,0.32
8,7,dirty,5,139,4,1,0.32
8,7,distant,7,140,2,5,0.6
8,7,divorced,8,141,2,6,0.8
8,7,dollar,6,142,1,5,0.56
8,7,dominant,8,143,2,6,0.76
8,7,donation,8,144,2,6,1.04
8,7,dot,3,145,2,1,0.24
8,7,drawing,7,146,1,6,0.68
8,7,duration,8,147,1,7,0.76
8,7,dust,4,148,2,2,0.32
8,7,ear,3,149,0,3,0.44
8,7,earnings,8,150,3,5,0.68
8,7,edit,4,151,1,3,0.36
8,7,edition,7,152,4,3,0.56
8,7,eight,5,153,1,4,0.52
8,7,embody,6,154,1,5,0.72
8,7,emotion,7,155,2,5,0.6
8,7,employer,8,156,2,6,0.72
8,7,enable,6,157,1,5,0.64
8,7,ending,6,158,2,4,0.68
8,7,endless,7,159,3,4,0.56
8,7,enemy,5,160,2,3,0.44
8,7,enrich,6,161,2,4,0.52
8,7,entrance,8,162,2,6,0.88
8,7,entry,5,163,4,1,0.32
8,7,equality,8,164,1,7,0.76
8,7,erect,5,165,1,4,0.48
8,7,essence,7,166,1,6,0.76
8,7,event,5,167,1,4,0.48
8,7,evidence,8,168,2,6,0.72
8,7,evoke,5,169,2,3,0.4
8,7,exact,5,170,1,4,0.56
8,7,exceed,6,171,2,4,0.64
8,7,exchange,8,172,3,5,0.64
8,7,excited,7,173,3,4,0.56
8,7,exciting,8,174,5,3,0.64
8,7,excuse,6,175,3,3,0.44
8,7,exit,4,176,2,2,0.32
8,7,expire,6,177,2,4,0.52
8,7,explode,7,178,3,4,0.48
8,7,exploit,7,179,5,2,0.32
8,7,extent,6,180,2,4,0.24
8,7,eye,3,181,1,2,0.12
8,7,faculty,7,182,0,7,0.28
8,7,failed,6,183,2,4,0.2
8,7,failure,7,184,4,3,0.28
8,7,fair,4,185,3,1,0.12
8,7,fairly,6,186,4,2,0.16
8,7,fast,4,187,2,2,0.16
8,7,fasten,6,188,4,2,0.16
8,7,fat,3,189,2,1,0.16
8,7,fear,4,190,1,3,0.16
8,7,fee,3,191,2,1,0.08
8,7,feeding,7,192,3,4,0.24
8,7,few,3,193,2,1,0.12
8,7,fifty,5,194,1,4,0.2
8,7,fight,5,195,2,3,0.24
8,7,file,4,196,2,2,0.16
8,7,finally,7,197,2,5,0.24
8,7,fine,4,198,3,1,0.12
8,7,firm,4,199,2,2,0.12
8,7,fixture,7,200,2,5,0.32
8,7,flag,4,201,1,3,0.16
8,7,flavour,7,202,3,4,0.24
8,7,flee,4,203,2,2,0.16
8,7,flu,3,204,2,1,0.08
8,7,flying,6,205,2,4,0.28
8,7,focus,5,206,1,4,0.2
8,7,folk,4,207,2,2,0.12
8,7,food,4,208,2,2,0.12
8,7,for,3,209,2,1,0.08
8,7,force,5,210,3,2,0.16
8,7,foreign,7,211,3,4,0.32
8,7,forward,7,212,3,4,0.24
8,7,foster,6,213,2,4,0.2
8,7,fourteen,8,214,2,6,0.32
8,7,fragment,8,215,1,7,0.4
8,7,freedom,7,216,2,5,0.28
8,7,friday,6,217,2,4,0.24
8,7,fridge,6,218,4,2,0.2
8,7,friendly,8,219,3,5,0.36
8,7,funding,7,220,1,6,0.28
8,7,fur,3,221,2,1,0.08
8,7,gallery,7,222,0,7,0.32
8,7,gallon,6,223,4,2,0.24
8,7,gender,6,224,1,5,0.24
8,7,gene,4,225,3,1,0.12
8,7,genetic,7,226,4,3,0.24
8,7,genre,5,227,3,2,0.16
8,7,giant,5,228,1,4,0.28
8,7,glass,5,229,1,4,0.2
8,7,globe,5,230,2,3,0.16
8,7,go,2,231,1,1,0.08
8,7,gold,4,232,2,2,0.16
8,7,good,4,233,2,2,0.16
8,7,goodbye,7,234,4,3,0.28
8,7,govern,6,235,2,4,0.2
8,7,grace,5,236,1,4,0.2
8,7,grade,5,237,3,2,0.16
8,7,graphics,8,238,3,5,0.28
8,7,gravity,7,239,3,4,0.32
8,7,green,5,240,2,3,0.16
8,7,greet,5,241,4,1,0.12
8,7,grey,4,242,3,1,0.12
8,7,grind,5,243,2,3,0.16
8,7,growth,6,244,2,4,0.28
8,7,guess,5,245,1,4,0.2
8,7,guest,5,246,4,1,0.12
8,7,guidance,8,247,2,6,0.28
8,7,guide,5,248,4,1,0.12
8,7,guitar,6,249,3,3,0.28
8,7,guy,3,250,2,1,0.12
8,7,gym,3,251,1,2,0.12
8,7,hair,4,252,0,4,0.2
8,7,handful,7,253,2,5,0.24
8,7,happen,6,254,2,4,0.28
8,7,harbour,7,255,2,5,0.28
8,7,harsh,5,256,3,2,0.16
8,7,harvest,7,257,3,4,0.24
8,7,hat,3,258,2,1,0.12
8,7,hate,4,259,3,1,0.2
8,7,hazard,6,260,2,4,0.2
8,7,health,6,261,1,5,0.24
8,7,heart,5,262,3,2,0.16
8,7,heat,4,263,3,1,0.12
8,7,heighten,8,264,2,6,0.36
8,7,hesitate,8,265,2,6,0.28
8,7,highly,6,266,1,5,0.24
8,7,holiday,7,267,1,6,0.28
8,7,homeland,8,268,2,6,0.4
8,7,honesty,7,269,2,5,0.28
8,7,hotel,5,270,2,3,0.16
8,7,hour,4,271,2,2,0.12
8,7,how,3,272,2,1,0.2
8,7,humanity,8,273,1,7,0.32
8,7,humour,6,274,3,3,0.2
8,7,hunger,6,275,2,4,0.24
8,7,illegal,7,276,0,7,0.4
8,7,image,5,277,1,4,0.2
8,7,imagery,7,278,5,2,0.2
8,7,import,6,279,2,4,0.2
8,7,improve,7,280,3,4,0.24
8,7,indirect,8,281,1,7,0.4
8,7,info,4,282,2,2,0.12
8,7,inform,6,283,4,2,0.16
8,7,informal,8,284,6,2,0.2
8,7,instant,7,285,2,5,0.32
8,7,instruct,8,286,4,4,0.24
8,7,intake,6,287,2,4,0.24
8,7,integral,8,288,3,5,0.28
8,7,intended,8,289,4,4,0.48
8,7,into,4,290,3,1,0.12
8,7,invade,6,291,2,4,0.2
8,7,involved,8,292,3,5,0.28
8,7,iron,4,293,1,3,0.24
8,7,issue,5,294,1,4,0.2
8,7,job,3,295,0,3,0.16
8,7,june,4,296,1,3,0.16
8,7,just,4,297,2,2,0.16
8,7,key,3,298,0,3,0.12
8,7,keyboard,8,299,3,5,0.36
8,7,king,4,300,1,3,0.16
8,7,kit,3,301,2,1,0.12
8,7,knife,5,302,1,4,0.2
8,7,know,4,303,2,2,0.16
8,7,lack,4,304,0,4,0.2
8,7,laser,5,305,2,3,0.28
8,7,latest,6,306,2,4,0.2
8,7,law,3,307,2,1,0.08
8,7,lawn,4,308,3,1,0.12
8,7,leaf,4,309,1,3,0.16
8,7,legend,6,310,2,4,0.28
8,7,lemon,5,311,2,3,0.2
8,7,lens,4,312,2,2,0.16
8,7,lesbian,7,313,2,5,0.28
8,7,lesser,6,314,3,3,0.2
8,7,letter,6,315,2,4,0.28
8,7,license,7,316,1,6,0.28
8,7,lie,3,317,2,1,0.08
8,7,limited,7,318,2,5,0.24
8,7,lion,4,319,2,2,0.12
8,7,literary,8,320,2,6,0.4
8,7,litter,6,321,3,3,0.2
8,7,liver,5,322,2,3,0.16
8,7,load,4,323,1,3,0.16
8,7,location,8,324,2,6,0.4
8,7,log,3,325,2,1,0.08
8,7,long,4,326,2,2,0.12
8,7,loose,5,327,2,3,0.2
8,7,love,4,328,2,2,0.12
8,7,mail,4,329,0,4,0.2
8,7,mandate,7,330,2,5,0.32
8,7,mark,4,331,2,2,0.16
8,7,master,6,332,2,4,0.2
8,7,meal,4,333,1,3,0.16
8,7,mean,4,334,3,1,0.12
8,7,media,5,335,2,3,0.16
8,7,meeting,7,336,2,5,0.36
8,7,melody,6,337,2,4,0.24
8,7,mental,6,338,2,4,0.2
8,7,mention,7,339,4,3,0.2
8,7,merger,6,340,2,4,0.28
8,7,mess,4,341,2,2,0.12
8,7,method,6,342,2,4,0.24
8,7,metre,5,343,3,2,0.16
8,7,midnight,8,344,1,7,0.4
8,7,militia,7,345,2,5,0.28
8,7,mind,4,346,2,2,0.16
8,7,minister,8,347,3,5,0.28
8,7,ministry,8,348,6,2,0.28
8,7,mirror,6,349,2,4,0.2
8,7,missing,7,350,2,5,0.28
8,7,money,5,351,1,4,0.2
8,7,monument,8,352,3,5,0.28
8,7,mouth,5,353,2,3,0.76
8,7,movie,5,354,2,3,0.76
8,7,much,4,355,1,3,0.88
8,7,multiple,8,356,2,6,1.08
8,7,museum,6,357,2,4,0.64
8,7,my,2,358,1,1,0.2
8,7,myth,4,359,2,2,0.32
8,7,name,4,360,0,4,0.44
8,7,nation,6,361,2,4,0.68
8,7,nature,6,362,3,3,0.44
8,7,needle,6,363,1,5,0.56
8,7,neutral,7,364,2,5,0.6
8,7,new,3,365,2,1,0.28
8,7,newly,5,366,3,2,0.48
8,7,noise,5,367,1,4,0.48
8,7,nominate,8,368,2,6,0.72
8,7,normal,6,369,2,4,0.52
8,7,north,5,370,3,2,0.44
8,7,northern,8,371,5,3,0.52
8,7,not,3,372,2,1,0.24
8,7,note,4,373,3,1,0.28
8,7,notice,6,374,3,3,0.44
8,7,novel,5,375,2,3,0.52
8,7,numerous,8,376,1,7,0.76
8,7,obesity,7,377,0,7,0.72
8,7,ocean,5,378,1,4,0.48
8,7,october,7,379,2,5,0.72
8,7,off,3,380,1,2,0.28
8,7,option,6,381,1,5,0.56
8,7,organic,7,382,1,6,0.64
8,7,ought,5,383,1,4,0.48
8,7,outbreak,8,384,2,6,0.8
8,7,outing,6,385,3,3,0.44
8,7,overall,7,386,1,6,0.64
8,7,oversee,7,387,4,3,0.52
8,7,pace,4,388,0,4,0.52
8,7,paint,5,389,2,3,0.4
8,7,parade,6,390,2,4,0.52
8,7,park,4,391,3,1,0.28
8,7,partner,7,392,3,4,0.56
8,7,password,8,393,2,6,0.76
8,7,patent,6,394,2,4,0.52
8,7,patience,8,395,3,5,0.64
8,7,peculiar,8,396,1,7,0.84
8,7,pepper,6,397,2,4,0.52
8,7,perhaps,7,398,2,5,0.6
8,7,phone,5,399,1,4,0.48
8,7,photo,5,400,3,2,0.36
8,7,picture,7,401,1,6,0.76
8,7,pile,4,402,2,2,0.32
8,7,pin,3,403,2,1,0.24
8,7,pipe,4,404,2,2,0.32
8,7,plan,4,405,1,3,0.36
8,7,plane,5,406,4,1,0.32
8,7,planning,8,407,4,4,0.76
8,7,plant,5,408,4,1,0.36
8,7,play,4,409,3,1,0.28
8,7,plot,4,410,2,2,0.32
8,7,police,6,411,1,5,0.6
8,7,portion,7,412,2,5,0.68
8,7,possess,7,413,2,5,0.6
8,7,pot,3,414,2,1,0.24
8,7,prayer,6,415,1,5,0.56
8,7,predict,7,416,2,5,0.68
8,7,premise,7,417,3,4,0.56
8,7,presence,8,418,3,5,0.8
8,7,printer,7,419,2,5,0.64
8,7,printing,8,420,5,3,0.64
8,7,process,7,421,2,5,0.6
8,7,produce,7,422,3,4,0.56
8,7,profound,8,423,3,5,0.64
8,7,proof,5,424,3,2,0.48
8,7,protest,7,425,3,4,0.56
8,7,punk,4,426,1,3,0.36
8,7,pursuit,7,427,2,5,0.64
8,7,push,4,428,2,2,0.44
8,7,put,3,429,2,1,0.32
8,7,quality,7,430,0,7,0.76
8,7,quantity,8,431,3,5,0.64
8,7,query,5,432,2,3,0.44
8,7,quest,5,433,3,2,0.4
8,7,quite,5,434,2,3,0.52
8,7,race,4,435,0,4,0.44
8,7,racism,6,436,3,3,0.44
8,7,raise,5,437,2,3,0.4
8,7,realm,5,438,1,4,0.48
8,7,rear,4,439,3,1,0.36
8,7,rebel,5,440,2,3,0.44
8,7,record,6,441,2,4,0.52
8,7,recruit,7,442,3,4,0.56
8,7,recycle,7,443,3,4,0.64
8,7,reduce,6,444,2,4,0.52
8,7,refuse,6,445,2,4,0.52
8,7,regional,8,446,2,6,0.72
8,7,relative,8,447,2,6,0.8
8,7,relax,5,448,4,1,0.32
8,7,repeat,6,449,2,4,0.52
8,7,republic,8,450,3,5,0.64
8,7,reside,6,451,2,4,0.6
8,7,residue,7,452,5,2,0.44
8,7,resolve,7,453,3,4,0.56
8,7,retail,6,454,2,4,0.52
8,7,retrieve,8,455,3,5,0.72
8,7,reveal,6,456,2,4,0.52
8,7,revenge,7,457,4,3,0.48
8,7,rival,5,458,1,4,0.48
8,7,roll,4,459,1,3,0.36
8,7,romance,7,460,2,5,0.72
8,7,roof,4,461,2,2,0.32
8,7,root,4,462,3,1,0.28
8,7,rotate,6,463,2,4,0.52
8,7,safe,4,464,0,4,0.44
8,7,sale,4,465,2,2,0.32
8,7,salt,4,466,3,1,0.36
8,7,satisfy,7,467,2,5,0.6
8,7,scan,4,468,1,3,0.36
8,7,score,5,469,2,3,0.4
8,7,seal,4,470,1,3,0.36
8,7,second,6,471,2,4,0.6
8,7,secure,6,472,3,3,0.48
8,7,segment,7,473,2,5,0.6
8,7,servant,7,474,2,5,0.6
8,7,serve,5,475,4,1,0.4
8,7,service,7,476,4,3,0.48
8,7,severely,8,477,2,6,0.68
8,7,sexual,6,478,2,4,0.52
8,7,sexy,4,479,3,1,0.28
8,7,share,5,480,1,4,0.6
8,7,shell,5,481,2,3,0.4
8,7,shift,5,482,2,3,0.4
8,7,ship,4,483,3,1,0.28
8,7,shipping,8,484,4,4,0.6
8,7,shopping,8,485,2,6,0.8
8,7,shore,5,486,3,2,0.36
8,7,shortage,8,487,4,4,0.6
8,7,shortly,7,488,5,2,0.44
8,7,sibling,7,489,1,6,0.76
8,7,silver,6,490,2,4,0.52
8,7,sin,3,491,2,1,0.24
8,7,singing,7,492,3,4,0.56
8,7,situated,8,493,2,6,0.8
8,7,skirt,5,494,1,4,0.48
8,7,slam,4,495,1,3,0.4
8,7,slip,4,496,2,2,0.32
8,7,smile,5,497,1,4,0.48
8,7,smoking,7,498,2,5,0.72
8,7,snow,4,499,1,3,0.36
8,7,solar,5,500,1,4,0.48
8,7,solo,4,501,3,1,0.28
8,7,soup,4,502,2,2,0.32
8,7,space,5,503,1,4,0.48
8,7,specify,7,504,2,5,0.72
8,7,spread,6,505,2,4,0.52
8,7,stab,4,506,1,3,0.4
8,7,stable,6,507,4,2,0.4
8,7,stamp,5,508,3,2,0.48
8,7,standing,8,509,3,5,0.68
8,7,star,4,510,3,1,0.28
8,7,stay,4,511,3,1,0.28
8,7,steadily,8,512,2,6,0.72
8,7,stem,4,513,3,1,0.36
8,7,stick,5,514,2,3,0.4
8,7,sticky,6,515,5,1,0.36
8,7,stop,4,516,2,2,0.32
8,7,store,5,517,3,2,0.36
8,7,straight,8,518,2,6,0.8
8,7,strange,7,519,4,3,0.52
8,7,street,6,520,3,3,0.48
8,7,stretch,7,521,4,3,0.52
8,7,striking,8,522,3,5,0.72
8,7,studio,6,523,2,4,0.52
8,7,subject,7,524,1,6,0.64
8,7,sudden,6,525,2,4,0.52
8,7,sue,3,526,2,1,0.24
8,7,surely,6,527,2,4,0.6
8,7,swallow,7,528,1,6,0.64
8,7,sweater,7,529,2,5,0.6
8,7,switch,6,530,2,4,0.52
8,7,symbolic,8,531,1,7,0.84
8,7,symptom,7,532,3,4,0.56
8,7,tactical,8,533,0,8,0.8
8,7,talk,4,534,2,2,0.32
8,7,tap,3,535,2,1,0.4
8,7,taste,5,536,2,3,0.4
8,7,team,4,537,1,3,0.36
8,7,tempt,5,538,2,3,0.4
8,7,tension,7,539,2,5,0.6
8,7,terror,6,540,2,4,0.6
8,7,textbook,8,541,2,6,0.72
8,7,texture,7,542,4,3,0.48
8,7,thereby,7,543,1,6,0.64
8,7,thesis,6,544,3,3,0.56
8,7,this,4,545,2,2,0.32
8,7,three,5,546,2,3,0.4
8,7,thrilled,8,547,3,5,0.64
8,7,thumb,5,548,2,3,0.4
8,7,ticket,6,549,1,5,0.68
8,7,tidy,4,550,2,2,0.32
8,7,till,4,551,2,2,0.32
8,7,to,2,552,1,1,0.2
8,7,too,3,553,2,1,0.24
8,7,torture,7,554,2,5,0.6
8,7,tour,4,555,2,2,0.44
8,7,trap,4,556,1,3,0.36
8,7,treasure,8,557,2,6,0.72
8,7,treaty,6,558,4,2,0.4
8,7,tree,4,559,3,1,0.28
8,7,trend,5,560,3,2,0.44
8,7,trial,5,561,2,3,0.4
8,7,tribal,6,562,3,3,0.44
8,7,tribe,5,563,4,1,0.32
8,7,tribute,7,564,4,3,0.48
8,7,tropical,8,565,2,6,0.8
8,7,trouble,7,566,3,4,0.56
8,7,two,3,567,1,2,0.28
8,7,unable,6,568,0,6,0.6
8,7,undergo,7,569,2,5,0.72
8,7,unfair,6,570,2,4,0.52
8,7,unify,5,571,2,3,0.44
8,7,universe,8,572,3,5,0.64
8,7,uphold,6,573,1,5,0.64
8,7,upon,4,574,2,2,0.32
8,7,urban,5,575,1,4,0.48
8,7,urgent,6,576,2,4,0.52
8,7,usage,5,577,1,4,0.48
8,7,utility,7,578,1,6,0.76
8,7,utilize,7,579,5,2,0.44
8,7,validity,8,580,0,8,1.24
8,7,valuable,8,581,3,5,0.76
8,7,variety,7,582,2,5,0.76
8,7,vary,4,583,3,1,0.28
8,7,veteran,7,584,1,6,0.68
8,7,video,5,585,1,4,0.48
8,7,viewer,6,586,2,4,0.6
8,7,virtual,7,587,2,5,0.6
8,7,virus,5,588,3,2,0.36
8,7,visitor,7,589,2,5,0.6
8,7,visual,6,590,3,3,0.44
8,7,vital,5,591,2,3,0.52
8,7,wait,4,592,0,4,0.44
8,7,war,3,593,2,1,0.24
8,7,warning,7,594,3,4,0.56
8,7,warrior,7,595,3,4,0.56
8,7,washing,7,596,2,5,0.56
8,7,watch,5,597,2,3,0.24
8,7,water,5,598,3,2,0.16
8,7,weapon,6,599,1,5,0.24
8,7,welcome,7,600,2,5,0.32
8,7,whenever,8,601,1,7,0.32
8,7,whose,5,602,2,3,0.2
8,7,willing,7,603,1,6,0.28
8,7,win,3,604,2,1,0.12
8,7,wind,4,605,3,1,0.2
8,7,wipe,4,606,2,2,0.16
8,7,wisdom,6,607,2,4,0.2
8,7,woman,5,608,1,4,0.2
8,7,worry,5,609,2,3,0.2
8,7,wrist,5,610,1,4,0.28
8,7,young,5,611,0,5,0.24
8,8,absence,7,0,0,7,0.72
8,8,activate,8,1,1,7,0.76
8,8,actress,7,2,3,4,0.68
8,8,add,3,3,1,2,0.28
8,8,admit,5,4,2,3,0.4
8,8,adopt,5,5,2,3,0.4
8,8,advice,6,6,2,4,0.52
8,8,agree,5,7,1,4,0.6
8,8,aids,4,8,1,3,0.36
8,8,alcohol,7,9,1,6,0.64
8,8,allocate,8,10,2,6,0.68
8,8,analysis,8,11,1,7,0.84
8,8,and,3,12,2,1,0.24
8,8,anger,5,13,2,3,0.4
8,8,ankle,5,14,2,3,0.4
8,8,announce,8,15,2,6,0.68
8,8,another,7,16,2,5,0.68
8,8,anxiety,7,17,2,5,0.6
8,8,anyway,6,18,2,4,0.52
8,8,apology,7,19,1,6,0.68
8,8,app,3,20,2,1,0.32
8,8,applaud,7,21,3,4,0.56
8,8,approve,7,22,3,4,0.56
8,8,argue,5,23,1,4,0.48
8,8,arms,4,24,2,2,0.32
8,8,around,6,25,2,4,0.6
8,8,arrest,6,26,2,4,0.52
8,8,artist,6,27,2,4,0.52
8,8,ask,3,28,1,2,0.28
8,8,at,2,29,1,1,0.2
8,8,attract,7,30,2,5,0.72
8,8,average,7,31,1,6,0.68
8,8,baby,4,32,0,4,0.48
8,8,backing,7,33,2,5,0.72
8,8,bacteria,8,34,3,5,0.76
8,8,balance,7,35,2,5,0.64
8,8,bath,4,36,2,2,0.32
8,8,beauty,6,37,1,5,0.56
8,8,beg,3,38,2,1,0.24
8,8,behalf,6,39,2,4,0.64
8,8,belief,6,40,2,4,0.52
8,8,belong,6,41,3,3,0.44
8,8,below,5,42,4,1,0.32
8,8,betray,6,43,2,4,0.56
8,8,beyond,6,44,2,4,0.72
8,8,bin,3,45,1,2,0.48
8,8,birthday,8,46,2,6,0.68
8,8,biscuit,7,47,2,5,0.6
8,8,bite,4,48,2,2,0.44
8,8,blame,5,49,1,4,0.68
8,8,blank,5,50,3,2,0.36
8,8,bless,5,51,2,3,0.44
8,8,blind,5,52,2,3,0.4
8,8,blog,4,53,2,2,0.32
8,8,boat,4,54,1,3,0.48
8,8,bomb,4,55,2,2,0.32
8,8,bound,5,56,2,3,0.4
8,8,box,3,57,2,1,0.24
8,8,brand,5,58,1,4,0.48
8,8,breach,6,59,2,4,0.52
8,8,breathe,7,60,4,3,0.6
8,8,bride,5,61,2,3,0.4
8,8,bridge,6,62,4,2,0.4
8,8,buffer,6,63,1,5,0.56
8,8,bug,3,64,2,1,0.32
8,8,build,5,65,2,3,0.44
8,8,bunch,5,66,2,3,0.4
8,8,butter,6,67,2,4,0.52
8,8,cafe,4,68,0,4,0.44
8,8,cake,4,69,2,2,0.32
8,8,cap,3,70,2,1,0.32
8,8,capable,7,71,3,4,0.48
8,8,career,6,72,2,4,0.28
8,8,carpet,6,73,3,3,0.24
8,8,carve,5,74,3,2,0.2
8,8,cease,5,75,1,4,0.28
8,8,central,7,76,2,5,0.28
8,8,chapter,7,77,1,6,0.28
8,8,charity,7,78,3,4,0.24
8,8,charm,5,79,4,1,0.2
8,8,charming,8,80,5,3,0.24
8,8,check,5,81,2,3,0.16
8,8,chicken,7,82,2,5,0.24
8,8,choose,6,83,2,4,0.28
8,8,chop,4,84,3,1,0.12
8,8,civil,5,85,1,4,0.2
8,8,clarity,7,86,1,6,0.28
8,8,clean,5,87,2,3,0.2
8,8,clearly,7,88,4,3,0.28
8,8,clinical,8,89,2,6,0.28
8,8,closely,7,90,2,5,0.24
8,8,club,4,91,2,2,0.12
8,8,cluster,7,92,3,4,0.32
8,8,coincide,8,93,1,7,0.32
8,8,comedy,6,94,2,4,0.2
8,8,commonly,8,95,3,5,0.28
8,8,company,7,96,3,4,0.32
8,8,conceal,7,97,2,5,0.28
8,8,concert,7,98,5,2,0.2
8,8,conduct,7,99,3,4,0.24
8,8,confer,6,100,3,3,0.28
8,8,consult,7,101,3,4,0.24
8,8,contempt,8,102,3,5,0.28
8,8,contend,7,103,5,2,0.2
8,8,contrast,8,104,4,4,0.36
8,8,convey,6,105,3,3,0.24
8,8,cooker,6,106,2,4,0.24
8,8,cottage,7,107,2,5,0.28
8,8,could,5,108,2,3,0.24
8,8,coup,4,109,3,1,0.12
8,8,couple,6,110,4,2,0.2
8,8,course,6,111,3,3,0.2
8,8,court,5,112,4,1,0.12
8,8,coverage,8,113,2,6,0.36
8,8,crime,5,114,1,4,0.2
8,8,crisis,6,115,3,3,0.2
8,8,cross,5,116,2,3,0.2
8,8,crowded,7,117,3,4,0.24
8,8,crucial,7,118,2,5,0.32
8,8,crude,5,119,3,2,0.16
8,8,cruel,5,120,3,2,0.16
8,8,cry,3,121,2,1,0.12
8,8,currency,8,122,1,7,0.4
8,8,current,7,123,6,1,0.16
8,8,cycle,5,124,1,4,0.2
8,8,dam,3,125,0,3,0.16
8,8,damage,6,126,3,3,0.2
8,8,dance,5,127,2,3,0.24
8,8,dare,4,128,2,2,0.16
8,8,day,3,129,2,1,0.12
8,8,decline,7,130,1,6,0.28
8,8,decrease,8,131,3,5,0.28
8,8,deem,4,132,2,2,0.16
8,8,default,7,133,2,5,0.32
8,8,defence,7,134,3,4,0.28
8,8,delight,7,135,2,5,0.28
8,8,demon,5,136,2,3,0.2
8,8,deposit,7,137,2,5,0.32
8,8,desktop,7,138,2,5,0.28
8,8,detect,6,139,2,4,0.2
8,8,diagram,7,140,1,6,0.32
8,8,diminish,8,141,2,6,0.4
8,8,diplomat,8,142,2,6,0.32
8,8,director,8,143,2,6,0.28
8,8,discuss,7,144,2,5,0.32
8,8,display,7,145,3,4,0.24
8,8,distant,7,146,3,4,0.24
8,8,divine,6,147,2,4,0.2
8,8,dollar,6,148,1,5,0.32
8,8,dominant,8,149,2,6,0.32
8,8,dot,3,150,2,1,0.08
8,8,drama,5,151,1,4,0.2
8,8,drawing,7,152,3,4,0.24
8,8,duration,8,153,1,7,0.4
8,8,earnings,8,154,0,8,0.36
8,8,earth,5,155,3,2,0.16
8,8,edit,4,156,1,3,0.16
8,8,edition,7,157,4,3,0.28
8,8,editor,6,158,4,2,0.16
8,8,effort,6,159,1,5,0.24
8,8,eight,5,160,1,4,0.2
8,8,eighty,6,161,5,1,0.2
8,8,elect,5,162,1,4,0.2
8,8,eleven,6,163,3,3,0.2
8,8,embody,6,164,1,5,0.24
8,8,emission,8,165,2,6,0.28
8,8,emotion,7,166,2,5,0.32
8,8,employer,8,167,2,6,0.32
8,8,enable,6,168,1,5,0.24
8,8,ending,6,169,2,4,0.2
8,8,enemy,5,170,2,3,0.24
8,8,engineer,8,171,2,6,0.28
8,8,enter,5,172,2,3,0.2
8,8,entitle,7,173,3,4,0.24
8,8,erect,5,174,1,4,0.28
8,8,essence,7,175,1,6,0.28
8,8,evoke,5,176,1,4,0.2
8,8,exact,5,177,1,4,0.2
8,8,examine,7,178,3,4,0.32
8,8,exceed,6,179,2,4,0.24
8,8,excuse,6,180,3,3,0.2
8,8,exercise,8,181,2,6,0.32
8,8,exit,4,182,2,2,0.16
8,8,expire,6,183,2,4,0.28
8,8,explain,7,184,3,4,0.24
8,8,explode,7,185,4,3,0.2
8,8,extend,6,186,2,4,0.24
8,8,eye,3,187,1,2,0.2
8,8,failure,7,188,0,7,0.32
8,8,fairly,6,189,3,3,0.2
8,8,famous,6,190,2,4,0.2
8,8,fast,4,191,2,2,0.12
8,8,fee,3,192,1,2,0.2
8,8,fellow,6,193,2,4,0.2
8,8,fiction,7,194,1,6,0.28
8,8,fifty,5,195,2,3,0.2
8,8,fight,5,196,2,3,0.16
8,8,file,4,197,2,2,0.2
8,8,firm,4,198,2,2,0.16
8,8,flag,4,199,1,3,0.2
8,8,flee,4,200,2,2,0.16
8,8,flexible,8,201,3,5,0.32
8,8,flourish,8,202,2,6,0.4
8,8,flu,3,203,2,1,0.08
8,8,flying,6,204,2,4,0.24
8,8,folding,7,205,1,6,0.28
8,8,folk,4,206,3,1,0.12
8,8,food,4,207,2,2,0.2
8,8,force,5,208,2,3,0.2
8,8,formula,7,209,3,4,0.24
8,8,fortune,7,210,3,4,0.28
8,8,foster,6,211,2,4,0.24
8,8,fourteen,8,212,2,6,0.4
8,8,frequent,8,213,1,7,0.32
8,8,friday,6,214,2,4,0.24
8,8,frighten,8,215,3,5,0.36
8,8,frog,4,216,2,2,0.16
8,8,funding,7,217,1,6,0.28
8,8,fur,3,218,2,1,0.08
8,8,gallery,7,219,0,7,0.32
8,8,game,4,220,2,2,0.2
8,8,genetic,7,221,1,6,0.32
8,8,glass,5,222,1,4,0.24
8,8,god,3,223,1,2,0.12
8,8,govern,6,224,2,4,0.24
8,8,governor,8,225,6,2,0.32
8,8,graphics,8,226,1,7,0.32
8,8,gravity,7,227,3,4,0.24
8,8,green,5,228,2,3,0.2
8,8,grid,4,229,2,2,0.2
8,8,grin,4,230,3,1,0.12
8,8,ground,6,231,2,4,0.24
8,8,growth,6,232,3,3,0.2
8,8,guest,5,233,1,4,0.2
8,8,guidance,8,234,2,6,0.36
8,8,harbour,7,235,0,7,0.32
8,8,hate,4,236,2,2,0.16
8,8,hazard,6,237,2,4,0.24
8,8,heighten,8,238,1,7,0.4
8,8,her,3,239,2,1,0.12
8,8,hers,4,240,3,1,0.2
8,8,hesitate,8,241,2,6,0.68
8,8,highly,6,242,1,5,0.56
8,8,hint,4,243,2,2,0.44
8,8,historic,8,244,2,6,0.8
8,8,honesty,7,245,1,6,0.68
8,8,horrible,8,246,2,6,0.72
8,8,horror,6,247,4,2,0.52
8,8,however,7,248,2,5,0.64
8,8,humble,6,249,1,5,0.56
8,8,humour,6,250,3,3,0.44
8,8,ice,3,251,0,3,0.36
8,8,ideal,5,252,1,4,0.6
8,8,ill,3,253,1,2,0.32
8,8,image,5,254,1,4,0.48
8,8,improve,7,255,2,5,0.64
8,8,index,5,256,1,4,0.48
8,8,indicate,8,257,3,5,0.92
8,8,infant,6,258,2,4,0.6
8,8,info,4,259,3,1,0.32
8,8,informal,8,260,4,4,0.68
8,8,initiate,8,261,2,6,0.84
8,8,injure,6,262,2,4,0.52
8,8,instant,7,263,2,5,0.6
8,8,instruct,8,264,4,4,0.6
8,8,integral,8,265,2,6,0.84
8,8,interior,8,266,4,4,0.64
8,8,into,4,267,3,1,0.28
8,8,invest,6,268,2,4,0.52
8,8,involve,7,269,3,4,1
8,8,involved,8,270,7,1,0.44
8,8,iron,4,271,1,3,0.36
8,8,isolated,8,272,1,7,0.8
8,8,issue,5,273,2,3,0.52
8,8,january,7,274,0,7,0.72
8,8,jet,3,275,1,2,0.28
8,8,jump,4,276,1,3,0.36
8,8,just,4,277,2,2,0.32
8,8,keyboard,8,278,0,8,0.96
8,8,kick,4,279,1,3,0.36
8,8,kidney,6,280,2,4,0.52
8,8,knife,5,281,1,4,0.48
8,8,know,4,282,2,2,0.32
8,8,lack,4,283,0,4,0.56
8,8,lad,3,284,2,1,0.24
8,8,landmark,8,285,2,6,0.72
8,8,laser,5,286,2,3,0.44
8,8,last,4,287,3,1,0.28
8,8,latest,6,288,2,4,0.64
8,8,laugh,5,289,2,3,0.44
8,8,leading,7,290,1,6,0.8
8,8,leaf,4,291,3,1,0.32
8,8,leaflet,7,292,4,3,0.6
8,8,lemon,5,293,2,3,0.56
8,8,lens,4,294,2,2,0.32
8,8,lesbian,7,295,2,5,0.6
8,8,lethal,6,296,2,4,0.52
8,8,license,7,297,1,6,0.76
8,8,lie,3,298,2,1,0.24
8,8,local,5,299,1,4,0.56
8,8,located,7,300,4,3,0.6
8,8,log,3,301,2,1,0.28
8,8,long,4,302,2,2,0.36
8,8,look,4,303,2,2,0.44
8,8,loose,5,304,3,2,0.4
8,8,loudly,6,305,2,4,0.56
8,8,mail,4,306,0,4,0.44
8,8,main,4,307,3,1,0.28
8,8,mark,4,308,2,2,0.32
8,8,mask,4,309,2,2,0.44
8,8,master,6,310,3,3,0.44
8,8,maximum,7,311,2,5,0.6
8,8,meal,4,312,1,3,0.36
8,8,media,5,313,2,3,0.44
8,8,memory,6,314,2,4,0.64
8,8,mentor,6,315,2,4,0.52
8,8,merger,6,316,2,4,0.52
8,8,mess,4,317,2,2,0.32
8,8,message,7,318,4,3,0.52
8,8,method,6,319,2,4,0.64
8,8,metre,5,320,3,2,0.36
8,8,militia,7,321,1,6,0.68
8,8,ministry,8,322,2,6,0.84
8,8,mirror,6,323,2,4,0.68
8,8,mixed,5,324,2,3,0.44
8,8,model,5,325,1,4,0.48
8,8,modify,6,326,3,3,0.44
8,8,moment,6,327,2,4,0.64
8,8,money,5,328,2,3,0.44
8,8,monthly,7,329,3,4,0.56
8,8,monument,8,330,3,5,0.64
8,8,more,4,331,2,2,0.32
8,8,most,4,332,2,2,0.44
8,8,mother,6,333,2,4,0.52
8,8,mouth,5,334,2,3,0.44
8,8,movie,5,335,2,3,0.44
8,8,my,2,336,1,1,0.2
8,8,naked,5,337,0,5,0.52
8,8,name,4,338,2,2,0.44
8,8,nasty,5,339,2,3,0.4
8,8,nation,6,340,2,4,0.52
8,8,neck,4,341,1,3,0.4
8,8,negative,8,342,2,6,0.84
8,8,new,3,343,2,1,0.28
8,8,newly,5,344,3,2,0.44
8,8,noise,5,345,1,4,0.56
8,8,noisy,5,346,4,1,0.4
8,8,non,3,347,2,1,0.24
8,8,norm,4,348,2,2,0.4
8,8,north,5,349,3,2,0.48
8,8,northern,8,350,5,3,0.52
8,8,note,4,351,2,2,0.32
8,8,notice,6,352,3,3,0.48
8,8,numerous,8,353,1,7,0.88
8,8,nut,3,354,2,1,0.24
8,8,offence,7,355,0,7,0.72
8,8,offend,6,356,5,1,0.36
8,8,official,8,357,3,5,0.76
8,8,opponent,8,358,1,7,0.88
8,8,opposed,7,359,4,3,0.52
8,8,option,6,360,2,4,0.52
8,8,outbreak,8,361,1,7,1
8,8,outlook,7,362,3,4,0.56
8,8,oversee,7,363,1,6,0.68
8,8,pad,3,364,0,3,0.32
8,8,page,4,365,2,2,0.32
8,8,painful,7,366,2,5,0.72
8,8,paint,5,367,4,1,0.32
8,8,pants,5,368,2,3,0.44
8,8,parade,6,369,2,4,0.6
8,8,parallel,8,370,4,4,0.8
8,8,park,4,371,3,1,0.28
8,8,partner,7,372,3,4,0.56
8,8,patron,6,373,2,4,0.56
8,8,pause,5,374,2,3,0.4
8,8,peculiar,8,375,1,7,0.88
8,8,peer,4,376,2,2,0.32
8,8,perhaps,7,377,2,5,0.6
8,8,pick,4,378,1,3,0.36
8,8,piece,5,379,2,3,0.4
8,8,place,5,380,1,4,0.6
8,8,planning,8,381,3,5,0.88
8,8,plant,5,382,4,1,0.4
8,8,pleased,7,383,2,5,0.76
8,8,point,5,384,1,4,0.64
8,8,possible,8,385,2,6,0.76
8,8,poster,6,386,3,3,0.48
8,8,praise,6,387,1,5,0.6
8,8,prayer,6,388,3,3,0.48
8,8,pregnant,8,389,2,6,0.84
8,8,printing,8,390,2,6,0.72
8,8,prior,5,391,3,2,0.44
8,8,priority,8,392,5,3,0.68
8,8,product,7,393,2,5,0.56
8,8,profile,7,394,3,4,0.32
8,8,profound,8,395,4,4,0.28
8,8,program,7,396,3,4,0.32
8,8,project,7,397,3,4,0.24
8,8,proof,5,398,3,2,0.16
8,8,proper,6,399,3,3,0.2
8,8,properly,8,400,6,2,0.28
8,8,propose,7,401,4,3,0.24
8,8,pump,4,402,1,3,0.16
8,8,push,4,403,2,2,0.16
8,8,put,3,404,2,1,0.08
8,8,puzzle,6,405,2,4,0.24
8,8,quality,7,406,0,7,0.36
8,8,query,5,407,2,3,0.16
8,8,quest,5,408,3,2,0.16
8,8,quite,5,409,2,3,0.16
8,8,race,4,410,0,4,0.2
8,8,racial,6,411,3,3,0.28
8,8,radar,5,412,2,3,0.16
8,8,railway,7,413,2,5,0.28
8,8,raise,5,414,3,2,0.16
8,8,rating,6,415,2,4,0.32
8,8,react,5,416,1,4,0.2
8,8,rear,4,417,3,1,0.12
8,8,rebel,5,418,2,3,0.16
8,8,recall,6,419,2,4,0.2
8,8,recycle,7,420,3,4,0.28
8,8,refer,5,421,2,3,0.2
8,8,referee,7,422,5,2,0.2
8,8,refuse,6,423,3,3,0.2
8,8,regime,6,424,2,4,0.2
8,8,regional,8,425,4,4,0.32
8,8,reign,5,426,2,3,0.16
8,8,relative,8,427,2,6,0.32
8,8,relaxed,7,428,4,3,0.24
8,8,relief,6,429,3,3,0.28
8,8,relieved,8,430,5,3,0.24
8,8,remind,6,431,2,4,0.24
8,8,removal,7,432,3,4,0.24
8,8,reside,6,433,2,4,0.28
8,8,residue,7,434,5,2,0.2
8,8,resolve,7,435,3,4,0.24
8,8,retire,6,436,2,4,0.2
8,8,reveal,6,437,2,4,0.28
8,8,revise,6,438,3,3,0.2
8,8,revision,8,439,5,3,0.24
8,8,rifle,5,440,1,4,0.2
8,8,road,4,441,1,3,0.16
8,8,roof,4,442,2,2,0.2
8,8,rough,5,443,2,3,0.16
8,8,round,5,444,3,2,0.16
8,8,rubber,6,445,1,5,0.24
8,8,ruin,4,446,2,2,0.12
8,8,safe,4,447,0,4,0.2
8,8,salt,4,448,2,2,0.2
8,8,sand,4,449,2,2,0.12
8,8,scan,4,450,1,3,0.16
8,8,scared,6,451,3,3,0.2
8,8,schedule,8,452,2,6,0.28
8,8,scheme,6,453,4,2,0.24
8,8,scholar,7,454,3,4,0.24
8,8,seal,4,455,1,3,0.16
8,8,second,6,456,2,4,0.24
8,8,secret,6,457,3,3,0.28
8,8,secure,6,458,3,3,0.2
8,8,security,8,459,5,3,0.24
8,8,segment,7,460,2,5,0.24
8,8,seminar,7,461,2,5,0.32
8,8,serious,7,462,2,5,0.28
8,8,servant,7,463,3,4,0.24
8,8,setting,7,464,2,5,0.28
8,8,sexual,6,465,2,4,0.32
8,8,sexy,4,466,3,1,0.12
8,8,shape,5,467,1,4,0.2
8,8,share,5,468,3,2,0.16
8,8,shell,5,469,2,3,0.16
8,8,shift,5,470,2,3,0.2
8,8,shipping,8,471,3,5,0.36
8,8,shopping,8,472,2,6,0.32
8,8,shore,5,473,3,2,0.16
8,8,sibling,7,474,1,6,0.36
8,8,silver,6,475,2,4,0.2
8,8,simply,6,476,2,4,0.24
8,8,sin,3,477,2,1,0.08
8,8,sink,4,478,3,1,0.12
8,8,sit,3,479,2,1,0.12
8,8,situated,8,480,3,5,0.36
8,8,six,3,481,2,1,0.08
8,8,skirt,5,482,1,4,0.2
8,8,skull,5,483,2,3,0.2
8,8,smoking,7,484,1,6,0.28
8,8,snow,4,485,1,3,0.24
8,8,soap,4,486,1,3,0.16
8,8,solid,5,487,2,3,0.2
8,8,somehow,7,488,2,5,0.28
8,8,space,5,489,1,4,0.2
8,8,spare,5,490,3,2,0.24
8,8,speak,5,491,2,3,0.2
8,8,speaker,7,492,5,2,0.2
8,8,specify,7,493,3,4,0.24
8,8,sphere,6,494,2,4,0.28
8,8,spine,5,495,2,3,0.16
8,8,spread,6,496,2,4,0.24
8,8,stab,4,497,1,3,0.16
8,8,stable,6,498,4,2,0.16
8,8,staff,5,499,3,2,0.16
8,8,stance,6,500,3,3,0.28
8,8,standing,8,501,4,4,0.24
8,8,star,4,502,3,1,0.12
8,8,statue,6,503,3,3,0.2
8,8,steadily,8,504,2,6,0.36
8,8,steer,5,505,3,2,0.16
8,8,stick,5,506,2,3,0.2
8,8,sticky,6,507,5,1,0.16
8,8,store,5,508,2,3,0.16
8,8,story,5,509,4,1,0.2
8,8,strange,7,510,2,5,0.28
8,8,stretch,7,511,3,4,0.24
8,8,strict,6,512,3,3,0.2
8,8,strike,6,513,4,2,0.24
8,8,striking,8,514,5,3,0.24
8,8,studio,6,515,2,4,0.2
8,8,study,5,516,4,1,0.12
8,8,stumble,7,517,3,4,0.24
8,8,stun,4,518,3,1,0.2
8,8,such,4,519,1,3,0.16
8,8,sudden,6,520,2,4,0.2
8,8,sugar,5,521,2,3,0.2
8,8,super,5,522,2,3,0.16
8,8,sure,4,523,2,2,0.2
8,8,surgical,8,524,3,5,0.28
8,8,survival,8,525,3,5,0.28
8,8,swallow,7,526,1,6,0.28
8,8,swear,5,527,2,3,0.24
8,8,sweater,7,528,4,3,0.24
8,8,sweep,5,529,3,2,0.16
8,8,switch,6,530,2,4,0.24
8,8,symbolic,8,531,1,7,0.4
8,8,tactical,8,532,0,8,0.36
8,8,tail,4,533,2,2,0.12
8,8,tale,4,534,2,2,0.12
8,8,talent,6,535,4,2,0.16
8,8,tank,4,536,2,2,0.12
8,8,tap,3,537,2,1,0.16
8,8,task,4,538,2,2,0.16
8,8,tea,3,539,1,2,0.12
8,8,team,4,540,3,1,0.12
8,8,tempt,5,541,2,3,0.2
8,8,terrific,8,542,2,6,0.4
8,8,terrify,7,543,6,1,0.16
8,8,thereby,7,544,1,6,0.28
8,8,thesis,6,545,3,3,0.2
8,8,this,4,546,2,2,0.16
8,8,thrilled,8,547,2,6,0.36
8,8,tidy,4,548,1,3,0.2
8,8,tight,5,549,2,3,0.2
8,8,till,4,550,2,2,0.16
8,8,timing,6,551,2,4,0.24
8,8,tonight,7,552,1,6,0.36
8,8,tonne,5,553,3,2,0.16
8,8,topic,5,554,2,3,0.2
8,8,torture,7,555,2,5,0.24
8,8,tour,4,556,2,2,0.2
8,8,trainer,7,557,1,6,0.28
8,8,tree,4,558,2,2,0.12
8,8,trial,5,559,2,3,0.2
8,8,tribal,6,560,3,3,0.2
8,8,tribute,7,561,4,3,0.28
8,8,trio,4,562,3,1,0.12
8,8,trouble,7,563,2,5,0.28
8,8,trousers,8,564,4,4,0.24
8,8,truck,5,565,2,3,0.2
8,8,tune,4,566,1,3,0.24
8,8,ultimate,8,567,0,8,0.36
8,8,undergo,7,568,1,6,0.28
8,8,unfair,6,569,2,4,0.24
8,8,union,5,570,2,3,0.56
8,8,unveil,6,571,2,4,0.24
8,8,upgrade,7,572,1,6,0.32
8,8,urgent,6,573,1,5,0.32
8,8,utilize,7,574,1,6,0.36
8,8,vague,5,575,0,5,0.24
8,8,valley,6,576,2,4,0.24
8,8,valuable,8,577,3,5,0.28
8,8,variety,7,578,2,5,0.32
8,8,venture,7,579,1,6,0.28
8,8,verify,6,580,2,4,0.24
8,8,vessel,6,581,2,4,0.24
8,8,veteran,7,582,2,5,0.36
8,8,viable,6,583,1,5,0.24
8,8,viewer,6,584,2,4,0.24
8,8,virtual,7,585,2,5,0.28
8,8,visitor,7,586,2,5,0.32
8,8,visual,6,587,3,3,0.2
8,8,vital,5,588,2,3,0.16
8,8,waiter,6,589,0,6,0.28
8,8,wake,4,590,2,2,0.12
8,8,war,3,591,2,1,0.16
8,8,warning,7,592,3,4,0.24
8,8,warrior,7,593,3,4,0.24
8,8,watch,5,594,2,3,0.16
8,8,way,3,595,2,1,0.12
8,8,wealthy,7,596,1,6,0.36
8,8,weapon,6,597,3,3,0.2
8,8,weekend,7,598,2,5,0.24
8,8,weird,5,599,2,3,0.2
8,8,welcome,7,600,2,5,0.32
8,8,welfare,7,601,3,4,0.24
8,8,whenever,8,602,1,7,0.32
8,8,whereas,7,603,3,4,0.24
8,8,width,5,604,1,4,0.28
8,8,win,3,605,2,1,0.12
8,8,window,6,606,3,3,0.2
8,8,wine,4,607,3,1,0.12
8,8,within,6,608,2,4,0.24
8,8,work,4,609,1,3,0.16
8,8,wrap,4,610,1,3,0.24
8,8,young,5,611,0,5,0.24
8,9,absorb,6,0,0,6,0.64
8,9,academic,8,1,1,7,0.88
8,9,accept,6,2,2,4,0.68
8,9,accident,8,3,3,5,0.64
8,9,accurate,8,4,3,5,0.64
8,9,activate,8,5,2,6,0.68
8,9,acute,5,6,2,3,0.56
8,9,address,7,7,1,6,0.64
8,9,adj,3,8,2,1,0.24
8,9,adjacent,8,9,3,5,0.64
8,9,admit,5,10,2,3,0.4
8,9,adopt,5,11,2,3,0.6
8,9,adoption,8,12,5,3,0.6
8,9,advice,6,13,2,4,0.52
8,9,against,7,14,1,6,0.68
8,9,agree,5,15,2,3,0.56
8,9,ahead,5,16,1,4,0.48
8,9,aids,4,17,1,3,0.36
8,9,alcohol,7,18,1,6,0.64
8,9,align,5,19,2,3,0.4
8,9,amateur,7,20,1,6,0.8
8,9,amusing,7,21,2,5,0.68
8,9,analyse,7,22,1,6,0.76
8,9,analysis,8,23,6,2,0.6
8,9,and,3,24,2,1,0.24
8,9,anger,5,25,2,3,0.4
8,9,animal,6,26,2,4,0.52
8,9,announce,8,27,2,6,0.68
8,9,annoyed,7,28,4,3,0.6
8,9,anxiety,7,29,2,5,0.64
8,9,anybody,7,30,2,5,0.64
8,9,app,3,31,1,2,0.28
8,9,applaud,7,32,3,4,0.68
8,9,approach,8,33,3,5,0.64
8,9,arguably,8,34,1,7,0.76
8,9,argue,5,35,4,1,0.32
8,9,arise,5,36,2,3,0.4
8,9,arrest,6,37,2,4,0.68
8,9,arrow,5,38,3,2,0.44
8,9,artistic,8,39,2,6,0.48
8,9,ask,3,40,1,2,0.12
8,9,at,2,41,1,1,0.08
8,9,attract,7,42,2,5,0.36
8,9,auction,7,43,1,6,0.32
8,9,auto,4,44,2,2,0.16
8,9,average,7,45,1,6,0.44
8,9,balance,7,46,0,7,0.4
8,9,barrel,6,47,2,4,0.24
8,9,bath,4,48,2,2,0.16
8,9,bay,3,49,2,1,0.12
8,9,beer,4,50,1,3,0.2
8,9,beg,3,51,2,1,0.12
8,9,behalf,6,52,2,4,0.32
8,9,behave,6,53,4,2,0.16
8,9,belief,6,54,2,4,0.24
8,9,bell,4,55,3,1,0.12
8,9,belong,6,56,3,3,0.2
8,9,below,5,57,4,1,0.2
8,9,best,4,58,2,2,0.12
8,9,betray,6,59,2,4,0.24
8,9,beyond,6,60,2,4,0.24
8,9,bill,4,61,1,3,0.16
8,9,bin,3,62,2,1,0.16
8,9,bird,4,63,2,2,0.12
8,9,bite,4,64,2,2,0.12
8,9,bitter,6,65,3,3,0.2
8,9,bizarre,7,66,2,5,0.24
8,9,blade,5,67,1,4,0.28
8,9,blame,5,68,3,2,0.16
8,9,blank,5,69,3,2,0.2
8,9,blind,5,70,2,3,0.2
8,9,blog,4,71,2,2,0.16
8,9,blow,4,72,3,1,0.12
8,9,boom,4,73,1,3,0.24
8,9,boot,4,74,3,1,0.12
8,9,break,5,75,1,4,0.2
8,9,bride,5,76,2,3,0.2
8,9,broken,6,77,2,4,0.24
8,9,buffer,6,78,1,5,0.32
8,9,build,5,79,2,3,0.2
8,9,butter,6,80,2,4,0.2
8,9,capable,7,81,0,7,0.32
8,9,card,4,82,2,2,0.12
8,9,career,6,83,3,3,0.28
8,9,carve,5,84,3,2,0.16
8,9,cave,4,85,2,2,0.12
8,9,cd,2,86,1,1,0.08
8,9,ceiling,7,87,1,6,0.28
8,9,cemetery,8,88,2,6,0.36
8,9,ceremony,8,89,2,6,0.32
8,9,certain,7,90,3,4,0.24
8,9,charity,7,91,1,6,0.28
8,9,charm,5,92,4,1,0.2
8,9,charming,8,93,5,3,0.24
8,9,cheat,5,94,2,3,0.2
8,9,check,5,95,3,2,0.16
8,9,cheerful,8,96,3,5,0.32
8,9,chop,4,97,2,2,0.16
8,9,chronic,7,98,2,5,0.28
8,9,circle,6,99,1,5,0.24
8,9,circuit,7,100,4,3,0.2
8,9,cite,4,101,2,2,0.2
8,9,city,4,102,3,1,0.12
8,9,civil,5,103,2,3,0.2
8,9,clean,5,104,1,4,0.2
8,9,clearly,7,105,4,3,0.2
8,9,clerk,5,106,3,2,0.24
8,9,clinical,8,107,2,6,0.28
8,9,closely,7,108,2,5,0.24
8,9,comfort,7,109,1,6,0.28
8,9,company,7,110,3,4,0.28
8,9,comply,6,111,4,2,0.16
8,9,conceal,7,112,2,5,0.24
8,9,concert,7,113,5,2,0.2
8,9,conduct,7,114,3,4,0.32
8,9,confer,6,115,3,3,0.2
8,9,consent,7,116,3,4,0.24
8,9,consult,7,117,4,3,0.2
8,9,cooker,6,118,2,4,0.28
8,9,cope,4,119,2,2,0.12
8,9,correct,7,120,2,5,0.24
8,9,cottage,7,121,2,5,0.24
8,9,could,5,122,2,3,0.16
8,9,county,6,123,3,3,0.28
8,9,coup,4,124,3,1,0.12
8,9,course,6,125,3,3,0.2
8,9,court,5,126,4,1,0.12
8,9,coverage,8,127,2,6,0.36
8,9,craft,5,128,1,4,0.2
8,9,create,6,129,2,4,0.2
8,9,creep,5,130,3,2,0.16
8,9,crisis,6,131,2,4,0.24
8,9,crowd,5,132,2,3,0.24
8,9,crucial,7,133,2,5,0.28
8,9,crude,5,134,3,2,0.16
8,9,cruel,5,135,3,2,0.16
8,9,currency,8,136,1,7,0.32
8,9,current,7,137,6,1,0.24
8,9,curved,6,138,3,3,0.2
8,9,cycle,5,139,1,4,0.2
8,9,dance,5,140,0,5,0.24
8,9,day,3,141,2,1,0.08
8,9,deal,4,142,1,3,0.24
8,9,december,8,143,2,6,0.32
8,9,declare,7,144,3,4,0.32
8,9,deed,4,145,2,2,0.16
8,9,deem,4,146,3,1,0.12
8,9,default,7,147,2,5,0.32
8,9,defect,6,148,3,3,0.2
8,9,definite,8,149,3,5,0.28
8,9,demon,5,150,2,3,0.16
8,9,dentist,7,151,2,5,0.32
8,9,detect,6,152,2,4,0.24
8,9,devil,5,153,2,3,0.2
8,9,diagram,7,154,1,6,0.28
8,9,dictate,7,155,2,5,0.32
8,9,dictator,8,156,6,2,0.2
8,9,dig,3,157,2,1,0.12
8,9,diminish,8,158,2,6,0.32
8,9,diplomat,8,159,2,6,0.4
8,9,director,8,160,2,6,0.36
8,9,dirt,4,161,3,1,0.12
8,9,disabled,8,162,2,6,0.32
8,9,discount,8,163,3,5,0.36
8,9,discuss,7,164,4,3,0.2
8,9,distant,7,165,3,4,0.24
8,9,divine,6,166,2,4,0.2
8,9,divorced,8,167,3,5,0.36
8,9,domain,6,168,1,5,0.28
8,9,dominant,8,169,3,5,0.32
8,9,download,8,170,2,6,0.32
8,9,drama,5,171,1,4,0.28
8,9,duration,8,172,1,7,0.32
8,9,earnings,8,173,0,8,0.36
8,9,edit,4,174,1,3,0.16
8,9,edition,7,175,4,3,0.28
8,9,eight,5,176,1,4,0.2
8,9,elect,5,177,1,4,0.2
8,9,enable,6,178,1,5,0.24
8,9,enemy,5,179,2,3,0.16
8,9,enjoy,5,180,2,3,0.24
8,9,enter,5,181,2,3,0.16
8,9,entitle,7,182,3,4,0.24
8,9,erect,5,183,1,4,0.2
8,9,essence,7,184,1,6,0.36
8,9,evening,7,185,1,6,0.28
8,9,event,5,186,4,1,0.12
8,9,evidence,8,187,2,6,0.28
8,9,examine,7,188,1,6,0.36
8,9,exceed,6,189,2,4,0.2
8,9,excuse,6,190,3,3,0.2
8,9,exercise,8,191,2,6,0.28
8,9,expire,6,192,2,4,0.28
8,9,extent,6,193,2,4,0.2
8,9,fail,4,194,0,4,0.2
8,9,fairly,6,195,3,3,0.2
8,9,fantasy,7,196,2,5,0.28
8,9,fasten,6,197,2,4,0.28
8,9,fellow,6,198,1,5,0.24
8,9,fibre,5,199,1,4,0.2
8,9,fight,5,200,2,3,0.16
8,9,fine,4,201,2,2,0.16
8,9,firm,4,202,2,2,0.2
8,9,fix,3,203,2,1,0.08
8,9,fixture,7,204,3,4,0.24
8,9,flag,4,205,1,3,0.16
8,9,flat,4,206,3,1,0.12
8,9,flavour,7,207,3,4,0.32
8,9,folding,7,208,1,6,0.28
8,9,food,4,209,2,2,0.12
8,9,for,3,210,2,1,0.08
8,9,force,5,211,3,2,0.16
8,9,former,6,212,3,3,0.28
8,9,formerly,8,213,6,2,0.2
8,9,formula,7,214,4,3,0.2
8,9,fortune,7,215,3,4,0.24
8,9,foster,6,216,2,4,0.28
8,9,founder,7,217,2,5,0.24
8,9,freedom,7,218,1,6,0.52
8,9,friday,6,219,2,4,0.52
8,9,friendly,8,220,3,5,0.76
8,9,frog,4,221,2,2,0.32
8,9,front,5,222,3,2,0.36
8,9,full,4,223,1,3,0.36
8,9,gallon,6,224,0,6,0.76
8,9,general,7,225,1,6,0.8
8,9,generate,8,226,6,2,0.52
8,9,genre,5,227,3,2,0.36
8,9,god,3,228,1,2,0.28
8,9,gold,4,229,2,2,0.36
8,9,good,4,230,2,2,0.32
8,9,goodbye,7,231,4,3,0.64
8,9,governor,8,232,2,6,0.68
8,9,grace,5,233,1,4,0.48
8,9,graphics,8,234,3,5,0.64
8,9,gravity,7,235,3,4,0.68
8,9,green,5,236,2,3,0.4
8,9,greet,5,237,4,1,0.32
8,9,grey,4,238,3,1,0.28
8,9,grid,4,239,2,2,0.32
8,9,growth,6,240,2,4,0.64
8,9,guess,5,241,1,4,0.48
8,9,guy,3,242,2,1,0.24
8,9,hair,4,243,0,4,0.44
8,9,handful,7,244,2,5,0.6
8,9,handy,5,245,4,1,0.44
8,9,harsh,5,246,2,3,0.4
8,9,harvest,7,247,3,4,0.56
8,9,hazard,6,248,2,4,0.52
8,9,headline,8,249,1,7,0.88
8,9,health,6,250,3,3,0.48
8,9,highly,6,251,1,5,0.56
8,9,historic,8,252,2,6,0.68
8,9,holiday,7,253,1,6,0.76
8,9,how,3,254,2,1,0.24
8,9,humble,6,255,1,5,0.56
8,9,humour,6,256,3,3,0.48
8,9,hunger,6,257,2,4,0.52
8,9,i,1,258,0,1,0.16
8,9,ice,3,259,1,2,0.4
8,9,icon,4,260,2,2,0.32
8,9,imagery,7,261,1,6,0.68
8,9,import,6,262,2,4,0.52
8,9,improve,7,263,3,4,0.56
8,9,include,7,264,1,6,0.8
8,9,index,5,265,2,3,0.44
8,9,indicate,8,266,3,5,0.64
8,9,indirect,8,267,4,4,0.6
8,9,infant,6,268,2,4,0.64
8,9,info,4,269,3,1,0.28
8,9,informal,8,270,4,4,0.6
8,9,inject,6,271,2,4,0.52
8,9,injure,6,272,3,3,0.6
8,9,insert,6,273,2,4,0.6
8,9,inspect,7,274,3,4,0.6
8,9,instant,7,275,3,4,0.64
8,9,intake,6,276,2,4,0.68
8,9,intense,7,277,3,4,0.56
8,9,interior,8,278,4,4,0.6
8,9,into,4,279,3,1,0.28
8,9,involve,7,280,2,5,0.92
8,9,involved,8,281,7,1,0.56
8,9,iron,4,282,1,3,0.4
8,9,island,6,283,1,5,0.56
8,9,job,3,284,0,3,0.32
8,9,joy,3,285,2,1,0.24
8,9,judicial,8,286,1,7,0.88
8,9,jump,4,287,2,2,0.32
8,9,june,4,288,2,2,0.32
8,9,key,3,289,0,3,0.32
8,9,keyboard,8,290,3,5,0.64
8,9,kidney,6,291,1,5,0.68
8,9,king,4,292,2,2,0.32
8,9,kit,3,293,2,1,0.24
8,9,lad,3,294,0,3,0.36
8,9,landmark,8,295,2,6,0.68
8,9,laser,5,296,2,3,0.56
8,9,last,4,297,3,1,0.28
8,9,leaf,4,298,1,3,0.36
8,9,league,6,299,3,3,0.44
8,9,learning,8,300,3,5,0.64
8,9,left,4,301,2,2,0.44
8,9,lemon,5,302,2,3,0.4
8,9,lens,4,303,2,2,0.32
8,9,lethal,6,304,2,4,0.52
8,9,lion,4,305,1,3,0.36
8,9,litter,6,306,2,4,0.64
8,9,live,4,307,2,2,0.32
8,9,load,4,308,1,3,0.36
8,9,local,5,309,2,3,0.4
8,9,located,7,310,4,3,0.52
8,9,location,8,311,5,3,0.68
8,9,log,3,312,2,1,0.24
8,9,lonely,6,313,2,4,0.52
8,9,lot,3,314,2,1,0.24
8,9,loudly,6,315,2,4,0.52
8,9,love,4,316,2,2,0.32
8,9,low,3,317,2,1,0.36
8,9,lunch,5,318,1,4,0.48
8,9,mandate,7,319,0,7,0.72
8,9,map,3,320,2,1,0.24
8,9,marine,6,321,2,4,0.52
8,9,master,6,322,2,4,0.64
8,9,match,5,323,2,3,0.4
8,9,mean,4,324,1,3,0.36
8,9,media,5,325,2,3,0.44
8,9,meeting,7,326,2,5,0.64
8,9,memory,6,327,2,4,0.64
8,9,mention,7,328,2,5,0.6
8,9,mentor,6,329,4,2,0.4
8,9,mess,4,330,2,2,0.32
8,9,message,7,331,4,3,0.48
8,9,midnight,8,332,1,7,0.88
8,9,minister,8,333,2,6,0.68
8,9,mirror,6,334,2,4,0.52
8,9,mixed,5,335,2,3,0.44
8,9,model,5,336,1,4,0.6
8,9,moment,6,337,2,4,0.52
8,9,most,4,338,2,2,0.36
8,9,movie,5,339,2,3,0.44
8,9,multiple,8,340,1,7,0.88
8,9,mum,3,341,2,1,0.24
8,9,museum,6,342,2,4,0.52
8,9,music,5,343,3,2,0.36
8,9,must,4,344,3,1,0.28
8,9,my,2,345,1,1,0.2
8,9,myth,4,346,2,2,0.48
8,9,naked,5,347,0,5,0.52
8,9,nation,6,348,2,4,0.52
8,9,needle,6,349,1,5,0.56
8,9,negative,8,350,2,6,0.68
8,9,new,3,351,2,1,0.36
8,9,nominate,8,352,1,7,0.76
8,9,norm,4,353,2,2,0.32
8,9,not,3,354,2,1,0.24
8,9,note,4,355,3,1,0.28
8,9,nothing,7,356,3,4,0.68
8,9,notice,6,357,3,3,0.44
8,9,novel,5,358,2,3,0.4
8,9,nut,3,359,1,2,0.28
8,9,obesity,7,360,0,7,0.72
8,9,oblige,6,361,2,4,0.64
8,9,ocean,5,362,1,4,0.48
8,9,once,4,363,1,3,0.36
8,9,one,3,364,2,1,0.24
8,9,opponent,8,365,1,7,0.76
8,9,outbreak,8,366,1,7,0.88
8,9,outdoor,7,367,3,4,0.56
8,9,outfit,6,368,3,3,0.44
8,9,outlet,6,369,3,3,0.44
8,9,outlook,7,370,4,3,0.6
8,9,oversee,7,371,1,6,0.64
8,9,pace,4,372,0,4,0.44
8,9,pad,3,373,2,1,0.24
8,9,painful,7,374,2,5,0.6
8,9,paint,5,375,4,1,0.44
8,9,park,4,376,2,2,0.32
8,9,peace,5,377,1,4,0.48
8,9,peaceful,8,378,5,3,0.6
8,9,peculiar,8,379,2,6,0.88
8,9,pepper,6,380,2,4,0.52
8,9,perceive,8,381,2,6,0.68
8,9,perfect,7,382,3,4,0.28
8,9,perhaps,7,383,3,4,0.32
8,9,photo,5,384,1,4,0.2
8,9,pick,4,385,1,3,0.16
8,9,pig,3,386,2,1,0.12
8,9,place,5,387,1,4,0.2
8,9,planning,8,388,3,5,0.36
8,9,play,4,389,3,1,0.12
8,9,pleased,7,390,2,5,0.28
8,9,pledge,6,391,3,3,0.2
8,9,point,5,392,1,4,0.2
8,9,pond,4,393,2,2,0.2
8,9,portion,7,394,2,5,0.28
8,9,possess,7,395,2,5,0.24
8,9,post,4,396,3,1,0.12
8,9,prayer,6,397,1,5,0.24
8,9,pregnant,8,398,2,6,0.4
8,9,presence,8,399,3,5,0.28
8,9,printing,8,400,2,6,0.28
8,9,process,7,401,2,5,0.32
8,9,produce,7,402,3,4,0.24
8,9,profound,8,403,3,5,0.28
8,9,project,7,404,3,4,0.24
8,9,proof,5,405,3,2,0.24
8,9,proper,6,406,3,3,0.2
8,9,properly,8,407,6,2,0.2
8,9,propose,7,408,4,3,0.2
8,9,pump,4,409,1,3,0.16
8,9,pupil,5,410,2,3,0.24
8,9,pursuit,7,411,2,5,0.28
8,9,push,4,412,2,2,0.12
8,9,puzzle,6,413,2,4,0.2
8,9,quest,5,414,0,5,0.24
8,9,quite,5,415,2,3,0.24
8,9,race,4,416,0,4,0.2
8,9,racism,6,417,3,3,0.2
8,9,radar,5,418,2,3,0.16
8,9,railway,7,419,2,5,0.32
8,9,raise,5,420,3,2,0.16
8,9,rather,6,421,2,4,0.2
8,9,rational,8,422,3,5,0.28
8,9,react,5,423,1,4,0.2
8,9,realm,5,424,3,2,0.24
8,9,rear,4,425,3,1,0.12
8,9,rebel,5,426,2,3,0.2
8,9,recount,7,427,2,5,0.28
8,9,recruit,7,428,3,4,0.24
8,9,reduce,6,429,2,4,0.32
8,9,refer,5,430,2,3,0.2
8,9,referee,7,431,5,2,0.2
8,9,regard,6,432,2,4,0.24
8,9,region,6,433,3,3,0.28
8,9,reign,5,434,2,3,0.2
8,9,relative,8,435,2,6,0.28
8,9,relax,5,436,4,1,0.12
8,9,relaxed,7,437,5,2,0.2
8,9,relief,6,438,3,3,0.24
8,9,remove,6,439,2,4,0.2
8,9,renew,5,440,2,3,0.2
8,9,repeat,6,441,2,4,0.2
8,9,republic,8,442,3,5,0.36
8,9,research,8,443,2,6,0.32
8,9,resolve,7,444,3,4,0.24
8,9,rest,4,445,3,1,0.12
8,9,retire,6,446,2,4,0.28
8,9,reveal,6,447,2,4,0.24
8,9,revise,6,448,3,3,0.24
8,9,revision,8,449,5,3,0.28
8,9,revive,6,450,4,2,0.2
8,9,rifle,5,451,1,4,0.28
8,9,right,5,452,2,3,0.2
8,9,rise,4,453,2,2,0.12
8,9,road,4,454,1,3,0.16
8,9,robbery,7,455,2,5,0.24
8,9,roll,4,456,2,2,0.2
8,9,rotate,6,457,2,4,0.2
8,9,rough,5,458,2,3,0.16
8,9,round,5,459,3,2,0.16
8,9,routine,7,460,3,4,0.24
8,9,safe,4,461,0,4,0.24
8,9,sale,4,462,2,2,0.16
8,9,salt,4,463,3,1,0.12
8,9,sample,6,464,2,4,0.2
8,9,scan,4,465,1,3,0.16
8,9,scared,6,466,3,3,0.28
8,9,schedule,8,467,2,6,0.32
8,9,school,6,468,3,3,0.2
8,9,seal,4,469,1,3,0.16
8,9,secret,6,470,2,4,0.24
8,9,servant,7,471,2,5,0.36
8,9,serve,5,472,4,1,0.12
8,9,service,7,473,4,3,0.2
8,9,setting,7,474,2,5,0.24
8,9,settler,7,475,4,3,0.28
8,9,severely,8,476,2,6,0.28
8,9,sheer,5,477,1,4,0.2
8,9,shell,5,478,3,2,0.16
8,9,shiny,5,479,2,3,0.2
8,9,ship,4,480,3,1,0.2
8,9,shoot,5,481,2,3,0.2
8,9,shopping,8,482,3,5,0.28
8,9,shore,5,483,3,2,0.16
8,9,shortage,8,484,4,4,0.32
8,9,shortly,7,485,5,2,0.2
8,9,sight,5,486,1,4,0.2
8,9,silver,6,487,2,4,0.24
8,9,simply,6,488,2,4,0.2
8,9,sin,3,489,2,1,0.16
8,9,singing,7,490,3,4,0.24
8,9,sink,4,491,3,1,0.12
8,9,six,3,492,2,1,0.08
8,9,ski,3,493,1,2,0.12
8,9,skip,4,494,3,1,0.12
8,9,skull,5,495,2,3,0.24
8,9,smoking,7,496,1,6,0.28
8,9,snow,4,497,1,3,0.16
8,9,solar,5,498,1,4,0.2
8,9,solid,5,499,3,2,0.16
8,9,solo,4,500,3,1,0.2
8,9,somehow,7,501,2,5,0.24
8,9,someone,7,502,4,3,0.2
8,9,song,4,503,2,2,0.12
8,9,space,5,504,1,4,0.2
8,9,specify,7,505,2,5,0.32
8,9,speech,6,506,3,3,0.2
8,9,sphere,6,507,2,4,0.24
8,9,spine,5,508,2,3,0.2
8,9,spread,6,509,2,4,0.32
8,9,stable,6,510,1,5,0.24
8,9,staff,5,511,3,2,0.16
8,9,stall,5,512,3,2,0.16
8,9,stance,6,513,3,3,0.24
8,9,star,4,514,3,1,0.2
8,9,statue,6,515,3,3,0.2
8,9,stay,4,516,3,1,0.12
8,9,steadily,8,517,2,6,0.28
8,9,stem,4,518,3,1,0.12
8,9,stick,5,519,2,3,0.24
8,9,storage,7,520,2,5,0.24
8,9,store,5,521,4,1,0.16
8,9,strange,7,522,2,5,0.24
8,9,street,6,523,3,3,0.2
8,9,strength,8,524,4,4,0.32
8,9,stretch,7,525,4,3,0.2
8,9,striking,8,526,3,5,0.28
8,9,string,6,527,4,2,0.16
8,9,studio,6,528,2,4,0.28
8,9,stumble,7,529,3,4,0.24
8,9,stun,4,530,3,1,0.12
8,9,sugar,5,531,1,4,0.2
8,9,sure,4,532,2,2,0.12
8,9,survival,8,533,3,5,0.36
8,9,swear,5,534,1,4,0.2
8,9,sweater,7,535,4,3,0.2
8,9,sweep,5,536,3,2,0.16
8,9,swim,4,537,2,2,0.12
8,9,symptom,7,538,1,6,0.36
8,9,table,5,539,0,5,0.24
8,9,talk,4,540,2,2,0.12
8,9,tap,3,541,2,1,0.12
8,9,tape,4,542,3,1,0.12
8,9,team,4,543,1,3,0.24
8,9,tempt,5,544,2,3,0.16
8,9,tendency,8,545,2,6,0.32
8,9,terribly,8,546,2,6,0.28
8,9,terrific,8,547,5,3,0.32
8,9,terrify,7,548,6,1,0.16
8,9,texture,7,549,2,5,0.28
8,9,thirsty,7,550,1,6,0.28
8,9,this,4,551,3,1,0.2
8,9,three,5,552,2,3,0.2
8,9,thumb,5,553,2,3,0.2
8,9,tight,5,554,1,4,0.2
8,9,tighten,7,555,5,2,0.2
8,9,timing,6,556,2,4,0.28
8,9,together,8,557,1,7,0.32
8,9,tonight,7,558,2,5,0.28
8,9,tonne,5,559,3,2,0.16
8,9,tool,4,560,2,2,0.12
8,9,tour,4,561,2,2,0.24
8,9,treat,5,562,1,4,0.2
8,9,tree,4,563,3,1,0.12
8,9,trend,5,564,3,2,0.16
8,9,trial,5,565,2,3,0.2
8,9,tribe,5,566,3,2,0.24
8,9,tribute,7,567,4,3,0.44
8,9,tropical,8,568,2,6,0.68
8,9,twice,5,569,1,4,0.48
8,9,unable,6,570,0,6,0.6
8,9,unfair,6,571,2,4,0.64
8,9,unify,5,572,2,3,0.4
8,9,unique,6,573,3,3,0.44
8,9,until,5,574,2,3,0.4
8,9,unveil,6,575,2,4,0.64
8,9,upon,4,576,1,3,0.36
8,9,urgent,6,577,1,5,0.56
8,9,utility,7,578,1,6,0.64
8,9,utilize,7,579,5,2,0.44
8,9,variety,7,580,0,7,0.84
8,9,verify,6,581,1,5,0.56
8,9,vessel,6,582,2,4,1.16
8,9,veteran,7,583,2,5,0.6
8,9,virtual,7,584,1,6,0.76
8,9,virtue,6,585,5,1,0.36
8,9,visual,6,586,2,4,0.52
8,9,vital,5,587,2,3,0.4
8,9,vocal,5,588,1,4,0.6
8,9,wait,4,589,0,4,0.44
8,9,walk,4,590,2,2,0.32
8,9,warrior,7,591,2,5,0.64
8,9,washing,7,592,2,5,0.6
8,9,water,5,593,2,3,0.56
8,9,weakness,8,594,1,7,0.76
8,9,weave,5,595,3,2,0.36
8,9,weight,6,596,2,4,0.52
8,9,weird,5,597,3,2,0.36
8,9,west,4,598,2,2,0.44
8,9,whenever,8,599,1,7,0.76
8,9,whereas,7,600,3,4,0.56
8,9,which,5,601,2,3,0.4
8,9,width,5,602,1,4,0.6
8,9,wildlife,8,603,2,6,0.68
8,9,win,3,604,2,1,0.24
8,9,wipe,4,605,2,2,0.32
8,9,word,4,606,1,3,0.4
8,9,work,4,607,3,1,0.28
8,9,world,5,608,3,2,0.52
8,9,written,7,609,1,6,0.64
8,9,yellow,6,610,0,6,0.6
8,9,young,5,611,1,4,0.48
9,0,a,1,0,0,1,0.12
9,0,academic,8,1,1,7,0.48
9,0,accident,8,2,2,6,0.36
9,0,accompany,9,3,3,6,0.36
9,0,address,7,4,1,6,0.36
9,0,adopt,5,5,2,3,0.28
9,0,advantage,9,6,2,7,0.36
9,0,advice,6,7,3,3,0.24
9,0,allocate,8,8,1,7,0.44
9,0,ambulance,9,9,1,8,0.44
9,0,amendment,9,10,2,7,0.36
9,0,amusing,7,11,2,5,0.36
9,0,announce,8,12,1,7,0.36
9,0,annoyed,7,13,4,3,0.24
9,0,another,7,14,2,5,0.32
9,0,anxiety,7,15,2,5,0.36
9,0,apologize,9,16,1,8,0.4
9,0,apology,7,17,6,1,0.2
9,0,app,3,18,2,1,0.12
9,0,applaud,7,19,3,4,0.36
9,0,approach,8,20,3,5,0.32
9,0,approve,7,21,5,2,0.2
9,0,argue,5,22,1,4,0.2
9,0,arms,4,23,2,2,0.2
9,0,army,4,24,3,1,0.16
9,0,around,6,25,2,4,0.24
9,0,artistic,8,26,2,6,0.32
9,0,assault,7,27,1,6,0.36
9,0,associate,9,28,3,6,0.32
9,0,assurance,9,29,3,6,0.36
9,0,attract,7,30,1,6,0.36
9,0,authorize,9,31,1,8,0.36
9,0,average,7,32,1,6,0.28
9,0,baby,4,33,0,4,0.2
9,0,backing,7,34,2,5,0.4
9,0,bacteria,8,35,3,5,0.36
9,0,ballet,6,36,2,4,0.24
9,0,barrel,6,37,2,4,0.24
9,0,beauty,6,38,1,5,0.32
9,0,bed,3,39,2,1,0.12
9,0,behalf,6,40,2,4,0.2
9,0,behave,6,41,4,2,0.16
9,0,belief,6,42,2,4,0.24
9,0,bell,4,43,3,1,0.16
9,0,belong,6,44,3,3,0.2
9,0,below,5,45,4,1,0.12
9,0,benchmark,9,46,2,7,0.36
9,0,between,7,47,2,5,0.32
9,0,bill,4,48,1,3,0.16
9,0,bird,4,49,2,2,0.16
9,0,birthday,8,50,3,5,0.28
9,0,bite,4,51,2,2,0.16
9,0,blank,5,52,1,4,0.2
9,0,blind,5,53,2,3,0.24
9,0,blog,4,54,2,2,0.16
9,0,blow,4,55,3,1,0.12
9,0,boat,4,56,1,3,0.16
9,0,boot,4,57,2,2,0.16
9,0,bound,5,58,2,3,0.24
9,0,boundary,8,59,5,3,0.24
9,0,boyfriend,9,60,2,7,0.36
9,0,bride,5,61,1,4,0.2
9,0,broken,6,62,2,4,0.28
9,0,buddy,5,63,1,4,0.2
9,0,bug,3,64,2,1,0.16
9,0,burden,6,65,2,4,0.24
9,0,cancer,6,66,0,6,0.28
9,0,candidate,9,67,3,6,0.4
9,0,cartoon,7,68,2,5,0.28
9,0,carve,5,69,3,2,0.16
9,0,category,8,70,2,6,0.32
9,0,cave,4,71,2,2,0.2
9,0,ceiling,7,72,1,6,0.28
9,0,celebrate,9,73,2,7,0.36
9,0,central,7,74,2,5,0.28
9,0,century,7,75,4,3,0.28
9,0,ceremony,8,76,2,6,0.32
9,0,challenge,9,77,1,8,0.36
9,0,chapter,7,78,3,4,0.28
9,0,character,9,79,3,6,0.36
9,0,charm,5,80,4,1,0.16
9,0,charter,7,81,4,3,0.24
9,0,cheat,5,82,2,3,0.24
9,0,check,5,83,3,2,0.16
9,0,cheerful,8,84,3,5,0.28
9,0,chemical,8,85,3,5,0.28
9,0,choose,6,86,2,4,0.28
9,0,chop,4,87,3,1,0.12
9,0,chronic,7,88,2,5,0.24
9,0,cite,4,89,1,3,0.16
9,0,civil,5,90,2,3,0.2
9,0,clause,6,91,1,5,0.36
9,0,clearly,7,92,2,5,0.28
9,0,clerk,5,93,3,2,0.16
9,0,clinical,8,94,2,6,0.28
9,0,cloud,5,95,2,3,0.2
9,0,club,4,96,2,2,0.2
9,0,colony,6,97,1,5,0.24
9,0,colourful,9,98,4,5,0.28
9,0,comedy,6,99,2,4,0.24
9,0,comfort,7,100,3,4,0.28
9,0,comment,7,101,3,4,0.24
9,0,community,9,102,4,5,0.28
9,0,company,7,103,3,4,0.24
9,0,compete,7,104,4,3,0.28
9,0,conceive,8,105,2,6,0.28
9,0,concept,7,106,5,2,0.2
9,0,confer,6,107,3,3,0.2
9,0,confess,7,108,5,2,0.24
9,0,consent,7,109,3,4,0.24
9,0,contempt,8,110,3,5,0.28
9,0,convey,6,111,3,3,0.2
9,0,cooker,6,112,2,4,0.28
9,0,correct,7,113,2,5,0.28
9,0,cost,4,114,2,2,0.16
9,0,cottage,7,115,2,5,0.28
9,0,could,5,116,2,3,0.24
9,0,counter,7,117,3,4,0.24
9,0,county,6,118,5,1,0.16
9,0,coup,4,119,3,1,0.12
9,0,course,6,120,3,3,0.2
9,0,coverage,8,121,2,6,0.36
9,0,creep,5,122,1,4,0.2
9,0,criminal,8,123,2,6,0.32
9,0,crisis,6,124,3,3,0.2
9,0,cross,5,125,2,3,0.4
9,0,crowd,5,126,3,2,0.28
9,0,crowded,7,127,5,2,0.44
9,0,crude,5,128,2,3,0.24
9,0,cruise,6,129,3,3,0.2
9,0,cry,3,130,2,1,0.16
9,0,cultivate,9,131,1,8,0.4
9,0,current,7,132,2,5,0.32
9,0,damage,6,133,0,6,0.32
9,0,day,3,134,2,1,0.12
9,0,deal,4,135,1,3,0.24
9,0,decline,7,136,2,5,0.28
9,0,deed,4,137,2,2,0.16
9,0,deem,4,138,3,1,0.12
9,0,default,7,139,2,5,0.36
9,0,defect,6,140,3,3,0.24
9,0,defence,7,141,4,3,0.24
9,0,delight,7,142,2,5,0.28
9,0,deposit,7,143,2,5,0.28
9,0,deputy,6,144,3,3,0.28
9,0,despite,7,145,2,5,0.28
9,0,detention,9,146,2,7,0.36
9,0,develop,7,147,2,5,0.36
9,0,digital,7,148,1,6,0.32
9,0,dinner,6,149,2,4,0.24
9,0,diplomat,8,150,2,6,0.32
9,0,dirty,5,151,2,3,0.28
9,0,disabled,8,152,2,6,0.32
9,0,discuss,7,153,3,4,0.24
9,0,distant,7,154,3,4,0.24
9,0,distort,7,155,4,3,0.28
9,0,dollar,6,156,1,5,0.24
9,0,domain,6,157,2,4,0.24
9,0,dot,3,158,2,1,0.08
9,0,double,6,159,2,4,0.24
9,0,drawing,7,160,1,6,0.36
9,0,effort,6,161,0,6,0.28
9,0,eight,5,162,1,4,0.2
9,0,either,6,163,2,4,0.24
9,0,eliminate,9,164,1,8,0.48
9,0,elsewhere,9,165,2,7,0.36
9,0,embark,6,166,1,5,0.24
9,0,embody,6,167,3,3,0.2
9,0,emergence,9,168,2,7,0.4
9,0,emotion,7,169,2,5,0.28
9,0,employer,8,170,2,6,0.32
9,0,enemy,5,171,1,4,0.28
9,0,engineer,8,172,2,6,0.28
9,0,enjoy,5,173,2,3,0.2
9,0,enjoyable,9,174,5,4,0.28
9,0,enormous,8,175,2,6,0.36
9,0,enter,5,176,2,3,0.2
9,0,entry,5,177,3,2,0.16
9,0,equipment,9,178,1,8,0.36
9,0,erect,5,179,1,4,0.28
9,0,essay,5,180,1,4,0.2
9,0,essence,7,181,3,4,0.24
9,0,evening,7,182,1,6,0.28
9,0,evidence,8,183,2,6,0.36
9,0,exceed,6,184,1,5,0.48
9,0,excellent,9,185,4,5,1.08
9,0,exception,9,186,4,5,0.72
9,0,exchange,8,187,3,5,0.76
9,0,exciting,8,188,3,5,0.64
9,0,exclusive,9,189,3,6,0.72
9,0,exit,4,190,2,2,0.44
9,0,expensive,9,191,2,7,0.84
9,0,expire,6,192,3,3,0.48
9,0,exploit,7,193,3,4,0.68
9,0,explosive,9,194,5,4,0.88
9,0,extent,6,195,2,4,0.56
9,0,faculty,7,196,0,7,0.72
9,0,failed,6,197,2,4,0.52
9,0,fair,4,198,3,1,0.36
9,0,fall,4,199,2,2,0.32
9,0,fantastic,9,200,2,7,0.8
9,0,fantasy,7,201,6,1,0.4
9,0,fast,4,202,2,2,0.32
9,0,fasten,6,203,4,2,0.52
9,0,fat,3,204,2,1,0.24
9,0,fee,3,205,1,2,0.28
9,0,feeding,7,206,3,4,0.56
9,0,fellow,6,207,2,4,0.56
9,0,fiction,7,208,1,6,0.76
9,0,finally,7,209,2,5,0.6
9,0,financial,9,210,4,5,0.68
9,0,firm,4,211,2,2,0.32
9,0,fixed,5,212,2,3,0.52
9,0,flag,4,213,1,3,0.44
9,0,flat,4,214,3,1,0.28
9,0,flee,4,215,2,2,0.32
9,0,floor,5,216,2,3,0.4
9,0,flourish,8,217,3,5,0.64
9,0,flu,3,218,2,1,0.32
9,0,flying,6,219,2,4,0.52
9,0,folding,7,220,1,6,0.68
9,0,food,4,221,2,2,0.32
9,0,foreigner,9,222,2,7,0.88
9,0,former,6,223,3,3,0.44
9,0,foster,6,224,2,4,0.52
9,0,fourteen,8,225,2,6,0.68
9,0,freedom,7,226,1,6,0.76
9,0,frequent,8,227,3,5,0.64
9,0,friendly,8,228,2,6,0.72
9,0,front,5,229,2,3,0.4
9,0,fulfil,6,230,1,5,0.68
9,0,full,4,231,3,1,0.28
9,0,funding,7,232,2,5,0.64
9,0,fur,3,233,2,1,0.24
9,0,gaming,6,234,0,6,0.64
9,0,gender,6,235,1,5,0.68
9,0,gene,4,236,3,1,0.28
9,0,generally,9,237,4,5,0.68
9,0,genetic,7,238,4,3,0.48
9,0,giant,5,239,1,4,0.56
9,0,glass,5,240,1,4,0.48
9,0,glimpse,7,241,2,5,0.6
9,0,go,2,242,1,1,0.2
9,0,golf,4,243,2,2,0.32
9,0,goodbye,7,244,2,5,0.6
9,0,govern,6,245,2,4,1.68
9,0,grace,5,246,1,4,0.96
9,0,green,5,247,2,3,1.72
9,0,greet,5,248,4,1,0.4
9,0,grief,5,249,2,3,0.44
9,0,grin,4,250,3,1,0.28
9,0,grind,5,251,4,1,0.32
9,0,ground,6,252,2,4,0.56
9,0,guess,5,253,1,4,0.92
9,0,guest,5,254,4,1,0.32
9,0,guidance,8,255,2,6,0.72
9,0,guide,5,256,4,1,0.32
9,0,guitar,6,257,3,3,0.48
9,0,gym,3,258,1,2,0.4
9,0,harbour,7,259,0,7,0.72
9,0,harm,4,260,3,1,0.28
9,0,harvest,7,261,3,4,0.56
9,0,hat,3,262,2,1,0.24
9,0,hate,4,263,3,1,0.4
9,0,hazard,6,264,2,4,0.52
9,0,heat,4,265,1,3,0.4
9,0,her,3,266,2,1,0.24
9,0,hers,4,267,3,1,0.28
9,0,highlight,9,268,1,8,0.96
9,0,highly,6,269,5,1,0.36
9,0,homeland,8,270,1,7,0.76
9,0,honesty,7,271,2,5,0.6
9,0,horrible,8,272,2,6,0.8
9,0,horror,6,273,4,2,0.4
9,0,hotel,5,274,2,3,0.4
9,0,hour,4,275,2,2,0.32
9,0,how,3,276,2,1,0.24
9,0,however,7,277,3,4,0.64
9,0,humanity,8,278,1,7,0.76
9,0,humour,6,279,3,3,0.44
9,0,hurricane,9,280,2,7,0.8
9,0,hydrogen,8,281,1,7,0.88
9,0,i,1,282,0,1,0.16
9,0,identical,9,283,1,8,0.84
9,0,ignorance,9,284,1,8,0.84
9,0,ill,3,285,1,2,0.4
9,0,illegal,7,286,3,4,0.56
9,0,image,5,287,1,4,0.48
9,0,imagery,7,288,5,2,0.44
9,0,imaginary,9,289,4,5,0.8
9,0,impatient,9,290,2,7,0.84
9,0,implement,9,291,3,6,0.76
9,0,important,9,292,3,6,0.84
9,0,include,7,293,1,6,0.68
9,0,incorrect,9,294,3,6,0.76
9,0,incur,5,295,3,2,0.4
9,0,index,5,296,2,3,0.52
9,0,indirect,8,297,3,5,0.64
9,0,influence,9,298,2,7,0.8
9,0,informal,8,299,3,5,0.64
9,0,inject,6,300,2,4,0.6
9,0,injure,6,301,3,3,0.44
9,0,injury,6,302,5,1,0.36
9,0,insert,6,303,2,4,0.6
9,0,insertion,9,304,6,3,0.72
9,0,inspect,7,305,3,4,0.56
9,0,instant,7,306,3,4,0.56
9,0,insurance,9,307,3,6,0.76
9,0,intended,8,308,2,6,0.8
9,0,into,4,309,3,1,0.28
9,0,invade,6,310,2,4,0.52
9,0,involve,7,311,3,4,0.56
9,0,involved,8,312,7,1,0.52
9,0,iron,4,313,1,3,0.36
9,0,island,6,314,1,5,0.56
9,0,isolated,8,315,2,6,0.72
9,0,january,7,316,0,7,0.84
9,0,joy,3,317,1,2,0.28
9,0,judicial,8,318,1,7,0.76
9,0,jump,4,319,2,2,0.32
9,0,just,4,320,2,2,0.32
9,0,keyboard,8,321,0,8,0.92
9,0,kit,3,322,1,2,0.28
9,0,know,4,323,1,3,0.4
9,0,lake,4,324,0,4,0.44
9,0,landmark,8,325,2,6,0.68
9,0,laser,5,326,2,3,0.52
9,0,latest,6,327,2,4,0.52
9,0,lawn,4,328,2,2,0.36
9,0,layer,5,329,2,3,0.48
9,0,leaf,4,330,1,3,0.44
9,0,league,6,331,3,3,0.64
9,0,learning,8,332,3,5,0.68
9,0,legend,6,333,2,4,0.52
9,0,letter,6,334,2,4,0.52
9,0,lifestyle,9,335,1,8,1
9,0,link,4,336,2,2,0.32
9,0,lion,4,337,2,2,0.32
9,0,litter,6,338,2,4,0.52
9,0,little,6,339,4,2,0.4
9,0,liver,5,340,2,3,0.52
9,0,load,4,341,1,3,0.36
9,0,located,7,342,2,5,0.6
9,0,log,3,343,2,1,0.24
9,0,lonely,6,344,2,4,0.52
9,0,long,4,345,3,1,0.28
9,0,loose,5,346,2,3,0.52
9,0,low,3,347,2,1,0.24
9,0,lunch,5,348,1,4,0.48
9,0,map,3,349,0,3,0.32
9,0,mark,4,350,2,2,0.32
9,0,married,7,351,3,4,0.64
9,0,mask,4,352,2,2,0.36
9,0,match,5,353,2,3,0.52
9,0,meal,4,354,1,3,0.44
9,0,memory,6,355,2,4,0.52
9,0,mental,6,356,2,4,0.64
9,0,mention,7,357,4,3,0.48
9,0,mentor,6,358,4,2,0.4
9,0,merger,6,359,2,4,0.52
9,0,mess,4,360,2,2,0.32
9,0,metre,5,361,2,3,0.52
9,0,midnight,8,362,1,7,0.76
9,0,militia,7,363,2,5,0.6
9,0,mind,4,364,2,2,0.32
9,0,minister,8,365,3,5,0.72
9,0,ministry,8,366,6,2,0.52
9,0,model,5,367,1,4,0.48
9,0,modify,6,368,3,3,0.48
9,0,moment,6,369,2,4,0.52
9,0,monthly,7,370,2,5,0.72
9,0,monument,8,371,3,5,0.64
9,0,more,4,372,2,2,0.36
9,0,most,4,373,2,2,0.36
9,0,mother,6,374,2,4,0.68
9,0,multiple,8,375,1,7,0.76
9,0,mum,3,376,2,1,0.24
9,0,municipal,9,377,2,7,0.8
9,0,musician,8,378,2,6,0.84
9,0,my,2,379,1,1,0.2
9,0,myth,4,380,2,2,0.32
9,0,naked,5,381,0,5,0.52
9,0,nasty,5,382,2,3,0.4
9,0,nature,6,383,2,4,0.56
9,0,neck,4,384,1,3,0.48
9,0,negative,8,385,2,6,0.68
9,0,new,3,386,2,1,0.24
9,0,noise,5,387,1,4,0.48
9,0,non,3,388,2,1,0.24
9,0,normal,6,389,2,4,0.68
9,0,north,5,390,3,2,0.36
9,0,nothing,7,391,2,5,0.64
9,0,notion,6,392,3,3,0.52
9,0,novel,5,393,2,3,0.52
9,0,nut,3,394,1,2,0.4
9,0,objective,9,395,0,9,0.92
9,0,obviously,9,396,2,7,0.8
9,0,ocean,5,397,1,4,0.48
9,0,off,3,398,1,2,0.4
9,0,offence,7,399,3,4,0.56
9,0,offensive,9,400,5,4,0.64
9,0,offspring,9,401,3,6,0.76
9,0,one,3,402,1,2,0.4
9,0,opponent,8,403,1,7,0.76
9,0,organic,7,404,1,6,0.68
9,0,organizer,9,405,6,3,0.6
9,0,originate,9,406,2,7,0.84
9,0,otherwise,9,407,1,8,0.48
9,0,outdoor,7,408,1,6,0.28
9,0,outdoors,8,409,7,1,0.24
9,0,outfit,6,410,3,3,0.2
9,0,outlet,6,411,3,3,0.2
9,0,outlook,7,412,4,3,0.2
9,0,oversee,7,413,1,6,0.36
9,0,owe,3,414,1,2,0.12
9,0,pace,4,415,0,4,0.2
9,0,pack,4,416,3,1,0.12
9,0,painful,7,417,2,5,0.24
9,0,palace,6,418,2,4,0.28
9,0,parallel,8,419,2,6,0.28
9,0,park,4,420,3,1,0.12
9,0,passenger,9,421,2,7,0.32
9,0,passport,8,422,4,4,0.32
9,0,patience,8,423,2,6,0.32
9,0,patron,6,424,3,3,0.2
9,0,pause,5,425,2,3,0.2
9,0,peaceful,8,426,1,7,0.4
9,0,peer,4,427,2,2,0.16
9,0,pepper,6,428,2,4,0.24
9,0,perfect,7,429,2,5,0.24
9,0,personnel,9,430,3,6,0.4
9,0,photo,5,431,1,4,0.2
9,0,physician,9,432,2,7,0.32
9,0,pick,4,433,1,3,0.2
9,0,piece,5,434,2,3,0.2
9,0,pig,3,435,2,1,0.16
9,0,pin,3,436,2,1,0.12
9,0,pipe,4,437,2,2,0.12
9,0,plane,5,438,1,4,0.2
9,0,planning,8,439,4,4,0.24
9,0,plant,5,440,4,1,0.24
9,0,plastic,7,441,3,4,0.24
9,0,plead,5,442,2,3,0.16
9,0,point,5,443,1,4,0.2
9,0,police,6,444,2,4,0.24
9,0,political,9,445,4,5,0.36
9,0,pond,4,446,2,2,0.12
9,0,position,8,447,2,6,0.28
9,0,post,4,448,3,1,0.12
9,0,practical,9,449,1,8,0.44
9,0,prayer,6,450,3,3,0.2
9,0,precedent,9,451,2,7,0.36
9,0,pregnant,8,452,3,5,0.28
9,0,premier,7,453,3,4,0.32
9,0,premise,7,454,5,2,0.2
9,0,prescribe,9,455,3,6,0.32
9,0,presence,8,456,4,4,0.32
9,0,printing,8,457,2,6,0.36
9,0,priority,8,458,3,5,0.28
9,0,product,7,459,2,5,0.28
9,0,profile,7,460,3,4,0.32
9,0,profound,8,461,4,4,0.24
9,0,project,7,462,3,4,0.24
9,0,prominent,9,463,3,6,0.4
9,0,proposal,8,464,3,5,0.28
9,0,prosecute,9,465,3,6,0.32
9,0,protest,7,466,3,4,0.24
9,0,publicity,9,467,1,8,0.44
9,0,pupil,5,468,2,3,0.16
9,0,pure,4,469,2,2,0.16
9,0,put,3,470,2,1,0.08
9,0,puzzle,6,471,2,4,0.2
9,0,quite,5,472,0,5,0.28
9,0,race,4,473,0,4,0.2
9,0,racial,6,474,3,3,0.2
9,0,radar,5,475,2,3,0.16
9,0,rail,4,476,2,2,0.16
9,0,railway,7,477,4,3,0.28
9,0,raise,5,478,3,2,0.16
9,0,rather,6,479,2,4,0.2
9,0,rating,6,480,3,3,0.2
9,0,rational,8,481,4,4,0.32
9,0,realistic,9,482,1,8,0.36
9,0,realm,5,483,4,1,0.12
9,0,reasoning,9,484,3,6,0.32
9,0,recall,6,485,2,4,0.28
9,0,reception,9,486,3,6,0.32
9,0,recognize,9,487,3,6,0.32
9,0,recommend,9,488,4,5,0.36
9,0,record,6,489,4,2,0.16
9,0,recording,9,490,6,3,0.24
9,0,reduce,6,491,2,4,0.2
9,0,reduction,9,492,5,4,0.32
9,0,refer,5,493,2,3,0.16
9,0,refuse,6,494,3,3,0.2
9,0,regard,6,495,2,4,0.24
9,0,region,6,496,3,3,0.2
9,0,reign,5,497,2,3,0.24
9,0,rejection,9,498,2,7,0.36
9,0,relax,5,499,2,3,0.16
9,0,relief,6,500,3,3,0.2
9,0,remind,6,501,2,4,0.28
9,0,removal,7,502,3,4,0.24
9,0,remove,6,503,5,1,0.16
9,0,renew,5,504,2,3,0.2
9,0,reporting,9,505,2,7,0.4
9,0,republic,8,506,3,5,0.28
9,0,retail,6,507,2,4,0.2
9,0,retire,6,508,3,3,0.2
9,0,retrieve,8,509,3,5,0.36
9,0,revenge,7,510,2,5,0.24
9,0,revival,7,511,3,4,0.24
9,0,ritual,6,512,1,5,0.28
9,0,rob,3,513,1,2,0.16
9,0,robust,6,514,3,3,0.24
9,0,roll,4,515,2,2,0.12
9,0,romance,7,516,2,5,0.24
9,0,roof,4,517,2,2,0.32
9,0,round,5,518,2,3,0.36
9,0,routine,7,519,3,4,0.32
9,0,rubbish,7,520,1,6,0.28
9,0,ruin,4,521,2,2,0.12
9,0,sacred,6,522,0,6,0.24
9,0,salt,4,523,2,2,0.2
9,0,satisfied,9,524,2,7,0.36
9,0,satisfy,7,525,6,1,0.16
9,0,scan,4,526,1,3,0.16
9,0,scattered,9,527,3,6,0.36
9,0,scheme,6,528,2,4,0.24
9,0,scholar,7,529,3,4,0.24
9,0,school,6,530,4,2,0.16
9,0,scientist,9,531,2,7,0.4
9,0,score,5,532,2,3,0.16
9,0,seal,4,533,1,3,0.16
9,0,second,6,534,2,4,0.24
9,0,secret,6,535,3,3,0.2
9,0,secretary,9,536,6,3,0.32
9,0,security,8,537,3,5,0.28
9,0,segment,7,538,2,5,0.24
9,0,selective,9,539,2,7,0.4
9,0,seminar,7,540,2,5,0.24
9,0,seriously,9,541,2,7,0.36
9,0,setting,7,542,2,5,0.24
9,0,sexual,6,543,2,4,0.28
9,0,sexy,4,544,3,1,0.12
9,0,shape,5,545,1,4,0.2
9,0,ship,4,546,2,2,0.12
9,0,shopping,8,547,2,6,0.28
9,0,shortage,8,548,3,5,0.32
9,0,sibling,7,549,1,6,0.28
9,0,sight,5,550,2,3,0.16
9,0,signature,9,551,3,6,0.4
9,0,similarly,9,552,2,7,0.36
9,0,sink,4,553,2,2,0.16
9,0,six,3,554,2,1,0.12
9,0,ski,3,555,1,2,0.12
9,0,skirt,5,556,3,2,0.16
9,0,slice,5,557,1,4,0.28
9,0,slip,4,558,3,1,0.12
9,0,smile,5,559,1,4,0.2
9,0,smoking,7,560,2,5,0.28
9,0,snow,4,561,1,3,0.16
9,0,soap,4,562,1,3,0.24
9,0,solar,5,563,2,3,0.16
9,0,solid,5,564,3,2,0.16
9,0,solo,4,565,3,1,0.12
9,0,some,4,566,2,2,0.12
9,0,somehow,7,567,4,3,0.32
9,0,sometimes,9,568,4,5,0.32
9,0,song,4,569,2,2,0.12
9,0,soup,4,570,2,2,0.12
9,0,south,5,571,3,2,0.16
9,0,spare,5,572,1,4,0.32
9,0,speak,5,573,2,3,0.44
9,0,speaker,7,574,5,2,0.44
9,0,specify,7,575,3,4,0.56
9,0,speech,6,576,3,3,0.48
9,0,sphere,6,577,2,4,0.6
9,0,spotlight,9,578,2,7,0.8
9,0,spread,6,579,2,4,0.52
9,0,stable,6,580,1,5,0.56
9,0,stall,5,581,3,2,0.48
9,0,stamp,5,582,3,2,0.36
9,0,stance,6,583,3,3,0.48
9,0,star,4,584,3,1,0.28
9,0,stay,4,585,3,1,0.28
9,0,steadily,8,586,2,6,0.8
9,0,stem,4,587,3,1,0.28
9,0,stick,5,588,2,3,0.44
9,0,sticky,6,589,5,1,0.36
9,0,stop,4,590,2,2,0.32
9,0,storage,7,591,3,4,0.64
9,0,story,5,592,4,1,0.32
9,0,strange,7,593,2,5,0.6
9,0,strategic,9,594,4,5,0.68
9,0,strike,6,595,3,3,0.56
9,0,striking,8,596,5,3,0.56
9,0,studio,6,597,2,4,0.52
9,0,study,5,598,4,1,0.32
9,0,stumble,7,599,3,4,0.64
9,0,stun,4,600,3,1,0.4
9,0,subject,7,601,1,6,0.68
9,0,such,4,602,2,2,0.32
9,0,sudden,6,603,2,4,0.52
9,0,supreme,7,604,2,5,0.6
9,0,sure,4,605,2,2,0.44
9,0,surely,6,606,4,2,0.48
9,0,survival,8,607,3,5,0.8
9,0,sweater,7,608,1,6,0.8
9,0,swim,4,609,2,2,0.44
9,0,symptom,7,610,1,6,0.68
9,0,synthesis,9,611,2,7,0.92
9,0,table,5,612,0,5,0.56
9,0,tactical,8,613,2,6,0.8
9,0,tail,4,614,2,2,0.32
9,0,talent,6,615,2,4,0.52
9,0,talk,4,616,3,1,0.28
9,0,task,4,617,2,2,0.32
9,0,taxi,4,618,2,2,0.44
9,0,tea,3,619,1,2,0.28
9,0,team,4,620,3,1,0.28
9,0,tendency,8,621,2,6,0.68
9,0,terrify,7,622,2,5,0.6
9,0,textbook,8,623,2,6,0.8
9,0,texture,7,624,4,3,0.48
9,0,therapist,9,625,1,8,0.84
9,0,thorough,8,626,2,6,0.84
9,0,three,5,627,2,3,0.44
9,0,thrilled,8,628,3,5,0.68
9,0,ticket,6,629,1,5,0.68
9,0,tidy,4,630,2,2,0.36
9,0,tighten,7,631,2,5,0.76
9,0,till,4,632,2,2,0.32
9,0,timing,6,633,2,4,0.52
9,0,to,2,634,1,1,0.2
9,0,together,8,635,2,6,0.72
9,0,tolerance,9,636,2,7,0.92
9,0,tonight,7,637,2,5,0.6
9,0,tonne,5,638,3,2,0.36
9,0,trademark,9,639,1,8,0.96
9,0,trainer,7,640,3,4,0.56
9,0,trap,4,641,3,1,0.28
9,0,traveller,9,642,3,6,0.76
9,0,treasure,8,643,2,6,0.8
9,0,treat,5,644,4,1,0.32
9,0,trio,4,645,2,2,0.32
9,0,tropical,8,646,2,6,0.72
9,0,tune,4,647,1,3,0.36
9,0,twice,5,648,1,4,0.56
9,0,two,3,649,2,1,0.24
9,0,undergo,7,650,0,7,0.72
9,0,undermine,9,651,5,4,0.64
9,0,underwear,9,652,5,4,0.8
9,0,unfair,6,653,2,4,0.52
9,0,unify,5,654,2,3,0.44
9,0,unique,6,655,3,3,0.44
9,0,universe,8,656,3,5,0.68
9,0,unusual,7,657,2,5,0.72
9,0,usual,5,658,1,4,0.48
9,0,utility,7,659,1,6,0.64
9,0,vague,5,660,0,5,0.52
9,0,valuable,8,661,2,6,0.84
9,0,venture,7,662,1,6,0.68
9,0,verify,6,663,2,4,0.52
9,0,veteran,7,664,2,5,0.6
9,0,video,5,665,1,4,0.6
9,0,virtue,6,666,2,4,0.52
9,0,virus,5,667,3,2,0.36
9,0,visitor,7,668,2,5,0.6
9,0,visual,6,669,3,3,0.6
9,0,vital,5,670,2,3,0.4
9,0,voice,5,671,1,4,0.48
9,0,volunteer,9,672,2,7,0.88
9,0,wait,4,673,0,4,0.52
9,0,waiter,6,674,4,2,0.52
9,0,wake,4,675,2,2,0.32
9,0,walk,4,676,2,2,0.36
9,0,warrior,7,677,2,5,0.72
9,0,washing,7,678,2,5,0.84
9,0,way,3,679,2,1,0.24
9,0,weakness,8,680,1,7,0.84
9,0,weave,5,681,3,2,0.4
9,0,weekend,7,682,2,5,0.64
9,0,weight,6,683,2,4,0.64
9,0,welcome,7,684,2,5,0.6
9,0,whenever,8,685,1,7,0.76
9,0,whose,5,686,2,3,0.48
9,0,width,5,687,1,4,0.68
9,0,willing,7,688,2,5,0.64
9,0,wine,4,689,2,2,0.32
9,0,wisdom,6,690,2,4,0.52
9,0,woman,5,691,1,4,0.48
9,0,wonderful,9,692,2,7,0.92
9,0,workforce,9,693,2,7,0.92
9,0,wrist,5,694,1,4,0.56
9,0,written,7,695,3,4,0.76
9,0,young,5,696,0,5,0.56
9,1,a,1,0,0,1,0.16
9,1,absence,7,1,1,6,0.64
9,1,absorb,6,2,3,3,0.44
9,1,accept,6,3,1,5,0.56
9,1,accurate,8,4,3,5,0.76
9,1,activate,8,5,2,6,0.68
9,1,acute,5,6,2,3,0.4
9,1,ad,2,7,1,1,0.2
9,1,add,3,8,2,1,0.32
9,1,admit,5,9,2,3,0.4
9,1,adopt,5,10,2,3,0.4
9,1,adoption,8,11,5,3,0.52
9,1,advantage,9,12,2,7,0.92
9,1,adventure,9,13,3,6,0.76
9,1,advice,6,14,3,3,0.48
9,1,aesthetic,9,15,1,8,0.88
9,1,aftermath,9,16,1,8,1.56
9,1,against,7,17,1,6,1.28
9,1,aids,4,18,1,3,0.6
9,1,align,5,19,1,4,0.56
9,1,amateur,7,20,1,6,0.84
9,1,ambulance,9,21,2,7,0.8
9,1,ancient,7,22,1,6,0.64
9,1,and,3,23,2,1,0.28
9,1,anger,5,24,2,3,0.6
9,1,animal,6,25,2,4,0.52
9,1,ankle,5,26,2,3,0.44
9,1,announce,8,27,2,6,0.72
9,1,annoyed,7,28,4,3,0.64
9,1,anyway,6,29,2,4,0.6
9,1,apology,7,30,1,6,0.8
9,1,app,3,31,2,1,0.28
9,1,applaud,7,32,3,4,0.64
9,1,approach,8,33,3,5,0.84
9,1,approve,7,34,5,2,0.44
9,1,arise,5,35,1,4,0.48
9,1,arrest,6,36,2,4,0.52
9,1,assistant,9,37,1,8,0.96
9,1,at,2,38,1,1,0.2
9,1,atrocity,8,39,2,6,0.76
9,1,attract,7,40,2,5,0.6
9,1,auction,7,41,1,6,0.76
9,1,automatic,9,42,2,7,0.8
9,1,backing,7,43,0,7,0.72
9,1,bacteria,8,44,3,5,0.68
9,1,banner,6,45,2,4,0.64
9,1,bat,3,46,2,1,0.24
9,1,bay,3,47,2,1,0.24
9,1,beast,5,48,1,4,0.48
9,1,beauty,6,49,3,3,0.44
9,1,bed,3,50,2,1,0.32
9,1,beer,4,51,2,2,0.32
9,1,behalf,6,52,2,4,0.52
9,1,benchmark,9,53,2,7,0.8
9,1,best,4,54,2,2,0.32
9,1,between,7,55,2,5,0.64
9,1,beyond,6,56,2,4,0.32
9,1,bill,4,57,1,3,0.2
9,1,bin,3,58,2,1,0.12
9,1,birthday,8,59,2,6,0.32
9,1,bishop,6,60,2,4,0.32
9,1,bitter,6,61,2,4,0.24
9,1,blind,5,62,1,4,0.24
9,1,blog,4,63,2,2,0.16
9,1,blow,4,64,3,1,0.12
9,1,boat,4,65,1,3,0.24
9,1,bomb,4,66,2,2,0.16
9,1,boost,5,67,2,3,0.16
9,1,bottle,6,68,2,4,0.24
9,1,bound,5,69,2,3,0.16
9,1,boundary,8,70,5,3,0.32
9,1,brand,5,71,1,4,0.2
9,1,breathe,7,72,2,5,0.28
9,1,breathing,9,73,6,3,0.24
9,1,bride,5,74,2,3,0.24
9,1,bright,6,75,3,3,0.2
9,1,buffer,6,76,1,5,0.24
9,1,bug,3,77,2,1,0.12
9,1,build,5,78,2,3,0.2
9,1,bunch,5,79,2,3,0.24
9,1,burden,6,80,2,4,0.2
9,1,burn,4,81,3,1,0.12
9,1,business,8,82,2,6,0.28
9,1,butter,6,83,2,4,0.2
9,1,candidate,9,84,0,9,0.44
9,1,cap,3,85,2,1,0.08
9,1,career,6,86,2,4,0.24
9,1,cave,4,87,2,2,0.16
9,1,cd,2,88,1,1,0.08
9,1,cease,5,89,1,4,0.28
9,1,celebrity,9,90,2,7,0.36
9,1,central,7,91,2,5,0.24
9,1,certain,7,92,2,5,0.28
9,1,certainty,9,93,7,2,0.28
9,1,chapter,7,94,1,6,0.28
9,1,character,9,95,3,6,0.32
9,1,charity,7,96,4,3,0.28
9,1,charming,8,97,4,4,0.28
9,1,cheerful,8,98,2,6,0.28
9,1,chicken,7,99,2,5,0.24
9,1,childhood,9,100,3,6,0.36
9,1,chop,4,101,2,2,0.12
9,1,chronic,7,102,2,5,0.28
9,1,city,4,103,1,3,0.16
9,1,clause,6,104,1,5,0.28
9,1,clinical,8,105,2,6,0.28
9,1,closely,7,106,2,5,0.24
9,1,cloud,5,107,3,2,0.16
9,1,colony,6,108,1,5,0.32
9,1,comment,7,109,2,5,0.24
9,1,commodity,9,110,4,5,0.28
9,1,commonly,8,111,5,3,0.24
9,1,community,9,112,4,5,0.36
9,1,company,7,113,3,4,0.24
9,1,comply,6,114,4,2,0.16
9,1,component,9,115,4,5,0.28
9,1,concern,7,116,2,5,0.32
9,1,conduct,7,117,3,4,0.24
9,1,confer,6,118,3,3,0.2
9,1,confess,7,119,5,2,0.2
9,1,confused,8,120,4,4,0.32
9,1,conscious,9,121,3,6,0.32
9,1,contempt,8,122,3,5,0.28
9,1,contrast,8,123,4,4,0.32
9,1,cooker,6,124,2,4,0.24
9,1,cost,4,125,2,2,0.16
9,1,county,6,126,2,4,0.24
9,1,coup,4,127,3,1,0.12
9,1,craft,5,128,1,4,0.32
9,1,create,6,129,2,4,0.24
9,1,credible,8,130,3,5,0.28
9,1,creep,5,131,3,2,0.16
9,1,cross,5,132,2,3,0.16
9,1,crucial,7,133,2,5,0.32
9,1,cruel,5,134,3,2,0.2
9,1,cry,3,135,2,1,0.12
9,1,currency,8,136,1,7,0.36
9,1,current,7,137,6,1,0.24
9,1,damage,6,138,0,6,0.28
9,1,dance,5,139,2,3,0.2
9,1,dare,4,140,2,2,0.12
9,1,day,3,141,2,1,0.08
9,1,deal,4,142,1,3,0.16
9,1,decline,7,143,2,5,0.36
9,1,decrease,8,144,3,5,0.28
9,1,deed,4,145,2,2,0.16
9,1,defence,7,146,2,5,0.28
9,1,defender,8,147,5,3,0.32
9,1,definite,8,148,3,5,0.28
9,1,delight,7,149,2,5,0.28
9,1,delighted,9,150,7,2,0.24
9,1,deliver,7,151,4,3,0.28
9,1,demon,5,152,2,3,0.16
9,1,dentist,7,153,2,5,0.28
9,1,deposit,7,154,2,5,0.28
9,1,desktop,7,155,2,5,0.36
9,1,despite,7,156,3,4,0.28
9,1,develop,7,157,2,5,0.28
9,1,devil,5,158,3,2,0.2
9,1,diagram,7,159,1,6,0.36
9,1,dictator,8,160,2,6,0.32
9,1,dig,3,161,2,1,0.08
9,1,dirt,4,162,2,2,0.16
9,1,discuss,7,163,2,5,0.24
9,1,display,7,164,3,4,0.32
9,1,domain,6,165,1,5,0.24
9,1,dominant,8,166,3,5,0.28
9,1,donation,8,167,2,6,0.36
9,1,dot,3,168,2,1,0.12
9,1,double,6,169,2,4,0.2
9,1,download,8,170,2,6,0.32
9,1,drink,5,171,1,4,0.2
9,1,dust,4,172,1,3,0.24
9,1,earth,5,173,0,5,0.24
9,1,edition,7,174,1,6,0.28
9,1,editor,6,175,4,2,0.16
9,1,effort,6,176,1,5,0.24
9,1,eighty,6,177,1,5,0.32
9,1,either,6,178,2,4,0.24
9,1,elect,5,179,1,4,0.2
9,1,eleven,6,180,3,3,0.2
9,1,elsewhere,9,181,2,7,0.4
9,1,embark,6,182,1,5,0.24
9,1,emergency,9,183,2,7,0.36
9,1,emission,8,184,2,6,0.36
9,1,emotion,7,185,2,5,0.28
9,1,empirical,9,186,2,7,0.32
9,1,employer,8,187,3,5,0.28
9,1,enable,6,188,1,5,0.32
9,1,endless,7,189,2,5,0.28
9,1,enemy,5,190,2,3,0.2
9,1,engineer,8,191,2,6,0.32
9,1,enjoyable,9,192,2,7,0.4
9,1,enrich,6,193,2,4,0.2
9,1,entrance,8,194,2,6,0.28
9,1,entry,5,195,4,1,0.12
9,1,essay,5,196,1,4,0.28
9,1,essence,7,197,3,4,0.24
9,1,establish,9,198,2,7,0.32
9,1,euro,4,199,1,3,0.16
9,1,evening,7,200,1,6,0.36
9,1,evoke,5,201,2,3,0.2
9,1,exact,5,202,1,4,0.2
9,1,exceed,6,203,2,4,0.2
9,1,exchange,8,204,3,5,0.36
9,1,excited,7,205,3,4,0.24
9,1,exciting,8,206,5,3,0.24
9,1,exclusive,9,207,3,6,0.32
9,1,excuse,6,208,3,3,0.28
9,1,execution,9,209,2,7,0.36
9,1,existence,9,210,2,7,0.36
9,1,exit,4,211,3,1,0.12
9,1,expensive,9,212,2,7,0.4
9,1,explain,7,213,3,4,0.24
9,1,exploit,7,214,4,3,0.2
9,1,explosive,9,215,5,4,0.32
9,1,extensive,9,216,2,7,0.36
9,1,faculty,7,217,0,7,0.6
9,1,failed,6,218,2,4,0.52
9,1,failure,7,219,4,3,0.64
9,1,fair,4,220,3,1,0.28
9,1,fall,4,221,2,2,0.36
9,1,fantastic,9,222,2,7,0.84
9,1,fasten,6,223,2,4,0.68
9,1,fat,3,224,2,1,0.24
9,1,fear,4,225,1,3,0.36
9,1,fellow,6,226,2,4,0.52
9,1,fifty,5,227,1,4,0.48
9,1,file,4,228,2,2,0.32
9,1,fixture,7,229,2,5,0.72
9,1,flag,4,230,1,3,0.4
9,1,flat,4,231,3,1,0.28
9,1,flee,4,232,2,2,0.32
9,1,flexible,8,233,3,5,0.64
9,1,floor,5,234,2,3,0.52
9,1,flower,6,235,3,3,0.48
9,1,flying,6,236,2,4,0.52
9,1,folding,7,237,1,6,0.68
9,1,folk,4,238,3,1,0.28
9,1,food,4,239,2,2,0.44
9,1,for,3,240,2,1,0.24
9,1,foreign,7,241,3,4,0.56
9,1,former,6,242,3,3,0.44
9,1,formula,7,243,4,3,0.52
9,1,forward,7,244,3,4,0.68
9,1,freedom,7,245,1,6,0.64
9,1,frequent,8,246,3,5,0.64
9,1,friday,6,247,2,4,0.52
9,1,fridge,6,248,4,2,0.52
9,1,frighten,8,249,3,5,0.64
9,1,front,5,250,2,3,0.4
9,1,funding,7,251,1,6,0.64
9,1,game,4,252,0,4,0.52
9,1,gender,6,253,1,5,0.6
9,1,generally,9,254,3,6,1.12
9,1,genetic,7,255,4,3,0.56
9,1,genuinely,9,256,3,6,0.88
9,1,glimpse,7,257,1,6,0.64
9,1,globe,5,258,2,3,0.44
9,1,gold,4,259,1,3,0.4
9,1,golf,4,260,3,1,0.44
9,1,good,4,261,2,2,0.4
9,1,goodbye,7,262,4,3,0.6
9,1,govern,6,263,2,4,0.6
9,1,governor,8,264,6,2,0.56
9,1,graphics,8,265,1,7,0.88
9,1,gravity,7,266,3,4,0.56
9,1,green,5,267,2,3,0.4
9,1,greet,5,268,4,1,0.32
9,1,ground,6,269,2,4,0.6
9,1,guess,5,270,1,4,0.48
9,1,guest,5,271,4,1,0.32
9,1,guidance,8,272,2,6,0.68
9,1,guide,5,273,4,1,0.32
9,1,handy,5,274,0,5,0.64
9,1,hat,3,275,2,1,0.24
9,1,hate,4,276,3,1,0.28
9,1,hazard,6,277,2,4,0.52
9,1,headline,8,278,1,7,0.76
9,1,health,6,279,3,3,0.56
9,1,heart,5,280,3,2,0.36
9,1,heat,4,281,3,1,0.28
9,1,heighten,8,282,2,6,0.72
9,1,herb,4,283,2,2,0.36
9,1,hers,4,284,3,1,0.4
9,1,highlight,9,285,1,8,0.88
9,1,highly,6,286,5,1,0.36
9,1,hint,4,287,2,2,0.32
9,1,historic,8,288,2,6,0.8
9,1,horrible,8,289,1,7,0.76
9,1,household,9,290,2,7,0.8
9,1,however,7,291,2,5,0.6
9,1,humble,6,292,1,5,0.72
9,1,hunger,6,293,2,4,0.52
9,1,hunt,4,294,3,1,0.28
9,1,hydrogen,8,295,1,7,0.76
9,1,i,1,296,0,1,0.16
9,1,ice,3,297,1,2,0.4
9,1,icon,4,298,2,2,0.32
9,1,ideal,5,299,1,4,0.48
9,1,identical,9,300,3,6,0.76
9,1,identity,8,301,6,2,0.6
9,1,image,5,302,1,4,0.48
9,1,imagery,7,303,5,2,0.44
9,1,implement,9,304,2,7,0.8
9,1,improve,7,305,3,4,0.68
9,1,inclusion,9,306,1,8,0.88
9,1,incur,5,307,3,2,0.36
9,1,indirect,8,308,2,6,0.72
9,1,influence,9,309,2,7,0.92
9,1,inherent,8,310,2,6,0.72
9,1,injure,6,311,2,4,0.52
9,1,insert,6,312,2,4,0.52
9,1,intensify,9,313,2,7,1.04
9,1,interior,8,314,4,4,0.72
9,1,invade,6,315,2,4,0.6
9,1,involve,7,316,3,4,0.76
9,1,iron,4,317,1,3,0.4
9,1,isolated,8,318,1,7,0.84
9,1,issue,5,319,2,3,0.44
9,1,january,7,320,0,7,0.72
9,1,joy,3,321,1,2,0.44
9,1,judicial,8,322,1,7,0.76
9,1,june,4,323,2,2,0.32
9,1,just,4,324,2,2,0.32
9,1,justify,7,325,4,3,0.52
9,1,key,3,326,0,3,0.48
9,1,kick,4,327,1,3,0.4
9,1,kid,3,328,2,1,0.24
9,1,king,4,329,2,2,0.36
9,1,kit,3,330,2,1,0.24
9,1,knife,5,331,1,4,0.48
9,1,lack,4,332,0,4,0.56
9,1,lad,3,333,2,1,0.24
9,1,landmark,8,334,2,6,0.72
9,1,landscape,9,335,4,5,0.68
9,1,lap,3,336,2,1,0.24
9,1,latest,6,337,2,4,0.64
9,1,laugh,5,338,2,3,0.44
9,1,law,3,339,2,1,0.24
9,1,lawn,4,340,3,1,0.28
9,1,leading,7,341,1,6,0.76
9,1,learning,8,342,3,5,0.84
9,1,left,4,343,2,2,0.32
9,1,legend,6,344,2,4,0.52
9,1,legendary,9,345,6,3,0.56
9,1,lens,4,346,2,2,0.32
9,1,lesser,6,347,2,4,0.6
9,1,letter,6,348,2,4,0.52
9,1,license,7,349,1,6,0.68
9,1,lifestyle,9,350,2,7,0.8
9,1,limb,4,351,2,2,0.44
9,1,litter,6,352,2,4,0.52
9,1,little,6,353,4,2,0.4
9,1,load,4,354,1,3,0.36
9,1,located,7,355,2,5,0.72
9,1,long,4,356,2,2,0.32
9,1,look,4,357,2,2,0.32
9,1,loose,5,358,3,2,0.36
9,1,lot,3,359,2,1,0.28
9,1,lunch,5,360,1,4,0.6
9,1,machinery,9,361,0,9,1.08
9,1,mail,4,362,2,2,0.32
9,1,main,4,363,3,1,0.28
9,1,mainland,8,364,4,4,0.6
9,1,mandate,7,365,2,5,0.72
9,1,mandatory,9,366,6,3,0.6
9,1,map,3,367,2,1,0.24
9,1,match,5,368,2,3,0.44
9,1,mean,4,369,1,3,0.4
9,1,meeting,7,370,2,5,0.76
9,1,melody,6,371,2,4,0.36
9,1,mentor,6,372,2,4,0.28
9,1,merger,6,373,2,4,0.24
9,1,method,6,374,2,4,0.24
9,1,mind,4,375,1,3,0.24
9,1,missing,7,376,2,5,0.32
9,1,mixed,5,377,2,3,0.2
9,1,model,5,378,1,4,0.2
9,1,moment,6,379,2,4,0.28
9,1,month,5,380,2,3,0.16
9,1,monthly,7,381,5,2,0.2
9,1,monument,8,382,3,5,0.28
9,1,more,4,383,2,2,0.16
9,1,mouth,5,384,2,3,0.24
9,1,movie,5,385,2,3,0.2
9,1,much,4,386,1,3,0.16
9,1,multiple,8,387,2,6,0.32
9,1,mum,3,388,2,1,0.08
9,1,museum,6,389,2,4,0.28
9,1,my,2,390,1,1,0.08
9,1,myth,4,391,2,2,0.12
9,1,naked,5,392,0,5,0.24
9,1,name,4,393,2,2,0.12
9,1,nasty,5,394,2,3,0.2
9,1,necessary,9,395,1,8,0.44
9,1,negative,8,396,2,6,0.28
9,1,neutral,7,397,2,5,0.24
9,1,new,3,398,2,1,0.08
9,1,noise,5,399,1,4,0.28
9,1,nominate,8,400,2,6,0.32
9,1,non,3,401,2,1,0.08
9,1,northern,8,402,2,6,0.28
9,1,nothing,7,403,2,5,0.36
9,1,notion,6,404,3,3,0.2
9,1,novel,5,405,2,3,0.16
9,1,numerous,8,406,1,7,0.32
9,1,nut,3,407,2,1,0.08
9,1,obviously,9,408,0,9,0.48
9,1,ocean,5,409,1,4,0.24
9,1,off,3,410,1,2,0.16
9,1,offence,7,411,3,4,0.28
9,1,offend,6,412,5,1,0.24
9,1,offspring,9,413,3,6,0.32
9,1,once,4,414,1,3,0.16
9,1,one,3,415,2,1,0.08
9,1,opponent,8,416,1,7,0.32
9,1,opposed,7,417,4,3,0.28
9,1,organized,9,418,1,8,0.36
9,1,originate,9,419,2,7,0.36
9,1,ought,5,420,1,4,0.28
9,1,outbreak,8,421,2,6,0.28
9,1,outdoor,7,422,3,4,0.24
9,1,outdoors,8,423,7,1,0.2
9,1,outfit,6,424,3,3,0.28
9,1,overall,7,425,1,6,0.28
9,1,owe,3,426,1,2,0.12
9,1,pad,3,427,0,3,0.12
9,1,page,4,428,2,2,0.16
9,1,pants,5,429,2,3,0.16
9,1,parade,6,430,2,4,0.28
9,1,parallel,8,431,4,4,0.24
9,1,park,4,432,3,1,0.12
9,1,passport,8,433,2,6,0.28
9,1,password,8,434,4,4,0.32
9,1,patience,8,435,2,6,0.32
9,1,patron,6,436,3,3,0.2
9,1,peace,5,437,1,4,0.2
9,1,peculiar,8,438,2,6,0.36
9,1,perfect,7,439,2,5,0.28
9,1,phone,5,440,1,4,0.2
9,1,photo,5,441,3,2,0.16
9,1,picture,7,442,1,6,0.36
9,1,pig,3,443,2,1,0.08
9,1,pile,4,444,2,2,0.16
9,1,pipe,4,445,2,2,0.12
9,1,planning,8,446,1,7,0.36
9,1,plastic,7,447,3,4,0.32
9,1,plead,5,448,2,3,0.2
9,1,pleased,7,449,4,3,0.2
9,1,plot,4,450,2,2,0.12
9,1,political,9,451,1,8,0.44
9,1,pollution,9,452,3,6,0.32
9,1,portion,7,453,2,5,0.28
9,1,position,8,454,2,6,0.32
9,1,possible,8,455,3,5,0.36
9,1,post,4,456,3,1,0.12
9,1,pot,3,457,2,1,0.08
9,1,practical,9,458,1,8,0.36
9,1,praise,6,459,3,3,0.28
9,1,precedent,9,460,2,7,0.36
9,1,predict,7,461,3,4,0.24
9,1,prejudice,9,462,3,6,0.32
9,1,premier,7,463,3,4,0.32
9,1,premise,7,464,5,2,0.2
9,1,presence,8,465,3,5,0.28
9,1,presently,9,466,6,3,0.32
9,1,principal,9,467,2,7,0.32
9,1,printer,7,468,4,3,0.2
9,1,procedure,9,469,2,7,0.36
9,1,process,7,470,5,2,0.24
9,1,processor,9,471,7,2,0.24
9,1,produce,7,472,3,4,0.24
9,1,profile,7,473,3,4,0.24
9,1,profound,8,474,4,4,0.32
9,1,prominent,9,475,3,6,0.32
9,1,proof,5,476,3,2,0.16
9,1,proper,6,477,3,3,0.2
9,1,prosecute,9,478,3,6,0.36
9,1,protest,7,479,3,4,0.24
9,1,publicity,9,480,1,8,0.36
9,1,purpose,7,481,2,5,0.32
9,1,pursuit,7,482,3,4,0.24
9,1,put,3,483,2,1,0.08
9,1,query,5,484,0,5,0.24
9,1,quest,5,485,3,2,0.16
9,1,race,4,486,0,4,0.24
9,1,racial,6,487,3,3,0.2
9,1,radiation,9,488,2,7,0.36
9,1,rail,4,489,2,2,0.12
9,1,realistic,9,490,1,8,0.44
9,1,realm,5,491,4,1,0.16
9,1,rear,4,492,3,1,0.12
9,1,recommend,9,493,2,7,0.36
9,1,record,6,494,4,2,0.16
9,1,recount,7,495,4,3,0.32
9,1,recycle,7,496,3,4,0.24
9,1,reduction,9,497,2,7,0.32
9,1,referee,7,498,2,5,0.32
9,1,regard,6,499,2,4,0.24
9,1,region,6,500,3,3,0.2
9,1,rejection,9,501,2,7,0.32
9,1,relative,8,502,2,6,0.36
9,1,relaxed,7,503,4,3,0.2
9,1,relevance,9,504,3,6,0.32
9,1,relief,6,505,3,3,0.2
9,1,relieved,8,506,5,3,0.32
9,1,religious,9,507,4,5,0.28
9,1,remind,6,508,2,4,0.24
9,1,repeat,6,509,2,4,0.24
9,1,replace,7,510,3,4,0.32
9,1,residue,7,511,2,5,0.28
9,1,retire,6,512,2,4,0.24
9,1,reveal,6,513,2,4,0.2
9,1,revenge,7,514,4,3,0.32
9,1,revise,6,515,3,3,0.24
9,1,revision,8,516,5,3,0.24
9,1,revival,7,517,4,3,0.24
9,1,rifle,5,518,1,4,0.28
9,1,right,5,519,2,3,0.2
9,1,rip,3,520,2,1,0.08
9,1,rise,4,521,2,2,0.16
9,1,rob,3,522,1,2,0.28
9,1,robust,6,523,3,3,0.32
9,1,romance,7,524,2,5,0.32
9,1,roof,4,525,2,2,0.16
9,1,routine,7,526,2,5,0.28
9,1,ruin,4,527,1,3,0.16
9,1,sacred,6,528,0,6,0.32
9,1,sale,4,529,2,2,0.24
9,1,sample,6,530,2,4,0.2
9,1,satellite,9,531,2,7,0.36
9,1,satisfied,9,532,3,6,0.4
9,1,scan,4,533,1,3,0.16
9,1,schedule,8,534,2,6,0.72
9,1,scheme,6,535,4,2,0.4
9,1,school,6,536,3,3,0.48
9,1,scientist,9,537,2,7,0.92
9,1,score,5,538,2,3,0.4
9,1,seal,4,539,1,3,0.36
9,1,secretary,9,540,2,7,0.8
9,1,seem,4,541,2,2,0.44
9,1,segment,7,542,2,5,0.64
9,1,sensible,8,543,2,6,0.72
9,1,september,9,544,2,7,0.8
9,1,servant,7,545,2,5,0.72
9,1,serve,5,546,4,1,0.32
9,1,settler,7,547,2,5,0.6
9,1,severely,8,548,2,6,0.72
9,1,share,5,549,1,4,0.64
9,1,shopping,8,550,2,6,0.84
9,1,shortage,8,551,3,5,0.76
9,1,shortly,7,552,5,2,0.6
9,1,sibling,7,553,1,6,0.72
9,1,sight,5,554,2,3,0.44
9,1,simply,6,555,2,4,0.56
9,1,sink,4,556,2,2,0.36
9,1,sit,3,557,2,1,0.24
9,1,situated,8,558,3,5,0.8
9,1,skirt,5,559,1,4,0.52
9,1,slam,4,560,1,3,0.4
9,1,slip,4,561,2,2,0.36
9,1,smile,5,562,1,4,0.52
9,1,smoking,7,563,2,5,0.76
9,1,snow,4,564,1,3,0.44
9,1,solid,5,565,1,4,0.52
9,1,solo,4,566,3,1,0.32
9,1,some,4,567,2,2,0.36
9,1,someone,7,568,4,3,0.64
9,1,soup,4,569,2,2,0.32
9,1,space,5,570,1,4,0.48
9,1,spare,5,571,3,2,0.4
9,1,speak,5,572,2,3,0.4
9,1,specify,7,573,3,4,0.68
9,1,speech,6,574,3,3,0.52
9,1,spin,4,575,2,2,0.36
9,1,spokesman,9,576,2,7,0.92
9,1,spread,6,577,2,4,0.64
9,1,stab,4,578,1,3,0.4
9,1,stable,6,579,4,2,0.44
9,1,stamp,5,580,3,2,0.36
9,1,stand,5,581,3,2,0.36
9,1,standing,8,582,5,3,0.68
9,1,star,4,583,3,1,0.32
9,1,statistic,9,584,3,6,0.84
9,1,statue,6,585,4,2,0.4
9,1,stay,4,586,3,1,0.28
9,1,stick,5,587,2,3,0.52
9,1,story,5,588,2,3,0.4
9,1,straight,8,589,2,6,0.72
9,1,strength,8,590,3,5,0.64
9,1,stretch,7,591,4,3,0.64
9,1,strict,6,592,3,3,0.48
9,1,strike,6,593,4,2,0.4
9,1,striking,8,594,5,3,0.56
9,1,strong,6,595,3,3,0.6
9,1,stumble,7,596,2,5,0.6
9,1,subject,7,597,1,6,0.68
9,1,sudden,6,598,2,4,0.52
9,1,sugar,5,599,2,3,0.44
9,1,supreme,7,600,2,5,0.76
9,1,sure,4,601,2,2,0.32
9,1,survival,8,602,3,5,0.64
9,1,swallow,7,603,1,6,0.64
9,1,swear,5,604,2,3,0.6
9,1,sweep,5,605,3,2,0.44
9,1,switch,6,606,2,4,0.6
9,1,symbolic,8,607,1,7,0.88
9,1,symptom,7,608,3,4,0.72
9,1,tactical,8,609,0,8,0.88
9,1,talent,6,610,2,4,0.56
9,1,tank,4,611,2,2,0.36
9,1,tap,3,612,2,1,0.24
9,1,tape,4,613,3,1,0.4
9,1,task,4,614,2,2,0.36
9,1,taste,5,615,3,2,0.36
9,1,taxi,4,616,2,2,0.32
9,1,tea,3,617,1,2,0.28
9,1,tender,6,618,2,4,0.52
9,1,terribly,8,619,2,6,0.84
9,1,texture,7,620,2,5,0.64
9,1,therapist,9,621,1,8,0.84
9,1,thesis,6,622,3,3,0.56
9,1,this,4,623,2,2,0.32
9,1,three,5,624,2,3,0.44
9,1,thrilled,8,625,3,5,0.64
9,1,thumb,5,626,2,3,0.4
9,1,tight,5,627,1,4,0.6
9,1,tighten,7,628,5,2,0.48
9,1,till,4,629,2,2,0.32
9,1,timing,6,630,2,4,0.52
9,1,to,2,631,1,1,0.2
9,1,tonight,7,632,2,5,0.72
9,1,tonne,5,633,3,2,0.36
9,1,too,3,634,2,1,0.24
9,1,tool,4,635,3,1,0.28
9,1,tragic,6,636,1,5,0.56
9,1,transport,9,637,3,6,0.88
9,1,traveller,9,638,3,6,0.84
9,1,treasure,8,639,2,6,0.84
9,1,treat,5,640,4,1,0.36
9,1,tree,4,641,3,1,0.4
9,1,trial,5,642,2,3,0.44
9,1,tribal,6,643,3,3,0.48
9,1,tribe,5,644,4,1,0.32
9,1,tribute,7,645,4,3,0.48
9,1,trio,4,646,3,1,0.28
9,1,tropical,8,647,2,6,0.84
9,1,truck,5,648,2,3,0.52
9,1,tune,4,649,1,3,0.48
9,1,twice,5,650,1,4,0.56
9,1,two,3,651,2,1,0.24
9,1,unable,6,652,0,6,0.76
9,1,undergo,7,653,2,5,0.68
9,1,union,5,654,2,3,0.44
9,1,universal,9,655,3,6,0.76
9,1,unusual,7,656,2,5,0.72
9,1,unveil,6,657,2,4,0.52
9,1,uphold,6,658,1,5,0.6
9,1,urban,5,659,1,4,0.48
9,1,urgent,6,660,2,4,0.64
9,1,utility,7,661,1,6,0.68
9,1,validity,8,662,0,8,0.8
9,1,valley,6,663,3,3,0.48
9,1,valuable,8,664,3,5,0.84
9,1,vein,4,665,1,3,0.4
9,1,verify,6,666,2,4,0.52
9,1,vessel,6,667,2,4,0.56
9,1,video,5,668,1,4,0.68
9,1,viewer,6,669,2,4,0.52
9,1,virtual,7,670,2,5,0.6
9,1,visitor,7,671,2,5,0.64
9,1,vital,5,672,2,3,0.44
9,1,voice,5,673,1,4,0.6
9,1,wake,4,674,0,4,0.44
9,1,walk,4,675,2,2,0.32
9,1,war,3,676,2,1,0.28
9,1,warning,7,677,3,4,0.68
9,1,watch,5,678,2,3,0.6
9,1,weapon,6,679,1,5,0.56
9,1,weekend,7,680,2,5,0.64
9,1,whatever,8,681,1,7,0.76
9,1,whenever,8,682,2,6,0.8
9,1,whereas,7,683,3,4,0.36
9,1,which,5,684,2,3,0.24
9,1,whose,5,685,2,3,0.2
9,1,willing,7,686,1,6,0.36
9,1,wind,4,687,2,2,0.16
9,1,wipe,4,688,2,2,0.16
9,1,without,7,689,2,5,0.28
9,1,wonderful,9,690,1,8,0.36
9,1,work,4,691,2,2,0.2
9,1,workforce,9,692,4,5,0.28
9,1,workplace,9,693,4,5,0.32
9,1,world,5,694,3,2,0.16
9,1,wrap,4,695,1,3,0.24
9,1,wrist,5,696,2,3,0.2
9,2,accompany,9,0,0,9,0.96
9,2,accurate,8,1,3,5,0.68
9,2,acid,4,2,2,2,0.44
9,2,acre,4,3,2,2,0.32
9,2,actress,7,4,2,5,0.6
9,2,acute,5,5,2,3,0.4
9,2,adjacent,8,6,1,7,0.76
9,2,admit,5,7,2,3,0.56
9,2,adopt,5,8,2,3,0.44
9,2,adoption,8,9,5,3,0.64
9,2,advantage,9,10,2,7,0.84
9,2,advice,6,11,3,3,0.56
9,2,aftermath,9,12,1,8,0.84
9,2,agree,5,13,1,4,0.48
9,2,alongside,9,14,1,8,0.96
9,2,amusing,7,15,1,6,0.68
9,2,analyse,7,16,1,6,0.64
9,2,analysis,8,17,6,2,0.48
9,2,and,3,18,2,1,0.24
9,2,anger,5,19,2,3,0.56
9,2,ankle,5,20,2,3,0.4
9,2,announce,8,21,2,6,0.88
9,2,annoying,8,22,4,4,0.6
9,2,anxiety,7,23,2,5,0.72
9,2,anybody,7,24,2,5,0.6
9,2,apologize,9,25,1,8,0.84
9,2,approach,8,26,2,6,0.84
9,2,approve,7,27,5,2,0.44
9,2,arguably,8,28,1,7,0.76
9,2,arms,4,29,2,2,0.32
9,2,arrow,5,30,2,3,0.56
9,2,assistant,9,31,1,8,0.84
9,2,associate,9,32,3,6,0.76
9,2,assurance,9,33,3,6,0.76
9,2,atrocity,8,34,1,7,0.88
9,2,bacteria,8,35,0,8,0.8
9,2,bath,4,36,2,2,0.32
9,2,beat,4,37,1,3,0.36
9,2,beer,4,38,2,2,0.44
9,2,behalf,6,39,2,4,0.52
9,2,belief,6,40,2,4,0.52
9,2,betray,6,41,2,4,0.6
9,2,between,7,42,3,4,0.68
9,2,beyond,6,43,2,4,0.52
9,2,bill,4,44,1,3,0.36
9,2,biscuit,7,45,2,5,0.6
9,2,bishop,6,46,3,3,0.52
9,2,bite,4,47,2,2,0.44
9,2,bitter,6,48,3,3,0.48
9,2,blade,5,49,1,4,0.48
9,2,blank,5,50,3,2,0.36
9,2,blind,5,51,2,3,0.4
9,2,boil,4,52,1,3,0.56
9,2,boot,4,53,2,2,0.32
9,2,box,3,54,2,1,0.24
9,2,boyfriend,9,55,2,7,0.8
9,2,brand,5,56,1,4,0.48
9,2,breach,6,57,2,4,0.64
9,2,breakdown,9,58,4,5,0.68
9,2,broken,6,59,2,4,0.6
9,2,build,5,60,1,4,0.48
9,2,bunch,5,61,2,3,0.44
9,2,burden,6,62,2,4,0.64
9,2,burn,4,63,3,1,0.28
9,2,cafe,4,64,0,4,0.44
9,2,cake,4,65,2,2,0.32
9,2,can,3,66,2,1,0.24
9,2,candidate,9,67,3,6,0.92
9,2,career,6,68,2,4,0.64
9,2,carefully,9,69,4,5,0.76
9,2,carpet,6,70,3,3,0.48
9,2,carve,5,71,3,2,0.48
9,2,cd,2,72,1,1,0.2
9,2,celebrate,9,73,1,8,0.88
9,2,celebrity,9,74,6,3,0.6
9,2,cemetery,8,75,2,6,0.84
9,2,ceremony,8,76,2,6,0.72
9,2,chapter,7,77,1,6,0.64
9,2,charter,7,78,3,4,0.56
9,2,check,5,79,2,3,0.52
9,2,cheerful,8,80,3,5,0.64
9,2,chicken,7,81,2,5,0.6
9,2,choose,6,82,2,4,0.52
9,2,chop,4,83,3,1,0.56
9,2,chronic,7,84,2,5,1.96
9,2,circle,6,85,1,5,1.56
9,2,circuit,7,86,4,3,1.04
9,2,city,4,87,2,2,0.36
9,2,clerk,5,88,1,4,0.56
9,2,club,4,89,2,2,0.32
9,2,cluster,7,90,3,4,0.68
9,2,coach,5,91,1,4,0.48
9,2,coffee,6,92,2,4,0.52
9,2,comedy,6,93,2,4,0.52
9,2,comfort,7,94,3,4,0.64
9,2,comment,7,95,3,4,0.56
9,2,company,7,96,3,4,0.56
9,2,comply,6,97,4,2,0.4
9,2,conceive,8,98,2,6,0.8
9,2,concept,7,99,5,2,0.52
9,2,confused,8,100,3,5,0.64
9,2,contempt,8,101,3,5,0.68
9,2,contend,7,102,5,2,0.56
9,2,cooker,6,103,2,4,0.52
9,2,correct,7,104,2,5,0.6
9,2,correctly,9,105,7,2,0.52
9,2,cottage,7,106,2,5,0.68
9,2,counter,7,107,2,5,0.6
9,2,coup,4,108,3,1,0.28
9,2,couple,6,109,4,2,0.4
9,2,coverage,8,110,2,6,0.8
9,2,credible,8,111,1,7,0.76
9,2,criminal,8,112,2,6,0.68
9,2,crisis,6,113,3,3,0.48
9,2,cross,5,114,2,3,0.52
9,2,crowd,5,115,3,2,0.36
9,2,crowded,7,116,5,2,0.44
9,2,crude,5,117,2,3,0.44
9,2,cruel,5,118,3,2,0.4
9,2,current,7,119,1,6,0.76
9,2,curved,6,120,3,3,0.44
9,2,dam,3,121,0,3,0.32
9,2,dance,5,122,2,3,0.4
9,2,dare,4,123,2,2,0.32
9,2,deal,4,124,1,3,0.48
9,2,death,5,125,3,2,0.36
9,2,december,8,126,2,6,0.68
9,2,default,7,127,2,5,0.64
9,2,defect,6,128,3,3,0.48
9,2,defence,7,129,4,3,0.6
9,2,defender,8,130,5,3,0.52
9,2,delight,7,131,2,5,0.6
9,2,delighted,9,132,7,2,0.6
9,2,deliver,7,133,4,3,0.52
9,2,demon,5,134,2,3,0.4
9,2,deputy,6,135,2,4,0.52
9,2,detect,6,136,2,4,0.52
9,2,detention,9,137,4,5,0.76
9,2,develop,7,138,2,5,0.6
9,2,diagram,7,139,1,6,0.68
9,2,dictate,7,140,2,5,0.72
9,2,dig,3,141,2,1,0.24
9,2,diminish,8,142,2,6,0.68
9,2,dinner,6,143,2,4,0.52
9,2,diplomat,8,144,2,6,0.68
9,2,director,8,145,2,6,0.8
9,2,dirty,5,146,3,2,0.36
9,2,discount,8,147,2,6,0.72
9,2,discovery,9,148,5,4,0.72
9,2,display,7,149,3,4,0.56
9,2,distort,7,150,3,4,0.56
9,2,divine,6,151,2,4,0.52
9,2,domain,6,152,1,5,0.64
9,2,dominant,8,153,3,5,0.64
9,2,dot,3,154,2,1,0.24
9,2,drawing,7,155,1,6,0.64
9,2,dust,4,156,1,3,0.36
9,2,earnings,8,157,0,8,0.92
9,2,earth,5,158,3,2,0.36
9,2,edit,4,159,1,3,0.36
9,2,edition,7,160,4,3,0.48
9,2,eight,5,161,1,4,0.48
9,2,eighty,6,162,5,1,0.44
9,2,eleven,6,163,1,5,0.56
9,2,elsewhere,9,164,2,7,0.84
9,2,embark,6,165,1,5,0.72
9,2,embody,6,166,3,3,0.6
9,2,emission,8,167,2,6,0.72
9,2,emotion,7,168,2,5,0.6
9,2,employer,8,169,2,6,0.8
9,2,empower,7,170,3,4,0.56
9,2,enemy,5,171,1,4,0.48
9,2,enjoy,5,172,2,3,0.4
9,2,enrich,6,173,2,4,0.52
9,2,entry,5,174,2,3,0.52
9,2,establish,9,175,1,8,0.84
9,2,evening,7,176,1,6,0.68
9,2,event,5,177,4,1,0.32
9,2,exact,5,178,1,4,0.56
9,2,examine,7,179,3,4,0.56
9,2,exceed,6,180,2,4,0.52
9,2,exception,9,181,4,5,0.68
9,2,excited,7,182,3,4,0.68
9,2,excuse,6,183,3,3,0.44
9,2,execution,9,184,2,7,0.76
9,2,exercise,8,185,3,5,0.64
9,2,existence,9,186,2,7,0.88
9,2,exit,4,187,3,1,0.28
9,2,expensive,9,188,2,7,0.8
9,2,extend,6,189,2,4,0.52
9,2,extent,6,190,5,1,0.44
9,2,fail,4,191,0,4,0.48
9,2,fairly,6,192,3,3,0.6
9,2,fantasy,7,193,2,5,0.68
9,2,fast,4,194,2,2,0.44
9,2,fasten,6,195,4,2,0.4
9,2,few,3,196,1,2,0.28
9,2,fibre,5,197,1,4,0.48
9,2,fiction,7,198,2,5,0.4
9,2,fight,5,199,2,3,0.28
9,2,finally,7,200,2,5,0.28
9,2,fine,4,201,3,1,0.12
9,2,firm,4,202,2,2,0.16
9,2,fix,3,203,2,1,0.12
9,2,flag,4,204,1,3,0.16
9,2,flee,4,205,2,2,0.2
9,2,flexible,8,206,3,5,0.28
9,2,floor,5,207,2,3,0.16
9,2,flourish,8,208,3,5,0.28
9,2,flower,6,209,3,3,0.28
9,2,focus,5,210,1,4,0.2
9,2,folding,7,211,2,5,0.28
9,2,foreigner,9,212,2,7,0.36
9,2,formula,7,213,3,4,0.32
9,2,forward,7,214,3,4,0.24
9,2,fourteen,8,215,2,6,0.32
9,2,fragment,8,216,1,7,0.48
9,2,freedom,7,217,2,5,0.36
9,2,friday,6,218,2,4,0.24
9,2,friendly,8,219,3,5,0.28
9,2,frighten,8,220,3,5,0.32
9,2,front,5,221,2,3,0.24
9,2,fulfil,6,222,1,5,0.24
9,2,funding,7,223,2,5,0.28
9,2,fur,3,224,2,1,0.12
9,2,gene,4,225,0,4,0.2
9,2,general,7,226,4,3,0.28
9,2,generally,9,227,7,2,0.24
9,2,generate,8,228,6,2,0.24
9,2,giant,5,229,1,4,0.24
9,2,glimpse,7,230,1,6,0.36
9,2,globe,5,231,2,3,0.2
9,2,go,2,232,1,1,0.08
9,2,god,3,233,2,1,0.12
9,2,gold,4,234,2,2,0.12
9,2,golf,4,235,3,1,0.12
9,2,good,4,236,2,2,0.2
9,2,goodbye,7,237,4,3,0.2
9,2,govern,6,238,2,4,0.2
9,2,grade,5,239,1,4,0.2
9,2,graphics,8,240,3,5,0.32
9,2,gravity,7,241,3,4,0.24
9,2,grin,4,242,2,2,0.12
9,2,growth,6,243,2,4,0.2
9,2,guest,5,244,1,4,0.2
9,2,guidance,8,245,2,6,0.36
9,2,guitar,6,246,3,3,0.2
9,2,guy,3,247,2,1,0.08
9,2,gym,3,248,1,2,0.12
9,2,harm,4,249,0,4,0.16
9,2,harvest,7,250,3,4,0.32
9,2,hate,4,251,2,2,0.12
9,2,hazard,6,252,2,4,0.24
9,2,headline,8,253,1,7,0.32
9,2,health,6,254,3,3,0.2
9,2,heart,5,255,3,2,0.2
9,2,heat,4,256,3,1,0.12
9,2,heighten,8,257,2,6,0.28
9,2,hesitate,8,258,2,6,0.28
9,2,hint,4,259,1,3,0.2
9,2,homeland,8,260,1,7,0.4
9,2,honesty,7,261,2,5,0.28
9,2,horrible,8,262,2,6,0.28
9,2,horror,6,263,4,2,0.24
9,2,household,9,264,2,7,0.36
9,2,how,3,265,2,1,0.12
9,2,however,7,266,3,4,0.24
9,2,humble,6,267,1,5,0.32
9,2,i,1,268,0,1,0.08
9,2,ice,3,269,1,2,0.12
9,2,identity,8,270,1,7,0.32
9,2,ill,3,271,1,2,0.12
9,2,illegal,7,272,3,4,0.24
9,2,image,5,273,1,4,0.24
9,2,imaginary,9,274,4,5,0.32
9,2,impatient,9,275,2,7,0.32
9,2,import,6,276,3,3,0.24
9,2,important,9,277,6,3,0.24
9,2,inclusion,9,278,1,8,0.36
9,2,incorrect,9,279,3,6,0.32
9,2,index,5,280,2,3,0.24
9,2,indirect,8,281,3,5,0.28
9,2,infant,6,282,2,4,0.2
9,2,influence,9,283,3,6,0.32
9,2,info,4,284,3,1,0.16
9,2,inherent,8,285,2,6,0.28
9,2,inject,6,286,2,4,0.24
9,2,injury,6,287,3,3,0.2
9,2,insert,6,288,2,4,0.28
9,2,insertion,9,289,6,3,0.24
9,2,inspect,7,290,3,4,0.24
9,2,instant,7,291,3,4,0.24
9,2,insurance,9,292,3,6,0.36
9,2,intended,8,293,2,6,0.28
9,2,intense,7,294,5,2,0.2
9,2,interior,8,295,4,4,0.32
9,2,invade,6,296,2,4,0.24
9,2,invest,6,297,3,3,0.2
9,2,involve,7,298,3,4,0.24
9,2,iron,4,299,1,3,0.16
9,2,island,6,300,1,5,0.32
9,2,isolated,8,301,2,6,0.32
9,2,issue,5,302,2,3,0.2
9,2,jewellery,9,303,0,9,0.4
9,2,job,3,304,1,2,0.2
9,2,joy,3,305,2,1,0.08
9,2,jump,4,306,1,3,0.16
9,2,june,4,307,2,2,0.16
9,2,justify,7,308,2,5,0.24
9,2,key,3,309,0,3,0.16
9,2,kidney,6,310,1,5,0.32
9,2,king,4,311,2,2,0.16
9,2,kingdom,7,312,4,3,0.2
9,2,kit,3,313,2,1,0.08
9,2,knife,5,314,1,4,0.24
9,2,know,4,315,2,2,0.2
9,2,lack,4,316,0,4,0.16
9,2,lad,3,317,2,1,0.08
9,2,lake,4,318,2,2,0.16
9,2,lap,3,319,2,1,0.08
9,2,last,4,320,2,2,0.12
9,2,layer,5,321,2,3,0.2
9,2,leaf,4,322,1,3,0.2
9,2,league,6,323,3,3,0.2
9,2,left,4,324,2,2,0.16
9,2,legend,6,325,2,4,0.2
9,2,legendary,9,326,6,3,0.28
9,2,lemon,5,327,2,3,0.2
9,2,lens,4,328,2,2,0.12
9,2,lesbian,7,329,2,5,0.28
9,2,lesser,6,330,3,3,0.2
9,2,lethal,6,331,2,4,0.28
9,2,letter,6,332,3,3,0.2
9,2,licence,7,333,1,6,0.28
9,2,license,7,334,5,2,0.2
9,2,lifestyle,9,335,2,7,0.4
9,2,limb,4,336,2,2,0.16
9,2,limited,7,337,3,4,0.24
9,2,link,4,338,2,2,0.12
9,2,literary,8,339,2,6,0.36
9,2,little,6,340,3,3,0.2
9,2,liver,5,341,2,3,0.16
9,2,load,4,342,1,3,0.16
9,2,local,5,343,2,3,0.16
9,2,located,7,344,4,3,0.28
9,2,location,8,345,5,3,0.24
9,2,log,3,346,2,1,0.08
9,2,lonely,6,347,2,4,0.24
9,2,long,4,348,3,1,0.12
9,2,love,4,349,2,2,0.16
9,2,lunch,5,350,1,4,0.24
9,2,machinery,9,351,0,9,0.4
9,2,mail,4,352,2,2,0.12
9,2,main,4,353,3,1,0.12
9,2,mainland,8,354,4,4,0.32
9,2,mandate,7,355,2,5,0.24
9,2,mandatory,9,356,6,3,0.24
9,2,map,3,357,2,1,0.08
9,2,mark,4,358,2,2,0.12
9,2,married,7,359,3,4,0.28
9,2,mask,4,360,2,2,0.12
9,2,master,6,361,3,3,0.2
9,2,match,5,362,2,3,0.16
9,2,meal,4,363,1,3,0.16
9,2,mean,4,364,3,1,0.16
9,2,meanwhile,9,365,4,5,0.32
9,2,meeting,7,366,2,5,0.24
9,2,melody,6,367,2,4,0.24
9,2,mental,6,368,2,4,0.28
9,2,mention,7,369,4,3,0.2
9,2,mentor,6,370,4,2,0.16
9,2,merely,6,371,2,4,0.24
9,2,merger,6,372,3,3,0.2
9,2,mess,4,373,2,2,0.2
9,2,metre,5,374,2,3,0.16
9,2,mind,4,375,1,3,0.16
9,2,minister,8,376,3,5,0.28
9,2,ministry,8,377,6,2,0.4
9,2,mirror,6,378,2,4,0.52
9,2,missing,7,379,2,5,0.6
9,2,more,4,380,1,3,0.36
9,2,most,4,381,2,2,0.32
9,2,mother,6,382,2,4,0.6
9,2,mouth,5,383,2,3,0.44
9,2,movie,5,384,2,3,0.4
9,2,multiple,8,385,1,7,0.76
9,2,mum,3,386,2,1,0.24
9,2,museum,6,387,2,4,0.6
9,2,musician,8,388,3,5,0.64
9,2,naked,5,389,0,5,0.52
9,2,nasty,5,390,2,3,0.4
9,2,nation,6,391,2,4,0.6
9,2,nature,6,392,3,3,0.48
9,2,necessary,9,393,1,8,0.88
9,2,needle,6,394,2,4,0.52
9,2,negative,8,395,2,6,0.8
9,2,neutral,7,396,2,5,0.6
9,2,new,3,397,2,1,0.24
9,2,newspaper,9,398,3,6,0.72
9,2,noise,5,399,1,4,0.56
9,2,nominate,8,400,2,6,0.72
9,2,normal,6,401,2,4,0.52
9,2,north,5,402,3,2,0.36
9,2,northern,8,403,5,3,0.52
9,2,note,4,404,2,2,0.4
9,2,numerous,8,405,1,7,0.76
9,2,nut,3,406,2,1,0.24
9,2,oblige,6,407,0,6,0.6
9,2,ocean,5,408,1,4,0.48
9,2,offence,7,409,1,6,0.76
9,2,official,8,410,3,5,0.76
9,2,offspring,9,411,3,6,0.8
9,2,one,3,412,1,2,0.36
9,2,opponent,8,413,1,7,0.8
9,2,organizer,9,414,1,8,0.84
9,2,other,5,415,1,4,0.48
9,2,otherwise,9,416,5,4,0.76
9,2,ought,5,417,1,4,0.48
9,2,outbreak,8,418,2,6,0.68
9,2,outdoor,7,419,3,4,0.56
9,2,outdoors,8,420,7,1,0.52
9,2,overall,7,421,1,6,0.68
9,2,pack,4,422,0,4,0.44
9,2,pad,3,423,2,1,0.24
9,2,painful,7,424,2,5,0.6
9,2,palace,6,425,2,4,0.6
9,2,park,4,426,2,2,0.32
9,2,partial,7,427,3,4,0.56
9,2,passenger,9,428,2,7,0.8
9,2,passport,8,429,4,4,0.68
9,2,patent,6,430,2,4,0.56
9,2,patience,8,431,3,5,0.68
9,2,patron,6,432,3,3,0.48
9,2,pause,5,433,2,3,0.52
9,2,peace,5,434,1,4,0.48
9,2,peer,4,435,2,2,0.32
9,2,perceive,8,436,2,6,0.72
9,2,perhaps,7,437,3,4,0.68
9,2,phone,5,438,1,4,0.48
9,2,photo,5,439,3,2,0.4
9,2,picture,7,440,1,6,0.68
9,2,pile,4,441,2,2,0.36
9,2,pioneer,7,442,2,5,0.76
9,2,plot,4,443,1,3,0.36
9,2,point,5,444,1,4,0.48
9,2,political,9,445,2,7,0.88
9,2,portion,7,446,2,5,0.68
9,2,position,8,447,2,6,0.68
9,2,possible,8,448,3,5,0.64
9,2,poster,6,449,3,3,0.44
9,2,practical,9,450,1,8,0.92
9,2,praise,6,451,3,3,0.44
9,2,prayer,6,452,3,3,0.44
9,2,precedent,9,453,2,7,0.8
9,2,precise,7,454,4,3,0.6
9,2,predict,7,455,3,4,0.56
9,2,pregnant,8,456,3,5,0.68
9,2,prejudice,9,457,3,6,0.84
9,2,presence,8,458,3,5,0.64
9,2,presently,9,459,6,3,0.56
9,2,printing,8,460,2,6,0.72
9,2,prior,5,461,3,2,0.44
9,2,priority,8,462,5,3,0.52
9,2,processor,9,463,2,7,0.8
9,2,produce,7,464,3,4,0.64
9,2,prominent,9,465,3,6,0.84
9,2,proof,5,466,3,2,0.44
9,2,properly,8,467,3,5,0.72
9,2,propose,7,468,4,3,0.64
9,2,publicity,9,469,1,8,0.84
9,2,punk,4,470,2,2,0.32
9,2,pupil,5,471,2,3,0.4
9,2,pure,4,472,2,2,0.32
9,2,push,4,473,2,2,0.44
9,2,put,3,474,2,1,0.24
9,2,puzzle,6,475,2,4,0.52
9,2,quality,7,476,0,7,0.76
9,2,quantity,8,477,3,5,0.68
9,2,quest,5,478,2,3,0.56
9,2,quite,5,479,2,3,0.44
9,2,race,4,480,0,4,0.44
9,2,radar,5,481,2,3,0.4
9,2,railway,7,482,2,5,0.64
9,2,raise,5,483,3,2,0.48
9,2,rally,5,484,2,3,0.4
9,2,rather,6,485,2,4,0.52
9,2,rating,6,486,3,3,0.48
9,2,react,5,487,1,4,0.64
9,2,rear,4,488,3,1,0.28
9,2,rebel,5,489,2,3,0.4
9,2,reception,9,490,2,7,0.76
9,2,recognize,9,491,3,6,0.76
9,2,recording,9,492,4,5,0.8
9,2,recruit,7,493,3,4,0.56
9,2,recycle,7,494,3,4,0.56
9,2,reduce,6,495,2,4,0.64
9,2,reduction,9,496,5,4,0.64
9,2,referee,7,497,2,5,0.6
9,2,reference,9,498,6,3,0.6
9,2,refuse,6,499,3,3,0.56
9,2,regime,6,500,2,4,0.52
9,2,region,6,501,4,2,0.4
9,2,regional,8,502,6,2,0.48
9,2,reign,5,503,2,3,0.52
9,2,rejection,9,504,2,7,0.8
9,2,relax,5,505,2,3,0.4
9,2,relaxed,7,506,5,2,0.44
9,2,relevance,9,507,3,6,0.84
9,2,relieved,8,508,3,5,0.64
9,2,remainder,9,509,2,7,0.84
9,2,remark,6,510,4,2,0.4
9,2,removal,7,511,3,4,0.64
9,2,replace,7,512,2,5,0.6
9,2,reporting,9,513,3,6,0.72
9,2,republic,8,514,3,5,0.72
9,2,reside,6,515,2,4,0.52
9,2,resolve,7,516,3,4,0.56
9,2,retail,6,517,2,4,0.56
9,2,retire,6,518,3,3,0.48
9,2,revenge,7,519,2,5,0.6
9,2,revise,6,520,3,3,0.24
9,2,revision,8,521,5,3,0.24
9,2,rifle,5,522,1,4,0.24
9,2,rise,4,523,2,2,0.2
9,2,rob,3,524,1,2,0.12
9,2,roll,4,525,2,2,0.12
9,2,romance,7,526,2,5,0.64
9,2,roof,4,527,2,2,0.12
9,2,rotate,6,528,2,4,0.24
9,2,rubbish,7,529,1,6,0.32
9,2,ruin,4,530,2,2,0.12
9,2,safe,4,531,0,4,0.2
9,2,sample,6,532,2,4,0.2
9,2,sand,4,533,2,2,0.12
9,2,scan,4,534,1,3,0.24
9,2,scholar,7,535,2,5,0.24
9,2,school,6,536,4,2,0.2
9,2,score,5,537,2,3,0.2
9,2,secure,6,538,1,5,0.36
9,2,security,8,539,5,3,0.24
9,2,seem,4,540,2,2,0.16
9,2,segment,7,541,2,5,0.28
9,2,selective,9,542,2,7,0.4
9,2,seminar,7,543,2,5,0.24
9,2,seriously,9,544,2,7,0.32
9,2,servant,7,545,3,4,0.24
9,2,serve,5,546,4,1,0.2
9,2,setting,7,547,2,5,0.28
9,2,seven,5,548,2,3,0.2
9,2,severely,8,549,4,4,0.24
9,2,shift,5,550,1,4,0.28
9,2,shipping,8,551,3,5,0.28
9,2,shoot,5,552,2,3,0.16
9,2,shopping,8,553,3,5,0.28
9,2,shore,5,554,3,2,0.16
9,2,shortage,8,555,4,4,0.32
9,2,shortly,7,556,5,2,0.2
9,2,sibling,7,557,1,6,0.28
9,2,simply,6,558,2,4,0.2
9,2,sin,3,559,2,1,0.16
9,2,singing,7,560,3,4,0.24
9,2,sister,6,561,2,4,0.2
9,2,sit,3,562,2,1,0.08
9,2,situated,8,563,3,5,0.28
9,2,ski,3,564,1,2,0.2
9,2,skip,4,565,3,1,0.12
9,2,skull,5,566,2,3,0.16
9,2,slam,4,567,1,3,0.16
9,2,smile,5,568,1,4,0.2
9,2,snow,4,569,1,3,0.16
9,2,solar,5,570,1,4,0.28
9,2,solo,4,571,3,1,0.12
9,2,somehow,7,572,2,5,0.24
9,2,something,9,573,4,5,0.28
9,2,song,4,574,2,2,0.2
9,2,soup,4,575,2,2,0.16
9,2,space,5,576,1,4,0.2
9,2,speak,5,577,2,3,0.2
9,2,special,7,578,3,4,0.24
9,2,sphere,6,579,2,4,0.28
9,2,spine,5,580,2,3,0.16
9,2,spokesman,9,581,2,7,0.32
9,2,spotlight,9,582,3,6,0.32
9,2,stable,6,583,1,5,0.32
9,2,stamp,5,584,3,2,0.16
9,2,stand,5,585,3,2,0.16
9,2,statue,6,586,3,3,0.2
9,2,sticky,6,587,2,4,0.2
9,2,stop,4,588,2,2,0.24
9,2,store,5,589,3,2,0.16
9,2,straight,8,590,2,6,0.28
9,2,strange,7,591,4,3,0.2
9,2,strategy,8,592,4,4,0.32
9,2,street,6,593,3,3,0.2
9,2,strength,8,594,4,4,0.24
9,2,stretch,7,595,4,3,0.2
9,2,striking,8,596,3,5,0.32
9,2,strong,6,597,3,3,0.2
9,2,stumble,7,598,2,5,0.24
9,2,stun,4,599,3,1,0.12
9,2,substance,9,600,1,8,0.44
9,2,sue,3,601,2,1,0.08
9,2,sugar,5,602,2,3,0.16
9,2,supreme,7,603,2,5,0.28
9,2,surely,6,604,2,4,0.2
9,2,surgical,8,605,3,5,0.36
9,2,symptom,7,606,1,6,0.28
9,2,tactical,8,607,0,8,0.36
9,2,tail,4,608,2,2,0.12
9,2,talent,6,609,2,4,0.28
9,2,team,4,610,1,3,0.16
9,2,tempt,5,611,2,3,0.16
9,2,tender,6,612,2,4,0.2
9,2,tension,7,613,3,4,0.32
9,2,terribly,8,614,2,6,0.32
9,2,terrific,8,615,5,3,0.24
9,2,terror,6,616,4,2,0.16
9,2,textbook,8,617,2,6,0.36
9,2,texture,7,618,4,3,0.2
9,2,thereby,7,619,1,6,0.28
9,2,thesis,6,620,3,3,0.2
9,2,thirsty,7,621,2,5,0.32
9,2,this,4,622,3,1,0.12
9,2,three,5,623,2,3,0.16
9,2,thrilled,8,624,3,5,0.28
9,2,ticket,6,625,1,5,0.24
9,2,tight,5,626,2,3,0.24
9,2,till,4,627,2,2,0.16
9,2,timing,6,628,2,4,0.24
9,2,to,2,629,1,1,0.08
9,2,together,8,630,2,6,0.32
9,2,tonight,7,631,2,5,0.32
9,2,tonne,5,632,3,2,0.16
9,2,tour,4,633,2,2,0.16
9,2,trademark,9,634,1,8,0.36
9,2,treat,5,635,2,3,0.24
9,2,tree,4,636,3,1,0.12
9,2,trial,5,637,2,3,0.2
9,2,tribal,6,638,3,3,0.2
9,2,tribe,5,639,4,1,0.12
9,2,trouble,7,640,2,5,0.32
9,2,truck,5,641,2,3,0.16
9,2,tune,4,642,1,3,0.16
9,2,twice,5,643,1,4,0.2
9,2,ultimate,8,644,0,8,0.36
9,2,undergo,7,645,1,6,0.32
9,2,unify,5,646,2,3,0.16
9,2,universe,8,647,3,5,0.28
9,2,until,5,648,2,3,0.16
9,2,uphold,6,649,1,5,0.32
9,2,upon,4,650,2,2,0.12
9,2,urban,5,651,1,4,0.2
9,2,urgent,6,652,2,4,0.2
9,2,usage,5,653,1,4,0.2
9,2,utilize,7,654,1,6,0.36
9,2,vague,5,655,0,5,0.24
9,2,validity,8,656,2,6,0.32
9,2,valuable,8,657,3,5,0.28
9,2,variety,7,658,2,5,0.32
9,2,vegetable,9,659,1,8,0.36
9,2,verify,6,660,2,4,0.24
9,2,vessel,6,661,2,4,0.24
9,2,veteran,7,662,2,5,0.32
9,2,viewer,6,663,1,5,0.24
9,2,virtual,7,664,2,5,0.24
9,2,visitor,7,665,2,5,0.24
9,2,vital,5,666,2,3,0.24
9,2,vocal,5,667,1,4,0.2
9,2,volunteer,9,668,2,7,0.36
9,2,warning,7,669,0,7,0.32
9,2,washing,7,670,2,5,0.32
9,2,watch,5,671,2,3,0.16
9,2,water,5,672,3,2,0.16
9,2,way,3,673,2,1,0.08
9,2,weakness,8,674,1,7,0.4
9,2,weave,5,675,3,2,0.16
9,2,weekend,7,676,2,5,0.24
9,2,weight,6,677,2,4,0.24
9,2,welcome,7,678,2,5,0.24
9,2,welfare,7,679,3,4,0.32
9,2,west,4,680,2,2,0.12
9,2,whenever,8,681,1,7,0.32
9,2,which,5,682,2,3,0.2
9,2,whose,5,683,2,3,0.24
9,2,width,5,684,1,4,0.2
9,2,wine,4,685,2,2,0.12
9,2,wipe,4,686,2,2,0.12
9,2,wisdom,6,687,2,4,0.24
9,2,within,6,688,2,4,0.28
9,2,woman,5,689,1,4,0.2
9,2,wonderful,9,690,2,7,0.36
9,2,word,4,691,2,2,0.16
9,2,workplace,9,692,3,6,0.8
9,2,worry,5,693,3,2,0.36
9,2,wow,3,694,2,1,0.24
9,2,written,7,695,1,6,0.68
9,2,youngster,9,696,0,9,0.88
9,3,absurd,6,0,0,6,0.28
9,3,accompany,9,1,1,8,0.44
9,3,accurate,8,2,3,5,0.28
9,3,acid,4,3,2,2,0.12
9,3,actress,7,4,2,5,0.32
9,3,acute,5,5,2,3,0.2
9,3,add,3,6,1,2,0.12
9,3,adj,3,7,2,1,0.12
9,3,adjacent,8,8,3,5,0.28
9,3,admit,5,9,2,3,0.16
9,3,adopt,5,10,2,3,0.24
9,3,adoption,8,11,5,3,0.24
9,3,aesthetic,9,12,1,8,0.36
9,3,again,5,13,1,4,0.2
9,3,alcohol,7,14,1,6,0.36
9,3,ally,4,15,2,2,0.12
9,3,alongside,9,16,2,7,0.32
9,3,amateur,7,17,1,6,0.28
9,3,amusing,7,18,2,5,0.32
9,3,analysis,8,19,1,7,0.36
9,3,anger,5,20,2,3,0.2
9,3,anybody,7,21,2,5,0.32
9,3,apology,7,22,1,6,0.28
9,3,app,3,23,2,1,0.12
9,3,applaud,7,24,3,4,0.24
9,3,approach,8,25,3,5,0.28
9,3,approve,7,26,5,2,0.28
9,3,arguably,8,27,1,7,0.32
9,3,arise,5,28,2,3,0.2
9,3,arms,4,29,2,2,0.16
9,3,arrest,6,30,2,4,0.28
9,3,arrow,5,31,3,2,0.16
9,3,artist,6,32,2,4,0.24
9,3,artistic,8,33,6,2,0.2
9,3,assistant,9,34,1,8,0.44
9,3,associate,9,35,3,6,0.32
9,3,atrocity,8,36,1,7,0.32
9,3,attract,7,37,2,5,0.24
9,3,auto,4,38,1,3,0.24
9,3,average,7,39,1,6,0.28
9,3,baby,4,40,0,4,0.2
9,3,backing,7,41,2,5,0.24
9,3,ballet,6,42,2,4,0.28
9,3,base,4,43,2,2,0.12
9,3,bat,3,44,2,1,0.08
9,3,beast,5,45,1,4,0.2
9,3,beat,4,46,3,1,0.12
9,3,beg,3,47,2,1,0.08
9,3,behalf,6,48,2,4,0.28
9,3,behave,6,49,4,2,0.2
9,3,bell,4,50,2,2,0.12
9,3,belong,6,51,3,3,0.2
9,3,below,5,52,4,1,0.12
9,3,between,7,53,2,5,0.32
9,3,beyond,6,54,2,4,0.2
9,3,birthday,8,55,1,7,0.32
9,3,biscuit,7,56,2,5,0.24
9,3,bitter,6,57,2,4,0.28
9,3,blade,5,58,1,4,0.2
9,3,blank,5,59,3,2,0.16
9,3,blind,5,60,2,3,0.2
9,3,blog,4,61,2,2,0.16
9,3,blow,4,62,3,1,0.12
9,3,boat,4,63,1,3,0.24
9,3,boil,4,64,2,2,0.12
9,3,boom,4,65,2,2,0.12
9,3,bound,5,66,2,3,0.2
9,3,box,3,67,2,1,0.08
9,3,boyfriend,9,68,2,7,0.4
9,3,breach,6,69,1,5,0.24
9,3,breathing,9,70,4,5,0.28
9,3,bride,5,71,2,3,0.16
9,3,bright,6,72,3,3,0.28
9,3,broken,6,73,2,4,0.2
9,3,buddy,5,74,1,4,0.2
9,3,buffer,6,75,2,4,0.2
9,3,bug,3,76,2,1,0.12
9,3,burden,6,77,2,4,0.28
9,3,burn,4,78,3,1,0.12
9,3,butter,6,79,2,4,0.24
9,3,cancer,6,80,0,6,0.28
9,3,cap,3,81,2,1,0.08
9,3,career,6,82,2,4,0.28
9,3,careful,7,83,4,3,0.2
9,3,carefully,9,84,7,2,0.24
9,3,carpet,6,85,3,3,0.2
9,3,cartoon,7,86,3,4,0.28
9,3,carve,5,87,3,2,0.16
9,3,celebrate,9,88,1,8,0.36
9,3,central,7,89,2,5,0.24
9,3,century,7,90,4,3,0.28
9,3,certain,7,91,2,5,0.28
9,3,certainty,9,92,7,2,0.24
9,3,challenge,9,93,1,8,0.36
9,3,charity,7,94,3,4,0.32
9,3,charm,5,95,4,1,0.12
9,3,charter,7,96,4,3,0.2
9,3,cheat,5,97,2,3,0.2
9,3,cheerful,8,98,3,5,0.36
9,3,chemical,8,99,3,5,0.28
9,3,childhood,9,100,2,7,0.32
9,3,chop,4,101,2,2,0.16
9,3,circuit,7,102,1,6,0.36
9,3,cite,4,103,2,2,0.12
9,3,clarity,7,104,1,6,0.28
9,3,clause,6,105,3,3,0.2
9,3,clean,5,106,2,3,0.2
9,3,clearly,7,107,4,3,0.28
9,3,clinical,8,108,2,6,0.32
9,3,club,4,109,2,2,0.12
9,3,colony,6,110,1,5,0.24
9,3,colourful,9,111,4,5,0.36
9,3,comedy,6,112,2,4,0.24
9,3,comment,7,113,3,4,0.24
9,3,community,9,114,4,5,0.36
9,3,company,7,115,3,4,0.24
9,3,compete,7,116,4,3,0.2
9,3,conceal,7,117,2,5,0.28
9,3,concept,7,118,5,2,0.28
9,3,concert,7,119,5,2,0.2
9,3,confess,7,120,3,4,0.24
9,3,connected,9,121,3,6,0.32
9,3,consent,7,122,3,4,0.28
9,3,contend,7,123,3,4,0.24
9,3,cope,4,124,2,2,0.16
9,3,correct,7,125,2,5,0.28
9,3,correctly,9,126,7,2,0.28
9,3,cost,4,127,2,2,0.16
9,3,counter,7,128,2,5,0.28
9,3,coup,4,129,3,1,0.12
9,3,course,6,130,3,3,0.2
9,3,court,5,131,4,1,0.12
9,3,creep,5,132,1,4,0.28
9,3,crime,5,133,2,3,0.2
9,3,criminal,8,134,4,4,0.28
9,3,cross,5,135,2,3,0.44
9,3,crowd,5,136,3,2,0.28
9,3,crowded,7,137,5,2,0.2
9,3,cruel,5,138,2,3,0.2
9,3,cry,3,139,2,1,0.12
9,3,cultivate,9,140,1,8,0.36
9,3,currency,8,141,2,6,0.36
9,3,current,7,142,6,1,0.2
9,3,curved,6,143,3,3,0.24
9,3,damage,6,144,0,6,0.28
9,3,dance,5,145,2,3,0.24
9,3,dare,4,146,2,2,0.16
9,3,deal,4,147,1,3,0.16
9,3,december,8,148,2,6,0.28
9,3,declare,7,149,3,4,0.24
9,3,deed,4,150,2,2,0.4
9,3,deem,4,151,3,1,0.44
9,3,defence,7,152,2,5,0.96
9,3,defender,8,153,5,3,0.36
9,3,definite,8,154,3,5,0.28
9,3,democracy,9,155,2,7,0.36
9,3,departure,9,156,2,7,0.44
9,3,deputy,6,157,3,3,0.2
9,3,desktop,7,158,2,5,0.28
9,3,detect,6,159,2,4,0.24
9,3,detention,9,160,4,5,0.36
9,3,diagnosis,9,161,1,8,0.36
9,3,dictate,7,162,2,5,0.28
9,3,dig,3,163,2,1,0.16
9,3,digital,7,164,3,4,0.24
9,3,dinner,6,165,2,4,0.24
9,3,diplomat,8,166,2,6,0.32
9,3,director,8,167,2,6,0.36
9,3,discount,8,168,2,6,0.28
9,3,discovery,9,169,5,4,0.28
9,3,discuss,7,170,4,3,0.2
9,3,display,7,171,3,4,0.32
9,3,distant,7,172,3,4,0.24
9,3,distort,7,173,4,3,0.2
9,3,divine,6,174,2,4,0.24
9,3,divorced,8,175,3,5,0.32
9,3,dollar,6,176,1,5,0.24
9,3,dot,3,177,2,1,0.08
9,3,download,8,178,2,6,0.32
9,3,duration,8,179,1,7,0.4
9,3,dust,4,180,2,2,0.16
9,3,earth,5,181,0,5,0.24
9,3,editor,6,182,1,5,0.24
9,3,eight,5,183,1,4,0.2
9,3,eighty,6,184,5,1,0.2
9,3,elect,5,185,1,4,0.2
9,3,eleven,6,186,3,3,0.2
9,3,eliminate,9,187,2,7,0.84
9,3,embody,6,188,1,5,0.64
9,3,emergence,9,189,2,7,0.8
9,3,emergency,9,190,8,1,0.48
9,3,emotion,7,191,2,5,0.68
9,3,empirical,9,192,2,7,0.8
9,3,employer,8,193,3,5,0.64
9,3,empower,7,194,3,4,0.56
9,3,ending,6,195,1,5,0.68
9,3,endless,7,196,3,4,0.56
9,3,enemy,5,197,2,3,0.4
9,3,enjoy,5,198,2,3,0.4
9,3,enjoyable,9,199,5,4,0.72
9,3,enrich,6,200,2,4,0.52
9,3,enter,5,201,2,3,0.4
9,3,entitle,7,202,3,4,0.56
9,3,entrance,8,203,3,5,0.64
9,3,essay,5,204,1,4,0.56
9,3,euro,4,205,1,3,0.36
9,3,event,5,206,1,4,0.48
9,3,evidence,8,207,2,6,0.72
9,3,evoke,5,208,2,3,0.52
9,3,exact,5,209,1,4,0.48
9,3,exceed,6,210,2,4,0.52
9,3,exchange,8,211,3,5,0.64
9,3,excited,7,212,3,4,0.64
9,3,exclusive,9,213,3,6,0.72
9,3,execution,9,214,2,7,0.8
9,3,executive,9,215,7,2,0.52
9,3,expire,6,216,2,4,0.64
9,3,exploit,7,217,3,4,0.68
9,3,extensive,9,218,2,7,0.92
9,3,extremist,9,219,3,6,0.88
9,3,fairly,6,220,0,6,0.6
9,3,famous,6,221,2,4,0.52
9,3,fantastic,9,222,2,7,0.8
9,3,fast,4,223,2,2,0.4
9,3,fasten,6,224,4,2,0.4
9,3,fear,4,225,1,3,0.36
9,3,fee,3,226,2,1,0.24
9,3,few,3,227,2,1,0.24
9,3,fibre,5,228,1,4,0.48
9,3,finally,7,229,2,5,0.72
9,3,financial,9,230,4,5,0.68
9,3,fixture,7,231,2,5,0.64
9,3,flat,4,232,1,3,0.36
9,3,flavour,7,233,3,4,0.64
9,3,flexible,8,234,2,6,0.72
9,3,floor,5,235,2,3,0.4
9,3,flu,3,236,2,1,0.24
9,3,focus,5,237,1,4,0.48
9,3,folding,7,238,2,5,0.72
9,3,force,5,239,2,3,0.44
9,3,foreign,7,240,3,4,0.56
9,3,former,6,241,3,3,0.44
9,3,forward,7,242,3,4,0.64
9,3,founder,7,243,2,5,0.6
9,3,fourteen,8,244,3,5,0.64
9,3,fragment,8,245,1,7,0.76
9,3,frequent,8,246,2,6,0.8
9,3,fridge,6,247,2,4,0.52
9,3,frighten,8,248,3,5,0.68
9,3,frog,4,249,2,2,0.32
9,3,fur,3,250,1,2,0.4
9,3,gallery,7,251,0,7,0.8
9,3,game,4,252,2,2,0.32
9,3,garage,6,253,2,4,0.52
9,3,gene,4,254,1,3,0.4
9,3,general,7,255,4,3,0.64
9,3,generally,9,256,7,2,0.52
9,3,generate,8,257,6,2,0.48
9,3,genetic,7,258,4,3,0.52
9,3,giant,5,259,1,4,0.6
9,3,give,4,260,2,2,0.32
9,3,god,3,261,1,2,0.36
9,3,goodbye,7,262,2,5,0.72
9,3,grade,5,263,1,4,0.48
9,3,gravity,7,264,3,4,0.64
9,3,green,5,265,2,3,0.4
9,3,greet,5,266,4,1,0.32
9,3,grey,4,267,3,1,0.28
9,3,grid,4,268,2,2,0.32
9,3,grief,5,269,3,2,0.36
9,3,grin,4,270,3,1,0.36
9,3,grind,5,271,4,1,0.32
9,3,growth,6,272,2,4,0.52
9,3,guest,5,273,1,4,0.48
9,3,guidance,8,274,2,6,0.76
9,3,guy,3,275,2,1,0.24
9,3,hair,4,276,0,4,0.44
9,3,handful,7,277,2,5,0.6
9,3,happen,6,278,2,4,0.52
9,3,harsh,5,279,2,3,0.44
9,3,harvest,7,280,3,4,0.64
9,3,health,6,281,1,5,0.56
9,3,her,3,282,2,1,0.24
9,3,herb,4,283,3,1,0.28
9,3,hers,4,284,3,1,0.28
9,3,hesitate,8,285,2,6,0.8
9,3,highlight,9,286,1,8,0.84
9,3,hint,4,287,2,2,0.32
9,3,holiday,7,288,1,6,0.64
9,3,hotel,5,289,2,3,0.52
9,3,hour,4,290,2,2,0.32
9,3,how,3,291,2,1,0.24
9,3,humour,6,292,1,5,0.56
9,3,hurricane,9,293,2,7,0.8
9,3,hydrogen,8,294,1,7,0.84
9,3,i,1,295,0,1,0.16
9,3,ice,3,296,1,2,0.28
9,3,identity,8,297,1,7,0.76
9,3,imagery,7,298,1,6,0.8
9,3,implement,9,299,2,7,0.8
9,3,import,6,300,3,3,0.44
9,3,inclusion,9,301,1,8,0.84
9,3,incorrect,9,302,3,6,0.84
9,3,incur,5,303,3,2,0.36
9,3,index,5,304,2,3,0.4
9,3,indicate,8,305,3,5,0.64
9,3,influence,9,306,2,7,0.88
9,3,info,4,307,3,1,0.28
9,3,inform,6,308,4,2,0.4
9,3,informal,8,309,6,2,0.48
9,3,injury,6,310,2,4,0.6
9,3,insert,6,311,2,4,0.52
9,3,insertion,9,312,6,3,0.56
9,3,instant,7,313,3,4,0.56
9,3,instruct,8,314,4,4,0.68
9,3,intended,8,315,2,6,0.68
9,3,intense,7,316,5,2,0.44
9,3,intensify,9,317,6,3,0.64
9,3,interior,8,318,4,4,0.6
9,3,into,4,319,3,1,0.28
9,3,invade,6,320,2,4,0.52
9,3,involve,7,321,3,4,0.56
9,3,isolated,8,322,1,7,0.88
9,3,issue,5,323,2,3,0.4
9,3,jet,3,324,0,3,0.32
9,3,jewellery,9,325,2,7,0.8
9,3,job,3,326,1,2,0.28
9,3,joy,3,327,2,1,0.32
9,3,jump,4,328,1,3,0.4
9,3,justify,7,329,2,5,0.6
9,3,keyboard,8,330,0,8,0.8
9,3,kick,4,331,1,3,0.48
9,3,king,4,332,2,2,0.32
9,3,kingdom,7,333,4,3,0.52
9,3,knife,5,334,1,4,0.48
9,3,landscape,9,335,0,9,0.92
9,3,lap,3,336,2,1,0.28
9,3,laser,5,337,2,3,0.2
9,3,last,4,338,3,1,0.12
9,3,latest,6,339,2,4,0.24
9,3,law,3,340,2,1,0.12
9,3,leading,7,341,1,6,0.36
9,3,league,6,342,3,3,0.24
9,3,left,4,343,2,2,0.16
9,3,legendary,9,344,2,7,0.36
9,3,lethal,6,345,2,4,0.24
9,3,letter,6,346,3,3,0.24
9,3,license,7,347,1,6,0.32
9,3,lifestyle,9,348,2,7,0.36
9,3,limb,4,349,2,2,0.12
9,3,limited,7,350,3,4,0.28
9,3,link,4,351,2,2,0.12
9,3,literary,8,352,2,6,0.28
9,3,little,6,353,3,3,0.2
9,3,live,4,354,2,2,0.2
9,3,liver,5,355,4,1,0.12
9,3,local,5,356,1,4,0.2
9,3,lonely,6,357,2,4,0.2
9,3,long,4,358,3,1,0.12
9,3,look,4,359,2,2,0.12
9,3,lot,3,360,2,1,0.16
9,3,machinery,9,361,0,9,0.4
9,3,mainland,8,362,2,6,0.32
9,3,map,3,363,2,1,0.08
9,3,marine,6,364,2,4,0.28
9,3,mark,4,365,3,1,0.12
9,3,married,7,366,3,4,0.32
9,3,match,5,367,2,3,0.2
9,3,maximum,7,368,2,5,0.32
9,3,memory,6,369,1,5,0.36
9,3,mention,7,370,2,5,0.32
9,3,method,6,371,2,4,0.24
9,3,metre,5,372,3,2,0.2
9,3,midnight,8,373,1,7,0.4
9,3,ministry,8,374,2,6,0.28
9,3,miserable,9,375,2,7,0.32
9,3,model,5,376,1,4,0.2
9,3,modify,6,377,3,3,0.28
9,3,moment,6,378,2,4,0.2
9,3,money,5,379,2,3,0.2
9,3,month,5,380,3,2,0.16
9,3,monthly,7,381,5,2,0.24
9,3,more,4,382,2,2,0.12
9,3,most,4,383,2,2,0.12
9,3,mother,6,384,2,4,0.2
9,3,mouth,5,385,2,3,0.16
9,3,movie,5,386,2,3,0.2
9,3,municipal,9,387,1,8,0.4
9,3,music,5,388,2,3,0.16
9,3,must,4,389,3,1,0.12
9,3,my,2,390,1,1,0.08
9,3,myth,4,391,2,2,0.16
9,3,nature,6,392,0,6,0.36
9,3,neck,4,393,1,3,0.16
9,3,negative,8,394,2,6,0.28
9,3,neutral,7,395,2,5,0.24
9,3,newspaper,9,396,2,7,0.4
9,3,night,5,397,1,4,0.2
9,3,noise,5,398,1,4,0.2
9,3,noisy,5,399,4,1,0.12
9,3,north,5,400,2,3,0.2
9,3,note,4,401,2,2,0.2
9,3,nothing,7,402,3,4,0.24
9,3,notion,6,403,3,3,0.2
9,3,novel,5,404,2,3,0.2
9,3,obesity,7,405,0,7,0.36
9,3,objective,9,406,2,7,0.32
9,3,obsess,6,407,2,4,0.2
9,3,october,7,408,1,6,0.28
9,3,official,8,409,1,7,0.4
9,3,offspring,9,410,3,6,0.32
9,3,once,4,411,1,3,0.16
9,3,one,3,412,2,1,0.08
9,3,online,6,413,2,4,0.2
9,3,opposed,7,414,1,6,0.36
9,3,organic,7,415,1,6,0.28
9,3,originate,9,416,2,7,0.36
9,3,ought,5,417,1,4,0.24
9,3,outbreak,8,418,2,6,0.32
9,3,outdoor,7,419,3,4,0.24
9,3,outing,6,420,3,3,0.2
9,3,overall,7,421,1,6,0.36
9,3,oversee,7,422,4,3,0.2
9,3,owe,3,423,1,2,0.12
9,3,pace,4,424,0,4,0.2
9,3,pad,3,425,2,1,0.08
9,3,page,4,426,2,2,0.12
9,3,palace,6,427,2,4,0.28
9,3,pants,5,428,2,3,0.2
9,3,parallel,8,429,2,6,0.32
9,3,park,4,430,3,1,0.12
9,3,partner,7,431,3,4,0.28
9,3,passenger,9,432,2,7,0.36
9,3,patience,8,433,2,6,0.28
9,3,patron,6,434,3,3,0.2
9,3,peace,5,435,1,4,0.24
9,3,peer,4,436,2,2,0.12
9,3,perhaps,7,437,2,5,0.24
9,3,personnel,9,438,3,6,0.32
9,3,phone,5,439,1,4,0.24
9,3,photo,5,440,3,2,0.16
9,3,physician,9,441,2,7,0.32
9,3,pick,4,442,1,3,0.16
9,3,picture,7,443,3,4,0.24
9,3,piece,5,444,2,3,0.24
9,3,pile,4,445,2,2,0.12
9,3,pin,3,446,2,1,0.12
9,3,pipe,4,447,2,2,0.16
9,3,place,5,448,1,4,0.2
9,3,plane,5,449,3,2,0.16
9,3,planning,8,450,4,4,0.32
9,3,pleased,7,451,2,5,0.28
9,3,pledge,6,452,3,3,0.2
9,3,plot,4,453,2,2,0.12
9,3,police,6,454,1,5,0.28
9,3,political,9,455,4,5,0.28
9,3,pollution,9,456,3,6,0.32
9,3,pond,4,457,2,2,0.12
9,3,portion,7,458,2,5,0.32
9,3,practical,9,459,1,8,0.36
9,3,precise,7,460,2,5,0.28
9,3,prejudice,9,461,3,6,0.4
9,3,premier,7,462,3,4,0.24
9,3,presence,8,463,3,5,0.28
9,3,presently,9,464,6,3,0.24
9,3,printer,7,465,2,5,0.32
9,3,prior,5,466,3,2,0.16
9,3,procedure,9,467,2,7,0.32
9,3,produce,7,468,3,4,0.24
9,3,product,7,469,6,1,0.24
9,3,profile,7,470,3,4,0.24
9,3,profound,8,471,4,4,0.24
9,3,program,7,472,3,4,0.24
9,3,prominent,9,473,3,6,0.4
9,3,proper,6,474,3,3,0.2
9,3,propose,7,475,4,3,0.24
9,3,prosecute,9,476,3,6,0.4
9,3,protest,7,477,3,4,0.24
9,3,protester,9,478,7,2,0.24
9,3,publicity,9,479,1,8,0.36
9,3,pump,4,480,2,2,0.2
9,3,punk,4,481,2,2,0.16
9,3,quality,7,482,0,7,0.32
9,3,query,5,483,2,3,0.2
9,3,quest,5,484,3,2,0.16
9,3,quite,5,485,2,3,0.24
9,3,race,4,486,0,4,0.2
9,3,racial,6,487,3,3,0.24
9,3,railway,7,488,2,5,0.28
9,3,rather,6,489,2,4,0.24
9,3,rating,6,490,3,3,0.28
9,3,realm,5,491,1,4,0.2
9,3,rear,4,492,3,1,0.12
9,3,reasoning,9,493,3,6,0.32
9,3,rebel,5,494,2,3,0.24
9,3,reception,9,495,2,7,0.36
9,3,recommend,9,496,3,6,0.32
9,3,recount,7,497,4,3,0.24
9,3,reduce,6,498,2,4,0.28
9,3,reduction,9,499,5,4,0.28
9,3,refer,5,500,2,3,0.2
9,3,refuse,6,501,3,3,0.2
9,3,regime,6,502,2,4,0.28
9,3,region,6,503,4,2,0.16
9,3,regional,8,504,6,2,0.2
9,3,rejection,9,505,2,7,0.44
9,3,relax,5,506,2,3,0.52
9,3,relief,6,507,3,3,0.44
9,3,remark,6,508,2,4,0.52
9,3,remind,6,509,3,3,0.44
9,3,removal,7,510,3,4,0.64
9,3,renew,5,511,2,3,0.4
9,3,replace,7,512,2,5,0.6
9,3,reporting,9,513,3,6,0.8
9,3,research,8,514,2,6,0.8
9,3,residence,9,515,3,6,0.76
9,3,retail,6,516,2,4,0.52
9,3,revenge,7,517,2,5,0.6
9,3,revival,7,518,3,4,0.68
9,3,revive,6,519,5,1,0.36
9,3,rifle,5,520,1,4,0.48
9,3,rise,4,521,2,2,0.32
9,3,ritual,6,522,2,4,0.52
9,3,road,4,523,1,3,0.48
9,3,robbery,7,524,2,5,0.6
9,3,roll,4,525,2,2,0.32
9,3,romance,7,526,2,5,0.64
9,3,roof,4,527,2,2,0.36
9,3,root,4,528,3,1,0.36
9,3,rotate,6,529,2,4,1.24
9,3,rough,5,530,2,3,0.44
9,3,routine,7,531,3,4,0.56
9,3,ruin,4,532,1,3,0.4
9,3,sailor,6,533,0,6,0.76
9,3,sale,4,534,2,2,0.32
9,3,sample,6,535,2,4,0.52
9,3,satellite,9,536,2,7,0.8
9,3,satisfied,9,537,3,6,0.84
9,3,satisfy,7,538,6,1,0.4
9,3,schedule,8,539,1,7,0.76
9,3,scheme,6,540,4,2,0.4
9,3,school,6,541,3,3,0.64
9,3,scientist,9,542,2,7,0.92
9,3,score,5,543,2,3,0.52
9,3,seal,4,544,1,3,0.4
9,3,secure,6,545,2,4,0.64
9,3,seem,4,546,2,2,0.32
9,3,segment,7,547,2,5,0.6
9,3,september,9,548,2,7,0.8
9,3,serious,7,549,2,5,0.72
9,3,servant,7,550,3,4,0.56
9,3,serve,5,551,4,1,0.32
9,3,service,7,552,4,3,0.52
9,3,settler,7,553,2,5,0.72
9,3,seven,5,554,2,3,0.44
9,3,severely,8,555,4,4,0.6
9,3,sexual,6,556,2,4,0.52
9,3,shallow,7,557,1,6,0.68
9,3,shell,5,558,2,3,0.52
9,3,shoot,5,559,2,3,0.44
9,3,shore,5,560,3,2,0.36
9,3,sight,5,561,1,4,0.48
9,3,silver,6,562,2,4,0.52
9,3,similarly,9,563,2,7,0.88
9,3,situated,8,564,2,6,0.72
9,3,six,3,565,2,1,0.24
9,3,skirt,5,566,1,4,0.48
9,3,skull,5,567,2,3,0.56
9,3,slice,5,568,1,4,0.48
9,3,smoking,7,569,1,6,0.68
9,3,snow,4,570,1,3,0.36
9,3,solid,5,571,1,4,0.48
9,3,solo,4,572,3,1,0.4
9,3,some,4,573,2,2,0.32
9,3,somehow,7,574,4,3,0.48
9,3,someone,7,575,4,3,0.48
9,3,something,9,576,4,5,0.8
9,3,song,4,577,2,2,0.32
9,3,south,5,578,2,3,0.4
9,3,spare,5,579,1,4,0.48
9,3,special,7,580,2,5,0.6
9,3,specify,7,581,5,2,0.56
9,3,spectator,9,582,4,5,0.68
9,3,speech,6,583,3,3,0.48
9,3,spine,5,584,2,3,0.4
9,3,spokesman,9,585,2,7,0.88
9,3,stab,4,586,1,3,0.36
9,3,staff,5,587,3,2,0.36
9,3,stand,5,588,3,2,0.36
9,3,standing,8,589,5,3,0.52
9,3,statue,6,590,3,3,0.56
9,3,steadily,8,591,2,6,0.72
9,3,stick,5,592,2,3,0.4
9,3,sticky,6,593,5,1,0.36
9,3,stop,4,594,2,2,0.44
9,3,storage,7,595,3,4,0.56
9,3,store,5,596,4,1,0.32
9,3,story,5,597,4,1,0.32
9,3,straight,8,598,2,6,0.72
9,3,strategic,9,599,4,5,0.8
9,3,street,6,600,3,3,0.44
9,3,strict,6,601,3,3,0.44
9,3,strike,6,602,4,2,0.4
9,3,string,6,603,4,2,0.52
9,3,strong,6,604,3,3,0.52
9,3,studio,6,605,2,4,0.6
9,3,substance,9,606,1,8,0.88
9,3,such,4,607,2,2,0.44
9,3,sugar,5,608,2,3,0.4
9,3,supreme,7,609,2,5,0.6
9,3,surely,6,610,2,4,0.52
9,3,swallow,7,611,1,6,0.68
9,3,sweater,7,612,2,5,0.68
9,3,swim,4,613,2,2,0.32
9,3,switch,6,614,3,3,0.44
9,3,tactical,8,615,0,8,0.8
9,3,talk,4,616,2,2,0.44
9,3,tank,4,617,2,2,0.32
9,3,tap,3,618,2,1,0.24
9,3,tape,4,619,3,1,0.28
9,3,task,4,620,2,2,0.32
9,3,taxi,4,621,2,2,0.32
9,3,tempt,5,622,1,4,0.56
9,3,tender,6,623,2,4,0.52
9,3,terribly,8,624,2,6,0.72
9,3,terrify,7,625,5,2,0.52
9,3,terrorism,9,626,4,5,0.88
9,3,texture,7,627,2,5,0.6
9,3,thereby,7,628,1,6,0.64
9,3,thrilled,8,629,2,6,0.68
9,3,thumb,5,630,2,3,0.52
9,3,ticket,6,631,1,5,0.56
9,3,tight,5,632,2,3,0.4
9,3,timing,6,633,2,4,0.52
9,3,to,2,634,1,1,0.2
9,3,too,3,635,2,1,0.24
9,3,tour,4,636,2,2,0.44
9,3,tragic,6,637,1,5,0.56
9,3,trap,4,638,3,1,0.28
9,3,treaty,6,639,2,4,0.52
9,3,trend,5,640,3,2,0.36
9,3,trial,5,641,2,3,0.52
9,3,tribe,5,642,3,2,0.36
9,3,trio,4,643,3,1,0.28
9,3,trouble,7,644,2,5,0.6
9,3,trousers,8,645,4,4,0.68
9,3,truck,5,646,2,3,0.4
9,3,twice,5,647,1,4,0.48
9,3,ultimate,8,648,0,8,0.8
9,3,unable,6,649,1,5,0.56
9,3,undermine,9,650,2,7,0.92
9,3,unique,6,651,2,4,0.52
9,3,universe,8,652,3,5,0.64
9,3,unusual,7,653,2,5,0.72
9,3,uphold,6,654,1,5,0.56
9,3,urban,5,655,1,4,0.48
9,3,urgent,6,656,2,4,0.52
9,3,usage,5,657,1,4,0.48
9,3,usual,5,658,2,3,0.52
9,3,utilize,7,659,1,6,0.68
9,3,vague,5,660,0,5,0.52
9,3,validity,8,661,2,6,0.72
9,3,vegetable,9,662,1,8,0.96
9,3,vein,4,663,2,2,0.32
9,3,verify,6,664,2,4,0.52
9,3,vessel,6,665,2,4,0.52
9,3,video,5,666,1,4,0.6
9,3,viewer,6,667,2,4,0.52
9,3,villager,8,668,2,6,0.72
9,3,virus,5,669,2,3,0.44
9,3,visual,6,670,2,4,0.52
9,3,vital,5,671,2,3,0.52
9,3,vocal,5,672,1,4,0.52
9,3,wait,4,673,0,4,0.48
9,3,waiter,6,674,4,2,0.44
9,3,walk,4,675,2,2,0.32
9,3,warrior,7,676,2,5,0.76
9,3,washing,7,677,2,5,0.68
9,3,weakness,8,678,1,7,0.92
9,3,weapon,6,679,3,3,0.56
9,3,weave,5,680,3,2,0.52
9,3,weight,6,681,2,4,0.52
9,3,weird,5,682,3,2,0.4
9,3,west,4,683,2,2,0.32
9,3,whenever,8,684,1,7,0.92
9,3,whereas,7,685,3,4,0.68
9,3,wind,4,686,1,3,0.36
9,3,wipe,4,687,2,2,0.32
9,3,wisdom,6,688,2,4,0.52
9,3,without,7,689,2,5,0.72
9,3,wonderful,9,690,1,8,0.88
9,3,work,4,691,2,2,0.32
9,3,workplace,9,692,4,5,0.72
9,3,world,5,693,3,2,0.48
9,3,wrap,4,694,1,3,0.36
9,3,written,7,695,2,5,0.6
9,3,yellow,6,696,0,6,0.64
9,4,a,1,0,0,1,0.16
9,4,absence,7,1,1,6,0.68
9,4,absorb,6,2,3,3,0.44
9,4,absurd,6,3,3,3,0.24
9,4,academic,8,4,1,7,0.36
9,4,accident,8,5,2,6,0.36
9,4,accurate,8,6,3,5,0.32
9,4,actress,7,7,2,5,0.24
9,4,ad,2,8,1,1,0.08
9,4,adopt,5,9,2,3,0.2
9,4,advantage,9,10,2,7,0.4
9,4,adventure,9,11,3,6,0.32
9,4,advice,6,12,3,3,0.2
9,4,aesthetic,9,13,1,8,0.44
9,4,again,5,14,1,4,0.2
9,4,against,7,15,5,2,0.2
9,4,agree,5,16,2,3,0.2
9,4,ally,4,17,1,3,0.16
9,4,alongside,9,18,2,7,0.4
9,4,amateur,7,19,1,6,0.28
9,4,ambulance,9,20,2,7,0.36
9,4,amendment,9,21,2,7,0.4
9,4,analyse,7,22,1,6,0.28
9,4,ancient,7,23,2,5,0.24
9,4,ankle,5,24,2,3,0.16
9,4,annoying,8,25,2,6,0.36
9,4,apology,7,26,1,6,0.28
9,4,app,3,27,2,1,0.08
9,4,approach,8,28,3,5,0.28
9,4,arise,5,29,1,4,0.28
9,4,arrest,6,30,2,4,0.24
9,4,artist,6,31,2,4,0.2
9,4,artistic,8,32,6,2,0.2
9,4,ask,3,33,1,2,0.12
9,4,associate,9,34,2,7,0.4
9,4,attract,7,35,1,6,0.28
9,4,authorize,9,36,1,8,0.36
9,4,average,7,37,1,6,0.4
9,4,baby,4,38,0,4,0.2
9,4,bacteria,8,39,2,6,0.28
9,4,balance,7,40,2,5,0.24
9,4,barrel,6,41,2,4,0.28
9,4,base,4,42,2,2,0.12
9,4,bat,3,43,2,1,0.08
9,4,bath,4,44,3,1,0.12
9,4,beast,5,45,1,4,0.2
9,4,beg,3,46,2,1,0.12
9,4,best,4,47,2,2,0.2
9,4,betray,6,48,2,4,0.2
9,4,bill,4,49,1,3,0.16
9,4,bin,3,50,2,1,0.12
9,4,bird,4,51,2,2,0.12
9,4,birthday,8,52,3,5,0.28
9,4,bite,4,53,2,2,0.2
9,4,bizarre,7,54,2,5,0.24
9,4,blog,4,55,1,3,0.16
9,4,blow,4,56,3,1,0.12
9,4,boil,4,57,1,3,0.16
9,4,bomb,4,58,2,2,0.2
9,4,boost,5,59,2,3,0.2
9,4,boot,4,60,3,1,0.12
9,4,bother,6,61,2,4,0.24
9,4,bottle,6,62,3,3,0.2
9,4,boyfriend,9,63,2,7,0.44
9,4,breach,6,64,1,5,0.24
9,4,break,5,65,4,1,0.12
9,4,bridge,6,66,2,4,0.24
9,4,broken,6,67,2,4,0.2
9,4,build,5,68,1,4,0.28
9,4,burden,6,69,2,4,0.2
9,4,business,8,70,2,6,0.28
9,4,cafe,4,71,0,4,0.2
9,4,cancer,6,72,2,4,0.28
9,4,card,4,73,2,2,0.16
9,4,carefully,9,74,3,6,0.32
9,4,category,8,75,2,6,0.28
9,4,cave,4,76,2,2,0.2
9,4,cd,2,77,1,1,0.08
9,4,cease,5,78,1,4,0.2
9,4,celebrity,9,79,2,7,0.32
9,4,central,7,80,2,5,0.28
9,4,century,7,81,4,3,0.28
9,4,certainty,9,82,2,7,0.48
9,4,challenge,9,83,1,8,0.8
9,4,chapter,7,84,3,4,0.32
9,4,charity,7,85,3,4,0.24
9,4,charter,7,86,4,3,0.24
9,4,cheat,5,87,2,3,0.24
9,4,check,5,88,3,2,0.16
9,4,cheerful,8,89,3,5,0.36
9,4,choir,5,90,2,3,0.2
9,4,chop,4,91,3,1,0.12
9,4,chronic,7,92,2,5,0.28
9,4,chunk,5,93,2,3,0.24
9,4,city,4,94,1,3,0.16
9,4,clarity,7,95,1,6,0.28
9,4,clean,5,96,2,3,0.16
9,4,clearly,7,97,4,3,0.2
9,4,clerk,5,98,3,2,0.24
9,4,clinical,8,99,2,6,0.28
9,4,closely,7,100,2,5,0.28
9,4,cloud,5,101,3,2,0.16
9,4,club,4,102,2,2,0.2
9,4,cluster,7,103,3,4,0.24
9,4,coffee,6,104,1,5,0.24
9,4,colony,6,105,2,4,0.24
9,4,company,7,106,2,5,0.24
9,4,compete,7,107,4,3,0.28
9,4,comply,6,108,4,2,0.16
9,4,component,9,109,4,5,0.28
9,4,conceive,8,110,2,6,0.36
9,4,concept,7,111,5,2,0.2
9,4,concern,7,112,5,2,0.2
9,4,confess,7,113,3,4,0.24
9,4,connected,9,114,3,6,0.36
9,4,conscious,9,115,3,6,0.32
9,4,consent,7,116,4,3,0.2
9,4,contend,7,117,3,4,0.24
9,4,convey,6,118,3,3,0.28
9,4,cooker,6,119,2,4,0.2
9,4,correct,7,120,2,5,0.24
9,4,correctly,9,121,7,2,0.24
9,4,could,5,122,2,3,0.24
9,4,county,6,123,3,3,0.2
9,4,course,6,124,3,3,0.2
9,4,coverage,8,125,2,6,0.28
9,4,craft,5,126,1,4,0.28
9,4,create,6,127,2,4,0.2
9,4,creature,8,128,5,3,0.24
9,4,criminal,8,129,2,6,0.4
9,4,crisis,6,130,3,3,0.24
9,4,cross,5,131,2,3,0.2
9,4,crowded,7,132,3,4,0.24
9,4,crucial,7,133,2,5,0.24
9,4,crude,5,134,3,2,0.16
9,4,cruel,5,135,3,2,0.2
9,4,cruise,6,136,3,3,0.2
9,4,cultivate,9,137,1,8,0.36
9,4,current,7,138,2,5,0.24
9,4,curved,6,139,3,3,0.28
9,4,cycle,5,140,1,4,0.2
9,4,dam,3,141,0,3,0.16
9,4,dance,5,142,2,3,0.16
9,4,dare,4,143,2,2,0.12
9,4,day,3,144,2,1,0.12
9,4,deal,4,145,1,3,0.24
9,4,death,5,146,3,2,0.16
9,4,declare,7,147,2,5,0.24
9,4,decline,7,148,4,3,0.2
9,4,decrease,8,149,3,5,0.36
9,4,default,7,150,2,5,0.24
9,4,defence,7,151,3,4,0.24
9,4,defender,8,152,5,3,0.24
9,4,deliver,7,153,2,5,0.32
9,4,democracy,9,154,2,7,0.32
9,4,demon,5,155,4,1,0.12
9,4,departure,9,156,2,7,0.32
9,4,deputy,6,157,3,3,0.28
9,4,desktop,7,158,2,5,0.24
9,4,develop,7,159,2,5,0.24
9,4,diagnosis,9,160,1,8,0.44
9,4,diagram,7,161,4,3,0.2
9,4,dictator,8,162,2,6,0.32
9,4,digital,7,163,2,5,0.28
9,4,diplomat,8,164,2,6,0.36
9,4,director,8,165,2,6,0.48
9,4,disabled,8,166,2,6,0.68
9,4,discovery,9,167,3,6,0.88
9,4,display,7,168,3,4,0.56
9,4,distant,7,169,3,4,0.56
9,4,divine,6,170,2,4,0.52
9,4,drawing,7,171,1,6,0.76
9,4,earth,5,172,0,5,0.52
9,4,edit,4,173,1,3,0.36
9,4,editor,6,174,4,2,0.4
9,4,effective,9,175,1,8,0.84
9,4,eighty,6,176,1,5,0.68
9,4,eleven,6,177,1,5,0.56
9,4,eliminate,9,178,2,7,0.8
9,4,elsewhere,9,179,2,7,0.92
9,4,embark,6,180,1,5,0.56
9,4,emission,8,181,2,6,0.68
9,4,emotion,7,182,2,5,0.6
9,4,empirical,9,183,2,7,0.96
9,4,employer,8,184,3,5,0.64
9,4,empower,7,185,3,4,0.56
9,4,endless,7,186,1,6,0.76
9,4,enjoy,5,187,2,3,0.4
9,4,enjoyable,9,188,5,4,0.64
9,4,enormous,8,189,2,6,0.68
9,4,equality,8,190,1,7,0.84
9,4,equipment,9,191,3,6,0.72
9,4,essay,5,192,1,4,0.48
9,4,essence,7,193,3,4,0.56
9,4,euro,4,194,1,3,0.48
9,4,evening,7,195,1,6,0.64
9,4,evoke,5,196,2,3,0.4
9,4,exact,5,197,1,4,0.48
9,4,examine,7,198,3,4,0.56
9,4,excellent,9,199,2,7,0.92
9,4,exception,9,200,4,5,0.68
9,4,exchange,8,201,3,5,0.64
9,4,excited,7,202,3,4,0.68
9,4,exciting,8,203,5,3,0.52
9,4,executive,9,204,2,7,0.8
9,4,exercise,8,205,3,5,0.76
9,4,expertise,9,206,2,7,0.8
9,4,explain,7,207,3,4,0.56
9,4,eye,3,208,1,2,0.28
9,4,failure,7,209,0,7,0.84
9,4,fairly,6,210,3,3,0.48
9,4,fantasy,7,211,2,5,0.6
9,4,fast,4,212,2,2,0.32
9,4,fasten,6,213,4,2,0.4
9,4,fear,4,214,1,3,0.48
9,4,feeding,7,215,2,5,0.6
9,4,fibre,5,216,1,4,0.48
9,4,fiction,7,217,2,5,0.64
9,4,fifty,5,218,2,3,0.44
9,4,finally,7,219,2,5,0.72
9,4,fine,4,220,3,1,0.28
9,4,fix,3,221,2,1,0.24
9,4,fixture,7,222,3,4,0.56
9,4,flag,4,223,1,3,0.36
9,4,flavour,7,224,3,4,0.68
9,4,floor,5,225,2,3,0.4
9,4,flower,6,226,3,3,0.48
9,4,flu,3,227,2,1,0.24
9,4,for,3,228,1,2,0.28
9,4,force,5,229,3,2,0.48
9,4,foreign,7,230,3,4,0.56
9,4,former,6,231,3,3,0.48
9,4,formerly,8,232,6,2,0.48
9,4,formula,7,233,4,3,0.6
9,4,forward,7,234,3,4,0.56
9,4,foster,6,235,2,4,0.52
9,4,founder,7,236,2,5,0.6
9,4,fourteen,8,237,3,5,0.76
9,4,fridge,6,238,1,5,0.56
9,4,front,5,239,2,3,0.4
9,4,fulfil,6,240,1,5,0.56
9,4,full,4,241,3,1,0.28
9,4,gallon,6,242,0,6,0.72
9,4,gender,6,243,1,5,0.56
9,4,gene,4,244,3,1,0.28
9,4,generally,9,245,4,5,0.72
9,4,generate,8,246,6,2,0.6
9,4,genetic,7,247,4,3,0.52
9,4,genre,5,248,3,2,0.44
9,4,genuinely,9,249,3,6,0.88
9,4,give,4,250,1,3,0.44
9,4,globe,5,251,1,4,0.88
9,4,god,3,252,1,2,0.28
9,4,govern,6,253,2,4,0.52
9,4,governor,8,254,6,2,0.48
9,4,grid,4,255,1,3,0.36
9,4,grief,5,256,3,2,0.48
9,4,grind,5,257,3,2,0.36
9,4,ground,6,258,2,4,0.52
9,4,guerrilla,9,259,1,8,0.84
9,4,guess,5,260,3,2,0.48
9,4,guidance,8,261,2,6,0.72
9,4,guitar,6,262,3,3,0.48
9,4,hair,4,263,0,4,0.48
9,4,handy,5,264,2,3,0.52
9,4,harbour,7,265,2,5,0.76
9,4,harm,4,266,3,1,0.28
9,4,harvest,7,267,3,4,0.56
9,4,hat,3,268,2,1,0.24
9,4,hate,4,269,3,1,0.28
9,4,hazard,6,270,2,4,0.64
9,4,health,6,271,1,5,0.56
9,4,heart,5,272,3,2,0.36
9,4,heat,4,273,3,1,0.28
9,4,heighten,8,274,2,6,0.68
9,4,hers,4,275,2,2,0.44
9,4,hesitate,8,276,2,6,0.68
9,4,highlight,9,277,1,8,0.84
9,4,hint,4,278,2,2,0.32
9,4,horror,6,279,1,5,0.68
9,4,hotel,5,280,2,3,0.4
9,4,how,3,281,2,1,0.24
9,4,humanity,8,282,1,7,0.76
9,4,i,1,283,0,1,0.16
9,4,ice,3,284,1,2,0.28
9,4,icon,4,285,2,2,0.44
9,4,identical,9,286,1,8,0.84
9,4,ill,3,287,1,2,0.28
9,4,import,6,288,1,5,0.56
9,4,improve,7,289,3,4,0.68
9,4,include,7,290,1,6,0.68
9,4,inclusion,9,291,5,4,0.72
9,4,index,5,292,2,3,0.48
9,4,indicate,8,293,3,5,0.8
9,4,indirect,8,294,4,4,0.6
9,4,infant,6,295,2,4,0.52
9,4,influence,9,296,3,6,0.76
9,4,inherent,8,297,2,6,0.88
9,4,injury,6,298,2,4,0.64
9,4,insertion,9,299,2,7,0.96
9,4,inspect,7,300,3,4,0.72
9,4,instruct,8,301,3,5,0.64
9,4,insurance,9,302,3,6,0.72
9,4,integral,8,303,2,6,0.68
9,4,intensify,9,304,4,5,0.8
9,4,interior,8,305,4,4,0.6
9,4,invade,6,306,2,4,0.52
9,4,invest,6,307,3,3,0.56
9,4,involve,7,308,3,4,0.56
9,4,iron,4,309,1,3,0.36
9,4,island,6,310,1,5,0.56
9,4,isolated,8,311,2,6,0.68
9,4,issue,5,312,2,3,0.52
9,4,job,3,313,0,3,0.32
9,4,judicial,8,314,1,7,0.76
9,4,jump,4,315,2,2,0.32
9,4,just,4,316,2,2,0.32
9,4,key,3,317,0,3,0.48
9,4,keyboard,8,318,3,5,0.68
9,4,kid,3,319,1,2,0.36
9,4,kingdom,7,320,2,5,0.72
9,4,kit,3,321,2,1,0.28
9,4,knife,5,322,1,4,0.64
9,4,know,4,323,2,2,0.32
9,4,laser,5,324,0,5,0.52
9,4,last,4,325,3,1,0.28
9,4,latest,6,326,2,4,0.52
9,4,layer,5,327,2,3,0.4
9,4,leaf,4,328,1,3,0.48
9,4,leaflet,7,329,4,3,0.48
9,4,learning,8,330,3,5,0.64
9,4,legend,6,331,2,4,0.52
9,4,legendary,9,332,6,3,0.68
9,4,lemon,5,333,2,3,0.44
9,4,lens,4,334,2,2,0.32
9,4,lesbian,7,335,2,5,0.6
9,4,letter,6,336,2,4,0.64
9,4,lifestyle,9,337,1,8,0.84
9,4,link,4,338,2,2,0.32
9,4,litter,6,339,2,4,0.52
9,4,live,4,340,2,2,0.32
9,4,local,5,341,1,4,0.56
9,4,log,3,342,2,1,0.24
9,4,long,4,343,2,2,0.32
9,4,look,4,344,2,2,0.32
9,4,loose,5,345,3,2,0.36
9,4,loudly,6,346,2,4,0.52
9,4,low,3,347,2,1,0.32
9,4,lunch,5,348,1,4,0.48
9,4,machinery,9,349,0,9,0.88
9,4,mail,4,350,2,2,0.32
9,4,main,4,351,3,1,0.28
9,4,map,3,352,2,1,0.32
9,4,marine,6,353,2,4,0.52
9,4,mark,4,354,3,1,0.28
9,4,married,7,355,3,4,0.56
9,4,match,5,356,2,3,0.44
9,4,maximum,7,357,2,5,0.72
9,4,meanwhile,9,358,1,8,0.84
9,4,media,5,359,2,3,0.4
9,4,meeting,7,360,2,5,0.6
9,4,melody,6,361,2,4,0.6
9,4,mention,7,362,2,5,0.6
9,4,merely,6,363,2,4,0.52
9,4,mess,4,364,2,2,0.32
9,4,metre,5,365,2,3,0.44
9,4,militia,7,366,1,6,0.76
9,4,mind,4,367,2,2,0.32
9,4,ministry,8,368,3,5,0.64
9,4,missing,7,369,2,5,0.6
9,4,mixed,5,370,2,3,0.52
9,4,model,5,371,1,4,0.48
9,4,modify,6,372,3,3,0.44
9,4,moment,6,373,2,4,0.52
9,4,money,5,374,2,3,0.4
9,4,monthly,7,375,3,4,0.68
9,4,more,4,376,2,2,0.32
9,4,most,4,377,2,2,0.32
9,4,mother,6,378,2,4,0.52
9,4,mouth,5,379,2,3,0.4
9,4,movie,5,380,2,3,0.92
9,4,much,4,381,1,3,0.8
9,4,multiple,8,382,2,6,1.72
9,4,municipal,9,383,2,7,2.2
9,4,museum,6,384,2,4,0.44
9,4,music,5,385,3,2,0.2
9,4,musician,8,386,5,3,0.28
9,4,my,2,387,1,1,0.08
9,4,myth,4,388,2,2,0.24
9,4,narrative,9,389,0,9,0.48
9,4,nasty,5,390,2,3,0.2
9,4,nature,6,391,2,4,0.24
9,4,neck,4,392,1,3,0.2
9,4,negative,8,393,2,6,0.4
9,4,neutral,7,394,2,5,0.28
9,4,newly,5,395,2,3,0.2
9,4,noisy,5,396,1,4,0.2
9,4,normal,6,397,2,4,0.28
9,4,north,5,398,3,2,0.16
9,4,northern,8,399,5,3,0.24
9,4,not,3,400,2,1,0.08
9,4,nothing,7,401,3,4,0.28
9,4,notion,6,402,3,3,0.2
9,4,novel,5,403,2,3,0.2
9,4,obesity,7,404,0,7,0.32
9,4,oblige,6,405,2,4,0.24
9,4,obsess,6,406,2,4,0.28
9,4,ocean,5,407,1,4,0.2
9,4,october,7,408,2,5,0.28
9,4,offend,6,409,1,5,0.24
9,4,official,8,410,3,5,0.36
9,4,one,3,411,1,2,0.12
9,4,online,6,412,2,4,0.24
9,4,organized,9,413,1,8,0.4
9,4,other,5,414,1,4,0.24
9,4,ought,5,415,1,4,0.28
9,4,outfit,6,416,2,4,0.24
9,4,outlook,7,417,3,4,0.24
9,4,oversee,7,418,1,6,0.28
9,4,owe,3,419,1,2,0.2
9,4,pace,4,420,0,4,0.2
9,4,pack,4,421,3,1,0.12
9,4,paint,5,422,2,3,0.16
9,4,parade,6,423,2,4,0.2
9,4,password,8,424,2,6,0.36
9,4,patent,6,425,2,4,0.2
9,4,patience,8,426,3,5,0.28
9,4,patron,6,427,3,3,0.2
9,4,peace,5,428,1,4,0.28
9,4,perfect,7,429,2,5,0.32
9,4,perhaps,7,430,3,4,0.28
9,4,personnel,9,431,3,6,0.36
9,4,phone,5,432,1,4,0.28
9,4,pig,3,433,1,2,0.12
9,4,pile,4,434,2,2,0.16
9,4,pin,3,435,2,1,0.08
9,4,place,5,436,1,4,0.2
9,4,plan,4,437,3,1,0.12
9,4,plane,5,438,4,1,0.2
9,4,planning,8,439,4,4,0.24
9,4,plastic,7,440,3,4,0.24
9,4,play,4,441,3,1,0.12
9,4,pledge,6,442,2,4,0.2
9,4,plot,4,443,2,2,0.2
9,4,police,6,444,1,5,0.24
9,4,political,9,445,4,5,0.28
9,4,pond,4,446,2,2,0.16
9,4,portion,7,447,2,5,0.32
9,4,possess,7,448,2,5,0.24
9,4,post,4,449,3,1,0.12
9,4,poster,6,450,4,2,0.16
9,4,pot,3,451,2,1,0.08
9,4,practical,9,452,1,8,0.44
9,4,praise,6,453,3,3,0.2
9,4,prayer,6,454,3,3,0.2
9,4,precedent,9,455,2,7,0.36
9,4,precise,7,456,4,3,0.28
9,4,predict,7,457,3,4,0.28
9,4,pregnant,8,458,3,5,0.32
9,4,premier,7,459,3,4,0.28
9,4,premise,7,460,5,2,0.24
9,4,principal,9,461,2,7,0.32
9,4,principle,9,462,7,2,0.24
9,4,printer,7,463,4,3,0.28
9,4,printing,8,464,5,3,0.24
9,4,prior,5,465,3,2,0.16
9,4,priority,8,466,5,3,0.24
9,4,procedure,9,467,2,7,0.4
9,4,processor,9,468,5,4,0.28
9,4,product,7,469,3,4,0.24
9,4,profile,7,470,3,4,0.24
9,4,prominent,9,471,3,6,0.36
9,4,proper,6,472,3,3,0.2
9,4,propose,7,473,4,3,0.2
9,4,protest,7,474,3,4,0.24
9,4,pump,4,475,1,3,0.24
9,4,punk,4,476,2,2,0.12
9,4,pupil,5,477,2,3,0.16
9,4,pure,4,478,2,2,0.12
9,4,pursuit,7,479,3,4,0.28
9,4,quantity,8,480,0,8,0.4
9,4,quest,5,481,2,3,0.2
9,4,quite,5,482,2,3,0.16
9,4,racial,6,483,0,6,0.28
9,4,radar,5,484,2,3,0.2
9,4,rail,4,485,2,2,0.2
9,4,railway,7,486,4,3,0.2
9,4,rally,5,487,2,3,0.2
9,4,rather,6,488,2,4,0.2
9,4,react,5,489,1,4,0.28
9,4,realm,5,490,3,2,0.16
9,4,rebel,5,491,2,3,0.2
9,4,recount,7,492,2,5,0.24
9,4,recruit,7,493,3,4,0.24
9,4,recycle,7,494,3,4,0.28
9,4,reduction,9,495,2,7,0.36
9,4,referee,7,496,2,5,0.24
9,4,reference,9,497,6,3,0.32
9,4,regard,6,498,2,4,0.24
9,4,relative,8,499,2,6,0.28
9,4,relaxed,7,500,4,3,0.24
9,4,relief,6,501,3,3,0.28
9,4,relieved,8,502,5,3,0.24
9,4,religious,9,503,4,5,0.28
9,4,remainder,9,504,2,7,0.36
9,4,renew,5,505,2,3,0.24
9,4,research,8,506,2,6,0.28
9,4,resolve,7,507,3,4,0.24
9,4,reveal,6,508,2,4,0.2
9,4,revise,6,509,3,3,0.28
9,4,revival,7,510,4,3,0.2
9,4,rival,5,511,1,4,0.2
9,4,robbery,7,512,1,6,0.28
9,4,root,4,513,2,2,0.12
9,4,rotate,6,514,2,4,0.28
9,4,rough,5,515,2,3,0.16
9,4,round,5,516,3,2,0.16
9,4,routine,7,517,3,4,0.24
9,4,ruin,4,518,1,3,0.16
9,4,safe,4,519,0,4,0.24
9,4,sailor,6,520,2,4,0.24
9,4,salt,4,521,2,2,0.16
9,4,sample,6,522,2,4,0.24
9,4,sand,4,523,2,2,0.12
9,4,satisfy,7,524,2,5,0.32
9,4,scan,4,525,1,3,0.32
9,4,scattered,9,526,3,6,0.32
9,4,schedule,8,527,2,6,0.32
9,4,scholar,7,528,3,4,0.32
9,4,scientist,9,529,2,7,0.36
9,4,score,5,530,2,3,0.2
9,4,secret,6,531,1,5,0.24
9,4,secretary,9,532,6,3,0.32
9,4,security,8,533,3,5,0.28
9,4,seeker,6,534,2,4,0.24
9,4,selective,9,535,2,7,0.4
9,4,sensible,8,536,2,6,0.32
9,4,september,9,537,2,7,0.36
9,4,serious,7,538,2,5,0.32
9,4,seriously,9,539,7,2,0.24
9,4,servant,7,540,3,4,0.24
9,4,service,7,541,4,3,0.2
9,4,setting,7,542,2,5,0.32
9,4,settler,7,543,4,3,0.2
9,4,severely,8,544,2,6,0.32
9,4,shape,5,545,1,4,0.2
9,4,shell,5,546,2,3,0.16
9,4,shift,5,547,2,3,0.24
9,4,ship,4,548,3,1,0.12
9,4,shopping,8,549,2,6,0.28
9,4,shortage,8,550,3,5,0.28
9,4,signature,9,551,1,8,0.44
9,4,similarly,9,552,2,7,0.36
9,4,singing,7,553,2,5,0.28
9,4,sink,4,554,3,1,0.12
9,4,sister,6,555,2,4,0.28
9,4,sit,3,556,2,1,0.08
9,4,situated,8,557,3,5,0.28
9,4,skirt,5,558,1,4,0.2
9,4,slam,4,559,1,3,0.16
9,4,slice,5,560,2,3,0.24
9,4,slip,4,561,3,1,0.12
9,4,smile,5,562,1,4,0.2
9,4,smoking,7,563,2,5,0.24
9,4,snow,4,564,1,3,0.16
9,4,soap,4,565,1,3,0.24
9,4,solar,5,566,2,3,0.2
9,4,solid,5,567,3,2,0.16
9,4,some,4,568,2,2,0.12
9,4,somehow,7,569,4,3,0.24
9,4,sometimes,9,570,4,5,0.36
9,4,song,4,571,2,2,0.12
9,4,soup,4,572,2,2,0.12
9,4,sphere,6,573,1,5,0.24
9,4,spine,5,574,2,3,0.16
9,4,spread,6,575,2,4,0.28
9,4,stab,4,576,1,3,0.16
9,4,stamp,5,577,3,2,0.16
9,4,standing,8,578,3,5,0.28
9,4,stay,4,579,3,1,0.12
9,4,steadily,8,580,2,6,0.36
9,4,steer,5,581,3,2,0.16
9,4,stick,5,582,2,3,0.2
9,4,sticky,6,583,5,1,0.16
9,4,story,5,584,2,3,0.24
9,4,straight,8,585,2,6,0.32
9,4,strategy,8,586,4,4,0.24
9,4,street,6,587,3,3,0.2
9,4,strength,8,588,4,4,0.32
9,4,string,6,589,3,3,0.2
9,4,strong,6,590,3,3,0.2
9,4,study,5,591,2,3,0.2
9,4,stumble,7,592,3,4,0.24
9,4,subject,7,593,1,6,0.32
9,4,such,4,594,2,2,0.16
9,4,sudden,6,595,2,4,0.2
9,4,sue,3,596,2,1,0.08
9,4,super,5,597,2,3,0.2
9,4,supreme,7,598,3,4,0.32
9,4,surely,6,599,2,4,0.24
9,4,swallow,7,600,1,6,0.28
9,4,swear,5,601,2,3,0.16
9,4,sweater,7,602,4,3,0.28
9,4,switch,6,603,2,4,0.2
9,4,tactical,8,604,0,8,0.32
9,4,tail,4,605,2,2,0.16
9,4,tale,4,606,2,2,0.12
9,4,talent,6,607,4,2,0.24
9,4,tank,4,608,2,2,0.16
9,4,tap,3,609,2,1,0.12
9,4,task,4,610,2,2,0.16
9,4,taste,5,611,3,2,0.16
9,4,team,4,612,1,3,0.16
9,4,tendency,8,613,2,6,0.36
9,4,tender,6,614,5,1,0.16
9,4,terrorism,9,615,2,7,0.36
9,4,thereby,7,616,1,6,0.32
9,4,thesis,6,617,3,3,0.2
9,4,thirsty,7,618,2,5,0.24
9,4,thorough,8,619,2,6,0.28
9,4,thrilled,8,620,2,6,0.36
9,4,thumb,5,621,2,3,0.16
9,4,ticket,6,622,1,5,0.24
9,4,tight,5,623,2,3,0.16
9,4,till,4,624,2,2,0.12
9,4,timing,6,625,2,4,0.28
9,4,tonne,5,626,1,4,0.2
9,4,too,3,627,2,1,0.12
9,4,tool,4,628,3,1,0.12
9,4,topic,5,629,2,3,0.16
9,4,trademark,9,630,1,8,0.44
9,4,transport,9,631,3,6,0.32
9,4,traveller,9,632,3,6,0.32
9,4,tribal,6,633,2,4,0.28
9,4,tribute,7,634,4,3,0.24
9,4,trio,4,635,3,1,0.16
9,4,tropical,8,636,2,6,0.36
9,4,trouble,7,637,3,4,0.32
9,4,trousers,8,638,4,4,0.32
9,4,truck,5,639,2,3,0.16
9,4,twice,5,640,1,4,0.2
9,4,two,3,641,2,1,0.08
9,4,unable,6,642,0,6,0.28
9,4,undergo,7,643,2,5,0.32
9,4,undermine,9,644,5,4,0.28
9,4,unique,6,645,2,4,0.24
9,4,unveil,6,646,2,4,0.28
9,4,usage,5,647,1,4,0.2
9,4,usual,5,648,2,3,0.2
9,4,utility,7,649,1,6,0.28
9,4,utilize,7,650,5,2,0.2
9,4,vague,5,651,0,5,0.28
9,4,validity,8,652,2,6,0.28
9,4,valley,6,653,3,3,0.2
9,4,valuable,8,654,3,5,0.28
9,4,vegetable,9,655,1,8,0.44
9,4,verify,6,656,2,4,0.2
9,4,vessel,6,657,2,4,0.2
9,4,veteran,7,658,2,5,0.24
9,4,viewer,6,659,1,5,0.32
9,4,violent,7,660,2,5,0.28
9,4,virtual,7,661,2,5,0.28
9,4,virus,5,662,3,2,0.16
9,4,visitor,7,663,2,5,0.36
9,4,visual,6,664,3,3,0.2
9,4,vocal,5,665,1,4,0.2
9,4,voice,5,666,2,3,0.2
9,4,volunteer,9,667,2,7,0.44
9,4,wake,4,668,0,4,0.2
9,4,walk,4,669,2,2,0.12
9,4,watch,5,670,2,3,0.2
9,4,water,5,671,3,2,0.16
9,4,way,3,672,2,1,0.08
9,4,weakness,8,673,1,7,0.4
9,4,wealthy,7,674,3,4,0.24
9,4,weapon,6,675,3,3,0.2
9,4,weave,5,676,3,2,0.16
9,4,weekend,7,677,2,5,0.32
9,4,weird,5,678,2,3,0.2
9,4,welcome,7,679,2,5,0.24
9,4,west,4,680,2,2,0.12
9,4,whatever,8,681,1,7,0.4
9,4,wildlife,8,682,1,7,0.32
9,4,win,3,683,2,1,0.08
9,4,wind,4,684,3,1,0.12
9,4,wisdom,6,685,2,4,0.24
9,4,without,7,686,2,5,0.32
9,4,word,4,687,1,3,0.16
9,4,workforce,9,688,3,6,0.32
9,4,workplace,9,689,4,5,0.28
9,4,worry,5,690,3,2,0.2
9,4,wow,3,691,2,1,0.08
9,4,wrap,4,692,1,3,0.16
9,4,wrist,5,693,2,3,0.2
9,4,yellow,6,694,0,6,0.28
9,4,young,5,695,1,4,0.28
9,4,youngster,9,696,5,4,0.28
9,5,a,1,0,0,1,0.08
9,5,absorb,6,1,1,5,0.24
9,5,absurd,6,2,3,3,0.2
9,5,accident,8,3,1,7,0.4
9,5,acid,4,4,2,2,0.12
9,5,acre,4,5,2,2,0.16
9,5,activate,8,6,2,6,0.28
9,5,actress,7,7,3,4,0.32
9,5,acute,5,8,2,3,0.2
9,5,add,3,9,1,2,0.12
9,5,adjacent,8,10,2,6,0.32
9,5,admit,5,11,2,3,0.16
9,5,adopt,5,12,2,3,0.24
9,5,adventure,9,13,2,7,0.36
9,5,advice,6,14,3,3,0.2
9,5,again,5,15,1,4,0.2
9,5,agree,5,16,2,3,0.2
9,5,aids,4,17,1,3,0.24
9,5,align,5,18,1,4,0.2
9,5,allocate,8,19,2,6,0.32
9,5,ally,4,20,3,1,0.12
9,5,alongside,9,21,2,7,0.4
9,5,amusing,7,22,1,6,0.28
9,5,analysis,8,23,1,7,0.32
9,5,animal,6,24,2,4,0.24
9,5,ankle,5,25,2,3,0.24
9,5,annoyed,7,26,2,5,0.24
9,5,annoying,8,27,5,3,0.24
9,5,anybody,7,28,2,5,0.24
9,5,anyway,6,29,3,3,0.28
9,5,apology,7,30,1,6,0.28
9,5,applaud,7,31,2,5,0.28
9,5,approach,8,32,3,5,0.28
9,5,arguably,8,33,1,7,0.4
9,5,argue,5,34,4,1,0.12
9,5,arise,5,35,2,3,0.16
9,5,arms,4,36,2,2,0.16
9,5,artist,6,37,2,4,0.28
9,5,assault,7,38,1,6,0.28
9,5,associate,9,39,3,6,0.32
9,5,assurance,9,40,3,6,0.32
9,5,attract,7,41,1,6,0.36
9,5,auction,7,42,1,6,0.28
9,5,auto,4,43,2,2,0.16
9,5,average,7,44,1,6,0.28
9,5,baby,4,45,0,4,0.28
9,5,balance,7,46,2,5,0.24
9,5,banner,6,47,2,4,0.24
9,5,base,4,48,2,2,0.12
9,5,bat,3,49,2,1,0.12
9,5,bath,4,50,3,1,0.12
9,5,bay,3,51,2,1,0.16
9,5,beast,5,52,1,4,0.2
9,5,beat,4,53,3,1,0.12
9,5,beauty,6,54,3,3,0.2
9,5,beer,4,55,2,2,0.12
9,5,beg,3,56,2,1,0.08
9,5,behalf,6,57,2,4,0.28
9,5,behave,6,58,4,2,0.16
9,5,belief,6,59,2,4,0.2
9,5,best,4,60,2,2,0.12
9,5,bird,4,61,1,3,0.16
9,5,bishop,6,62,2,4,0.28
9,5,bizarre,7,63,2,5,0.24
9,5,blame,5,64,1,4,0.2
9,5,blind,5,65,2,3,0.16
9,5,boil,4,66,1,3,0.2
9,5,boot,4,67,2,2,0.24
9,5,bother,6,68,2,4,0.24
9,5,bottle,6,69,3,3,0.2
9,5,box,3,70,2,1,0.12
9,5,boyfriend,9,71,2,7,0.4
9,5,brand,5,72,1,4,0.2
9,5,breach,6,73,2,4,0.24
9,5,break,5,74,4,1,0.12
9,5,breathe,7,75,4,3,0.2
9,5,breathing,9,76,6,3,0.32
9,5,bride,5,77,2,3,0.2
9,5,bridge,6,78,4,2,0.16
9,5,broken,6,79,2,4,0.24
9,5,buffer,6,80,1,5,0.28
9,5,bug,3,81,2,1,0.12
9,5,build,5,82,2,3,0.2
9,5,cafe,4,83,0,4,0.2
9,5,cake,4,84,2,2,0.12
9,5,cancer,6,85,2,4,0.2
9,5,candidate,9,86,3,6,0.4
9,5,card,4,87,2,2,0.12
9,5,carefully,9,88,3,6,0.32
9,5,carpet,6,89,3,3,0.2
9,5,cartoon,7,90,3,4,0.32
9,5,carve,5,91,3,2,0.16
9,5,category,8,92,2,6,0.28
9,5,cave,4,93,2,2,0.12
9,5,cd,2,94,1,1,0.08
9,5,celebrate,9,95,1,8,0.44
9,5,cemetery,8,96,2,6,0.32
9,5,century,7,97,2,5,0.28
9,5,ceremony,8,98,2,6,0.36
9,5,certain,7,99,3,4,0.24
9,5,certainty,9,100,7,2,0.24
9,5,chair,5,101,1,4,0.2
9,5,chapter,7,102,3,4,0.32
9,5,charm,5,103,3,2,0.16
9,5,chart,5,104,4,1,0.12
9,5,cheat,5,105,2,3,0.2
9,5,check,5,106,3,2,0.16
9,5,cheerful,8,107,3,5,0.36
9,5,chemical,8,108,3,5,0.28
9,5,chicken,7,109,2,5,0.24
9,5,cite,4,110,1,3,0.16
9,5,city,4,111,3,1,0.12
9,5,clarity,7,112,1,6,0.36
9,5,clause,6,113,3,3,0.2
9,5,clearly,7,114,2,5,0.28
9,5,clerk,5,115,3,2,0.16
9,5,cloud,5,116,2,3,0.24
9,5,club,4,117,2,2,0.12
9,5,cluster,7,118,3,4,0.24
9,5,coffee,6,119,1,5,0.24
9,5,commodity,9,120,2,7,0.4
9,5,commonly,8,121,5,3,0.24
9,5,company,7,122,3,4,0.24
9,5,comply,6,123,4,2,0.16
9,5,conceive,8,124,2,6,0.36
9,5,concept,7,125,5,2,0.2
9,5,confer,6,126,3,3,0.2
9,5,confess,7,127,5,2,0.2
9,5,confused,8,128,4,4,0.32
9,5,connected,9,129,3,6,0.32
9,5,conscious,9,130,3,6,0.32
9,5,consent,7,131,4,3,0.2
9,5,contempt,8,132,3,5,0.32
9,5,contrast,8,133,4,4,0.24
9,5,convey,6,134,3,3,0.2
9,5,cope,4,135,2,2,0.12
9,5,correct,7,136,2,5,0.32
9,5,cottage,7,137,2,5,0.32
9,5,could,5,138,2,3,0.4
9,5,county,6,139,3,3,0.36
9,5,coup,4,140,3,1,0.12
9,5,couple,6,141,4,2,0.24
9,5,court,5,142,3,2,0.16
9,5,creature,8,143,1,7,0.36
9,5,criminal,8,144,2,6,0.32
9,5,cross,5,145,2,3,0.28
9,5,crowd,5,146,3,2,0.16
9,5,crude,5,147,2,3,0.2
9,5,cruise,6,148,3,3,0.28
9,5,cultivate,9,149,1,8,0.68
9,5,currency,8,150,2,6,0.32
9,5,current,7,151,6,1,0.16
9,5,curved,6,152,3,3,0.2
9,5,dance,5,153,0,5,0.28
9,5,dare,4,154,2,2,0.16
9,5,day,3,155,2,1,0.08
9,5,deal,4,156,1,3,0.16
9,5,death,5,157,3,2,0.16
9,5,declare,7,158,2,5,0.24
9,5,decline,7,159,4,3,0.28
9,5,decrease,8,160,3,5,0.28
9,5,deed,4,161,2,2,0.12
9,5,deem,4,162,3,1,0.12
9,5,definite,8,163,2,6,0.36
9,5,deliver,7,164,2,5,0.28
9,5,democracy,9,165,2,7,0.32
9,5,departure,9,166,2,7,0.32
9,5,deposit,7,167,3,4,0.32
9,5,deputy,6,168,3,3,0.2
9,5,desktop,7,169,2,5,0.28
9,5,develop,7,170,2,5,0.28
9,5,diagnosis,9,171,1,8,0.44
9,5,diagram,7,172,4,3,0.2
9,5,dictate,7,173,2,5,0.24
9,5,digital,7,174,2,5,0.32
9,5,dinner,6,175,2,4,0.2
9,5,dirt,4,176,2,2,0.16
9,5,dirty,5,177,4,1,0.16
9,5,disabled,8,178,2,6,0.28
9,5,discovery,9,179,3,6,0.4
9,5,discuss,7,180,4,3,0.2
9,5,display,7,181,3,4,0.24
9,5,distort,7,182,3,4,0.24
9,5,divine,6,183,2,4,0.28
9,5,divorced,8,184,3,5,0.28
9,5,dollar,6,185,1,5,0.24
9,5,domain,6,186,2,4,0.24
9,5,dominant,8,187,3,5,0.36
9,5,donation,8,188,2,6,0.28
9,5,dot,3,189,2,1,0.08
9,5,drama,5,190,1,4,0.2
9,5,drawing,7,191,3,4,0.32
9,5,duration,8,192,1,7,0.32
9,5,dust,4,193,2,2,0.12
9,5,ear,3,194,0,3,0.16
9,5,effective,9,195,1,8,0.44
9,5,eight,5,196,1,4,0.2
9,5,either,6,197,2,4,0.24
9,5,eleven,6,198,1,5,0.24
9,5,eliminate,9,199,2,7,0.4
9,5,elsewhere,9,200,2,7,0.32
9,5,embody,6,201,1,5,0.24
9,5,emission,8,202,2,6,0.32
9,5,empirical,9,203,2,7,0.44
9,5,employer,8,204,3,5,0.28
9,5,empower,7,205,3,4,0.24
9,5,enable,6,206,1,5,0.32
9,5,endless,7,207,2,5,0.28
9,5,enemy,5,208,2,3,0.16
9,5,engineer,8,209,2,6,0.32
9,5,enormous,8,210,2,6,0.36
9,5,enrich,6,211,2,4,0.24
9,5,enter,5,212,2,3,0.16
9,5,entrance,8,213,3,5,0.28
9,5,equipment,9,214,1,8,0.44
9,5,erect,5,215,1,4,0.2
9,5,essay,5,216,1,4,0.2
9,5,evening,7,217,1,6,0.28
9,5,evoke,5,218,2,3,0.2
9,5,exceed,6,219,1,5,0.32
9,5,excellent,9,220,4,5,0.28
9,5,exception,9,221,4,5,0.28
9,5,exchange,8,222,3,5,0.36
9,5,excited,7,223,3,4,0.24
9,5,executive,9,224,2,7,0.36
9,5,exercise,8,225,3,5,0.28
9,5,exit,4,226,2,2,0.2
9,5,expertise,9,227,2,7,0.32
9,5,explain,7,228,3,4,0.24
9,5,explode,7,229,4,3,0.24
9,5,explosive,9,230,5,4,0.36
9,5,extensive,9,231,2,7,0.4
9,5,failure,7,232,0,7,0.72
9,5,fairly,6,233,3,3,0.56
9,5,fall,4,234,2,2,0.32
9,5,famous,6,235,2,4,0.52
9,5,fantasy,7,236,2,5,0.6
9,5,fasten,6,237,2,4,0.52
9,5,fat,3,238,2,1,0.32
9,5,fee,3,239,1,2,0.28
9,5,feeding,7,240,3,4,0.56
9,5,fellow,6,241,2,4,0.56
9,5,few,3,242,2,1,0.24
9,5,fibre,5,243,1,4,0.6
9,5,fifty,5,244,2,3,0.4
9,5,fight,5,245,2,3,0.44
9,5,fix,3,246,2,1,0.24
9,5,fixture,7,247,3,4,0.56
9,5,flat,4,248,1,3,0.4
9,5,flavour,7,249,3,4,0.68
9,5,flee,4,250,2,2,0.32
9,5,flexible,8,251,3,5,0.64
9,5,flourish,8,252,2,6,0.72
9,5,focus,5,253,1,4,0.6
9,5,food,4,254,2,2,0.32
9,5,foreign,7,255,2,5,0.6
9,5,foreigner,9,256,7,2,0.52
9,5,former,6,257,3,3,0.56
9,5,formerly,8,258,6,2,0.48
9,5,frequent,8,259,1,7,1.08
9,5,fridge,6,260,2,4,0.52
9,5,frighten,8,261,3,5,0.8
9,5,frog,4,262,2,2,0.32
9,5,front,5,263,3,2,0.36
9,5,funding,7,264,1,6,0.72
9,5,fur,3,265,2,1,0.28
9,5,gallon,6,266,0,6,0.84
9,5,gaming,6,267,2,4,0.52
9,5,garage,6,268,2,4,0.52
9,5,gene,4,269,1,3,0.4
9,5,generate,8,270,4,4,0.72
9,5,genre,5,271,3,2,0.36
9,5,genuinely,9,272,3,6,0.76
9,5,geography,9,273,2,7,0.8
9,5,giant,5,274,1,4,0.6
9,5,glass,5,275,1,4,0.48
9,5,globe,5,276,2,3,0.4
9,5,go,2,277,1,1,0.2
9,5,gold,4,278,2,2,0.32
9,5,good,4,279,2,2,0.32
9,5,goodbye,7,280,4,3,0.64
9,5,governor,8,281,2,6,0.72
9,5,grace,5,282,1,4,0.52
9,5,grade,5,283,3,2,0.4
9,5,green,5,284,2,3,0.48
9,5,grief,5,285,2,3,0.56
9,5,grin,4,286,3,1,0.28
9,5,ground,6,287,2,4,0.52
9,5,guess,5,288,1,4,0.48
9,5,guidance,8,289,2,6,0.84
9,5,guy,3,290,2,1,0.24
9,5,hair,4,291,0,4,0.44
9,5,handy,5,292,2,3,0.4
9,5,happen,6,293,2,4,0.52
9,5,harbour,7,294,2,5,0.76
9,5,harvest,7,295,3,4,0.64
9,5,hate,4,296,2,2,0.4
9,5,hazard,6,297,2,4,0.6
9,5,herb,4,298,1,3,0.4
9,5,hers,4,299,3,1,0.28
9,5,highly,6,300,1,5,0.72
9,5,historic,8,301,2,6,0.76
9,5,holiday,7,302,1,6,0.68
9,5,homeland,8,303,2,6,0.96
9,5,honesty,7,304,2,5,0.6
9,5,hour,4,305,2,2,0.32
9,5,how,3,306,2,1,0.24
9,5,however,7,307,3,4,0.56
9,5,humanity,8,308,1,7,0.88
9,5,humour,6,309,3,3,0.44
9,5,i,1,310,0,1,0.16
9,5,ice,3,311,1,2,0.28
9,5,identity,8,312,1,7,0.76
9,5,ignorance,9,313,1,8,0.96
9,5,ill,3,314,1,2,0.28
9,5,illegal,7,315,3,4,0.56
9,5,imaginary,9,316,1,8,0.84
9,5,impatient,9,317,2,7,0.92
9,5,import,6,318,3,3,0.44
9,5,important,9,319,6,3,0.6
9,5,improve,7,320,3,4,0.64
9,5,inclusion,9,321,1,8,0.84
9,5,index,5,322,2,3,0.4
9,5,indicate,8,323,3,5,0.68
9,5,influence,9,324,2,7,0.96
9,5,inform,6,325,3,3,0.44
9,5,informal,8,326,6,2,0.48
9,5,inherent,8,327,2,6,0.68
9,5,initiate,8,328,2,6,0.8
9,5,injury,6,329,2,4,0.52
9,5,insertion,9,330,2,7,0.8
9,5,intake,6,331,2,4,0.64
9,5,integral,8,332,3,5,0.64
9,5,intended,8,333,4,4,0.64
9,5,intense,7,334,5,2,0.44
9,5,interior,8,335,4,4,0.72
9,5,into,4,336,3,1,0.28
9,5,invest,6,337,2,4,0.52
9,5,involve,7,338,3,4,0.56
9,5,island,6,339,1,5,0.56
9,5,isolated,8,340,2,6,0.8
9,5,january,7,341,0,7,0.72
9,5,jewellery,9,342,1,8,0.84
9,5,jump,4,343,1,3,0.48
9,5,june,4,344,2,2,0.32
9,5,justify,7,345,2,5,0.6
9,5,key,3,346,0,3,0.36
9,5,kick,4,347,1,3,0.36
9,5,kid,3,348,2,1,0.24
9,5,kidney,6,349,3,3,0.56
9,5,king,4,350,2,2,0.32
9,5,kingdom,7,351,4,3,0.48
9,5,lad,3,352,0,3,0.36
9,5,lake,4,353,2,2,0.32
9,5,landscape,9,354,2,7,0.92
9,5,lap,3,355,2,1,0.24
9,5,last,4,356,2,2,0.32
9,5,leading,7,357,1,6,0.64
9,5,leaf,4,358,3,1,0.28
9,5,leaflet,7,359,4,3,0.6
9,5,left,4,360,2,2,0.32
9,5,lemon,5,361,2,3,0.44
9,5,lethal,6,362,2,4,0.52
9,5,license,7,363,1,6,0.64
9,5,lifestyle,9,364,2,7,0.88
9,5,limited,7,365,2,5,0.64
9,5,lion,4,366,2,2,0.32
9,5,litter,6,367,2,4,0.52
9,5,local,5,368,1,4,0.56
9,5,located,7,369,4,3,0.52
9,5,location,8,370,5,3,0.56
9,5,long,4,371,2,2,0.32
9,5,look,4,372,2,2,0.32
9,5,lot,3,373,2,1,0.36
9,5,loudly,6,374,2,4,0.52
9,5,mainland,8,375,0,8,0.8
9,5,mandatory,9,376,2,7,0.8
9,5,marine,6,377,2,4,0.6
9,5,mark,4,378,3,1,0.28
9,5,mask,4,379,2,2,0.32
9,5,master,6,380,3,3,0.44
9,5,match,5,381,2,3,0.44
9,5,melody,6,382,1,5,0.68
9,5,memory,6,383,2,4,0.52
9,5,mental,6,384,2,4,0.52
9,5,mention,7,385,4,3,0.52
9,5,mentor,6,386,4,2,0.52
9,5,merely,6,387,2,4,0.52
9,5,merger,6,388,3,3,0.44
9,5,midnight,8,389,1,7,0.76
9,5,militia,7,390,2,5,0.8
9,5,minister,8,391,2,6,0.72
9,5,miserable,9,392,2,7,0.8
9,5,modify,6,393,1,5,0.56
9,5,month,5,394,2,3,0.52
9,5,monthly,7,395,5,2,0.44
9,5,more,4,396,2,2,0.32
9,5,mother,6,397,2,4,0.52
9,5,mouth,5,398,2,3,0.4
9,5,movie,5,399,2,3,0.52
9,5,multiple,8,400,1,7,0.76
9,5,museum,6,401,2,4,0.52
9,5,music,5,402,3,2,0.36
9,5,my,2,403,1,1,0.2
9,5,myth,4,404,2,2,0.44
9,5,naked,5,405,0,5,0.52
9,5,narrative,9,406,2,7,0.8
9,5,nasty,5,407,2,3,0.4
9,5,nature,6,408,2,4,0.52
9,5,necessary,9,409,1,8,0.96
9,5,new,3,410,2,1,0.24
9,5,newly,5,411,3,2,0.36
9,5,noise,5,412,1,4,0.48
9,5,nominate,8,413,2,6,0.84
9,5,normal,6,414,2,4,0.52
9,5,north,5,415,3,2,0.36
9,5,not,3,416,2,1,0.24
9,5,note,4,417,3,1,0.28
9,5,notice,6,418,3,3,0.56
9,5,objective,9,419,0,9,0.92
9,5,oblige,6,420,2,4,0.52
9,5,obviously,9,421,2,7,0.8
9,5,offence,7,422,1,6,0.76
9,5,official,8,423,3,5,0.64
9,5,offspring,9,424,3,6,0.72
9,5,one,3,425,1,2,0.28
9,5,online,6,426,2,4,0.64
9,5,opponent,8,427,1,7,0.76
9,5,opposed,7,428,4,3,0.48
9,5,organic,7,429,1,6,0.68
9,5,organized,9,430,6,3,0.68
9,5,other,5,431,1,4,0.48
9,5,otherwise,9,432,5,4,0.64
9,5,outdoor,7,433,1,6,0.76
9,5,outdoors,8,434,7,1,0.44
9,5,outfit,6,435,3,3,0.48
9,5,oversee,7,436,1,6,0.68
9,5,pace,4,437,0,4,0.44
9,5,pack,4,438,3,1,0.4
9,5,pad,3,439,2,1,0.24
9,5,palace,6,440,2,4,0.52
9,5,park,4,441,2,2,0.32
9,5,partial,7,442,3,4,0.56
9,5,partner,7,443,4,3,0.6
9,5,passenger,9,444,2,7,0.8
9,5,passport,8,445,4,4,0.6
9,5,patron,6,446,2,4,0.52
9,5,peculiar,8,447,1,7,0.84
9,5,perfect,7,448,2,5,0.6
9,5,pick,4,449,1,3,0.36
9,5,piece,5,450,2,3,0.4
9,5,place,5,451,1,4,0.6
9,5,plane,5,452,3,2,0.36
9,5,planning,8,453,4,4,0.6
9,5,play,4,454,3,1,0.28
9,5,pleased,7,455,2,5,0.68
9,5,pledge,6,456,3,3,0.56
9,5,police,6,457,1,5,0.6
9,5,pollution,9,458,3,6,0.64
9,5,pond,4,459,2,2,0.24
9,5,post,4,460,2,2,0.2
9,5,poster,6,461,4,2,0.2
9,5,praise,6,462,1,5,0.24
9,5,precedent,9,463,2,7,0.36
9,5,premier,7,464,3,4,0.32
9,5,prescribe,9,465,3,6,0.32
9,5,presently,9,466,4,5,0.28
9,5,principal,9,467,2,7,0.44
9,5,printer,7,468,4,3,0.24
9,5,prior,5,469,3,2,0.16
9,5,procedure,9,470,2,7,0.32
9,5,processor,9,471,5,4,0.32
9,5,produce,7,472,3,4,0.24
9,5,profile,7,473,3,4,0.24
9,5,program,7,474,3,4,0.24
9,5,project,7,475,3,4,0.32
9,5,prosecute,9,476,3,6,0.32
9,5,protest,7,477,3,4,0.24
9,5,punk,4,478,1,3,0.16
9,5,pupil,5,479,2,3,0.24
9,5,quantity,8,480,0,8,0.36
9,5,query,5,481,2,3,0.2
9,5,racial,6,482,0,6,0.28
9,5,radar,5,483,2,3,0.2
9,5,radiation,9,484,3,6,0.4
9,5,rail,4,485,2,2,0.16
9,5,raise,5,486,3,2,0.16
9,5,rating,6,487,2,4,0.24
9,5,rational,8,488,4,4,0.32
9,5,reasoning,9,489,1,8,0.36
9,5,recall,6,490,2,4,0.2
9,5,recognize,9,491,3,6,0.4
9,5,recommend,9,492,4,5,0.32
9,5,record,6,493,4,2,0.16
9,5,recording,9,494,6,3,0.24
9,5,recruit,7,495,3,4,0.32
9,5,recycle,7,496,3,4,0.24
9,5,reduction,9,497,2,7,0.36
9,5,refer,5,498,2,3,0.2
9,5,reference,9,499,5,4,0.36
9,5,refuse,6,500,3,3,0.2
9,5,regard,6,501,2,4,0.24
9,5,regime,6,502,3,3,0.2
9,5,relaxed,7,503,2,5,0.36
9,5,relevance,9,504,3,6,0.32
9,5,relieved,8,505,3,5,0.28
9,5,religious,9,506,4,5,0.36
9,5,remainder,9,507,2,7,0.32
9,5,remark,6,508,4,2,0.16
9,5,remind,6,509,3,3,0.2
9,5,renew,5,510,2,3,0.16
9,5,reside,6,511,2,4,0.28
9,5,residence,9,512,6,3,0.24
9,5,residue,7,513,5,2,0.2
9,5,rest,4,514,3,1,0.12
9,5,revenge,7,515,2,5,0.32
9,5,revise,6,516,3,3,0.2
9,5,revive,6,517,4,2,0.2
9,5,rifle,5,518,1,4,0.2
9,5,rip,3,519,2,1,0.12
9,5,rise,4,520,2,2,0.52
9,5,ritual,6,521,2,4,0.24
9,5,root,4,522,1,3,0.16
9,5,rotate,6,523,2,4,0.24
9,5,rough,5,524,2,3,0.2
9,5,sacred,6,525,0,6,0.36
9,5,sand,4,526,2,2,0.12
9,5,satisfied,9,527,2,7,0.36
9,5,satisfy,7,528,6,1,0.2
9,5,scared,6,529,1,5,0.32
9,5,schedule,8,530,2,6,0.28
9,5,scheme,6,531,4,2,0.2
9,5,scholar,7,532,3,4,0.24
9,5,school,6,533,4,2,0.24
9,5,score,5,534,2,3,0.16
9,5,seal,4,535,1,3,0.16
9,5,secretary,9,536,2,7,0.32
9,5,secure,6,537,3,3,0.2
9,5,seeker,6,538,2,4,0.28
9,5,seem,4,539,3,1,0.12
9,5,segment,7,540,2,5,0.28
9,5,selective,9,541,2,7,0.36
9,5,september,9,542,2,7,0.44
9,5,seriously,9,543,2,7,0.36
9,5,serve,5,544,3,2,0.16
9,5,setting,7,545,2,5,0.28
9,5,seven,5,546,2,3,0.28
9,5,sexual,6,547,2,4,0.24
9,5,share,5,548,1,4,0.2
9,5,sheer,5,549,2,3,0.16
9,5,shift,5,550,2,3,0.16
9,5,shiny,5,551,3,2,0.24
9,5,shipping,8,552,3,5,0.28
9,5,shopping,8,553,2,6,0.28
9,5,shore,5,554,3,2,0.16
9,5,sibling,7,555,1,6,0.36
9,5,sight,5,556,2,3,0.16
9,5,similarly,9,557,2,7,0.36
9,5,sin,3,558,2,1,0.08
9,5,sink,4,559,3,1,0.12
9,5,six,3,560,2,1,0.16
9,5,skip,4,561,1,3,0.16
9,5,skirt,5,562,3,2,0.16
9,5,slice,5,563,1,4,0.2
9,5,slip,4,564,3,1,0.12
9,5,snow,4,565,1,3,0.16
9,5,soap,4,566,1,3,0.24
9,5,solid,5,567,2,3,0.2
9,5,someone,7,568,2,5,0.24
9,5,something,9,569,4,5,0.28
9,5,south,5,570,2,3,0.28
9,5,spare,5,571,1,4,0.2
9,5,speaker,7,572,2,5,0.28
9,5,spectator,9,573,3,6,0.32
9,5,speech,6,574,3,3,0.28
9,5,spine,5,575,2,3,0.2
9,5,spotlight,9,576,2,7,0.36
9,5,stable,6,577,1,5,0.24
9,5,stall,5,578,3,2,0.24
9,5,stamp,5,579,3,2,0.16
9,5,standing,8,580,3,5,0.28
9,5,star,4,581,3,1,0.12
9,5,statistic,9,582,3,6,0.32
9,5,steer,5,583,2,3,0.24
9,5,stick,5,584,2,3,0.2
9,5,store,5,585,2,3,0.16
9,5,straight,8,586,2,6,0.32
9,5,strange,7,587,4,3,0.28
9,5,strategy,8,588,4,4,0.28
9,5,street,6,589,3,3,0.2
9,5,strength,8,590,4,4,0.24
9,5,stretch,7,591,4,3,0.28
9,5,strict,6,592,3,3,0.2
9,5,strong,6,593,3,3,0.2
9,5,study,5,594,2,3,0.16
9,5,stumble,7,595,3,4,0.32
9,5,stun,4,596,3,1,0.12
9,5,sudden,6,597,1,5,0.24
9,5,sue,3,598,2,1,0.12
9,5,super,5,599,2,3,0.2
9,5,sure,4,600,2,2,0.16
9,5,swallow,7,601,1,6,0.36
9,5,sweater,7,602,2,5,0.28
9,5,swim,4,603,2,2,0.16
9,5,symbolic,8,604,1,7,0.32
9,5,symptom,7,605,3,4,0.32
9,5,tactical,8,606,0,8,0.36
9,5,tail,4,607,2,2,0.16
9,5,tale,4,608,2,2,0.12
9,5,tank,4,609,2,2,0.12
9,5,taste,5,610,2,3,0.24
9,5,team,4,611,1,3,0.16
9,5,tender,6,612,2,4,0.24
9,5,tension,7,613,3,4,0.24
9,5,terribly,8,614,2,6,0.4
9,5,terrific,8,615,5,3,0.24
9,5,terror,6,616,4,2,0.2
9,5,terrorism,9,617,6,3,0.24
9,5,texture,7,618,2,5,0.32
9,5,thereby,7,619,1,6,0.28
9,5,thesis,6,620,3,3,0.2
9,5,thirsty,7,621,2,5,0.24
9,5,thumb,5,622,2,3,0.16
9,5,tight,5,623,1,4,0.28
9,5,tighten,7,624,5,2,0.2
9,5,timing,6,625,2,4,0.2
9,5,tolerance,9,626,1,8,0.44
9,5,tonne,5,627,2,3,0.24
9,5,tool,4,628,2,2,0.12
9,5,tragic,6,629,1,5,0.24
9,5,trap,4,630,3,1,0.12
9,5,treaty,6,631,2,4,0.2
9,5,tree,4,632,3,1,0.2
9,5,trend,5,633,3,2,0.16
9,5,trial,5,634,2,3,0.2
9,5,tribal,6,635,3,3,0.2
9,5,tribe,5,636,4,1,0.16
9,5,tribute,7,637,4,3,0.28
9,5,trio,4,638,3,1,0.12
9,5,truck,5,639,2,3,0.16
9,5,tune,4,640,1,3,0.16
9,5,twice,5,641,1,4,0.2
9,5,two,3,642,2,1,0.08
9,5,ultimate,8,643,0,8,0.4
9,5,undergo,7,644,1,6,0.28
9,5,underwear,9,645,5,4,0.28
9,5,unfair,6,646,2,4,0.28
9,5,unify,5,647,2,3,0.2
9,5,union,5,648,3,2,0.16
9,5,universe,8,649,3,5,0.28
9,5,until,5,650,2,3,0.16
9,5,unusual,7,651,2,5,0.32
9,5,unveil,6,652,2,4,0.2
9,5,uphold,6,653,1,5,0.24
9,5,urban,5,654,1,4,0.2
9,5,usage,5,655,1,4,0.28
9,5,utility,7,656,1,6,0.28
9,5,utilize,7,657,5,2,0.2
9,5,vague,5,658,0,5,0.28
9,5,validity,8,659,2,6,0.36
9,5,variety,7,660,2,5,0.24
9,5,vary,4,661,3,1,0.12
9,5,venture,7,662,1,6,0.28
9,5,verify,6,663,2,4,0.24
9,5,vessel,6,664,2,4,0.28
9,5,violent,7,665,1,6,0.28
9,5,virtue,6,666,2,4,0.24
9,5,virus,5,667,3,2,0.16
9,5,visitor,7,668,2,5,0.32
9,5,visual,6,669,3,3,0.2
9,5,volunteer,9,670,1,8,0.36
9,5,wait,4,671,0,4,0.2
9,5,waiter,6,672,4,2,0.24
9,5,war,3,673,2,1,0.12
9,5,warning,7,674,3,4,0.24
9,5,way,3,675,2,1,0.08
9,5,wealthy,7,676,1,6,0.28
9,5,weave,5,677,3,2,0.16
9,5,weekend,7,678,2,5,0.32
9,5,weird,5,679,2,3,0.2
9,5,welfare,7,680,2,5,0.24
9,5,west,4,681,2,2,0.16
9,5,which,5,682,1,4,0.28
9,5,whose,5,683,2,3,0.16
9,5,wildlife,8,684,1,7,0.32
9,5,woman,5,685,1,4,0.2
9,5,wonderful,9,686,2,7,0.4
9,5,word,4,687,2,2,0.16
9,5,work,4,688,3,1,0.12
9,5,workforce,9,689,4,5,0.28
9,5,world,5,690,3,2,0.16
9,5,wow,3,691,2,1,0.16
9,5,wrap,4,692,1,3,0.16
9,5,wrist,5,693,2,3,0.16
9,5,written,7,694,3,4,0.24
9,5,young,5,695,0,5,0.24
9,5,youngster,9,696,5,4,0.36
9,6,a,1,0,0,1,0.08
9,6,absorb,6,1,1,5,0.24
9,6,academic,8,2,1,7,0.32
9,6,acre,4,3,2,2,0.12
9,6,activate,8,4,2,6,0.4
9,6,actress,7,5,3,4,0.24
9,6,add,3,6,1,2,0.12
9,6,address,7,7,3,4,0.24
9,6,adj,3,8,2,1,0.08
9,6,admit,5,9,2,3,0.24
9,6,advantage,9,10,2,7,0.32
9,6,aesthetic,9,11,1,8,0.36
9,6,again,5,12,1,4,0.28
9,6,ahead,5,13,1,4,0.2
9,6,alongside,9,14,1,8,0.36
9,6,ambulance,9,15,1,8,0.36
9,6,amendment,9,16,2,7,0.44
9,6,amusing,7,17,2,5,0.28
9,6,analyse,7,18,1,6,0.28
9,6,analysis,8,19,6,2,0.28
9,6,ancient,7,20,2,5,0.28
9,6,and,3,21,2,1,0.08
9,6,anger,5,22,2,3,0.2
9,6,animal,6,23,2,4,0.2
9,6,annoying,8,24,2,6,0.36
9,6,another,7,25,2,5,0.28
9,6,anxiety,7,26,2,5,0.24
9,6,anybody,7,27,2,5,0.28
9,6,apologize,9,28,1,8,0.44
9,6,applaud,7,29,2,5,0.28
9,6,approach,8,30,3,5,0.28
9,6,argue,5,31,1,4,0.28
9,6,arise,5,32,2,3,0.2
9,6,arms,4,33,2,2,0.12
9,6,around,6,34,2,4,0.2
9,6,arrest,6,35,2,4,0.24
9,6,arrow,5,36,3,2,0.24
9,6,artist,6,37,2,4,0.24
9,6,artistic,8,38,6,2,0.2
9,6,assault,7,39,1,6,0.28
9,6,at,2,40,1,1,0.08
9,6,atrocity,8,41,2,6,0.36
9,6,attract,7,42,2,5,0.28
9,6,auto,4,43,1,3,0.16
9,6,baby,4,44,0,4,0.2
9,6,backing,7,45,2,5,0.32
9,6,bacteria,8,46,3,5,0.28
9,6,bat,3,47,2,1,0.08
9,6,beat,4,48,1,3,0.16
9,6,beer,4,49,2,2,0.12
9,6,beg,3,50,2,1,0.08
9,6,behalf,6,51,2,4,0.32
9,6,belief,6,52,2,4,0.2
9,6,bell,4,53,3,1,0.12
9,6,benchmark,9,54,2,7,0.36
9,6,best,4,55,2,2,0.12
9,6,beyond,6,56,2,4,0.28
9,6,bin,3,57,1,2,0.12
9,6,blade,5,58,1,4,0.2
9,6,blank,5,59,3,2,0.16
9,6,bless,5,60,2,3,0.16
9,6,blind,5,61,2,3,0.24
9,6,blow,4,62,2,2,0.12
9,6,boat,4,63,1,3,0.16
9,6,bomb,4,64,2,2,0.16
9,6,boom,4,65,2,2,0.12
9,6,boot,4,66,3,1,0.12
9,6,bother,6,67,2,4,0.28
9,6,boundary,8,68,2,6,0.32
9,6,box,3,69,2,1,0.08
9,6,breach,6,70,1,5,0.28
9,6,breathe,7,71,4,3,0.28
9,6,bright,6,72,2,4,0.2
9,6,broken,6,73,2,4,0.24
9,6,buddy,5,74,1,4,0.2
9,6,buffer,6,75,2,4,0.24
9,6,bug,3,76,2,1,0.16
9,6,build,5,77,2,3,0.16
9,6,burn,4,78,2,2,0.16
9,6,butter,6,79,2,4,0.2
9,6,can,3,80,0,3,0.16
9,6,candidate,9,81,3,6,0.4
9,6,cap,3,82,2,1,0.08
9,6,capable,7,83,3,4,0.24
9,6,careful,7,84,2,5,0.28
9,6,carefully,9,85,7,2,0.24
9,6,cd,2,86,1,1,0.16
9,6,cease,5,87,1,4,0.2
9,6,ceiling,7,88,2,5,0.28
9,6,central,7,89,2,5,0.28
9,6,century,7,90,4,3,0.28
9,6,ceremony,8,91,2,6,0.32
9,6,certain,7,92,3,4,0.28
9,6,chapter,7,93,1,6,0.32
9,6,character,9,94,3,6,0.44
9,6,charity,7,95,4,3,0.2
9,6,charter,7,96,4,3,0.2
9,6,cheat,5,97,2,3,0.16
9,6,check,5,98,3,2,0.24
9,6,cheerful,8,99,3,5,0.28
9,6,chicken,7,100,2,5,0.28
9,6,childhood,9,101,3,6,0.32
9,6,choose,6,102,2,4,0.28
9,6,chop,4,103,3,1,0.12
9,6,chunk,5,104,2,3,0.16
9,6,civil,5,105,1,4,0.2
9,6,clause,6,106,1,5,0.24
9,6,clerk,5,107,2,3,0.24
9,6,clinical,8,108,2,6,0.28
9,6,cloud,5,109,2,3,0.16
9,6,club,4,110,2,2,0.12
9,6,coffee,6,111,1,5,0.24
9,6,colourful,9,112,2,7,0.4
9,6,comedy,6,113,2,4,0.2
9,6,commonly,8,114,3,5,0.28
9,6,company,7,115,3,4,0.32
9,6,compete,7,116,4,3,0.2
9,6,conceive,8,117,2,6,0.32
9,6,concern,7,118,5,2,0.2
9,6,concert,7,119,6,1,0.24
9,6,confer,6,120,3,3,0.2
9,6,connected,9,121,3,6,0.36
9,6,contempt,8,122,3,5,0.48
9,6,contend,7,123,5,2,0.28
9,6,cooker,6,124,2,4,0.24
9,6,cope,4,125,2,2,0.16
9,6,correct,7,126,2,5,0.28
9,6,cottage,7,127,2,5,0.4
9,6,could,5,128,2,3,0.24
9,6,county,6,129,3,3,0.24
9,6,coup,4,130,3,1,0.12
9,6,course,6,131,3,3,0.24
9,6,court,5,132,4,1,0.2
9,6,craft,5,133,1,4,0.2
9,6,create,6,134,2,4,0.28
9,6,creature,8,135,5,3,0.24
9,6,creep,5,136,3,2,0.16
9,6,crime,5,137,2,3,0.28
9,6,crisis,6,138,3,3,0.2
9,6,crowd,5,139,2,3,0.16
9,6,crowded,7,140,5,2,0.2
9,6,crude,5,141,2,3,0.2
9,6,currency,8,142,1,7,0.4
9,6,current,7,143,6,1,0.16
9,6,curved,6,144,3,3,0.24
9,6,damage,6,145,0,6,0.28
9,6,dance,5,146,2,3,0.24
9,6,dare,4,147,2,2,0.12
9,6,deal,4,148,1,3,0.16
9,6,declare,7,149,2,5,0.28
9,6,decrease,8,150,3,5,0.28
9,6,deed,4,151,2,2,0.44
9,6,defect,6,152,2,4,0.56
9,6,defender,8,153,4,4,0.6
9,6,definite,8,154,3,5,0.64
9,6,delight,7,155,2,5,0.76
9,6,delighted,9,156,7,2,0.52
9,6,deposit,7,157,2,5,0.64
9,6,detect,6,158,2,4,0.52
9,6,detention,9,159,4,5,0.84
9,6,develop,7,160,2,5,0.6
9,6,devil,5,161,3,2,0.36
9,6,diagnosis,9,162,1,8,1
9,6,diagram,7,163,4,3,0.48
9,6,dictate,7,164,2,5,0.6
9,6,dictator,8,165,6,2,0.48
9,6,dig,3,166,2,1,0.24
9,6,digital,7,167,3,4,0.68
9,6,dinner,6,168,2,4,0.52
9,6,diplomat,8,169,2,6,0.72
9,6,disabled,8,170,2,6,0.8
9,6,discount,8,171,3,5,0.64
9,6,discovery,9,172,5,4,0.64
9,6,display,7,173,3,4,0.56
9,6,distant,7,174,3,4,0.68
9,6,divine,6,175,2,4,0.52
9,6,divorced,8,176,3,5,0.64
9,6,dollar,6,177,1,5,0.6
9,6,donation,8,178,2,6,0.84
9,6,double,6,179,2,4,0.52
9,6,download,8,180,2,6,0.68
9,6,drama,5,181,1,4,0.48
9,6,drawing,7,182,3,4,0.68
9,6,dust,4,183,1,3,0.36
9,6,ear,3,184,0,3,0.36
9,6,effective,9,185,1,8,0.88
9,6,effort,6,186,3,3,0.44
9,6,eight,5,187,1,4,0.6
9,6,eighty,6,188,5,1,0.36
9,6,either,6,189,2,4,0.52
9,6,eleven,6,190,1,5,0.56
9,6,emergency,9,191,1,8,0.96
9,6,emotion,7,192,2,5,0.6
9,6,empirical,9,193,2,7,0.8
9,6,ending,6,194,1,5,0.68
9,6,enjoy,5,195,2,3,0.4
9,6,enrich,6,196,2,4,0.52
9,6,enter,5,197,2,3,0.4
9,6,entitle,7,198,3,4,0.56
9,6,equipment,9,199,1,8,1
9,6,essay,5,200,1,4,0.48
9,6,establish,9,201,2,7,0.8
9,6,evening,7,202,1,6,0.8
9,6,event,5,203,4,1,0.32
9,6,examine,7,204,1,6,0.68
9,6,exceed,6,205,2,4,0.52
9,6,excellent,9,206,4,5,0.84
9,6,excited,7,207,3,4,0.56
9,6,excuse,6,208,3,3,0.44
9,6,executive,9,209,2,7,0.8
9,6,exit,4,210,2,2,0.32
9,6,expensive,9,211,2,7,0.92
9,6,expire,6,212,3,3,0.48
9,6,explode,7,213,3,4,0.6
9,6,exploit,7,214,5,2,0.64
9,6,extensive,9,215,2,7,0.8
9,6,extent,6,216,5,1,0.36
9,6,fail,4,217,0,4,0.44
9,6,fair,4,218,3,1,0.28
9,6,fairly,6,219,4,2,0.52
9,6,famous,6,220,2,4,0.52
9,6,fantasy,7,221,2,5,0.6
9,6,fast,4,222,2,2,0.32
9,6,fat,3,223,2,1,0.24
9,6,fear,4,224,1,3,0.36
9,6,few,3,225,2,1,0.36
9,6,fight,5,226,1,4,0.48
9,6,file,4,227,2,2,0.32
9,6,finally,7,228,2,5,0.6
9,6,fixed,5,229,2,3,0.4
9,6,flag,4,230,1,3,0.48
9,6,flee,4,231,2,2,0.32
9,6,flexible,8,232,3,5,0.68
9,6,floor,5,233,2,3,0.4
9,6,flower,6,234,3,3,0.44
9,6,flu,3,235,2,1,0.36
9,6,flying,6,236,2,4,0.52
9,6,for,3,237,1,2,0.28
9,6,force,5,238,3,2,0.36
9,6,foreign,7,239,3,4,0.56
9,6,foreigner,9,240,7,2,0.64
9,6,former,6,241,3,3,0.44
9,6,formerly,8,242,6,2,0.48
9,6,formula,7,243,4,3,0.48
9,6,fortune,7,244,3,4,0.64
9,6,forward,7,245,3,4,0.56
9,6,foster,6,246,2,4,0.52
9,6,founder,7,247,2,5,0.64
9,6,fourteen,8,248,3,5,0.76
9,6,fragment,8,249,1,7,0.76
9,6,freedom,7,250,2,5,0.6
9,6,frequent,8,251,3,5,0.64
9,6,fridge,6,252,2,4,0.64
9,6,frog,4,253,2,2,0.32
9,6,front,5,254,3,2,0.36
9,6,fulfil,6,255,1,5,0.6
9,6,funding,7,256,2,5,0.72
9,6,fur,3,257,2,1,0.24
9,6,gallon,6,258,0,6,0.6
9,6,garage,6,259,2,4,0.52
9,6,gender,6,260,1,5,0.56
9,6,gene,4,261,3,1,0.4
9,6,general,7,262,4,3,0.48
9,6,generate,8,263,6,2,0.48
9,6,genetic,7,264,4,3,0.48
9,6,genre,5,265,3,2,0.36
9,6,genuinely,9,266,3,6,0.84
9,6,giant,5,267,1,4,0.64
9,6,give,4,268,2,2,0.44
9,6,glass,5,269,1,4,0.48
9,6,glimpse,7,270,2,5,0.72
9,6,god,3,271,1,2,0.28
9,6,gold,4,272,2,2,0.32
9,6,govern,6,273,2,4,0.52
9,6,governor,8,274,6,2,0.48
9,6,grace,5,275,1,4,0.6
9,6,graphics,8,276,3,5,0.64
9,6,gravity,7,277,3,4,0.56
9,6,greet,5,278,2,3,0.4
9,6,grid,4,279,2,2,0.32
9,6,grind,5,280,3,2,0.48
9,6,ground,6,281,2,4,0.52
9,6,guess,5,282,1,4,0.48
9,6,guidance,8,283,2,6,0.72
9,6,guide,5,284,4,1,0.44
9,6,guy,3,285,2,1,0.24
9,6,gym,3,286,1,2,0.28
9,6,hair,4,287,0,4,0.44
9,6,happen,6,288,2,4,0.52
9,6,harm,4,289,2,2,0.32
9,6,harsh,5,290,3,2,0.48
9,6,harvest,7,291,3,4,0.56
9,6,health,6,292,1,5,0.56
9,6,heart,5,293,3,2,0.36
9,6,heighten,8,294,2,6,0.8
9,6,her,3,295,2,1,0.24
9,6,herb,4,296,3,1,0.28
9,6,highly,6,297,1,5,0.56
9,6,hint,4,298,2,2,0.32
9,6,holiday,7,299,1,6,0.64
9,6,homeland,8,300,2,6,0.8
9,6,horror,6,301,2,4,0.28
9,6,hotel,5,302,2,3,0.2
9,6,household,9,303,2,7,0.36
9,6,how,3,304,2,1,0.16
9,6,humble,6,305,1,5,0.24
9,6,hunger,6,306,2,4,0.2
9,6,hunt,4,307,3,1,0.12
9,6,hurricane,9,308,2,7,0.44
9,6,hydrogen,8,309,1,7,0.32
9,6,ice,3,310,0,3,0.16
9,6,ideal,5,311,1,4,0.2
9,6,identical,9,312,3,6,0.4
9,6,identity,8,313,6,2,0.2
9,6,illegal,7,314,1,6,0.28
9,6,image,5,315,1,4,0.2
9,6,imagery,7,316,5,2,0.2
9,6,import,6,317,2,4,0.28
9,6,important,9,318,6,3,0.24
9,6,incur,5,319,1,4,0.2
9,6,index,5,320,2,3,0.16
9,6,inform,6,321,2,4,0.28
9,6,inherent,8,322,2,6,0.32
9,6,initiate,8,323,2,6,0.32
9,6,inject,6,324,2,4,0.24
9,6,injure,6,325,3,3,0.28
9,6,insert,6,326,2,4,0.24
9,6,insertion,9,327,6,3,0.24
9,6,insurance,9,328,3,6,0.4
9,6,intended,8,329,2,6,0.32
9,6,intense,7,330,5,2,0.2
9,6,involve,7,331,2,5,0.24
9,6,involved,8,332,7,1,0.24
9,6,isolated,8,333,1,7,0.32
9,6,jet,3,334,0,3,0.16
9,6,joy,3,335,1,2,0.12
9,6,keyboard,8,336,0,8,0.36
9,6,kick,4,337,1,3,0.24
9,6,kid,3,338,2,1,0.08
9,6,king,4,339,2,2,0.12
9,6,kingdom,7,340,4,3,0.2
9,6,knife,5,341,1,4,0.2
9,6,lake,4,342,0,4,0.2
9,6,landmark,8,343,2,6,0.36
9,6,latest,6,344,2,4,0.24
9,6,laugh,5,345,2,3,0.16
9,6,law,3,346,2,1,0.08
9,6,lawn,4,347,3,1,0.12
9,6,leaf,4,348,1,3,0.24
9,6,learning,8,349,3,5,0.28
9,6,legendary,9,350,2,7,0.32
9,6,lens,4,351,2,2,0.12
9,6,lesser,6,352,2,4,0.28
9,6,lethal,6,353,2,4,0.24
9,6,letter,6,354,3,3,0.2
9,6,licence,7,355,1,6,0.28
9,6,lie,3,356,2,1,0.08
9,6,literary,8,357,2,6,0.36
9,6,litter,6,358,3,3,0.2
9,6,little,6,359,4,2,0.16
9,6,live,4,360,2,2,0.12
9,6,liver,5,361,4,1,0.2
9,6,local,5,362,1,4,0.2
9,6,located,7,363,4,3,0.2
9,6,log,3,364,2,1,0.12
9,6,lonely,6,365,2,4,0.2
9,6,long,4,366,3,1,0.12
9,6,look,4,367,2,2,0.2
9,6,lot,3,368,2,1,0.08
9,6,loudly,6,369,2,4,0.24
9,6,machinery,9,370,0,9,0.4
9,6,mandate,7,371,2,5,0.36
9,6,mandatory,9,372,6,3,0.24
9,6,map,3,373,2,1,0.08
9,6,marine,6,374,2,4,0.24
9,6,married,7,375,3,4,0.24
9,6,mask,4,376,2,2,0.2
9,6,match,5,377,2,3,0.2
9,6,maximum,7,378,2,5,0.28
9,6,meanwhile,9,379,1,8,0.44
9,6,media,5,380,2,3,0.28
9,6,melody,6,381,2,4,0.2
9,6,mention,7,382,2,5,0.28
9,6,mentor,6,383,4,2,0.16
9,6,merely,6,384,2,4,0.32
9,6,mess,4,385,2,2,0.16
9,6,minister,8,386,1,7,0.32
9,6,ministry,8,387,6,2,0.2
9,6,mobilize,8,388,1,7,0.4
9,6,modify,6,389,2,4,0.24
9,6,month,5,390,2,3,0.2
9,6,monthly,7,391,5,2,0.2
9,6,monument,8,392,3,5,0.36
9,6,more,4,393,2,2,0.16
9,6,most,4,394,2,2,0.12
9,6,movie,5,395,2,3,0.16
9,6,much,4,396,1,3,0.16
9,6,multiple,8,397,2,6,0.32
9,6,mum,3,398,2,1,0.16
9,6,municipal,9,399,2,7,0.36
9,6,musician,8,400,2,6,0.32
9,6,my,2,401,1,1,0.08
9,6,naked,5,402,0,5,0.32
9,6,name,4,403,2,2,0.12
9,6,narrative,9,404,2,7,0.32
9,6,nasty,5,405,2,3,0.16
9,6,necessary,9,406,1,8,0.44
9,6,negative,8,407,2,6,0.32
9,6,newly,5,408,2,3,0.2
9,6,newspaper,9,409,3,6,0.32
9,6,night,5,410,1,4,0.28
9,6,normal,6,411,1,5,0.24
9,6,not,3,412,2,1,0.08
9,6,note,4,413,3,1,0.12
9,6,nothing,7,414,3,4,0.24
9,6,notion,6,415,3,3,0.28
9,6,novel,5,416,2,3,0.2
9,6,numerous,8,417,1,7,0.32
9,6,nut,3,418,2,1,0.08
9,6,obsess,6,419,0,6,0.28
9,6,offence,7,420,1,6,0.36
9,6,offensive,9,421,5,4,0.28
9,6,offspring,9,422,3,6,0.32
9,6,once,4,423,1,3,0.16
9,6,one,3,424,2,1,0.16
9,6,online,6,425,2,4,0.24
9,6,option,6,426,1,5,0.24
9,6,organic,7,427,1,6,0.28
9,6,otherwise,9,428,1,8,0.44
9,6,outbreak,8,429,1,7,0.32
9,6,outdoor,7,430,3,4,0.24
9,6,outlet,6,431,3,3,0.2
9,6,pack,4,432,0,4,0.28
9,6,pad,3,433,2,1,0.08
9,6,page,4,434,2,2,0.12
9,6,painful,7,435,2,5,0.28
9,6,parade,6,436,2,4,0.2
9,6,park,4,437,3,1,0.2
9,6,passport,8,438,2,6,0.32
9,6,password,8,439,4,4,0.24
9,6,patience,8,440,2,6,0.32
9,6,patron,6,441,3,3,0.28
9,6,peace,5,442,1,4,0.2
9,6,perceive,8,443,2,6,0.32
9,6,phone,5,444,1,4,0.2
9,6,pick,4,445,1,3,0.16
9,6,piece,5,446,2,3,0.28
9,6,pig,3,447,2,1,0.08
9,6,pipe,4,448,2,2,0.12
9,6,plant,5,449,1,4,0.2
9,6,plastic,7,450,3,4,0.24
9,6,play,4,451,3,1,0.2
9,6,plead,5,452,2,3,0.2
9,6,plot,4,453,2,2,0.12
9,6,police,6,454,1,5,0.24
9,6,pollution,9,455,3,6,0.32
9,6,pond,4,456,2,2,0.2
9,6,position,8,457,2,6,0.32
9,6,possess,7,458,3,4,0.24
9,6,post,4,459,3,1,0.12
9,6,pot,3,460,2,1,0.08
9,6,praise,6,461,1,5,0.32
9,6,prayer,6,462,3,3,0.2
9,6,predict,7,463,2,5,0.24
9,6,pregnant,8,464,3,5,0.28
9,6,premise,7,465,3,4,0.32
9,6,prescribe,9,466,3,6,0.32
9,6,presently,9,467,4,5,0.28
9,6,principle,9,468,2,7,0.44
9,6,printer,7,469,4,3,0.24
9,6,printing,8,470,5,3,0.24
9,6,prior,5,471,3,2,0.16
9,6,priority,8,472,5,3,0.32
9,6,procedure,9,473,2,7,0.32
9,6,process,7,474,5,2,0.2
9,6,processor,9,475,7,2,0.24
9,6,profile,7,476,3,4,0.32
9,6,program,7,477,3,4,0.24
9,6,project,7,478,3,4,0.24
9,6,prominent,9,479,3,6,0.4
9,6,proposal,8,480,3,5,0.28
9,6,propose,7,481,6,1,0.16
9,6,prosecute,9,482,3,6,0.32
9,6,protest,7,483,3,4,0.32
9,6,protester,9,484,7,2,0.24
9,6,publicity,9,485,1,8,0.36
9,6,punk,4,486,2,2,0.12
9,6,pupil,5,487,2,3,0.28
9,6,pure,4,488,2,2,0.16
9,6,purpose,7,489,3,4,0.24
9,6,put,3,490,2,1,0.12
9,6,quality,7,491,0,7,0.32
9,6,quantity,8,492,3,5,0.36
9,6,quite,5,493,2,3,0.16
9,6,radar,5,494,0,5,0.24
9,6,radiation,9,495,3,6,0.32
9,6,raise,5,496,2,3,0.28
9,6,rather,6,497,2,4,0.24
9,6,rating,6,498,3,3,0.2
9,6,rational,8,499,4,4,0.28
9,6,rear,4,500,1,3,0.16
9,6,reasoning,9,501,3,6,0.4
9,6,recall,6,502,2,4,0.24
9,6,record,6,503,3,3,0.2
9,6,recruit,7,504,3,4,0.32
9,6,reduction,9,505,2,7,0.36
9,6,referee,7,506,2,5,0.28
9,6,reference,9,507,6,3,0.24
9,6,refuse,6,508,3,3,0.28
9,6,rejection,9,509,2,7,0.36
9,6,relaxed,7,510,2,5,0.28
9,6,relief,6,511,3,3,0.2
9,6,religious,9,512,4,5,0.4
9,6,removal,7,513,2,5,0.28
9,6,remove,6,514,5,1,0.16
9,6,replace,7,515,2,5,0.28
9,6,republic,8,516,3,5,0.36
9,6,resolve,7,517,2,5,0.28
9,6,retail,6,518,2,4,0.2
9,6,retrieve,8,519,3,5,0.36
9,6,reveal,6,520,2,4,0.24
9,6,revenge,7,521,4,3,0.2
9,6,revision,8,522,3,5,0.28
9,6,right,5,523,1,4,0.2
9,6,rip,3,524,2,1,0.2
9,6,ritual,6,525,2,4,0.2
9,6,rival,5,526,2,3,0.2
9,6,roll,4,527,1,3,0.16
9,6,roof,4,528,2,2,0.12
9,6,root,4,529,3,1,0.12
9,6,round,5,530,2,3,0.24
9,6,routine,7,531,3,4,0.24
9,6,rubbish,7,532,1,6,0.28
9,6,safe,4,533,0,4,0.2
9,6,sale,4,534,2,2,0.24
9,6,sample,6,535,2,4,0.2
9,6,sand,4,536,2,2,0.16
9,6,satellite,9,537,2,7,0.32
9,6,satisfied,9,538,3,6,0.72
9,6,satisfy,7,539,6,1,0.16
9,6,scared,6,540,1,5,0.24
9,6,schedule,8,541,2,6,0.28
9,6,scheme,6,542,4,2,0.28
9,6,scholar,7,543,3,4,0.24
9,6,school,6,544,4,2,0.16
9,6,security,8,545,1,7,0.32
9,6,seem,4,546,2,2,0.12
9,6,seminar,7,547,2,5,0.36
9,6,sensible,8,548,2,6,0.28
9,6,seriously,9,549,2,7,0.36
9,6,servant,7,550,3,4,0.32
9,6,serve,5,551,4,1,0.12
9,6,settler,7,552,2,5,0.28
9,6,seven,5,553,2,3,0.2
9,6,sexy,4,554,2,2,0.12
9,6,share,5,555,1,4,0.28
9,6,shell,5,556,2,3,0.16
9,6,shift,5,557,2,3,0.2
9,6,shiny,5,558,3,2,0.16
9,6,shoot,5,559,2,3,0.2
9,6,shore,5,560,3,2,0.24
9,6,shortage,8,561,4,4,0.28
9,6,sibling,7,562,1,6,0.28
9,6,signature,9,563,2,7,0.32
9,6,similarly,9,564,2,7,0.44
9,6,simply,6,565,3,3,0.2
9,6,sin,3,566,2,1,0.08
9,6,sink,4,567,3,1,0.12
9,6,situated,8,568,2,6,0.36
9,6,six,3,569,2,1,0.12
9,6,ski,3,570,1,2,0.12
9,6,skip,4,571,3,1,0.12
9,6,skirt,5,572,3,2,0.16
9,6,skull,5,573,2,3,0.2
9,6,slip,4,574,1,3,0.16
9,6,soap,4,575,1,3,0.24
9,6,solar,5,576,2,3,0.16
9,6,sometimes,9,577,2,7,0.36
9,6,south,5,578,2,3,0.16
9,6,spare,5,579,1,4,0.28
9,6,speaker,7,580,2,5,0.28
9,6,specify,7,581,3,4,0.24
9,6,spectator,9,582,4,5,0.28
9,6,spin,4,583,2,2,0.2
9,6,spotlight,9,584,2,7,0.32
9,6,stab,4,585,1,3,0.16
9,6,stable,6,586,4,2,0.16
9,6,stall,5,587,3,2,0.16
9,6,stamp,5,588,3,2,0.24
9,6,stand,5,589,3,2,0.16
9,6,steadily,8,590,2,6,0.32
9,6,steer,5,591,3,2,0.16
9,6,stick,5,592,2,3,0.16
9,6,sticky,6,593,5,1,0.24
9,6,stop,4,594,2,2,0.12
9,6,story,5,595,3,2,0.16
9,6,strange,7,596,2,5,0.28
9,6,strategy,8,597,4,4,0.32
9,6,street,6,598,3,3,0.2
9,6,striking,8,599,3,5,0.28
9,6,string,6,600,4,2,0.16
9,6,strong,6,601,3,3,0.2
9,6,studio,6,602,2,4,0.32
9,6,stumble,7,603,3,4,0.24
9,6,subject,7,604,1,6,0.28
9,6,sudden,6,605,2,4,0.2
9,6,sugar,5,606,2,3,0.28
9,6,super,5,607,2,3,0.16
9,6,survival,8,608,2,6,0.28
9,6,swear,5,609,1,4,0.2
9,6,symptom,7,610,1,6,0.36
9,6,tactical,8,611,0,8,0.36
9,6,talent,6,612,2,4,0.2
9,6,talk,4,613,3,1,0.12
9,6,tank,4,614,2,2,0.12
9,6,tape,4,615,2,2,0.24
9,6,taste,5,616,2,3,0.16
9,6,team,4,617,1,3,0.16
9,6,tender,6,618,2,4,0.24
9,6,tension,7,619,3,4,0.24
9,6,terrific,8,620,2,6,0.8
9,6,terrify,7,621,6,1,0.56
9,6,terror,6,622,4,2,0.68
9,6,terrorism,9,623,6,3,0.84
9,6,thereby,7,624,1,6,1.16
9,6,thesis,6,625,3,3,0.4
9,6,thirsty,7,626,2,5,1.2
9,6,thumb,5,627,2,3,0.6
9,6,tighten,7,628,1,6,0.96
9,6,too,3,629,1,2,0.48
9,6,topic,5,630,2,3,0.48
9,6,torture,7,631,2,5,0.72
9,6,tour,4,632,2,2,0.36
9,6,trademark,9,633,1,8,1.08
9,6,tragic,6,634,3,3,0.48
9,6,trainer,7,635,3,4,0.6
9,6,treat,5,636,2,3,0.48
9,6,treaty,6,637,5,1,0.36
9,6,tree,4,638,3,1,0.44
9,6,trend,5,639,3,2,0.4
9,6,tribe,5,640,2,3,0.44
9,6,twice,5,641,1,4,0.48
9,6,two,3,642,2,1,0.24
9,6,undermine,9,643,0,9,1.04
9,6,union,5,644,2,3,0.44
9,6,unique,6,645,3,3,0.44
9,6,universal,9,646,3,6,0.72
9,6,universe,8,647,7,1,0.52
9,6,unveil,6,648,2,4,0.64
9,6,upgrade,7,649,1,6,0.8
9,6,upon,4,650,2,2,0.4
9,6,urban,5,651,1,4,0.56
9,6,usage,5,652,1,4,0.6
9,6,usual,5,653,2,3,0.44
9,6,utility,7,654,1,6,0.72
9,6,vague,5,655,0,5,0.56
9,6,valley,6,656,2,4,0.64
9,6,valuable,8,657,3,5,0.64
9,6,variety,7,658,2,5,0.64
9,6,vegetable,9,659,1,8,0.88
9,6,vein,4,660,2,2,0.44
9,6,viable,6,661,1,5,0.56
9,6,villager,8,662,2,6,0.72
9,6,visual,6,663,2,4,0.52
9,6,vocal,5,664,1,4,0.6
9,6,volunteer,9,665,2,7,0.8
9,6,wait,4,666,0,4,0.52
9,6,waiter,6,667,4,2,0.52
9,6,wake,4,668,2,2,0.36
9,6,warrior,7,669,2,5,0.76
9,6,water,5,670,2,3,0.44
9,6,way,3,671,2,1,0.24
9,6,weakness,8,672,1,7,0.8
9,6,wealthy,7,673,3,4,0.64
9,6,weave,5,674,3,2,0.4
9,6,weekend,7,675,2,5,0.6
9,6,weird,5,676,2,3,0.44
9,6,welfare,7,677,2,5,0.6
9,6,whatever,8,678,1,7,0.84
9,6,whenever,8,679,2,6,0.72
9,6,whose,5,680,2,3,0.44
9,6,wildlife,8,681,1,7,0.88
9,6,wind,4,682,2,2,0.32
9,6,window,6,683,4,2,0.4
9,6,wipe,4,684,2,2,0.36
9,6,wisdom,6,685,2,4,0.64
9,6,within,6,686,2,4,0.72
9,6,woman,5,687,1,4,0.48
9,6,wonderful,9,688,2,7,0.8
9,6,work,4,689,2,2,0.4
9,6,workforce,9,690,4,5,0.84
9,6,world,5,691,3,2,0.48
9,6,worry,5,692,3,2,0.4
9,6,wow,3,693,2,1,0.24
9,6,wrist,5,694,1,4,0.64
9,6,young,5,695,0,5,0.56
9,6,youngster,9,696,5,4,0.84
9,7,a,1,0,0,1,0.16
9,7,absorb,6,1,1,5,0.56
9,7,accept,6,2,1,5,0.56
9,7,accompany,9,3,3,6,0.92
9,7,accurate,8,4,3,5,0.64
9,7,acid,4,5,2,2,0.36
9,7,activate,8,6,2,6,0.84
9,7,ad,2,7,1,1,0.24
9,7,adj,3,8,2,1,0.32
9,7,adoption,8,9,2,6,0.68
9,7,advantage,9,10,2,7,0.8
9,7,aesthetic,9,11,1,8,0.84
9,7,again,5,12,1,4,0.6
9,7,aids,4,13,1,3,0.36
9,7,align,5,14,1,4,0.48
9,7,ally,4,15,2,2,0.32
9,7,amateur,7,16,1,6,0.68
9,7,amendment,9,17,2,7,0.92
9,7,amusing,7,18,2,5,0.6
9,7,ankle,5,19,1,4,0.48
9,7,annoyed,7,20,2,5,0.72
9,7,annoying,8,21,5,3,0.56
9,7,anybody,7,22,2,5,0.6
9,7,apologize,9,23,1,8,0.84
9,7,apology,7,24,6,1,0.48
9,7,app,3,25,2,1,0.24
9,7,applaud,7,26,3,4,0.56
9,7,approach,8,27,3,5,0.64
9,7,argue,5,28,1,4,0.56
9,7,army,4,29,2,2,0.32
9,7,around,6,30,2,4,0.52
9,7,arrest,6,31,2,4,0.6
9,7,artist,6,32,2,4,0.52
9,7,ask,3,33,1,2,0.28
9,7,associate,9,34,2,7,0.88
9,7,assurance,9,35,3,6,0.72
9,7,atrocity,8,36,1,7,0.76
9,7,attract,7,37,2,5,0.72
9,7,automatic,9,38,1,8,0.84
9,7,average,7,39,1,6,0.64
9,7,backing,7,40,0,7,0.84
9,7,ballet,6,41,2,4,0.52
9,7,banner,6,42,2,4,0.52
9,7,base,4,43,2,2,0.32
9,7,bat,3,44,2,1,0.24
9,7,bay,3,45,2,1,0.24
9,7,beauty,6,46,1,5,0.68
9,7,bed,3,47,2,1,0.24
9,7,beg,3,48,2,1,0.24
9,7,behalf,6,49,2,4,0.52
9,7,behave,6,50,4,2,0.44
9,7,belong,6,51,2,4,0.84
9,7,benchmark,9,52,2,7,0.84
9,7,betray,6,53,2,4,0.52
9,7,beyond,6,54,2,4,0.52
9,7,bill,4,55,1,3,0.52
9,7,bin,3,56,2,1,0.24
9,7,birthday,8,57,2,6,0.76
9,7,blade,5,58,1,4,0.48
9,7,blank,5,59,3,2,0.36
9,7,blind,5,60,2,3,0.56
9,7,boat,4,61,1,3,0.4
9,7,bomb,4,62,2,2,0.36
9,7,boom,4,63,2,2,0.4
9,7,bother,6,64,2,4,0.52
9,7,bound,5,65,2,3,0.44
9,7,box,3,66,2,1,0.32
9,7,boyfriend,9,67,2,7,0.96
9,7,brand,5,68,1,4,0.48
9,7,breach,6,69,2,4,0.52
9,7,breakdown,9,70,4,5,0.84
9,7,breathe,7,71,4,3,0.48
9,7,bright,6,72,2,4,0.52
9,7,buddy,5,73,1,4,0.48
9,7,bug,3,74,2,1,0.24
9,7,bunch,5,75,2,3,0.56
9,7,butter,6,76,2,4,0.52
9,7,cafe,4,77,0,4,0.44
9,7,cancer,6,78,2,4,0.52
9,7,cap,3,79,2,1,0.24
9,7,capable,7,80,3,4,0.64
9,7,carefully,9,81,2,7,0.8
9,7,cartoon,7,82,3,4,0.56
9,7,cave,4,83,2,2,0.32
9,7,cd,2,84,1,1,0.2
9,7,celebrity,9,85,1,8,0.96
9,7,ceremony,8,86,2,6,0.72
9,7,certainty,9,87,3,6,0.72
9,7,character,9,88,1,8,0.96
9,7,charity,7,89,4,3,0.52
9,7,charm,5,90,4,1,0.32
9,7,charter,7,91,4,3,0.52
9,7,cheerful,8,92,2,6,0.84
9,7,chemical,8,93,3,5,0.64
9,7,chicken,7,94,2,5,0.6
9,7,childhood,9,95,3,6,0.84
9,7,choose,6,96,2,4,0.52
9,7,chop,4,97,3,1,0.28
9,7,circuit,7,98,1,6,0.68
9,7,clarity,7,99,1,6,0.64
9,7,clean,5,100,2,3,0.52
9,7,clearly,7,101,4,3,0.48
9,7,clerk,5,102,3,2,0.36
9,7,closely,7,103,2,5,0.6
9,7,coach,5,104,1,4,0.56
9,7,coffee,6,105,2,4,0.52
9,7,colony,6,106,2,4,0.52
9,7,comedy,6,107,2,4,0.56
9,7,comfort,7,108,3,4,0.6
9,7,commodity,9,109,3,6,0.88
9,7,company,7,110,3,4,0.56
9,7,component,9,111,4,5,0.68
9,7,concern,7,112,2,5,0.72
9,7,conduct,7,113,3,4,0.56
9,7,confess,7,114,3,4,0.6
9,7,confused,8,115,4,4,0.6
9,7,consent,7,116,3,4,0.64
9,7,consult,7,117,4,3,0.48
9,7,contend,7,118,3,4,0.56
9,7,contrast,8,119,4,4,0.6
9,7,convey,6,120,3,3,0.56
9,7,cope,4,121,2,2,0.32
9,7,correct,7,122,2,5,0.6
9,7,cost,4,123,2,2,0.32
9,7,cottage,7,124,2,5,0.68
9,7,county,6,125,2,4,0.52
9,7,coup,4,126,3,1,0.28
9,7,couple,6,127,4,2,0.4
9,7,court,5,128,3,2,0.36
9,7,creature,8,129,1,7,0.96
9,7,credible,8,130,3,5,0.64
9,7,creep,5,131,3,2,0.36
9,7,crime,5,132,2,3,0.4
9,7,criminal,8,133,4,4,0.68
9,7,cross,5,134,2,3,0.4
9,7,crowded,7,135,3,4,0.52
9,7,crucial,7,136,2,5,0.32
9,7,crude,5,137,3,2,0.16
9,7,cruel,5,138,3,2,0.24
9,7,cruise,6,139,3,3,0.2
9,7,cultivate,9,140,1,8,0.36
9,7,current,7,141,2,5,0.28
9,7,cycle,5,142,1,4,0.28
9,7,dance,5,143,0,5,0.24
9,7,day,3,144,2,1,0.12
9,7,death,5,145,1,4,0.2
9,7,december,8,146,2,6,0.32
9,7,decline,7,147,3,4,0.32
9,7,decrease,8,148,3,5,0.28
9,7,definite,8,149,2,6,0.28
9,7,deliver,7,150,2,5,0.32
9,7,democracy,9,151,2,7,0.32
9,7,demon,5,152,4,1,0.12
9,7,dentist,7,153,2,5,0.24
9,7,departure,9,154,2,7,0.4
9,7,deposit,7,155,3,4,0.24
9,7,deputy,6,156,3,3,0.2
9,7,despite,7,157,2,5,0.28
9,7,detect,6,158,2,4,0.28
9,7,develop,7,159,2,5,0.28
9,7,devil,5,160,3,2,0.16
9,7,dictate,7,161,1,6,0.28
9,7,digital,7,162,2,5,0.32
9,7,diplomat,8,163,2,6,0.28
9,7,dirty,5,164,2,3,0.2
9,7,disabled,8,165,2,6,0.28
9,7,discovery,9,166,3,6,0.4
9,7,discuss,7,167,4,3,0.2
9,7,display,7,168,3,4,0.24
9,7,dollar,6,169,1,5,0.24
9,7,dominant,8,170,2,6,0.36
9,7,donation,8,171,2,6,0.28
9,7,drama,5,172,1,4,0.2
9,7,drawing,7,173,3,4,0.24
9,7,duration,8,174,1,7,0.4
9,7,dust,4,175,2,2,0.12
9,7,ear,3,176,0,3,0.16
9,7,earnings,8,177,3,5,0.28
9,7,edition,7,178,1,6,0.36
9,7,editor,6,179,4,2,0.16
9,7,effective,9,180,1,8,0.36
9,7,effort,6,181,3,3,0.2
9,7,eight,5,182,1,4,0.28
9,7,eighty,6,183,5,1,0.16
9,7,either,6,184,2,4,0.2
9,7,embark,6,185,1,5,0.24
9,7,embody,6,186,3,3,0.2
9,7,emergence,9,187,2,7,0.4
9,7,emission,8,188,2,6,0.28
9,7,empirical,9,189,2,7,0.32
9,7,employer,8,190,3,5,0.36
9,7,engineer,8,191,1,7,0.32
9,7,entitle,7,192,2,5,0.24
9,7,entrance,8,193,3,5,0.36
9,7,erect,5,194,1,4,0.2
9,7,essay,5,195,1,4,0.2
9,7,essence,7,196,3,4,0.24
9,7,evening,7,197,1,6,0.32
9,7,event,5,198,4,1,0.2
9,7,evidence,8,199,2,6,0.28
9,7,evoke,5,200,2,3,0.16
9,7,exact,5,201,1,4,0.2
9,7,examine,7,202,3,4,0.32
9,7,exceed,6,203,2,4,0.2
9,7,excellent,9,204,4,5,0.28
9,7,exclusive,9,205,3,6,0.32
9,7,execution,9,206,2,7,0.4
9,7,existence,9,207,2,7,0.32
9,7,expensive,9,208,2,7,0.36
9,7,expire,6,209,3,3,0.28
9,7,explain,7,210,3,4,0.24
9,7,exploit,7,211,4,3,0.2
9,7,explosive,9,212,5,4,0.28
9,7,extent,6,213,2,4,0.28
9,7,extremist,9,214,3,6,0.32
9,7,eye,3,215,1,2,0.12
9,7,faculty,7,216,0,7,0.32
9,7,fail,4,217,2,2,0.2
9,7,failure,7,218,4,3,0.24
9,7,fair,4,219,3,1,0.12
9,7,fast,4,220,2,2,0.16
9,7,fasten,6,221,4,2,0.16
9,7,fat,3,222,2,1,0.08
9,7,fear,4,223,1,3,0.24
9,7,fee,3,224,2,1,0.12
9,7,feeding,7,225,3,4,0.24
9,7,fiction,7,226,1,6,0.28
9,7,fight,5,227,2,3,0.2
9,7,finally,7,228,2,5,0.32
9,7,financial,9,229,4,5,0.28
9,7,firm,4,230,2,2,0.12
9,7,fix,3,231,2,1,0.08
9,7,flat,4,232,1,3,0.16
9,7,flavour,7,233,3,4,0.32
9,7,flee,4,234,2,2,0.12
9,7,flexible,8,235,3,5,0.28
9,7,floor,5,236,2,3,0.2
9,7,flower,6,237,3,3,0.28
9,7,flu,3,238,2,1,0.08
9,7,focus,5,239,1,4,0.2
9,7,food,4,240,2,2,0.12
9,7,for,3,241,2,1,0.08
9,7,foreign,7,242,3,4,0.24
9,7,formerly,8,243,3,5,0.36
9,7,fortune,7,244,3,4,0.24
9,7,forward,7,245,3,4,0.24
9,7,foster,6,246,2,4,0.24
9,7,fragment,8,247,1,7,0.4
9,7,freedom,7,248,2,5,0.28
9,7,friday,6,249,2,4,0.2
9,7,fridge,6,250,4,2,0.16
9,7,friendly,8,251,3,5,0.4
9,7,frighten,8,252,3,5,0.36
9,7,full,4,253,1,3,0.16
9,7,funding,7,254,2,5,0.24
9,7,game,4,255,0,4,0.24
9,7,gaming,6,256,3,3,0.2
9,7,garage,6,257,2,4,0.24
9,7,generally,9,258,1,8,0.4
9,7,genetic,7,259,4,3,0.28
9,7,genre,5,260,3,2,0.16
9,7,god,3,261,1,2,0.12
9,7,gold,4,262,2,2,0.16
9,7,good,4,263,2,2,0.16
9,7,govern,6,264,2,4,0.28
9,7,governor,8,265,6,2,0.2
9,7,grace,5,266,1,4,0.2
9,7,grade,5,267,3,2,0.16
9,7,graphics,8,268,3,5,0.28
9,7,gravity,7,269,3,4,0.28
9,7,greet,5,270,2,3,0.2
9,7,grey,4,271,3,1,0.12
9,7,grid,4,272,2,2,0.12
9,7,grief,5,273,3,2,0.16
9,7,growth,6,274,2,4,0.28
9,7,guess,5,275,1,4,0.2
9,7,guest,5,276,4,1,0.12
9,7,guidance,8,277,2,6,0.32
9,7,guide,5,278,4,1,0.12
9,7,guy,3,279,2,1,0.16
9,7,gym,3,280,1,2,0.12
9,7,harm,4,281,0,4,0.2
9,7,hat,3,282,2,1,0.08
9,7,headline,8,283,1,7,0.32
9,7,her,3,284,2,1,0.08
9,7,hesitate,8,285,2,6,0.36
9,7,hint,4,286,1,3,0.16
9,7,holiday,7,287,1,6,0.28
9,7,homeland,8,288,2,6,0.32
9,7,honesty,7,289,2,5,0.32
9,7,horrible,8,290,2,6,0.28
9,7,hour,4,291,2,2,0.12
9,7,however,7,292,2,5,0.24
9,7,humanity,8,293,1,7,0.4
9,7,humble,6,294,3,3,0.2
9,7,hunger,6,295,2,4,0.2
9,7,hunt,4,296,3,1,0.12
9,7,hurricane,9,297,2,7,0.4
9,7,hydrogen,8,298,1,7,0.32
9,7,i,1,299,0,1,0.08
9,7,ideal,5,300,1,4,0.2
9,7,identical,9,301,3,6,0.4
9,7,identity,8,302,6,2,0.2
9,7,image,5,303,1,4,0.2
9,7,imagery,7,304,5,2,0.2
9,7,imaginary,9,305,4,5,0.36
9,7,impatient,9,306,2,7,0.36
9,7,implement,9,307,3,6,0.32
9,7,import,6,308,3,3,0.2
9,7,indirect,8,309,1,7,0.4
9,7,infant,6,310,2,4,0.24
9,7,influence,9,311,3,6,0.32
9,7,informal,8,312,3,5,0.36
9,7,initiate,8,313,2,6,0.28
9,7,injure,6,314,2,4,0.2
9,7,instruct,8,315,2,6,0.32
9,7,integral,8,316,2,6,0.36
9,7,interior,8,317,4,4,0.28
9,7,into,4,318,3,1,0.12
9,7,invade,6,319,2,4,0.24
9,7,invest,6,320,3,3,0.28
9,7,involve,7,321,3,4,0.24
9,7,island,6,322,1,5,0.24
9,7,jet,3,323,0,3,0.16
9,7,jewellery,9,324,2,7,0.36
9,7,jump,4,325,1,3,0.24
9,7,just,4,326,2,2,0.12
9,7,justify,7,327,4,3,0.2
9,7,key,3,328,0,3,0.16
9,7,keyboard,8,329,3,5,0.28
9,7,kick,4,330,1,3,0.24
9,7,kid,3,331,2,1,0.08
9,7,kidney,6,332,3,3,0.2
9,7,kingdom,7,333,2,5,0.28
9,7,know,4,334,1,3,0.16
9,7,lad,3,335,0,3,0.2
9,7,lake,4,336,2,2,0.16
9,7,lap,3,337,2,1,0.08
9,7,laser,5,338,2,3,0.16
9,7,last,4,339,3,1,0.12
9,7,latest,6,340,2,4,0.24
9,7,law,3,341,2,1,0.16
9,7,layer,5,342,2,3,0.2
9,7,left,4,343,1,3,0.16
9,7,legendary,9,344,2,7,0.36
9,7,lens,4,345,2,2,0.16
9,7,lesbian,7,346,2,5,0.32
9,7,lesser,6,347,3,3,0.2
9,7,letter,6,348,2,4,0.2
9,7,license,7,349,1,6,0.28
9,7,limited,7,350,2,5,0.36
9,7,link,4,351,2,2,0.12
9,7,litter,6,352,2,4,0.24
9,7,little,6,353,4,2,0.16
9,7,live,4,354,2,2,0.16
9,7,liver,5,355,4,1,0.2
9,7,located,7,356,1,6,0.28
9,7,log,3,357,2,1,0.08
9,7,lonely,6,358,2,4,0.2
9,7,long,4,359,3,1,0.12
9,7,love,4,360,2,2,0.12
9,7,low,3,361,2,1,0.16
9,7,lunch,5,362,1,4,0.2
9,7,machinery,9,363,0,9,0.4
9,7,mail,4,364,2,2,0.16
9,7,mainland,8,365,3,5,0.36
9,7,mandatory,9,366,2,7,0.32
9,7,marine,6,367,2,4,0.24
9,7,mark,4,368,3,1,0.12
9,7,mask,4,369,2,2,0.16
9,7,master,6,370,3,3,0.28
9,7,match,5,371,2,3,0.2
9,7,meal,4,372,1,3,0.16
9,7,mean,4,373,3,1,0.12
9,7,media,5,374,2,3,0.2
9,7,meeting,7,375,2,5,0.32
9,7,mental,6,376,2,4,0.2
9,7,mention,7,377,4,3,0.2
9,7,merger,6,378,2,4,0.2
9,7,method,6,379,2,4,0.28
9,7,midnight,8,380,1,7,0.32
9,7,mind,4,381,2,2,0.12
9,7,ministry,8,382,3,5,0.28
9,7,mixed,5,383,2,3,0.16
9,7,model,5,384,1,4,0.28
9,7,moment,6,385,2,4,0.2
9,7,monthly,7,386,2,5,0.24
9,7,monument,8,387,3,5,0.28
9,7,mouth,5,388,2,3,0.24
9,7,much,4,389,1,3,0.16
9,7,multiple,8,390,2,6,0.28
9,7,mum,3,391,2,1,0.08
9,7,municipal,9,392,2,7,0.4
9,7,music,5,393,2,3,0.16
9,7,musician,8,394,5,3,0.24
9,7,must,4,395,3,1,0.12
9,7,my,2,396,1,1,0.08
9,7,nasty,5,397,0,5,0.24
9,7,necessary,9,398,1,8,0.44
9,7,neck,4,399,3,1,0.12
9,7,needle,6,400,2,4,0.24
9,7,negative,8,401,2,6,0.32
9,7,new,3,402,2,1,0.16
9,7,newly,5,403,3,2,0.16
9,7,noise,5,404,1,4,0.2
9,7,norm,4,405,2,2,0.12
9,7,north,5,406,3,2,0.16
9,7,not,3,407,2,1,0.08
9,7,notion,6,408,3,3,0.28
9,7,numerous,8,409,1,7,0.32
9,7,objective,9,410,0,9,0.4
9,7,oblige,6,411,2,4,0.2
9,7,october,7,412,1,6,0.36
9,7,official,8,413,1,7,0.32
9,7,once,4,414,1,3,0.16
9,7,one,3,415,2,1,0.08
9,7,organized,9,416,1,8,0.44
9,7,organizer,9,417,8,1,0.2
9,7,originate,9,418,2,7,0.36
9,7,other,5,419,1,4,0.28
9,7,outdoor,7,420,1,6,0.28
9,7,outlet,6,421,3,3,0.2
9,7,oversee,7,422,1,6,0.28
9,7,owe,3,423,1,2,0.12
9,7,pace,4,424,0,4,0.24
9,7,pad,3,425,2,1,0.12
9,7,page,4,426,2,2,0.12
9,7,painful,7,427,2,5,0.28
9,7,paint,5,428,4,1,0.12
9,7,parade,6,429,2,4,0.28
9,7,parallel,8,430,4,4,0.24
9,7,park,4,431,3,1,0.12
9,7,passenger,9,432,2,7,0.32
9,7,password,8,433,4,4,0.32
9,7,patent,6,434,2,4,0.2
9,7,patience,8,435,3,5,0.28
9,7,peaceful,8,436,1,7,0.32
9,7,personnel,9,437,2,7,0.4
9,7,phone,5,438,1,4,0.2
9,7,physician,9,439,2,7,0.32
9,7,pick,4,440,1,3,0.16
9,7,piece,5,441,2,3,0.28
9,7,pig,3,442,2,1,0.08
9,7,pin,3,443,2,1,0.12
9,7,pioneer,7,444,2,5,0.28
9,7,place,5,445,1,4,0.2
9,7,plan,4,446,3,1,0.12
9,7,planning,8,447,4,4,0.32
9,7,plant,5,448,4,1,0.12
9,7,plastic,7,449,3,4,0.24
9,7,play,4,450,3,1,0.12
9,7,pledge,6,451,2,4,0.28
9,7,plot,4,452,2,2,0.12
9,7,point,5,453,1,4,0.2
9,7,pollution,9,454,2,7,0.32
9,7,portion,7,455,2,5,0.28
9,7,position,8,456,2,6,0.36
9,7,possible,8,457,3,5,0.28
9,7,poster,6,458,3,3,0.2
9,7,practical,9,459,1,8,0.44
9,7,praise,6,460,3,3,0.2
9,7,precedent,9,461,2,7,0.36
9,7,precise,7,462,4,3,0.2
9,7,predict,7,463,3,4,0.32
9,7,pregnant,8,464,3,5,0.28
9,7,prejudice,9,465,3,6,0.32
9,7,premise,7,466,3,4,0.32
9,7,principle,9,467,2,7,0.36
9,7,printer,7,468,4,3,0.2
9,7,prior,5,469,3,2,0.16
9,7,procedure,9,470,2,7,0.4
9,7,produce,7,471,3,4,0.24
9,7,product,7,472,6,1,0.16
9,7,profile,7,473,3,4,0.24
9,7,profound,8,474,4,4,0.52
9,7,project,7,475,3,4,0.56
9,7,prominent,9,476,3,6,0.76
9,7,proposal,8,477,3,5,0.64
9,7,protest,7,478,3,4,0.64
9,7,protester,9,479,7,2,0.52
9,7,publicity,9,480,1,8,0.84
9,7,punk,4,481,2,2,0.44
9,7,pupil,5,482,2,3,0.4
9,7,purpose,7,483,2,5,0.6
9,7,push,4,484,2,2,0.32
9,7,put,3,485,2,1,0.24
9,7,puzzle,6,486,2,4,0.52
9,7,query,5,487,0,5,0.64
9,7,race,4,488,0,4,0.44
9,7,radar,5,489,2,3,0.4
9,7,rail,4,490,2,2,0.32
9,7,railway,7,491,4,3,0.48
9,7,rather,6,492,2,4,0.64
9,7,rating,6,493,3,3,0.48
9,7,rational,8,494,4,4,0.6
9,7,realistic,9,495,1,8,0.96
9,7,reception,9,496,2,7,0.8
9,7,record,6,497,3,3,0.44
9,7,recycle,7,498,3,4,0.56
9,7,refer,5,499,2,3,0.52
9,7,referee,7,500,5,2,0.48
9,7,refuse,6,501,3,3,0.44
9,7,regime,6,502,2,4,0.52
9,7,regional,8,503,4,4,0.6
9,7,reign,5,504,2,3,0.56
9,7,relative,8,505,2,6,0.72
9,7,relaxed,7,506,4,3,0.48
9,7,relevance,9,507,3,6,0.84
9,7,relieved,8,508,3,5,0.68
9,7,religious,9,509,4,5,0.68
9,7,remind,6,510,2,4,0.52
9,7,remove,6,511,3,3,0.6
9,7,repeat,6,512,2,4,0.52
9,7,replace,7,513,3,4,0.56
9,7,republic,8,514,3,5,0.68
9,7,research,8,515,2,6,0.84
9,7,reside,6,516,3,3,0.48
9,7,resolve,7,517,3,4,0.56
9,7,retail,6,518,2,4,0.52
9,7,retire,6,519,3,3,0.56
9,7,revenge,7,520,2,5,1.36
9,7,revision,8,521,3,5,0.8
9,7,revive,6,522,4,2,0.44
9,7,rival,5,523,1,4,0.6
9,7,romance,7,524,1,6,0.68
9,7,roof,4,525,2,2,0.32
9,7,rotate,6,526,2,4,0.52
9,7,rough,5,527,2,3,0.4
9,7,safe,4,528,0,4,0.56
9,7,sale,4,529,2,2,0.32
9,7,salt,4,530,3,1,0.28
9,7,sample,6,531,2,4,0.52
9,7,satellite,9,532,2,7,0.8
9,7,satisfied,9,533,3,6,0.84
9,7,satisfy,7,534,6,1,0.4
9,7,scared,6,535,1,5,0.6
9,7,scattered,9,536,3,6,0.76
9,7,scheme,6,537,2,4,0.64
9,7,scientist,9,538,2,7,0.8
9,7,score,5,539,2,3,0.44
9,7,seal,4,540,1,3,0.36
9,7,second,6,541,2,4,0.64
9,7,secretary,9,542,3,6,0.72
9,7,secure,6,543,3,3,0.44
9,7,seem,4,544,2,2,0.32
9,7,september,9,545,2,7,0.92
9,7,seriously,9,546,2,7,0.8
9,7,servant,7,547,3,4,0.56
9,7,serve,5,548,4,1,0.32
9,7,setting,7,549,2,5,0.72
9,7,shape,5,550,1,4,0.48
9,7,share,5,551,3,2,0.36
9,7,sheer,5,552,2,3,0.4
9,7,shell,5,553,3,2,0.36
9,7,shift,5,554,2,3,0.52
9,7,ship,4,555,3,1,0.28
9,7,shipping,8,556,4,4,0.6
9,7,shoot,5,557,2,3,0.4
9,7,shortly,7,558,3,4,0.64
9,7,sibling,7,559,1,6,0.68
9,7,sight,5,560,2,3,0.44
9,7,signature,9,561,3,6,0.76
9,7,silver,6,562,2,4,0.52
9,7,similarly,9,563,2,7,0.92
9,7,simply,6,564,3,3,0.52
9,7,singing,7,565,2,5,0.68
9,7,sink,4,566,3,1,0.28
9,7,six,3,567,2,1,0.36
9,7,slam,4,568,1,3,0.36
9,7,smile,5,569,1,4,0.48
9,7,snow,4,570,1,3,0.36
9,7,solar,5,571,1,4,0.48
9,7,solid,5,572,3,2,0.4
9,7,someone,7,573,2,5,0.72
9,7,something,9,574,4,5,0.68
9,7,sometimes,9,575,5,4,0.64
9,7,south,5,576,2,3,0.56
9,7,spectator,9,577,1,8,0.84
9,7,speech,6,578,3,3,0.48
9,7,spin,4,579,2,2,0.32
9,7,spine,5,580,4,1,0.32
9,7,spokesman,9,581,2,7,0.88
9,7,spotlight,9,582,3,6,0.76
9,7,spread,6,583,2,4,0.52
9,7,stab,4,584,1,3,0.36
9,7,staff,5,585,3,2,0.48
9,7,stand,5,586,3,2,0.36
9,7,star,4,587,3,1,0.28
9,7,statistic,9,588,3,6,0.72
9,7,statue,6,589,4,2,0.52
9,7,steadily,8,590,2,6,0.72
9,7,steer,5,591,3,2,0.36
9,7,stem,4,592,3,1,0.28
9,7,sticky,6,593,2,4,0.52
9,7,storage,7,594,2,5,0.72
9,7,store,5,595,4,1,0.32
9,7,strange,7,596,2,5,0.6
9,7,strategic,9,597,4,5,0.68
9,7,street,6,598,3,3,0.56
9,7,strike,6,599,3,3,0.44
9,7,striking,8,600,5,3,0.52
9,7,study,5,601,2,3,0.4
9,7,stumble,7,602,3,4,0.64
9,7,substance,9,603,1,8,0.84
9,7,such,4,604,2,2,0.32
9,7,sudden,6,605,2,4,0.52
9,7,suppose,7,606,2,5,0.72
9,7,supreme,7,607,3,4,0.56
9,7,sure,4,608,2,2,0.32
9,7,synthesis,9,609,1,8,0.84
9,7,table,5,610,0,5,0.52
9,7,tail,4,611,2,2,0.44
9,7,talent,6,612,2,4,0.52
9,7,tap,3,613,2,1,0.24
9,7,tape,4,614,3,1,0.28
9,7,task,4,615,2,2,0.32
9,7,taste,5,616,3,2,0.36
9,7,tea,3,617,1,2,0.4
9,7,tempt,5,618,2,3,0.4
9,7,terribly,8,619,2,6,0.68
9,7,terrify,7,620,5,2,0.44
9,7,terror,6,621,4,2,0.52
9,7,texture,7,622,2,5,0.64
9,7,thirsty,7,623,1,6,0.68
9,7,this,4,624,3,1,0.28
9,7,thorough,8,625,2,6,0.84
9,7,ticket,6,626,1,5,0.56
9,7,tight,5,627,2,3,0.4
9,7,to,2,628,1,1,0.2
9,7,together,8,629,2,6,0.76
9,7,tonight,7,630,2,5,0.8
9,7,tonne,5,631,3,2,0.36
9,7,topic,5,632,2,3,0.44
9,7,tour,4,633,2,2,0.32
9,7,trap,4,634,1,3,0.4
9,7,treaty,6,635,2,4,0.64
9,7,tree,4,636,3,1,0.28
9,7,trio,4,637,2,2,0.32
9,7,tropical,8,638,2,6,0.68
9,7,trouble,7,639,3,4,0.56
9,7,twice,5,640,1,4,0.56
9,7,two,3,641,2,1,0.24
9,7,ultimate,8,642,0,8,0.8
9,7,unable,6,643,1,5,0.56
9,7,undergo,7,644,2,5,0.6
9,7,unify,5,645,2,3,0.56
9,7,universal,9,646,3,6,0.72
9,7,universe,8,647,7,1,0.44
9,7,unusual,7,648,2,5,0.72
9,7,unveil,6,649,2,4,0.52
9,7,upgrade,7,650,1,6,0.68
9,7,uphold,6,651,2,4,0.52
9,7,urban,5,652,1,4,0.52
9,7,utility,7,653,1,6,0.8
9,7,utilize,7,654,5,2,0.44
9,7,validity,8,655,0,8,0.92
9,7,valuable,8,656,3,5,0.84
9,7,variety,7,657,2,5,0.6
9,7,vary,4,658,3,1,0.28
9,7,venture,7,659,1,6,0.72
9,7,verify,6,660,2,4,0.56
9,7,veteran,7,661,2,5,0.76
9,7,violent,7,662,1,6,0.68
9,7,virtual,7,663,2,5,0.64
9,7,visual,6,664,2,4,0.6
9,7,voice,5,665,1,4,0.6
9,7,volunteer,9,666,2,7,0.8
9,7,wait,4,667,0,4,0.44
9,7,waiter,6,668,4,2,0.4
9,7,wake,4,669,2,2,0.44
9,7,warning,7,670,2,5,0.6
9,7,washing,7,671,2,5,0.6
9,7,watch,5,672,2,3,0.4
9,7,way,3,673,2,1,0.24
9,7,weapon,6,674,1,5,0.68
9,7,weave,5,675,3,2,0.36
9,7,weight,6,676,2,4,0.52
9,7,weird,5,677,3,2,0.36
9,7,west,4,678,2,2,0.32
9,7,whatever,8,679,1,7,0.88
9,7,whenever,8,680,2,6,0.72
9,7,width,5,681,1,4,0.48
9,7,wildlife,8,682,2,6,0.72
9,7,win,3,683,2,1,0.36
9,7,wind,4,684,3,1,0.28
9,7,window,6,685,4,2,0.4
9,7,wipe,4,686,2,2,0.32
9,7,wisdom,6,687,2,4,0.52
9,7,without,7,688,2,5,0.72
9,7,woman,5,689,1,4,0.48
9,7,work,4,690,2,2,0.32
9,7,workplace,9,691,4,5,0.68
9,7,world,5,692,3,2,0.36
9,7,wow,3,693,2,1,0.36
9,7,wrist,5,694,1,4,0.48
9,7,written,7,695,3,4,0.56
9,7,yellow,6,696,0,6,0.6
9,8,a,1,0,0,1,0.16
9,8,absence,7,1,1,6,0.64
9,8,absurd,6,2,3,3,0.56
9,8,academic,8,3,1,7,0.76
9,8,accident,8,4,2,6,0.68
9,8,accompany,9,5,3,6,0.84
9,8,acid,4,6,2,2,0.32
9,8,acre,4,7,2,2,0.32
9,8,activate,8,8,2,6,0.72
9,8,actress,7,9,3,4,0.68
9,8,acute,5,10,2,3,0.44
9,8,add,3,11,1,2,0.28
9,8,adjacent,8,12,2,6,0.68
9,8,adventure,9,13,2,7,0.92
9,8,advice,6,14,3,3,0.64
9,8,aids,4,15,1,3,0.36
9,8,alcohol,7,16,1,6,0.64
9,8,align,5,17,2,3,0.4
9,8,alongside,9,18,2,7,0.92
9,8,amateur,7,19,1,6,0.64
9,8,amendment,9,20,2,7,0.8
9,8,analysis,8,21,1,7,0.88
9,8,and,3,22,2,1,0.24
9,8,anger,5,23,2,3,0.4
9,8,animal,6,24,2,4,0.52
9,8,announce,8,25,2,6,0.72
9,8,another,7,26,2,5,0.8
9,8,anxiety,7,27,2,5,0.68
9,8,app,3,28,1,2,0.32
9,8,applaud,7,29,3,4,0.64
9,8,approve,7,30,3,4,0.72
9,8,arms,4,31,1,3,0.36
9,8,artist,6,32,2,4,0.52
9,8,assistant,9,33,1,8,0.84
9,8,associate,9,34,3,6,0.84
9,8,assurance,9,35,3,6,0.76
9,8,at,2,36,1,1,0.2
9,8,attract,7,37,2,5,0.64
9,8,auction,7,38,1,6,0.8
9,8,automatic,9,39,2,7,0.48
9,8,average,7,40,1,6,0.36
9,8,baby,4,41,0,4,0.24
9,8,backing,7,42,2,5,0.6
9,8,bacteria,8,43,3,5,0.32
9,8,banner,6,44,2,4,0.24
9,8,barrel,6,45,2,4,0.24
9,8,bat,3,46,2,1,0.12
9,8,bath,4,47,3,1,0.2
9,8,bay,3,48,2,1,0.12
9,8,bed,3,49,1,2,0.12
9,8,beg,3,50,2,1,0.12
9,8,belong,6,51,2,4,0.2
9,8,betray,6,52,2,4,0.24
9,8,between,7,53,3,4,0.32
9,8,beyond,6,54,2,4,0.24
9,8,bin,3,55,1,2,0.12
9,8,bird,4,56,2,2,0.16
9,8,birthday,8,57,3,5,0.28
9,8,biscuit,7,58,2,5,0.32
9,8,bishop,6,59,3,3,0.2
9,8,blind,5,60,1,4,0.2
9,8,blow,4,61,2,2,0.16
9,8,boat,4,62,1,3,0.16
9,8,bomb,4,63,2,2,0.2
9,8,boom,4,64,2,2,0.12
9,8,boost,5,65,3,2,0.16
9,8,bottle,6,66,2,4,0.24
9,8,bound,5,67,2,3,0.16
9,8,boundary,8,68,5,3,0.32
9,8,breakdown,9,69,1,8,0.36
9,8,breathe,7,70,4,3,0.2
9,8,breathing,9,71,6,3,0.32
9,8,bride,5,72,2,3,0.2
9,8,broken,6,73,2,4,0.2
9,8,buffer,6,74,1,5,0.24
9,8,build,5,75,2,3,0.16
9,8,burn,4,76,2,2,0.2
9,8,business,8,77,2,6,0.28
9,8,cake,4,78,0,4,0.2
9,8,cancer,6,79,2,4,0.2
9,8,cap,3,80,2,1,0.08
9,8,career,6,81,2,4,0.28
9,8,careful,7,82,4,3,0.2
9,8,carefully,9,83,7,2,0.24
9,8,category,8,84,2,6,0.28
9,8,cd,2,85,1,1,0.16
9,8,celebrate,9,86,1,8,0.36
9,8,ceremony,8,87,2,6,0.32
9,8,chair,5,88,1,4,0.2
9,8,challenge,9,89,3,6,0.44
9,8,chapter,7,90,3,4,0.28
9,8,character,9,91,3,6,0.36
9,8,charming,8,92,4,4,0.32
9,8,charter,7,93,4,3,0.2
9,8,cheat,5,94,2,3,0.16
9,8,chemical,8,95,3,5,0.28
9,8,childhood,9,96,2,7,0.44
9,8,choir,5,97,2,3,0.2
9,8,chunk,5,98,2,3,0.2
9,8,cite,4,99,1,3,0.16
9,8,city,4,100,3,1,0.12
9,8,civil,5,101,2,3,0.2
9,8,clause,6,102,1,5,0.32
9,8,clearly,7,103,2,5,0.28
9,8,clinical,8,104,2,6,0.32
9,8,closely,7,105,2,5,0.36
9,8,cloud,5,106,3,2,0.16
9,8,club,4,107,2,2,0.16
9,8,coach,5,108,1,4,0.2
9,8,coffee,6,109,2,4,0.2
9,8,colony,6,110,2,4,0.28
9,8,comedy,6,111,2,4,0.24
9,8,comfort,7,112,3,4,0.24
9,8,commodity,9,113,3,6,0.32
9,8,compete,7,114,3,4,0.32
9,8,comply,6,115,4,2,0.16
9,8,component,9,116,4,5,0.28
9,8,conceal,7,117,2,5,0.28
9,8,concept,7,118,5,2,0.28
9,8,concern,7,119,5,2,0.2
9,8,concert,7,120,6,1,0.2
9,8,conduct,7,121,3,4,0.24
9,8,confused,8,122,3,5,0.36
9,8,consult,7,123,3,4,0.24
9,8,contempt,8,124,3,5,0.28
9,8,cooker,6,125,2,4,0.2
9,8,cope,4,126,2,2,0.2
9,8,cost,4,127,2,2,0.12
9,8,counter,7,128,2,5,0.24
9,8,course,6,129,3,3,0.28
9,8,craft,5,130,1,4,0.2
9,8,create,6,131,2,4,0.32
9,8,credible,8,132,3,5,0.28
9,8,creep,5,133,3,2,0.16
9,8,crime,5,134,2,3,0.16
9,8,criminal,8,135,4,4,0.32
9,8,crowded,7,136,2,5,0.24
9,8,cruel,5,137,2,3,0.16
9,8,cry,3,138,2,1,0.12
9,8,currency,8,139,1,7,0.32
9,8,current,7,140,6,1,0.24
9,8,curved,6,141,3,3,0.2
9,8,damage,6,142,0,6,0.24
9,8,dance,5,143,2,3,0.16
9,8,day,3,144,2,1,0.08
9,8,deal,4,145,1,3,0.24
9,8,death,5,146,3,2,0.16
9,8,december,8,147,2,6,0.28
9,8,declare,7,148,3,4,0.24
9,8,decrease,8,149,3,5,0.36
9,8,default,7,150,2,5,0.28
9,8,defect,6,151,3,3,0.2
9,8,delighted,9,152,2,7,0.32
9,8,deliver,7,153,4,3,0.28
9,8,deposit,7,154,2,5,0.24
9,8,deputy,6,155,3,3,0.2
9,8,desktop,7,156,2,5,0.24
9,8,despite,7,157,3,4,0.32
9,8,develop,7,158,2,5,0.24
9,8,dig,3,159,1,2,0.12
9,8,digital,7,160,3,4,0.24
9,8,diminish,8,161,2,6,0.36
9,8,dinner,6,162,2,4,0.2
9,8,diplomat,8,163,2,6,0.32
9,8,director,8,164,2,6,0.28
9,8,dirt,4,165,3,1,0.2
9,8,dirty,5,166,4,1,0.12
9,8,disabled,8,167,2,6,0.28
9,8,discuss,7,168,3,4,0.24
9,8,display,7,169,3,4,0.32
9,8,distant,7,170,3,4,0.28
9,8,distort,7,171,4,3,0.24
9,8,divorced,8,172,2,6,0.36
9,8,domain,6,173,1,5,0.36
9,8,dot,3,174,2,1,0.08
9,8,drink,5,175,1,4,0.2
9,8,duration,8,176,1,7,0.32
9,8,earth,5,177,0,5,0.24
9,8,edit,4,178,1,3,0.24
9,8,edition,7,179,4,3,0.2
9,8,editor,6,180,4,2,0.16
9,8,effort,6,181,1,5,0.24
9,8,eight,5,182,1,4,0.2
9,8,eighty,6,183,5,1,0.24
9,8,either,6,184,2,4,0.2
9,8,elect,5,185,1,4,0.2
9,8,eleven,6,186,3,3,0.2
9,8,eliminate,9,187,2,7,0.44
9,8,elsewhere,9,188,2,7,0.4
9,8,emergency,9,189,1,8,0.4
9,8,emotion,7,190,2,5,0.36
9,8,empirical,9,191,2,7,0.36
9,8,empower,7,192,3,4,0.24
9,8,enable,6,193,1,5,0.24
9,8,enemy,5,194,2,3,0.24
9,8,engineer,8,195,2,6,0.28
9,8,enjoy,5,196,2,3,0.2
9,8,enormous,8,197,2,6,0.28
9,8,enrich,6,198,2,4,0.28
9,8,enter,5,199,2,3,0.2
9,8,entitle,7,200,3,4,0.24
9,8,entrance,8,201,3,5,0.28
9,8,equipment,9,202,1,8,0.44
9,8,essay,5,203,1,4,0.2
9,8,essence,7,204,3,4,0.24
9,8,evening,7,205,1,6,0.28
9,8,event,5,206,4,1,0.2
9,8,excited,7,207,1,6,0.32
9,8,exciting,8,208,5,3,0.28
9,8,excuse,6,209,3,3,0.2
9,8,execution,9,210,2,7,0.48
9,8,existence,9,211,2,7,0.32
9,8,expensive,9,212,2,7,0.36
9,8,expire,6,213,3,3,0.2
9,8,extent,6,214,2,4,0.28
9,8,faculty,7,215,0,7,0.32
9,8,failed,6,216,2,4,0.24
9,8,fair,4,217,3,1,0.12
9,8,fairly,6,218,4,2,0.28
9,8,fall,4,219,2,2,0.12
9,8,famous,6,220,2,4,0.2
9,8,fast,4,221,2,2,0.16
9,8,fasten,6,222,4,2,0.16
9,8,fee,3,223,1,2,0.12
9,8,feeding,7,224,3,4,0.32
9,8,few,3,225,2,1,0.12
9,8,fiction,7,226,1,6,0.28
9,8,fifty,5,227,2,3,0.16
9,8,file,4,228,2,2,0.12
9,8,financial,9,229,2,7,0.4
9,8,firm,4,230,2,2,0.12
9,8,fixture,7,231,2,5,0.24
9,8,flag,4,232,1,3,0.16
9,8,flee,4,233,2,2,0.2
9,8,flourish,8,234,2,6,0.32
9,8,focus,5,235,1,4,0.2
9,8,for,3,236,2,1,0.08
9,8,force,5,237,3,2,0.16
9,8,foreign,7,238,3,4,0.32
9,8,formerly,8,239,3,5,0.28
9,8,formula,7,240,4,3,0.2
9,8,fortune,7,241,3,4,0.24
9,8,founder,7,242,2,5,0.32
9,8,fourteen,8,243,3,5,0.28
9,8,fragment,8,244,1,7,0.32
9,8,freedom,7,245,2,5,0.28
9,8,frequent,8,246,3,5,0.36
9,8,friday,6,247,2,4,0.24
9,8,fridge,6,248,4,2,0.2
9,8,friendly,8,249,3,5,0.32
9,8,frighten,8,250,3,5,0.36
9,8,frog,4,251,2,2,0.16
9,8,front,5,252,3,2,0.16
9,8,fulfil,6,253,1,5,0.24
9,8,funding,7,254,2,5,0.32
9,8,fur,3,255,2,1,0.12
9,8,gallery,7,256,0,7,0.44
9,8,game,4,257,2,2,0.16
9,8,garage,6,258,2,4,0.24
9,8,generate,8,259,1,7,0.4
9,8,genetic,7,260,4,3,0.2
9,8,genre,5,261,3,2,0.16
9,8,genuinely,9,262,3,6,0.32
9,8,globe,5,263,1,4,0.28
9,8,go,2,264,1,1,0.08
9,8,god,3,265,2,1,0.08
9,8,good,4,266,2,2,0.16
9,8,goodbye,7,267,4,3,0.2
9,8,governor,8,268,2,6,0.36
9,8,grace,5,269,1,4,0.2
9,8,grade,5,270,3,2,0.16
9,8,graphics,8,271,3,5,0.28
9,8,grin,4,272,2,2,0.12
9,8,ground,6,273,2,4,0.28
9,8,growth,6,274,3,3,0.2
9,8,guerrilla,9,275,1,8,0.36
9,8,guest,5,276,3,2,0.16
9,8,guidance,8,277,2,6,0.4
9,8,guy,3,278,2,1,0.12
9,8,gym,3,279,1,2,0.16
9,8,handful,7,280,0,7,0.36
9,8,happen,6,281,2,4,0.24
9,8,harbour,7,282,2,5,0.36
9,8,hat,3,283,2,1,0.08
9,8,hate,4,284,3,1,0.12
9,8,hazard,6,285,2,4,0.2
9,8,headline,8,286,1,7,0.32
9,8,health,6,287,3,3,0.28
9,8,heart,5,288,3,2,0.16
9,8,hers,4,289,2,2,0.12
9,8,hesitate,8,290,2,6,0.28
9,8,highly,6,291,1,5,0.32
9,8,historic,8,292,2,6,0.28
9,8,honesty,7,293,1,6,0.28
9,8,horror,6,294,2,4,0.2
9,8,hotel,5,295,2,3,0.28
9,8,household,9,296,2,7,0.36
9,8,however,7,297,2,5,0.28
9,8,humour,6,298,1,5,0.24
9,8,hunt,4,299,2,2,0.2
9,8,hurricane,9,300,2,7,0.36
9,8,ideal,5,301,0,5,0.24
9,8,identical,9,302,3,6,0.32
9,8,ill,3,303,1,2,0.2
9,8,imaginary,9,304,1,8,0.36
9,8,impatient,9,305,2,7,0.36
9,8,implement,9,306,3,6,0.32
9,8,important,9,307,3,6,0.4
9,8,inclusion,9,308,1,8,0.44
9,8,incorrect,9,309,3,6,0.36
9,8,incur,5,310,3,2,0.24
9,8,indicate,8,311,2,6,0.28
9,8,indirect,8,312,4,4,0.24
9,8,influence,9,313,2,7,0.4
9,8,info,4,314,3,1,0.12
9,8,informal,8,315,4,4,0.24
9,8,inherent,8,316,2,6,0.28
9,8,initiate,8,317,2,6,0.36
9,8,inject,6,318,2,4,0.2
9,8,instant,7,319,2,5,0.28
9,8,instruct,8,320,4,4,0.24
9,8,insurance,9,321,3,6,0.4
9,8,integral,8,322,2,6,0.28
9,8,intense,7,323,4,3,0.2
9,8,interior,8,324,4,4,0.36
9,8,into,4,325,3,1,0.12
9,8,invade,6,326,2,4,0.32
9,8,involved,8,327,3,5,0.28
9,8,island,6,328,1,5,0.24
9,8,issue,5,329,2,3,0.24
9,8,january,7,330,0,7,0.32
9,8,jet,3,331,1,2,0.12
9,8,jewellery,9,332,2,7,0.32
9,8,job,3,333,1,2,0.12
9,8,justify,7,334,1,6,0.36
9,8,key,3,335,0,3,0.16
9,8,kit,3,336,1,2,0.12
9,8,lack,4,337,0,4,0.2
9,8,landscape,9,338,2,7,0.32
9,8,lap,3,339,2,1,0.2
9,8,laser,5,340,2,3,0.16
9,8,latest,6,341,2,4,0.2
9,8,laugh,5,342,2,3,0.16
9,8,law,3,343,2,1,0.08
9,8,leading,7,344,1,6,0.36
9,8,leaflet,7,345,3,4,0.24
9,8,league,6,346,3,3,0.2
9,8,learning,8,347,3,5,0.28
9,8,left,4,348,2,2,0.24
9,8,legend,6,349,2,4,0.2
9,8,lesser,6,350,2,4,0.24
9,8,letter,6,351,2,4,0.2
9,8,lie,3,352,1,2,0.12
9,8,lifestyle,9,353,2,7,0.4
9,8,limb,4,354,2,2,0.12
9,8,litter,6,355,2,4,0.24
9,8,live,4,356,2,2,0.16
9,8,liver,5,357,4,1,0.16
9,8,load,4,358,1,3,0.24
9,8,lonely,6,359,2,4,0.24
9,8,look,4,360,2,2,0.16
9,8,low,3,361,2,1,0.08
9,8,mainland,8,362,0,8,0.36
9,8,mandatory,9,363,2,7,0.44
9,8,marine,6,364,2,4,0.24
9,8,married,7,365,3,4,0.24
9,8,mask,4,366,2,2,0.16
9,8,meal,4,367,1,3,0.52
9,8,meeting,7,368,2,5,0.6
9,8,melody,6,369,2,4,0.52
9,8,mental,6,370,2,4,0.52
9,8,mentor,6,371,4,2,0.4
9,8,merely,6,372,2,4,0.64
9,8,merger,6,373,3,3,0.48
9,8,method,6,374,2,4,0.52
9,8,metre,5,375,3,2,0.36
9,8,militia,7,376,1,6,0.8
9,8,mind,4,377,2,2,0.36
9,8,minister,8,378,3,5,0.8
9,8,ministry,8,379,6,2,0.6
9,8,mirror,6,380,2,4,0.56
9,8,miserable,9,381,2,7,0.92
9,8,mixed,5,382,2,3,0.44
9,8,mobilize,8,383,1,7,0.76
9,8,moment,6,384,2,4,0.64
9,8,money,5,385,2,3,0.44
9,8,month,5,386,3,2,0.36
9,8,monument,8,387,3,5,0.64
9,8,mouth,5,388,2,3,0.4
9,8,movie,5,389,2,3,0.56
9,8,multiple,8,390,1,7,0.76
9,8,municipal,9,391,2,7,0.8
9,8,music,5,392,2,3,0.4
9,8,musician,8,393,5,3,0.68
9,8,must,4,394,3,1,0.28
9,8,my,2,395,1,1,0.2
9,8,naked,5,396,0,5,0.52
9,8,narrative,9,397,2,7,0.8
9,8,nation,6,398,2,4,0.68
9,8,neck,4,399,1,3,0.36
9,8,newly,5,400,2,3,0.44
9,8,newspaper,9,401,3,6,0.72
9,8,night,5,402,1,4,0.6
9,8,norm,4,403,1,3,0.4
9,8,north,5,404,3,2,0.36
9,8,note,4,405,2,2,0.32
9,8,nothing,7,406,3,4,0.56
9,8,notice,6,407,3,3,0.6
9,8,notion,6,408,4,2,0.4
9,8,novel,5,409,2,3,0.44
9,8,obesity,7,410,0,7,0.72
9,8,oblige,6,411,2,4,0.56
9,8,ocean,5,412,1,4,0.6
9,8,official,8,413,1,7,0.76
9,8,one,3,414,1,2,0.28
9,8,online,6,415,2,4,0.52
9,8,opponent,8,416,1,7,0.88
9,8,organic,7,417,1,6,0.64
9,8,organized,9,418,6,3,0.56
9,8,organizer,9,419,8,1,0.44
9,8,other,5,420,1,4,0.64
9,8,ought,5,421,1,4,0.52
9,8,outdoor,7,422,2,5,0.72
9,8,outdoors,8,423,7,1,0.48
9,8,outfit,6,424,3,3,0.6
9,8,pace,4,425,0,4,0.48
9,8,pack,4,426,3,1,0.28
9,8,paint,5,427,2,3,0.48
9,8,palace,6,428,2,4,0.64
9,8,parade,6,429,2,4,0.72
9,8,partial,7,430,3,4,0.6
9,8,passenger,9,431,2,7,0.84
9,8,passport,8,432,4,4,0.6
9,8,patent,6,433,2,4,0.64
9,8,patron,6,434,3,3,0.48
9,8,peace,5,435,1,4,0.48
9,8,peer,4,436,2,2,0.32
9,8,perfect,7,437,2,5,0.6
9,8,photo,5,438,1,4,0.6
9,8,physician,9,439,2,7,0.8
9,8,piece,5,440,1,4,0.48
9,8,pin,3,441,2,1,0.24
9,8,pipe,4,442,2,2,0.32
9,8,plan,4,443,1,3,0.48
9,8,plant,5,444,4,1,0.32
9,8,play,4,445,3,1,0.28
9,8,plead,5,446,2,3,0.4
9,8,police,6,447,1,5,0.56
9,8,pollution,9,448,3,6,0.88
9,8,position,8,449,2,6,0.72
9,8,possess,7,450,3,4,0.56
9,8,possible,8,451,4,4,0.72
9,8,post,4,452,3,1,0.28
9,8,practical,9,453,1,8,0.88
9,8,praise,6,454,3,3,0.44
9,8,precise,7,455,2,5,0.76
9,8,predict,7,456,3,4,0.56
9,8,pregnant,8,457,3,5,0.64
9,8,prejudice,9,458,3,6,0.76
9,8,premier,7,459,3,4,0.68
9,8,premise,7,460,5,2,0.44
9,8,prescribe,9,461,3,6,0.76
9,8,principal,9,462,2,7,0.92
9,8,prior,5,463,3,2,0.4
9,8,procedure,9,464,2,7,0.8
9,8,product,7,465,3,4,0.56
9,8,profile,7,466,3,4,0.68
9,8,project,7,467,3,4,0.56
9,8,prominent,9,468,3,6,0.76
9,8,propose,7,469,3,4,0.56
9,8,prosecute,9,470,3,6,0.88
9,8,protest,7,471,3,4,0.56
9,8,pump,4,472,1,3,0.4
9,8,pupil,5,473,2,3,0.4
9,8,pure,4,474,2,2,0.32
9,8,pursuit,7,475,3,4,0.68
9,8,push,4,476,2,2,0.32
9,8,put,3,477,2,1,0.28
9,8,quantity,8,478,0,8,1.2
9,8,query,5,479,2,3,0.56
9,8,quest,5,480,3,2,0.52
9,8,race,4,481,0,4,0.48
9,8,racism,6,482,3,3,0.52
9,8,radiation,9,483,2,7,0.88
9,8,rail,4,484,2,2,0.48
9,8,railway,7,485,4,3,0.52
9,8,rational,8,486,2,6,0.72
9,8,recall,6,487,1,5,0.6
9,8,recognize,9,488,3,6,0.92
9,8,recording,9,489,4,5,0.72
9,8,recount,7,490,4,3,0.52
9,8,recruit,7,491,3,4,0.6
9,8,recycle,7,492,3,4,0.68
9,8,reduction,9,493,2,7,0.8
9,8,refer,5,494,2,3,0.4
9,8,refuse,6,495,3,3,0.44
9,8,regard,6,496,2,4,0.64
9,8,regime,6,497,3,3,0.44
9,8,reign,5,498,2,3,0.4
9,8,rejection,9,499,2,7,0.8
9,8,relative,8,500,2,6,0.84
9,8,relaxed,7,501,4,3,0.48
9,8,religious,9,502,3,6,0.76
9,8,renew,5,503,2,3,0.48
9,8,repeat,6,504,2,4,0.68
9,8,republic,8,505,3,5,0.64
9,8,residence,9,506,2,7,0.8
9,8,resolve,7,507,3,4,0.52
9,8,rest,4,508,3,1,0.16
9,8,retire,6,509,2,4,0.24
9,8,reveal,6,510,2,4,0.44
9,8,revision,8,511,3,5,0.4
9,8,rifle,5,512,1,4,0.28
9,8,right,5,513,2,3,0.2
9,8,rip,3,514,2,1,0.12
9,8,rise,4,515,2,2,0.12
9,8,ritual,6,516,2,4,0.24
9,8,rival,5,517,2,3,0.28
9,8,road,4,518,1,3,0.16
9,8,roll,4,519,2,2,0.12
9,8,rotate,6,520,2,4,0.24
9,8,rough,5,521,2,3,0.2
9,8,rub,3,522,1,2,0.12
9,8,rubber,6,523,3,3,0.28
9,8,sacred,6,524,0,6,0.28
9,8,sailor,6,525,2,4,0.2
9,8,sale,4,526,2,2,0.12
9,8,sand,4,527,2,2,0.12
9,8,satellite,9,528,2,7,0.4
9,8,satisfied,9,529,3,6,0.32
9,8,scan,4,530,1,3,0.16
9,8,scared,6,531,3,3,0.2
9,8,scheme,6,532,2,4,0.28
9,8,scholar,7,533,3,4,0.24
9,8,score,5,534,2,3,0.16
9,8,seal,4,535,1,3,0.16
9,8,second,6,536,2,4,0.2
9,8,secret,6,537,3,3,0.28
9,8,secure,6,538,3,3,0.2
9,8,seeker,6,539,2,4,0.24
9,8,seem,4,540,3,1,0.12
9,8,selective,9,541,2,7,0.44
9,8,sensible,8,542,2,6,0.32
9,8,september,9,543,2,7,0.36
9,8,servant,7,544,2,5,0.36
9,8,serve,5,545,4,1,0.12
9,8,service,7,546,4,3,0.2
9,8,setting,7,547,2,5,0.24
9,8,settler,7,548,4,3,0.2
9,8,seven,5,549,2,3,0.28
9,8,severely,8,550,4,4,0.28
9,8,shallow,7,551,1,6,0.32
9,8,shape,5,552,3,2,0.16
9,8,share,5,553,3,2,0.24
9,8,shell,5,554,2,3,0.2
9,8,shift,5,555,2,3,0.2
9,8,shoot,5,556,2,3,0.16
9,8,shore,5,557,3,2,0.16
9,8,shortage,8,558,4,4,0.32
9,8,sibling,7,559,1,6,0.28
9,8,silver,6,560,2,4,0.2
9,8,similarly,9,561,2,7,0.36
9,8,simply,6,562,3,3,0.28
9,8,sin,3,563,2,1,0.12
9,8,singing,7,564,3,4,0.24
9,8,sink,4,565,3,1,0.12
9,8,sister,6,566,2,4,0.2
9,8,sit,3,567,2,1,0.2
9,8,situated,8,568,3,5,0.28
9,8,skip,4,569,1,3,0.16
9,8,slam,4,570,1,3,0.16
9,8,slice,5,571,2,3,0.2
9,8,slip,4,572,3,1,0.12
9,8,smoking,7,573,1,6,0.36
9,8,solid,5,574,1,4,0.2
9,8,someone,7,575,2,5,0.28
9,8,sometimes,9,576,4,5,0.36
9,8,song,4,577,2,2,0.16
9,8,soup,4,578,2,2,0.12
9,8,speak,5,579,1,4,0.2
9,8,special,7,580,3,4,0.24
9,8,specify,7,581,5,2,0.28
9,8,spectator,9,582,4,5,0.28
9,8,sphere,6,583,2,4,0.2
9,8,spokesman,9,584,2,7,0.32
9,8,spotlight,9,585,3,6,0.4
9,8,staff,5,586,1,4,0.2
9,8,stance,6,587,3,3,0.2
9,8,standing,8,588,4,4,0.24
9,8,star,4,589,3,1,0.2
9,8,statue,6,590,3,3,0.2
9,8,steadily,8,591,2,6,0.28
9,8,steer,5,592,3,2,0.16
9,8,sticky,6,593,2,4,0.2
9,8,storage,7,594,2,5,0.32
9,8,store,5,595,4,1,0.12
9,8,story,5,596,4,1,0.16
9,8,strategic,9,597,2,7,0.32
9,8,strength,8,598,3,5,0.36
9,8,strike,6,599,3,3,0.2
9,8,striking,8,600,5,3,0.24
9,8,stumble,7,601,2,5,0.28
9,8,stun,4,602,3,1,0.2
9,8,sugar,5,603,1,4,0.2
9,8,super,5,604,2,3,0.2
9,8,suppose,7,605,3,4,0.24
9,8,swallow,7,606,1,6,0.36
9,8,sweater,7,607,2,5,0.24
9,8,symbolic,8,608,1,7,0.32
9,8,sympathy,8,609,3,5,0.28
9,8,symptom,7,610,4,3,0.32
9,8,synthesis,9,611,2,7,0.32
9,8,table,5,612,0,5,0.24
9,8,tactical,8,613,2,6,0.32
9,8,tail,4,614,2,2,0.2
9,8,tank,4,615,2,2,0.16
9,8,tape,4,616,2,2,0.12
9,8,taxi,4,617,2,2,0.16
9,8,tea,3,618,1,2,0.12
9,8,team,4,619,3,1,0.12
9,8,tendency,8,620,2,6,0.4
9,8,tender,6,621,5,1,0.16
9,8,tension,7,622,3,4,0.24
9,8,terrific,8,623,2,6,0.28
9,8,terrorism,9,624,4,5,0.4
9,8,texture,7,625,2,5,0.24
9,8,three,5,626,1,4,0.2
9,8,thrilled,8,627,3,5,0.28
9,8,tight,5,628,1,4,0.28
9,8,tighten,7,629,5,2,0.2
9,8,till,4,630,2,2,0.12
9,8,timing,6,631,2,4,0.24
9,8,tonight,7,632,1,6,0.36
9,8,too,3,633,2,1,0.12
9,8,trainer,7,634,1,6,0.36
9,8,traveller,9,635,3,6,0.4
9,8,treasure,8,636,2,6,0.44
9,8,treat,5,637,4,1,0.12
9,8,trial,5,638,2,3,0.2
9,8,trio,4,639,3,1,0.12
9,8,trouble,7,640,2,5,0.28
9,8,tune,4,641,1,3,0.16
9,8,two,3,642,1,2,0.2
9,8,undergo,7,643,0,7,0.32
9,8,underwear,9,644,5,4,0.28
9,8,unfair,6,645,2,4,0.24
9,8,unify,5,646,2,3,0.24
9,8,unique,6,647,3,3,0.2
9,8,until,5,648,2,3,0.16
9,8,unusual,7,649,2,5,0.24
9,8,unveil,6,650,2,4,0.32
9,8,upon,4,651,1,3,0.16
9,8,urgent,6,652,1,5,0.24
9,8,utilize,7,653,1,6,0.28
9,8,vague,5,654,0,5,0.24
9,8,validity,8,655,2,6,0.4
9,8,vary,4,656,2,2,0.12
9,8,vein,4,657,1,3,0.16
9,8,venture,7,658,2,5,0.28
9,8,vessel,6,659,2,4,0.32
9,8,veteran,7,660,2,5,0.28
9,8,viable,6,661,1,5,0.24
9,8,viewer,6,662,2,4,0.2
9,8,villager,8,663,2,6,0.4
9,8,violent,7,664,2,5,0.24
9,8,virtue,6,665,2,4,0.24
9,8,virus,5,666,3,2,0.16
9,8,visitor,7,667,2,5,0.28
9,8,vital,5,668,2,3,0.28
9,8,voice,5,669,1,4,0.2
9,8,waiter,6,670,0,6,0.28
9,8,war,3,671,2,1,0.12
9,8,washing,7,672,2,5,0.28
9,8,watch,5,673,2,3,0.28
9,8,way,3,674,2,1,0.12
9,8,weakness,8,675,1,7,0.36
9,8,weave,5,676,3,2,0.28
9,8,weekend,7,677,2,5,0.76
9,8,welfare,7,678,2,5,0.64
9,8,whatever,8,679,1,7,0.76
9,8,whenever,8,680,2,6,0.72
9,8,whereas,7,681,3,4,0.68
9,8,which,5,682,2,3,0.4
9,8,whose,5,683,2,3,0.4
9,8,width,5,684,1,4,0.48
9,8,wildlife,8,685,2,6,0.84
9,8,window,6,686,2,4,0.52
9,8,wine,4,687,3,1,0.28
9,8,wipe,4,688,2,2,0.32
9,8,woman,5,689,1,4,0.48
9,8,wonderful,9,690,2,7,0.96
9,8,workplace,9,691,2,7,0.8
9,8,world,5,692,3,2,0.4
9,8,wow,3,693,2,1,0.24
9,8,wrist,5,694,1,4,0.48
9,8,written,7,695,3,4,0.68
9,8,youngster,9,696,0,9,0.92
9,9,absence,7,0,0,7,0.76
9,9,academic,8,1,1,7,1.04
9,9,accompany,9,2,2,7,0.8
9,9,accurate,8,3,3,5,0.68
9,9,acid,4,4,2,2,0.44
9,9,activate,8,5,2,6,1.08
9,9,acute,5,6,2,3,0.52
9,9,ad,2,7,1,1,0.2
9,9,add,3,8,2,1,0.28
9,9,adj,3,9,2,1,0.28
9,9,adjacent,8,10,3,5,0.8
9,9,admit,5,11,2,3,0.64
9,9,adopt,5,12,2,3,0.52
9,9,adoption,8,13,5,3,0.64
9,9,advantage,9,14,2,7,0.96
9,9,adventure,9,15,3,6,0.92
9,9,advice,6,16,3,3,0.52
9,9,again,5,17,1,4,0.52
9,9,against,7,18,5,2,0.48
9,9,aids,4,19,1,3,0.56
9,9,alcohol,7,20,1,6,0.84
9,9,align,5,21,2,3,0.52
9,9,allocate,8,22,2,6,0.84
9,9,ally,4,23,3,1,0.44
9,9,ambulance,9,24,1,8,0.92
9,9,amendment,9,25,2,7,0.84
9,9,ancient,7,26,1,6,0.8
9,9,another,7,27,2,5,0.8
9,9,anybody,7,28,2,5,0.64
9,9,anyway,6,29,3,3,0.52
9,9,apology,7,30,1,6,1.12
9,9,app,3,31,2,1,0.44
9,9,applaud,7,32,3,4,0.6
9,9,approve,7,33,3,4,0.84
9,9,arise,5,34,1,4,0.48
9,9,army,4,35,2,2,0.32
9,9,arrest,6,36,2,4,0.84
9,9,arrow,5,37,3,2,0.4
9,9,artistic,8,38,2,6,0.72
9,9,assistant,9,39,1,8,0.92
9,9,at,2,40,1,1,0.36
9,9,attract,7,41,2,5,0.8
9,9,authorize,9,42,1,8,0.88
9,9,average,7,43,1,6,0.92
9,9,baby,4,44,0,4,0.6
9,9,bacteria,8,45,2,6,0.72
9,9,ballet,6,46,2,4,0.56
9,9,bat,3,47,2,1,0.24
9,9,bath,4,48,3,1,0.28
9,9,bay,3,49,2,1,0.4
9,9,beat,4,50,1,3,0.4
9,9,bed,3,51,2,1,0.24
9,9,behalf,6,52,2,4,0.52
9,9,belief,6,53,2,4,0.64
9,9,best,4,54,2,2,0.4
9,9,biscuit,7,55,1,6,0.92
9,9,blame,5,56,1,4,0.52
9,9,bless,5,57,2,3,0.52
9,9,blow,4,58,2,2,0.4
9,9,boil,4,59,1,3,0.44
9,9,bomb,4,60,2,2,0.52
9,9,boot,4,61,2,2,0.36
9,9,bottle,6,62,2,4,0.56
9,9,bound,5,63,2,3,0.44
9,9,boundary,8,64,5,3,0.56
9,9,boyfriend,9,65,2,7,1
9,9,brand,5,66,1,4,0.48
9,9,breathe,7,67,2,5,0.64
9,9,breathing,9,68,6,3,0.84
9,9,broken,6,69,2,4,0.52
9,9,buddy,5,70,1,4,0.48
9,9,bug,3,71,2,1,0.24
9,9,bunch,5,72,2,3,0.44
9,9,burden,6,73,2,4,0.52
9,9,burn,4,74,3,1,0.44
9,9,cake,4,75,0,4,0.52
9,9,can,3,76,2,1,0.28
9,9,candidate,9,77,3,6,0.92
9,9,capable,7,78,2,5,0.84
9,9,card,4,79,2,2,0.36
9,9,career,6,80,3,3,0.52
9,9,careful,7,81,4,3,0.56
9,9,carpet,6,82,3,3,0.52
9,9,cartoon,7,83,3,4,0.76
9,9,cave,4,84,2,2,0.4
9,9,celebrate,9,85,1,8,0.92
9,9,celebrity,9,86,6,3,0.8
9,9,central,7,87,2,5,1
9,9,certain,7,88,2,5,0.72
9,9,character,9,89,1,8,1.04
9,9,charity,7,90,4,3,0.76
9,9,chart,5,91,4,1,0.32
9,9,cheerful,8,92,2,6,0.8
9,9,chemical,8,93,3,5,0.8
9,9,chicken,7,94,2,5,0.84
9,9,chop,4,95,2,2,0.36
9,9,chronic,7,96,2,5,0.64
9,9,circuit,7,97,1,6,0.76
9,9,civil,5,98,2,3,0.52
9,9,clarity,7,99,1,6,0.92
9,9,clause,6,100,3,3,0.52
9,9,clinical,8,101,2,6,0.8
9,9,closely,7,102,2,5,0.68
9,9,cloud,5,103,3,2,0.52
9,9,club,4,104,2,2,0.52
9,9,cluster,7,105,3,4,0.56
9,9,coach,5,106,1,4,0.48
9,9,coffee,6,107,2,4,0.52
9,9,coincide,8,108,2,6,0.88
9,9,colony,6,109,2,4,0.52
9,9,colourful,9,110,4,5,1
9,9,comedy,6,111,2,4,0.72
9,9,commodity,9,112,3,6,0.92
9,9,company,7,113,3,4,0.68
9,9,comply,6,114,4,2,0.44
9,9,component,9,115,4,5,0.84
9,9,conceal,7,116,2,5,0.64
9,9,concept,7,117,5,2,0.44
9,9,confer,6,118,3,3,0.44
9,9,connected,9,119,3,6,0.92
9,9,consult,7,120,3,4,0.64
9,9,contempt,8,121,3,5,0.76
9,9,contend,7,122,5,2,0.52
9,9,cooker,6,123,2,4,0.68
9,9,correct,7,124,2,5,0.64
9,9,cost,4,125,2,2,0.36
9,9,cottage,7,126,2,5,0.76
9,9,coup,4,127,2,2,0.52
9,9,court,5,128,3,2,0.4
9,9,coverage,8,129,2,6,0.56
9,9,craft,5,130,1,4,0.24
9,9,create,6,131,2,4,0.24
9,9,creature,8,132,5,3,0.36
9,9,creep,5,133,3,2,0.16
9,9,crime,5,134,2,3,0.2
9,9,criminal,8,135,4,4,0.28
9,9,crisis,6,136,3,3,0.28
9,9,cross,5,137,2,3,0.2
9,9,crowd,5,138,3,2,0.2
9,9,crucial,7,139,2,5,0.32
9,9,currency,8,140,1,7,0.36
9,9,cycle,5,141,1,4,0.32
9,9,damage,6,142,0,6,0.32
9,9,darkness,8,143,2,6,0.36
9,9,day,3,144,2,1,0.12
9,9,deal,4,145,1,3,0.28
9,9,decline,7,146,2,5,0.32
9,9,deem,4,147,2,2,0.16
9,9,defect,6,148,2,4,0.24
9,9,defender,8,149,4,4,0.28
9,9,delight,7,150,2,5,0.36
9,9,delighted,9,151,7,2,0.24
9,9,deliver,7,152,4,3,0.24
9,9,demon,5,153,2,3,0.2
9,9,departure,9,154,2,7,0.6
9,9,deposit,7,155,3,4,0.44
9,9,devil,5,156,2,3,0.2
9,9,diagram,7,157,1,6,0.32
9,9,dig,3,158,2,1,0.2
9,9,digital,7,159,3,4,0.24
9,9,dinner,6,160,2,4,0.24
9,9,diplomat,8,161,2,6,0.32
9,9,dirty,5,162,2,3,0.28
9,9,disabled,8,163,2,6,0.32
9,9,discovery,9,164,3,6,0.48
9,9,distort,7,165,3,4,0.48
9,9,divorced,8,166,2,6,0.44
9,9,dollar,6,167,1,5,0.28
9,9,domain,6,168,2,4,0.28
9,9,dominant,8,169,3,5,0.32
9,9,dot,3,170,2,1,0.2
9,9,drama,5,171,1,4,0.24
9,9,drawing,7,172,3,4,0.24
9,9,drink,5,173,2,3,0.2
9,9,duration,8,174,1,7,0.44
9,9,earnings,8,175,0,8,0.4
9,9,earth,5,176,3,2,0.16
9,9,edition,7,177,1,6,0.32
9,9,editor,6,178,4,2,0.32
9,9,eight,5,179,1,4,0.24
9,9,elect,5,180,1,4,0.24
9,9,embody,6,181,1,5,0.28
9,9,emergence,9,182,2,7,0.44
9,9,emergency,9,183,8,1,0.36
9,9,emotion,7,184,2,5,0.32
9,9,employer,8,185,2,6,0.4
9,9,empower,7,186,3,4,0.36
9,9,enable,6,187,1,5,0.28
9,9,enemy,5,188,2,3,0.2
9,9,enjoyable,9,189,2,7,0.36
9,9,enter,5,190,2,3,0.28
9,9,entry,5,191,3,2,0.2
9,9,essence,7,192,1,6,0.32
9,9,establish,9,193,2,7,0.36
9,9,evening,7,194,1,6,0.4
9,9,evidence,8,195,2,6,0.32
9,9,evoke,5,196,2,3,0.2
9,9,exact,5,197,1,4,0.24
9,9,examine,7,198,3,4,0.36
9,9,exceed,6,199,2,4,0.24
9,9,exclusive,9,200,3,6,0.32
9,9,exercise,8,201,2,6,0.32
9,9,existence,9,202,2,7,0.48
9,9,explosive,9,203,2,7,0.36
9,9,extend,6,204,2,4,0.24
9,9,extensive,9,205,5,4,0.4
9,9,extent,6,206,5,1,0.16
9,9,eye,3,207,1,2,0.12
9,9,failed,6,208,0,6,0.28
9,9,failure,7,209,4,3,0.28
9,9,fair,4,210,3,1,0.24
9,9,famous,6,211,2,4,0.24
9,9,fantastic,9,212,2,7,0.36
9,9,fantasy,7,213,6,1,0.2
9,9,fast,4,214,2,2,0.16
9,9,fee,3,215,1,2,0.24
9,9,feeding,7,216,3,4,0.32
9,9,fellow,6,217,2,4,0.28
9,9,fiction,7,218,1,6,0.36
9,9,file,4,219,2,2,0.28
9,9,fine,4,220,2,2,0.16
9,9,fixed,5,221,2,3,0.2
9,9,fixture,7,222,3,4,0.28
9,9,flavour,7,223,1,6,0.32
9,9,flee,4,224,2,2,0.24
9,9,flexible,8,225,3,5,0.28
9,9,flu,3,226,2,1,0.12
9,9,flying,6,227,2,4,0.24
9,9,folding,7,228,1,6,0.28
9,9,folk,4,229,3,1,0.2
9,9,for,3,230,2,1,0.12
9,9,force,5,231,3,2,0.2
9,9,foreigner,9,232,3,6,0.32
9,9,formation,9,233,3,6,0.44
9,9,formerly,8,234,4,4,0.28
9,9,forward,7,235,3,4,0.24
9,9,founder,7,236,2,5,0.28
9,9,fragment,8,237,1,7,0.44
9,9,freedom,7,238,2,5,0.28
9,9,friday,6,239,2,4,0.24
9,9,friendly,8,240,3,5,0.32
9,9,frighten,8,241,3,5,0.4
9,9,frog,4,242,2,2,0.16
9,9,front,5,243,3,2,0.16
9,9,fulfil,6,244,1,5,0.28
9,9,funding,7,245,2,5,0.4
9,9,fur,3,246,2,1,0.12
9,9,gallery,7,247,0,7,0.32
9,9,gallon,6,248,4,2,0.2
9,9,game,4,249,2,2,0.16
9,9,garage,6,250,2,4,0.32
9,9,gender,6,251,1,5,0.28
9,9,general,7,252,3,4,0.24
9,9,generate,8,253,6,2,0.2
9,9,genetic,7,254,4,3,0.32
9,9,genuinely,9,255,3,6,0.52
9,9,giant,5,256,1,4,0.24
9,9,give,4,257,2,2,0.16
9,9,glass,5,258,1,4,0.2
9,9,glimpse,7,259,2,5,0.36
9,9,go,2,260,1,1,0.08
9,9,god,3,261,2,1,0.12
9,9,grace,5,262,1,4,0.2
9,9,grid,4,263,2,2,0.16
9,9,grief,5,264,3,2,0.16
9,9,grin,4,265,3,1,0.24
9,9,grind,5,266,4,1,0.16
9,9,ground,6,267,2,4,0.24
9,9,guerrilla,9,268,1,8,0.44
9,9,guidance,8,269,2,6,0.4
9,9,guide,5,270,4,1,0.16
9,9,guitar,6,271,3,3,0.2
9,9,guy,3,272,2,1,0.12
9,9,gym,3,273,1,2,0.12
9,9,hair,4,274,0,4,0.2
9,9,harbour,7,275,2,5,0.36
9,9,hate,4,276,2,2,0.16
9,9,headline,8,277,1,7,0.36
9,9,heat,4,278,3,1,0.12
9,9,herb,4,279,2,2,0.16
9,9,hesitate,8,280,2,6,0.4
9,9,highlight,9,281,1,8,0.4
9,9,highly,6,282,5,1,0.16
9,9,hint,4,283,2,2,0.16
9,9,holiday,7,284,1,6,0.4
9,9,homeland,8,285,2,6,0.32
9,9,horror,6,286,2,4,0.24
9,9,hour,4,287,2,2,0.16
9,9,how,3,288,2,1,0.2
9,9,humble,6,289,1,5,0.28
9,9,humour,6,290,3,3,0.2
9,9,icon,4,291,0,4,0.2
9,9,ideal,5,292,1,4,0.2
9,9,identical,9,293,3,6,0.44
9,9,identity,8,294,6,2,0.24
9,9,ill,3,295,1,2,0.12
9,9,image,5,296,1,4,0.24
9,9,imagery,7,297,5,2,0.32
9,9,imaginary,9,298,4,5,0.32
9,9,impatient,9,299,2,7,0.36
9,9,implement,9,300,3,6,0.36
9,9,important,9,301,3,6,0.44
9,9,improve,7,302,3,4,0.28
9,9,incorrect,9,303,1,8,0.4
9,9,index,5,304,2,3,0.28
9,9,indicate,8,305,3,5,0.28
9,9,indirect,8,306,4,4,0.28
9,9,influence,9,307,2,7,0.36
9,9,info,4,308,3,1,0.24
9,9,inherent,8,309,2,6,0.32
9,9,injure,6,310,2,4,0.24
9,9,injury,6,311,5,1,0.16
9,9,insertion,9,312,2,7,0.48
9,9,inspect,7,313,3,4,0.24
9,9,instant,7,314,3,4,0.24
9,9,intake,6,315,2,4,0.24
9,9,integral,8,316,3,5,0.4
9,9,intended,8,317,4,4,0.28
9,9,intense,7,318,5,2,0.2
9,9,intensify,9,319,6,3,0.28
9,9,interior,8,320,4,4,0.36
9,9,into,4,321,3,1,0.12
9,9,involve,7,322,2,5,0.48
9,9,iron,4,323,1,3,0.36
9,9,jewellery,9,324,0,9,0.64
9,9,judicial,8,325,1,7,0.4
9,9,june,4,326,2,2,0.16
9,9,key,3,327,0,3,0.16
9,9,keyboard,8,328,3,5,0.44
9,9,kick,4,329,1,3,0.2
9,9,kid,3,330,2,1,0.12
9,9,kidney,6,331,3,3,0.2
9,9,kingdom,7,332,2,5,0.28
9,9,knife,5,333,1,4,0.32
9,9,know,4,334,2,2,0.16
9,9,lack,4,335,0,4,0.28
9,9,lake,4,336,2,2,0.16
9,9,landmark,8,337,2,6,0.32
9,9,latest,6,338,2,4,0.32
9,9,law,3,339,2,1,0.12
9,9,lawn,4,340,3,1,0.16
9,9,leaf,4,341,1,3,0.16
9,9,left,4,342,2,2,0.16
9,9,lens,4,343,2,2,0.16
9,9,lesbian,7,344,2,5,0.36
9,9,lesser,6,345,3,3,0.2
9,9,lie,3,346,1,2,0.12
9,9,lifestyle,9,347,2,7,0.36
9,9,limb,4,348,2,2,0.16
9,9,limited,7,349,3,4,0.36
9,9,link,4,350,2,2,0.16
9,9,lion,4,351,2,2,0.16
9,9,literary,8,352,2,6,0.32
9,9,live,4,353,2,2,0.16
9,9,local,5,354,1,4,0.32
9,9,located,7,355,4,3,0.24
9,9,look,4,356,2,2,0.16
9,9,love,4,357,2,2,0.16
9,9,mandate,7,358,0,7,0.52
9,9,map,3,359,2,1,0.2
9,9,master,6,360,2,4,0.24
9,9,match,5,361,2,3,0.2
9,9,maximum,7,362,2,5,0.28
9,9,meal,4,363,1,3,0.16
9,9,mean,4,364,3,1,0.2
9,9,melody,6,365,2,4,0.24
9,9,mention,7,366,2,5,0.28
9,9,mentor,6,367,4,2,0.2
9,9,merely,6,368,2,4,0.28
9,9,merger,6,369,3,3,0.32
9,9,metre,5,370,2,3,0.2
9,9,midnight,8,371,1,7,0.36
9,9,militia,7,372,2,5,0.32
9,9,mind,4,373,2,2,0.24
9,9,mirror,6,374,2,4,0.24
9,9,miserable,9,375,2,7,0.4
9,9,mixed,5,376,2,3,0.2
9,9,mobilize,8,377,1,7,0.44
9,9,model,5,378,2,3,0.2
9,9,modify,6,379,3,3,0.24
9,9,money,5,380,2,3,0.2
9,9,monument,8,381,3,5,0.4
9,9,more,4,382,2,2,0.16
9,9,most,4,383,2,2,0.16
9,9,movie,5,384,2,3,0.2
9,9,mum,3,385,1,2,0.12
9,9,musician,8,386,2,6,0.32
9,9,must,4,387,3,1,0.2
9,9,naked,5,388,0,5,0.24
9,9,narrative,9,389,2,7,0.36
9,9,nasty,5,390,2,3,0.2
9,9,nature,6,391,2,4,0.32
9,9,necessary,9,392,1,8,0.4
9,9,neck,4,393,3,1,0.12
9,9,needle,6,394,2,4,0.24
9,9,negative,8,395,2,6,0.4
9,9,newly,5,396,2,3,0.2
9,9,nominate,8,397,1,7,0.36
9,9,non,3,398,2,1,0.12
9,9,norm,4,399,2,2,0.16
9,9,northern,8,400,3,5,0.4
9,9,not,3,401,2,1,0.12
9,9,note,4,402,3,1,0.12
9,9,nothing,7,403,3,4,0.28
9,9,numerous,8,404,1,7,0.36
9,9,nut,3,405,2,1,0.24
9,9,objective,9,406,0,9,0.48
9,9,obsess,6,407,2,4,0.48
9,9,ocean,5,408,1,4,0.44
9,9,october,7,409,2,5,0.52
9,9,offend,6,410,1,5,0.28
9,9,offensive,9,411,5,4,0.28
9,9,offspring,9,412,3,6,0.4
9,9,online,6,413,1,5,0.28
9,9,option,6,414,1,5,0.28
9,9,organized,9,415,1,8,0.44
9,9,originate,9,416,2,7,0.48
9,9,other,5,417,1,4,0.2
9,9,otherwise,9,418,5,4,0.28
9,9,ought,5,419,1,4,0.2
9,9,outbreak,8,420,2,6,0.4
9,9,outfit,6,421,3,3,0.2
9,9,overall,7,422,1,6,0.28
9,9,owe,3,423,1,2,0.12
9,9,pad,3,424,0,3,0.16
9,9,painful,7,425,2,5,0.6
9,9,pants,5,426,2,3,0.52
9,9,parade,6,427,2,4,0.64
9,9,parallel,8,428,4,4,0.68
9,9,partial,7,429,3,4,0.72
9,9,patent,6,430,2,4,0.52
9,9,patience,8,431,3,5,0.72
9,9,pause,5,432,2,3,0.44
9,9,peaceful,8,433,1,7,0.92
9,9,peculiar,8,434,2,6,0.72
9,9,peer,4,435,2,2,0.4
9,9,pepper,6,436,2,4,0.72
9,9,perfect,7,437,2,5,1
9,9,perhaps,7,438,3,4,0.6
9,9,phone,5,439,1,4,0.48
9,9,physician,9,440,2,7,0.8
9,9,piece,5,441,1,4,0.64
9,9,pig,3,442,2,1,0.24
9,9,pile,4,443,2,2,0.32
9,9,plane,5,444,1,4,0.52
9,9,planning,8,445,4,4,0.6
9,9,play,4,446,3,1,0.28
9,9,plead,5,447,2,3,0.64
9,9,police,6,448,1,5,0.68
9,9,pollution,9,449,3,6,0.88
9,9,possess,7,450,2,5,0.64
9,9,post,4,451,3,1,0.44
9,9,prayer,6,452,1,5,0.6
9,9,pregnant,8,453,2,6,0.88
9,9,principal,9,454,2,7,0.88
9,9,printer,7,455,4,3,0.72
9,9,prior,5,456,3,2,0.4
9,9,priority,8,457,5,3,0.64
9,9,processor,9,458,2,7,1.36
9,9,produce,7,459,3,4,0.56
9,9,product,7,460,6,1,0.4
9,9,profile,7,461,3,4,0.56
9,9,project,7,462,3,4,0.68
9,9,properly,8,463,3,5,0.68
9,9,proposal,8,464,4,4,0.64
9,9,prosecute,9,465,3,6,1
9,9,protest,7,466,3,4,0.72
9,9,publicity,9,467,1,8,0.84
9,9,pump,4,468,2,2,0.32
9,9,put,3,469,2,1,0.24
9,9,quality,7,470,0,7,0.88
9,9,quantity,8,471,3,5,0.68
9,9,quest,5,472,2,3,0.44
9,9,racism,6,473,0,6,0.64
9,9,radar,5,474,2,3,0.44
9,9,railway,7,475,2,5,0.76
9,9,rally,5,476,2,3,0.44
9,9,rather,6,477,2,4,0.52
9,9,rating,6,478,3,3,0.48
9,9,realm,5,479,1,4,0.64
9,9,rear,4,480,3,1,0.28
9,9,reasoning,9,481,3,6,0.76
9,9,rebel,5,482,2,3,0.44
9,9,recall,6,483,2,4,0.52
9,9,reception,9,484,3,6,0.92
9,9,recording,9,485,3,6,0.76
9,9,refer,5,486,2,3,0.44
9,9,reference,9,487,5,4,0.84
9,9,refuse,6,488,3,3,0.44
9,9,regard,6,489,2,4,0.52
9,9,regime,6,490,3,3,0.44
9,9,regional,8,491,4,4,0.72
9,9,reign,5,492,2,3,0.44
9,9,rejection,9,493,2,7,0.8
9,9,relaxed,7,494,2,5,0.64
9,9,relevance,9,495,3,6,0.88
9,9,remainder,9,496,2,7,0.8
9,9,remind,6,497,3,3,0.48
9,9,removal,7,498,3,4,0.56
9,9,remove,6,499,5,1,0.48
9,9,replace,7,500,2,5,0.64
9,9,republic,8,501,3,5,0.68
9,9,research,8,502,2,6,0.72
9,9,residue,7,503,3,4,0.68
9,9,retail,6,504,2,4,0.52
9,9,reveal,6,505,2,4,0.52
9,9,revenge,7,506,4,3,0.48
9,9,revise,6,507,3,3,0.6
9,9,revival,7,508,4,3,0.48
9,9,revive,6,509,5,1,0.36
9,9,rifle,5,510,1,4,0.48
9,9,rip,3,511,2,1,0.24
9,9,rise,4,512,2,2,0.44
9,9,ritual,6,513,2,4,0.52
9,9,road,4,514,1,3,0.4
9,9,rob,3,515,2,1,0.24
9,9,robust,6,516,3,3,0.48
9,9,root,4,517,2,2,0.32
9,9,rough,5,518,2,3,0.56
9,9,round,5,519,3,2,0.4
9,9,rub,3,520,1,2,0.32
9,9,rubber,6,521,3,3,0.56
9,9,ruin,4,522,2,2,0.36
9,9,safe,4,523,0,4,1.24
9,9,sand,4,524,2,2,0.32
9,9,satellite,9,525,2,7,0.8
9,9,scan,4,526,1,3,0.4
9,9,schedule,8,527,2,6,0.72
9,9,scheme,6,528,4,2,0.68
9,9,scholar,7,529,3,4,0.6
9,9,school,6,530,4,2,0.48
9,9,scientist,9,531,2,7,0.92
9,9,secret,6,532,1,5,0.84
9,9,secretary,9,533,6,3,0.6
9,9,secure,6,534,3,3,0.56
9,9,security,8,535,5,3,0.96
9,9,segment,7,536,2,5,0.8
9,9,selective,9,537,2,7,0.8
9,9,serious,7,538,2,5,0.6
9,9,service,7,539,3,4,0.72
9,9,seven,5,540,2,3,0.44
9,9,sexual,6,541,2,4,0.52
9,9,sexy,4,542,3,1,0.28
9,9,shape,5,543,1,4,0.48
9,9,ship,4,544,2,2,0.36
9,9,shipping,8,545,4,4,0.76
9,9,shoot,5,546,2,3,0.44
9,9,shore,5,547,3,2,0.36
9,9,shortage,8,548,4,4,0.64
9,9,shortly,7,549,5,2,0.64
9,9,sibling,7,550,1,6,1.2
9,9,simply,6,551,2,4,0.52
9,9,singing,7,552,2,5,0.64
9,9,sink,4,553,3,1,0.6
9,9,sister,6,554,2,4,0.84
9,9,ski,3,555,1,2,0.28
9,9,skip,4,556,3,1,0.28
9,9,skull,5,557,2,3,0.68
9,9,slice,5,558,1,4,0.92
9,9,smile,5,559,1,4,0.64
9,9,smoking,7,560,2,5,0.6
9,9,soap,4,561,1,3,0.36
9,9,solar,5,562,2,3,0.44
9,9,solid,5,563,3,2,0.36
9,9,solo,4,564,3,1,0.44
9,9,sometimes,9,565,2,7,0.8
9,9,song,4,566,2,2,0.36
9,9,speaker,7,567,1,6,0.68
9,9,special,7,568,3,4,0.72
9,9,specify,7,569,5,2,0.44
9,9,spectator,9,570,4,5,0.68
9,9,speech,6,571,3,3,0.44
9,9,sphere,6,572,2,4,0.68
9,9,spin,4,573,2,2,0.32
9,9,spine,5,574,4,1,0.32
9,9,spokesman,9,575,2,7,0.88
9,9,spread,6,576,2,4,0.56
9,9,stable,6,577,1,5,0.72
9,9,staff,5,578,3,2,0.36
9,9,stamp,5,579,3,2,0.36
9,9,stance,6,580,3,3,0.48
9,9,standing,8,581,4,4,1.08
9,9,statue,6,582,3,3,0.48
9,9,stay,4,583,3,1,0.28
9,9,steadily,8,584,2,6,0.72
9,9,steer,5,585,3,2,0.36
9,9,stick,5,586,2,3,0.56
9,9,story,5,587,2,3,0.44
9,9,strange,7,588,2,5,0.64
9,9,strength,8,589,3,5,0.68
9,9,stretch,7,590,4,3,0.64
9,9,strict,6,591,3,3,0.48
9,9,striking,8,592,4,4,0.6
9,9,studio,6,593,2,4,0.52
9,9,stumble,7,594,3,4,0.68
9,9,stun,4,595,3,1,0.28
9,9,substance,9,596,1,8,0.88
9,9,such,4,597,2,2,0.32
9,9,sue,3,598,2,1,0.24
9,9,super,5,599,2,3,0.56
9,9,suppose,7,600,3,4,0.56
9,9,survival,8,601,2,6,0.72
9,9,swallow,7,602,1,6,0.68
9,9,sweater,7,603,2,5,0.76
9,9,swim,4,604,2,2,0.32
9,9,switch,6,605,3,3,0.44
9,9,symbolic,8,606,1,7,0.8
9,9,sympathy,8,607,3,5,0.8
9,9,synthesis,9,608,2,7,0.8
9,9,table,5,609,0,5,0.56
9,9,tail,4,610,2,2,0.32
9,9,tale,4,611,2,2,0.32
9,9,talent,6,612,4,2,0.56
9,9,taste,5,613,2,3,0.44
9,9,taxi,4,614,2,2,0.32
9,9,tea,3,615,1,2,0.28
9,9,tempt,5,616,2,3,0.44
9,9,tension,7,617,2,5,0.76
9,9,terribly,8,618,2,6,0.8
9,9,terrify,7,619,5,2,0.56
9,9,terror,6,620,4,2,0.48
9,9,terrorism,9,621,6,3,0.76
9,9,texture,7,622,2,5,0.64
9,9,thereby,7,623,1,6,0.68
9,9,thorough,8,624,2,6,0.72
9,9,three,5,625,2,3,0.56
9,9,thrilled,8,626,3,5,0.8
9,9,ticket,6,627,1,5,0.68
9,9,tidy,4,628,2,2,0.36
9,9,tight,5,629,2,3,0.48
9,9,tighten,7,630,5,2,0.64
9,9,till,4,631,2,2,0.32
9,9,together,8,632,1,7,0.76
9,9,tolerance,9,633,2,7,0.6
9,9,tonne,5,634,2,3,0.2
9,9,topic,5,635,2,3,0.2
9,9,tour,4,636,2,2,0.16
9,9,trap,4,637,1,3,0.16
9,9,treasure,8,638,2,6,0.4
9,9,treaty,6,639,4,2,0.2
9,9,tree,4,640,3,1,0.12
9,9,trend,5,641,3,2,0.16
9,9,tribal,6,642,2,4,0.24
9,9,tribe,5,643,4,1,0.12
9,9,trio,4,644,3,1,0.2
9,9,tropical,8,645,2,6,0.32
9,9,ultimate,8,646,0,8,0.36
9,9,unable,6,647,1,5,0.24
9,9,undermine,9,648,2,7,0.44
9,9,underwear,9,649,5,4,0.28
9,9,unfair,6,650,2,4,0.24
9,9,unify,5,651,2,3,0.28
9,9,unique,6,652,3,3,0.2
9,9,universal,9,653,3,6,0.32
9,9,until,5,654,2,3,0.2
9,9,unveil,6,655,2,4,0.24
9,9,uphold,6,656,1,5,0.32
9,9,urgent,6,657,1,5,0.24
9,9,utility,7,658,1,6,0.28
9,9,vague,5,659,0,5,0.24
9,9,variety,7,660,2,5,0.36
9,9,vary,4,661,3,1,0.12
9,9,vein,4,662,1,3,0.16
9,9,venture,7,663,2,5,0.28
9,9,vessel,6,664,2,4,0.2
9,9,veteran,7,665,2,5,0.36
9,9,video,5,666,1,4,0.2
9,9,viewer,6,667,2,4,0.24
9,9,virtual,7,668,2,5,0.28
9,9,virtue,6,669,5,1,0.24
9,9,visual,6,670,2,4,0.24
9,9,vital,5,671,2,3,0.16
9,9,vocal,5,672,1,4,0.2
9,9,wake,4,673,0,4,0.2
9,9,walk,4,674,2,2,0.24
9,9,warrior,7,675,2,5,0.24
9,9,washing,7,676,2,5,0.24
9,9,watch,5,677,2,3,0.16
9,9,water,5,678,3,2,0.16
9,9,way,3,679,2,1,0.2
9,9,weakness,8,680,1,7,0.32
9,9,weapon,6,681,3,3,0.2
9,9,weight,6,682,2,4,0.2
9,9,welcome,7,683,2,5,0.36
9,9,west,4,684,2,2,0.16
9,9,whenever,8,685,1,7,0.32
9,9,which,5,686,2,3,0.16
9,9,wildlife,8,687,1,7,0.4
9,9,window,6,688,2,4,0.2
9,9,wisdom,6,689,2,4,0.24
9,9,woman,5,690,1,4,0.2
9,9,word,4,691,2,2,0.16
9,9,workplace,9,692,3,6,0.4
9,9,wow,3,693,2,1,0.08
9,9,wrist,5,694,1,4,0.2
9,9,yellow,6,695,0,6,0.28
9,9,young,5,696,1,4,0.2
