lettersIn,batchIn,wordIn,wordLengthIn,numWordsOut,numReadLettersOut,numNewLettersOut,timeOut
10,0,absent,6,0,0,6,3.75
10,0,abstract,8,1,3,5,3.75
10,0,academy,7,2,1,6,11.75
10,0,accent,6,3,2,4,3
10,0,acceptance,10,4,4,6,11.75
10,0,access,6,5,4,2,2
10,0,accessible,10,6,6,4,3.5
10,0,according,9,7,3,6,11.75
10,0,account,7,8,4,3,2.75
10,0,act,3,9,2,1,1
10,0,action,6,10,3,3,2.25
10,0,admission,9,11,1,8,12.5
10,0,advanced,8,12,2,6,4.25
10,0,affection,9,13,1,8,12
10,0,afraid,6,14,2,4,3
10,0,ah,2,15,1,1,0.75
10,0,aircraft,8,16,1,7,11.5
10,0,alike,5,17,1,4,2.75
10,0,all,3,18,2,1,1
10,0,allegedly,9,19,3,6,4.25
10,0,alliance,8,20,3,5,11
10,0,allow,5,21,3,2,1.75
10,0,along,5,22,2,3,2.25
10,0,also,4,23,2,2,1.75
10,0,ambitious,9,24,1,8,12.75
10,0,amid,4,25,2,2,1.75
10,0,angel,5,26,1,4,2.75
10,0,anyone,6,27,2,4,9.75
10,0,anything,8,28,3,5,3.75
10,0,apart,5,29,1,4,2.75
10,0,appearance,10,30,2,8,12.5
10,0,appetite,8,31,4,4,3.25
10,0,arena,5,32,1,4,2.75
10,0,arrival,7,33,2,5,10.5
10,0,asset,5,34,1,4,2.75
10,0,associated,10,35,3,7,11.75
10,0,athlete,7,36,1,6,4
10,0,attach,6,37,2,4,3
10,0,attendance,10,38,3,7,11.75
10,0,audience,8,39,1,7,4.75
10,0,audit,5,40,4,1,1.5
10,0,authority,9,41,2,7,11.5
10,0,away,4,42,1,3,2.25
10,0,back,4,43,0,4,10.25
10,0,backdrop,8,44,4,4,3.25
10,0,ballot,6,45,2,4,3
10,0,bare,4,46,2,2,1.5
10,0,basis,5,47,2,3,6
10,0,basket,6,48,3,3,7.75
10,0,basketball,10,49,6,4,6.5
10,0,bean,4,50,1,3,2.75
10,0,bear,4,51,3,1,1.5
10,0,become,6,52,2,4,13.75
10,0,bee,3,53,2,1,1.25
10,0,before,6,54,2,4,3
10,0,beginning,9,55,2,7,13.5
10,0,being,5,56,2,3,2.25
10,0,beneath,7,57,2,5,3.5
10,0,beside,6,58,2,4,3
10,0,bet,3,59,2,1,1
10,0,bias,4,60,1,3,9.75
10,0,bicycle,7,61,2,5,4.75
10,0,big,3,62,2,1,1
10,0,biological,10,63,2,8,13.75
10,0,biology,7,64,6,1,1.75
10,0,blast,5,65,1,4,2.75
10,0,body,4,66,1,3,2.25
10,0,booking,7,67,2,5,13.5
10,0,born,4,68,2,2,3
10,0,brain,5,69,1,4,4.75
10,0,branch,6,70,3,3,2.75
10,0,bread,5,71,2,3,11.25
10,0,breast,6,72,4,2,2.5
10,0,breath,6,73,4,2,2.25
10,0,bring,5,74,2,3,2.5
10,0,broadband,9,75,2,7,13
10,0,broadcast,9,76,5,4,3.75
10,0,broadly,7,77,5,2,2.5
10,0,brother,7,78,3,4,3.25
10,0,building,8,79,1,7,12.75
10,0,burial,6,80,2,4,3
10,0,burst,5,81,3,2,2
10,0,bury,4,82,3,1,1.5
10,0,but,3,83,2,1,9
10,0,button,6,84,3,3,2.5
10,0,cabinet,7,85,0,7,4.5
10,0,calm,4,86,2,2,1.75
10,0,camp,4,87,2,2,9.5
10,0,captain,7,88,2,5,3.5
10,0,capture,7,89,4,3,2.75
10,0,carriage,8,90,2,6,12
10,0,case,4,91,2,2,1.75
10,0,castle,6,92,3,3,2.5
10,0,cat,3,93,2,1,1
10,0,catch,5,94,3,2,1.75
10,0,cause,5,95,2,3,2.5
10,0,caution,7,96,3,4,11
10,0,cautious,8,97,6,2,2.25
10,0,centre,6,98,1,5,3.75
10,0,champion,8,99,1,7,14
10,0,chance,6,100,3,3,3
10,0,charge,6,101,3,3,3
10,0,chat,4,102,3,1,1.25
10,0,chest,5,103,2,3,11.25
10,0,cigarette,9,104,1,8,5.5
10,0,civic,5,105,2,3,2.75
10,0,claim,5,106,1,4,11.25
10,0,class,5,107,3,2,2
10,0,classical,9,108,5,4,3.75
10,0,cleaning,8,109,2,6,12.5
10,0,climate,7,110,2,5,3.75
10,0,clip,4,111,3,1,1.25
10,0,clock,5,112,2,3,2.5
10,0,cloth,5,113,3,2,2
10,0,cognitive,9,114,1,8,16.5
10,0,college,7,115,2,5,4.25
10,0,columnist,9,116,3,6,13.5
10,0,combat,6,117,2,4,3
10,0,comic,5,118,3,2,2.5
10,0,commander,9,119,3,6,12.75
10,0,commerce,8,120,4,4,3.25
10,0,commit,6,121,4,2,2
10,0,comparison,10,122,3,7,12
10,0,compelling,10,123,4,6,4.5
10,0,complain,8,124,4,4,3.25
10,0,complex,7,125,5,2,9.5
10,0,compose,7,126,4,3,2.75
10,0,comprise,8,127,4,4,3
10,0,computer,8,128,4,4,3
10,0,concerned,9,129,2,7,11.75
10,0,conclude,8,130,4,4,2.25
10,0,concrete,8,131,4,4,1.75
10,0,confession,10,132,3,7,6.75
10,0,confuse,7,133,4,3,1.25
10,0,confusion,9,134,6,3,1.5
10,0,consist,7,135,3,4,199.75
10,0,conspiracy,10,136,4,6,5.25
10,0,constitute,10,137,4,6,5
10,0,construct,9,138,5,4,10.25
10,0,consumer,8,139,4,4,4.75
10,0,contact,7,140,3,4,4
10,0,contender,9,141,4,5,10.75
10,0,contest,7,142,5,2,3.25
10,0,context,7,143,5,2,2.75
10,0,conviction,10,144,3,7,15.25
10,0,cooking,7,145,2,5,4.75
10,0,copy,4,146,2,2,2
10,0,correlate,9,147,2,7,14
10,0,correspond,10,148,5,5,5.5
10,0,corrupt,7,149,4,3,3.75
10,0,costume,7,150,2,5,9.25
10,0,cotton,6,151,2,4,10
10,0,council,7,152,2,5,4.25
10,0,covered,7,153,2,5,21.5
10,0,cow,3,154,2,1,1.25
10,0,crazy,5,155,1,4,3.25
10,0,creative,8,156,2,6,5
10,0,creator,7,157,5,2,9
10,0,critical,8,158,2,6,4.25
10,0,critique,8,159,5,3,2.75
10,0,cue,3,160,1,2,1.5
10,0,cult,4,161,2,2,1.75
10,0,custody,7,162,2,5,8.75
10,0,dark,4,163,0,4,2.75
10,0,data,4,164,2,2,1.75
10,0,database,8,165,4,4,8.5
10,0,date,4,166,3,1,1.25
10,0,dead,4,167,1,3,2
10,0,deadline,8,168,4,4,3.25
10,0,deadly,6,169,5,1,1.25
10,0,deck,4,170,2,2,1.75
10,0,decorate,8,171,3,5,9.25
10,0,dedicated,9,172,2,7,4.75
10,0,defend,6,173,2,4,8.5
10,0,defensive,9,174,5,4,3.25
10,0,define,6,175,3,3,2.5
10,0,delivery,8,176,2,6,9.75
10,0,denial,6,177,2,4,3
10,0,depart,6,178,2,4,2.75
10,0,dependence,10,179,3,7,10
10,0,dependent,9,180,8,1,2
10,0,depict,6,181,3,3,2.5
10,0,derive,6,182,2,4,2.75
10,0,descend,7,183,2,5,8.75
10,0,desperate,9,184,3,6,4.25
10,0,destroy,7,185,3,4,3
10,0,detail,6,186,2,4,8.25
10,0,detection,9,187,3,6,4.25
10,0,determined,10,188,4,6,9.75
10,0,devise,6,189,2,4,3
10,0,dialogue,8,190,1,7,4.5
10,0,diary,5,191,3,2,7
10,0,dictionary,10,192,2,8,5.5
10,0,differ,6,193,2,4,2.75
10,0,direction,9,194,2,7,10
10,0,directory,9,195,6,3,2.75
10,0,discharge,9,196,2,7,9.75
10,0,disease,7,197,3,4,3
10,0,dispose,7,198,3,4,3.25
10,0,dispute,7,199,4,3,7.75
10,0,distinct,8,200,3,5,3.75
10,0,district,8,201,4,4,3.25
10,0,diverse,7,202,2,5,9
10,0,doctrine,8,203,1,7,4.75
10,0,dominance,9,204,2,7,10.25
10,0,donate,6,205,2,4,3
10,0,dose,4,206,2,2,1.5
10,0,drag,4,207,1,3,2
10,0,dramatic,8,208,3,5,8.75
10,0,draw,4,209,3,1,1.25
10,0,drive,5,210,2,3,2.25
10,0,drown,5,211,2,3,2.25
10,0,drum,4,212,2,2,1.5
10,0,drunk,5,213,3,2,1.75
10,0,dry,3,214,2,1,6
10,0,due,3,215,1,2,1.5
10,0,dull,4,216,2,2,1.75
10,0,dump,4,217,2,2,1.5
10,0,during,6,218,2,4,2.75
10,0,duty,4,219,2,2,1.5
10,0,dynamic,7,220,1,6,9.25
10,0,each,4,221,0,4,2.75
10,0,easily,6,222,2,4,3
10,0,easy,4,223,3,1,6.5
10,0,eat,3,224,2,1,1
10,0,ecological,10,225,1,9,6
10,0,edge,4,226,1,3,7.5
10,0,editorial,9,227,2,7,4.75
10,0,educated,8,228,2,6,4.25
10,0,efficiency,10,229,1,9,11.25
10,0,elaborate,9,230,1,8,10.5
10,0,electoral,9,231,2,7,4.75
10,0,electric,8,232,5,3,2.75
10,0,elementary,10,233,3,7,10
10,0,else,4,234,2,2,1.75
10,0,emerge,6,235,1,5,8.5
10,0,emotional,9,236,2,7,5
10,0,emphasize,9,237,2,7,10
10,0,employ,6,238,3,3,2.75
10,0,endorse,7,239,1,6,4
10,0,enforce,7,240,2,5,8.75
10,0,enquire,7,241,2,5,3.5
10,0,enrol,5,242,2,3,2.25
10,0,entire,6,243,2,4,2.75
10,0,epidemic,8,244,1,7,10
10,0,equation,8,245,1,7,4.5
10,0,equivalent,10,246,3,7,10.25
10,0,erupt,5,247,1,4,2.75
10,0,escape,6,248,1,5,8.75
10,0,ethical,7,249,1,6,4
10,0,every,5,250,1,4,3
10,0,everywhere,10,251,5,5,9.75
10,0,evil,4,252,2,2,1.75
10,0,evolution,9,253,2,7,4.75
10,0,exam,4,254,1,3,8
10,0,except,6,255,2,4,3
10,0,excitement,10,256,3,7,5
10,0,exert,5,257,2,3,7.75
10,0,exotic,6,258,2,4,3
10,0,expect,6,259,2,4,2.75
10,0,explosion,9,260,3,6,9.75
10,0,export,6,261,3,3,2.5
10,0,exposure,8,262,4,4,3.25
10,0,external,8,263,2,6,9.75
10,0,extra,5,264,3,2,1.75
10,0,facility,8,265,0,8,5
10,0,factory,7,266,3,4,8.75
10,0,faith,5,267,2,3,2.25
10,0,favour,6,268,2,4,2.75
10,0,favourite,9,269,6,3,2.75
10,0,feat,4,270,1,3,7.5
10,0,feather,7,271,4,3,2.5
10,0,feature,7,272,4,3,2.5
10,0,feed,4,273,2,2,1.75
10,0,fence,5,274,2,3,8
10,0,festival,8,275,2,6,4.25
10,0,figure,6,276,1,5,4
10,0,fill,4,277,2,2,5.25
10,0,film,4,278,3,1,4.25
10,0,filter,6,279,3,3,2.5
10,0,finish,6,280,2,4,2.75
10,0,fire,4,281,2,2,1.5
10,0,firearm,7,282,4,3,2.25
10,0,first,5,283,3,2,7.75
10,0,fish,4,284,2,2,1.75
10,0,fishing,7,285,4,3,2.5
10,0,flame,5,286,1,4,2.75
10,0,flaw,4,287,3,1,1.25
10,0,flawed,6,288,4,2,8.75
10,0,fleet,5,289,2,3,2.5
10,0,flour,5,290,2,3,2.25
10,0,follow,6,291,1,5,3.5
10,0,fond,4,292,2,2,8
10,0,forecast,8,293,2,6,4
10,0,forever,7,294,4,3,2.75
10,0,forge,5,295,3,2,1.75
10,0,forgive,7,296,4,3,6.25
10,0,formal,6,297,3,3,1.25
10,0,format,6,298,5,1,0.75
10,0,forth,5,299,3,2,0.75
10,0,fossil,6,300,2,4,1.25
10,0,frame,5,301,1,4,4.75
10,0,framework,9,302,5,4,1.5
10,0,franchise,9,303,3,6,2
10,0,frankly,7,304,4,3,4.5
10,0,frequently,10,305,2,8,2.5
10,0,from,4,306,2,2,0.75
10,0,function,8,307,1,7,5.5
10,0,furious,7,308,2,5,1.75
10,0,gambling,8,309,0,8,5.75
10,0,gang,4,310,2,2,0.75
10,0,garden,6,311,2,4,1.25
10,0,gas,3,312,2,1,0.5
10,0,gentle,6,313,1,5,5
10,0,genuine,7,314,3,4,1.5
10,0,ghost,5,315,1,4,1.25
10,0,goal,4,316,1,3,4.25
10,0,goods,5,317,2,3,1.25
10,0,governance,10,318,2,8,2.5
10,0,gradually,9,319,1,8,5.75
10,0,graduate,8,320,6,2,1
10,0,grant,5,321,3,2,0.75
10,0,greenhouse,10,322,2,8,5.75
10,0,guideline,9,323,1,8,2.25
10,0,half,4,324,0,4,4.75
10,0,hand,4,325,2,2,1
10,0,hardware,8,326,2,6,2
10,0,hatred,6,327,2,4,4.75
10,0,he,2,328,1,1,0.5
10,0,healthcare,10,329,2,8,2.25
10,0,hear,4,330,3,1,0.5
10,0,heating,7,331,3,4,4.75
10,0,hello,5,332,2,3,1
10,0,helmet,6,333,3,3,1
10,0,help,4,334,3,1,0.5
10,0,hence,5,335,2,3,1
10,0,hidden,6,336,1,5,5.25
10,0,hierarchy,9,337,2,7,2.25
10,0,highway,7,338,2,5,5.5
10,0,hill,4,339,2,2,0.75
10,0,himself,7,340,2,5,1.5
10,0,hobby,5,341,1,4,1.25
10,0,hockey,6,342,2,4,5
10,0,homeless,8,343,2,6,1.75
10,0,homework,8,344,4,4,1.5
10,0,honour,6,345,2,4,4.75
10,0,hook,4,346,2,2,0.75
10,0,horizon,7,347,2,5,1.5
10,0,hostile,7,348,2,5,5.5
10,0,housing,7,349,2,5,1.75
10,0,ideology,8,350,0,8,5.75
10,0,imagine,7,351,1,6,2
10,0,impact,6,352,2,4,1.5
10,0,inadequate,10,353,1,9,6.25
10,0,incidence,9,354,2,7,6
10,0,including,9,355,3,6,2.25
10,0,indeed,6,356,2,4,1.25
10,0,indoors,7,357,3,4,4.75
10,0,infection,9,358,2,7,2
10,0,inflation,9,359,3,6,5.75
10,0,inhabitant,10,360,2,8,2.5
10,0,initial,7,361,2,5,1.5
10,0,injured,7,362,2,5,5.25
10,0,inmate,6,363,2,4,1.25
10,0,innovative,10,364,2,8,6.25
10,0,input,5,365,2,3,1
10,0,insect,6,366,2,4,1.25
10,0,inspire,7,367,3,4,5
10,0,instantly,9,368,3,6,2
10,0,insult,6,369,3,3,1.25
10,0,intensity,9,370,2,7,5.75
10,0,intention,9,371,5,4,1.75
10,0,interview,9,372,4,5,1.75
10,0,invent,6,373,2,4,4.75
10,0,investor,8,374,4,4,1.75
10,0,invisible,9,375,3,6,2
10,0,invoke,6,376,3,3,4.5
10,0,irrelevant,10,377,1,9,2.5
10,0,isolation,9,378,1,8,6
10,0,jam,3,379,0,3,0.75
10,0,jeans,5,380,1,4,1.25
10,0,join,4,381,1,3,4.75
10,0,joint,5,382,4,1,0.75
10,0,journalist,10,383,2,8,2.5
10,0,july,4,384,1,3,4.75
10,0,keen,4,385,0,4,1.25
10,0,kidnap,6,386,1,5,1.5
10,0,kill,4,387,2,2,1
10,0,kiss,4,388,2,2,4.5
10,0,knock,5,389,1,4,1.5
10,0,knowledge,9,390,3,6,2
10,0,label,5,391,0,5,5
10,0,lady,4,392,2,2,0.75
10,0,lane,4,393,2,2,0.75
10,0,language,8,394,3,5,1.5
10,0,laptop,6,395,2,4,4.75
10,0,lawsuit,7,396,2,5,1.5
10,0,lawyer,6,397,3,3,1.25
10,0,legacy,6,398,1,5,5.5
10,0,legal,5,399,4,1,0.75
10,0,leisure,7,400,2,5,1.5
10,0,less,4,401,2,2,0.75
10,0,let,3,402,2,1,0.5
10,0,light,5,403,1,4,4.75
10,0,likewise,8,404,2,6,2
10,0,limit,5,405,2,3,1
10,0,listener,8,406,2,6,5.5
10,0,lively,6,407,2,4,1.25
10,0,loan,4,408,1,3,1
10,0,lobby,5,409,2,3,1
10,0,logic,5,410,2,3,4.75
10,0,logo,4,411,3,1,0.75
10,0,loop,4,412,2,2,0.75
10,0,lovely,6,413,2,4,1.25
10,0,lower,5,414,2,3,1
10,0,magazine,8,415,0,8,6
10,0,major,5,416,2,3,1
10,0,management,10,417,2,8,6
10,0,marathon,8,418,2,6,1.75
10,0,marry,5,419,3,2,1
10,0,matching,8,420,2,6,8
10,0,matter,6,421,3,3,1.25
10,0,me,2,422,1,1,0.5
10,0,means,5,423,2,3,1
10,0,medicine,8,424,2,6,5.5
10,0,meditation,10,425,4,6,2
10,0,menu,4,426,2,2,0.75
10,0,metal,5,427,2,3,4.75
10,0,metaphor,8,428,4,4,1.5
10,0,military,8,429,1,7,2
10,0,milk,4,430,3,1,0.75
10,0,mining,6,431,2,4,5
10,0,minor,5,432,3,2,1
10,0,miracle,7,433,2,5,1.5
10,0,missile,7,434,2,5,6
10,0,mistake,7,435,3,4,1.5
10,0,modest,6,436,1,5,1.5
10,0,momentum,8,437,2,6,6.25
10,0,monitor,7,438,2,5,1.75
10,0,monk,4,439,3,1,0.5
10,0,motive,6,440,2,4,5.25
10,0,mount,5,441,2,3,1
10,0,mountain,8,442,5,3,1.25
10,0,move,4,443,2,2,0.75
10,0,multiply,8,444,1,7,6
10,0,musical,7,445,2,5,1.75
10,0,mystery,7,446,1,6,1.75
10,0,naturally,9,447,0,9,6.75
10,0,naval,5,448,2,3,1.25
10,0,necessity,9,449,1,8,6.5
10,0,neglect,7,450,2,5,1.75
10,0,nerve,5,451,2,3,5
10,0,net,3,452,2,1,0.5
10,0,network,7,453,3,4,1.25
10,0,news,4,454,2,2,0.75
10,0,nineteen,8,455,1,7,5.5
10,0,ninety,6,456,5,1,0.75
10,0,noble,5,457,1,4,1.25
10,0,nod,3,458,2,1,0.5
10,0,nonsense,8,459,2,6,1.75
10,0,now,3,460,2,1,4
10,0,nurse,5,461,1,4,1.25
10,0,nursing,7,462,4,3,1
10,0,nutrition,9,463,2,7,5.75
10,0,o,1,464,0,1,0.25
10,0,obey,4,465,1,3,1
10,0,object,6,466,2,4,1.25
10,0,observe,7,467,2,5,5.25
10,0,obtain,6,468,2,4,1.25
10,0,obvious,7,469,2,5,1.75
10,0,occasion,8,470,1,7,6
10,0,occur,5,471,3,2,0.75
10,0,of,2,472,1,1,0.5
10,0,offender,8,473,2,6,1.75
10,0,onion,5,474,1,4,5
10,0,open,4,475,1,3,1
10,0,operate,7,476,3,4,1.5
10,0,operator,8,477,6,2,1
10,0,optimism,8,478,2,6,6.5
10,0,orchestra,9,479,1,8,2.75
10,0,ordinary,8,480,2,6,6.5
10,0,organize,8,481,2,6,2.25
10,0,originally,10,482,2,8,7.25
10,0,overseas,8,483,1,7,2.5
10,0,own,3,484,1,2,5.25
10,0,pair,4,485,0,4,1.25
10,0,parameter,9,486,2,7,2.5
10,0,parent,6,487,3,3,8.5
10,0,party,5,488,3,2,2
10,0,passing,7,489,2,5,4
10,0,pathway,7,490,2,5,3.75
10,0,payment,7,491,2,5,10.75
10,0,penalty,7,492,1,6,4
10,0,pension,7,493,3,4,10.25
10,0,people,6,494,2,4,3
10,0,period,6,495,2,4,3
10,0,permanent,9,496,3,6,11.5
10,0,persuade,8,497,3,5,3.75
10,0,physics,7,498,1,6,4
10,0,pilot,5,499,1,4,10.25
10,0,pit,3,500,2,1,1
10,0,plain,5,501,1,4,2.75
10,0,player,6,502,3,3,2.5
10,0,plunge,6,503,2,4,10.5
10,0,pocket,6,504,1,5,3.5
10,0,policeman,9,505,2,7,12
10,0,policy,6,506,5,1,1.5
10,0,politics,8,507,4,4,3.5
10,0,pop,3,508,2,1,1
10,0,popular,7,509,3,4,3
10,0,popularity,10,510,7,3,9.75
10,0,pose,4,511,2,2,1.75
10,0,positive,8,512,3,5,3.75
10,0,potential,9,513,2,7,11.75
10,0,powder,6,514,2,4,3
10,0,precision,9,515,1,8,5.25
10,0,prefer,6,516,3,3,8.75
10,0,premium,7,517,3,4,3
10,0,present,7,518,3,4,3
10,0,president,9,519,4,5,10.25
10,0,prevalence,10,520,3,7,5
10,0,previous,8,521,4,4,3.25
10,0,prey,4,522,3,1,7.25
10,0,prince,6,523,2,4,3
10,0,prison,6,524,3,3,2.5
10,0,prisoner,8,525,6,2,2
10,0,privilege,9,526,3,6,12.5
10,0,probably,8,527,2,6,6.25
10,0,production,10,528,3,7,11.25
10,0,profitable,10,529,3,7,5
10,0,promote,7,530,3,4,3
10,0,promotion,9,531,6,3,9
10,0,pronounce,9,532,3,6,4.25
10,0,pronounced,10,533,9,1,1.75
10,0,prosecutor,10,534,3,7,12.25
10,0,protection,10,535,3,7,5.25
10,0,provide,7,536,3,4,3
10,0,provincial,10,537,5,5,12.75
10,0,provoke,7,538,4,3,3
10,0,psychology,10,539,1,9,13.75
10,0,punishment,10,540,1,9,6
10,0,purple,6,541,2,4,10.25
10,0,queen,5,542,0,5,3.25
10,0,question,8,543,3,5,3.75
10,0,queue,5,544,3,2,8.25
10,0,quickly,7,545,2,5,3.5
10,0,quietly,7,546,3,4,3
10,0,quota,5,547,2,3,2.25
10,0,quote,5,548,4,1,11.75
10,0,radio,5,549,0,5,1658
10,0,random,6,550,2,4,3.25
10,0,rapid,5,551,2,3,2.75
10,0,read,4,552,1,3,2.5
10,0,readily,7,553,4,3,8.75
10,0,reading,7,554,5,2,1.75
10,0,real,4,555,3,1,1
10,0,really,6,556,4,2,1.25
10,0,rebellion,9,557,2,7,8.25
10,0,receive,7,558,2,5,2.25
10,0,recession,9,559,4,5,2.5
10,0,recovery,8,560,3,5,7.75
10,0,refuge,6,561,2,4,2
10,0,refugee,7,562,6,1,1.25
10,0,register,8,563,2,6,2.75
10,0,regret,6,564,3,3,8.5
10,0,regularly,9,565,3,6,3
10,0,regulator,9,566,6,3,2.5
10,0,relatively,10,567,2,8,9
10,0,reliable,8,568,3,5,2.5
10,0,remote,6,569,2,4,7
10,0,renowned,8,570,2,6,2.75
10,0,rental,6,571,3,3,2
10,0,repeated,8,572,2,6,8.5
10,0,reputation,10,573,3,7,3.5
10,0,request,7,574,2,5,7.75
10,0,restaurant,10,575,2,8,3.5
10,0,restraint,9,576,4,5,6.75
10,0,reverse,7,577,2,5,1.75
10,0,review,6,578,3,3,1.25
10,0,rhythm,6,579,1,5,6
10,0,rice,4,580,1,3,1.25
10,0,ridiculous,10,581,2,8,2.5
10,0,riot,4,582,2,2,1
10,0,rock,4,583,1,3,5.75
10,0,romantic,8,584,2,6,2.25
10,0,royal,5,585,2,3,1.25
10,0,rugby,5,586,1,4,5.5
10,0,runner,6,587,2,4,1.5
10,0,sad,3,588,0,3,1
10,0,sadly,5,589,3,2,0.75
10,0,sail,4,590,2,2,4.75
10,0,saint,5,591,3,2,1
10,0,sanction,8,592,2,6,2
10,0,say,3,593,2,1,0.5
10,0,scream,6,594,1,5,6
10,0,sea,3,595,1,2,0.75
10,0,see,3,596,2,1,0.5
10,0,seize,5,597,2,3,1
10,0,senator,7,598,2,5,1.5
10,0,send,4,599,3,1,0.5
10,0,senior,6,600,3,3,5.75
10,0,sensation,9,601,3,6,2.25
10,0,sentence,8,602,3,5,6.25
10,0,session,7,603,2,5,1.75
10,0,set,3,604,2,1,0.5
10,0,several,7,605,2,5,1.5
10,0,sex,3,606,2,1,0.5
10,0,shade,5,607,1,4,5.75
10,0,shake,5,608,3,2,1
10,0,shall,5,609,3,2,1
10,0,sheet,5,610,2,3,1
10,0,shine,5,611,2,3,1
10,0,shocking,8,612,2,6,7.25
10,0,should,6,613,3,3,1.5
10,0,shout,5,614,4,1,1
10,0,shrink,6,615,2,4,6.5
10,0,silence,7,616,1,6,3
10,0,silent,6,617,5,1,0.75
10,0,silly,5,618,3,2,1
10,0,simulate,8,619,2,6,6.5
10,0,sir,3,620,2,1,0.5
10,0,sixty,5,621,2,3,1
10,0,size,4,622,2,2,1
10,0,skiing,6,623,1,5,2
10,0,sky,3,624,2,1,5
10,0,slave,5,625,1,4,1.5
10,0,slow,4,626,2,2,1
10,0,soar,4,627,1,3,1
10,0,soccer,6,628,2,4,6
10,0,society,7,629,3,4,1.75
10,0,soft,4,630,2,2,0.75
10,0,software,8,631,4,4,1.5
10,0,soldier,7,632,2,5,6.25
10,0,somewhere,9,633,2,7,2.5
10,0,son,3,634,2,1,0.5
10,0,source,6,635,2,4,6
10,0,span,4,636,1,3,1
10,0,speculate,9,637,2,7,2.25
10,0,spending,8,638,3,5,6.5
10,0,spicy,5,639,2,3,1.25
10,0,spite,5,640,3,2,1
10,0,spoon,5,641,2,3,1
10,0,sport,5,642,3,2,1
10,0,stadium,7,643,1,6,6.5
10,0,stage,5,644,3,2,1
10,0,status,6,645,3,3,1.25
10,0,stream,6,646,2,4,5.75
10,0,stress,6,647,4,2,1.25
10,0,structure,9,648,3,6,2.25
10,0,student,7,649,2,5,1.75
10,0,stupid,6,650,3,3,6
10,0,suburb,6,651,1,5,1.5
10,0,summarize,9,652,2,7,7.25
10,0,summer,6,653,4,2,1
10,0,summit,6,654,4,2,1
10,0,superb,6,655,2,4,1.5
10,0,supervisor,10,656,5,5,6.75
10,0,surge,5,657,2,3,1.25
10,0,surrender,9,658,3,6,2
10,0,suspicious,10,659,2,8,7
10,0,swimming,8,660,1,7,2.25
10,0,syndrome,8,661,1,7,7
10,0,t,1,662,0,1,0.25
10,0,technique,9,663,1,8,4.5
10,0,teenage,7,664,2,5,4.25
10,0,teenager,8,665,7,1,0.75
10,0,tent,4,666,2,2,0.75
10,0,tenure,6,667,3,3,1.25
10,0,terrain,7,668,2,5,6.25
10,0,testing,7,669,2,5,1.75
10,0,than,4,670,1,3,1
10,0,that,4,671,3,1,0.5
10,0,theft,5,672,2,3,5.75
10,0,theirs,6,673,3,3,1.25
10,0,then,4,674,3,1,0.75
10,0,theology,8,675,3,5,1.75
10,0,there,5,676,3,2,0.75
10,0,thick,5,677,2,3,5.25
10,0,thin,4,678,3,1,0.5
10,0,thought,7,679,2,5,1.5
10,0,threat,6,680,2,4,1.25
10,0,thrive,6,681,3,3,5.75
10,0,throughout,10,682,3,7,2.5
10,0,total,5,683,1,4,1.25
10,0,touch,5,684,2,3,6
10,0,toy,3,685,2,1,0.5
10,0,transform,9,686,1,8,2.25
10,0,trillion,8,687,2,6,7
10,0,troubled,8,688,2,6,2
10,0,true,4,689,2,2,0.75
10,0,truly,5,690,3,2,5.5
10,0,trust,5,691,3,2,1
10,0,try,3,692,2,1,0.5
10,0,tuesday,7,693,1,6,2
10,0,tunnel,6,694,2,4,6
10,0,turn,4,695,2,2,0.75
10,0,turnout,7,696,4,3,1
10,0,turnover,8,697,5,3,1.25
10,0,typical,7,698,1,6,6.5
10,0,ugly,4,699,0,4,1.25
10,0,ultimately,10,700,1,9,7.25
10,0,umbrella,8,701,1,7,2.25
10,0,unfold,6,702,1,5,1.5
10,0,unit,4,703,2,2,6.5
10,0,unlike,6,704,2,4,2.5
10,0,unlikely,8,705,6,2,1.25
10,0,up,2,706,1,1,0.5
10,0,upset,5,707,2,3,1.5
10,0,upwards,7,708,2,5,8.25
10,0,us,2,709,1,1,0.5
10,0,use,3,710,2,1,0.75
10,0,used,4,711,3,1,0.75
10,0,user,4,712,3,1,0.75
10,0,utterly,7,713,1,6,2.25
10,0,vast,4,714,0,4,7.25
10,0,versus,6,715,1,5,1.75
10,0,very,4,716,3,1,0.75
10,0,vicious,7,717,1,6,7
10,0,victim,6,718,3,3,1.25
10,0,violation,9,719,2,7,2.75
10,0,volume,6,720,1,5,6.75
10,0,voluntary,9,721,4,5,1.75
10,0,vote,4,722,2,2,1
10,0,want,4,723,0,4,6
10,0,warfare,7,724,2,5,1.75
10,0,wash,4,725,2,2,0.75
10,0,we,2,726,1,1,0.25
10,0,weak,4,727,2,2,0.75
10,0,wear,4,728,3,1,0.5
10,0,weather,7,729,3,4,9
10,0,website,7,730,2,5,3.5
10,0,week,4,731,2,2,1.5
10,0,weekly,6,732,4,2,1.75
10,0,when,4,733,1,3,9.25
10,0,where,5,734,3,2,1.75
10,0,while,5,735,2,3,2.25
10,0,whilst,6,736,4,2,2
10,0,whisper,7,737,3,4,3
10,0,who,3,738,2,1,8.25
10,0,whole,5,739,3,2,2
10,0,wide,4,740,1,3,2.25
10,0,widely,6,741,4,2,2
10,0,winner,6,742,2,4,3
10,0,winter,6,743,3,3,10
10,0,wise,4,744,2,2,1.75
10,0,withdraw,8,745,2,6,4.25
10,0,workout,7,746,1,6,11.75
10,0,worldwide,9,747,3,6,4.25
10,0,worse,5,748,3,2,1.75
10,0,writing,7,749,1,6,11.5
10,0,wrong,5,750,2,3,2.25
10,0,yesterday,9,751,0,9,13.5
10,0,yourself,8,752,1,7,4.75
10,0,zero,4,753,0,4,2.75
10,1,ability,7,0,0,7,4.5
10,1,abortion,8,1,2,6,11.75
10,1,about,5,2,3,2,2
10,1,above,5,3,3,2,1.75
10,1,abroad,6,4,2,4,2.75
10,1,absent,6,5,2,4,3
10,1,abstract,8,6,3,5,12
10,1,accent,6,7,1,5,3.5
10,1,access,6,8,4,2,2
10,1,accessible,10,9,6,4,10.75
10,1,according,9,10,3,6,4.5
10,1,account,7,11,4,3,2.75
10,1,acquire,7,12,2,5,14.5
10,1,act,3,13,2,1,1.25
10,1,activation,10,14,3,7,6
10,1,addition,8,15,1,7,15
10,1,admission,9,16,2,7,6
10,1,affection,9,17,1,8,15.75
10,1,afford,6,18,3,3,3.5
10,1,agent,5,19,1,4,4
10,1,alert,5,20,1,4,11
10,1,alignment,9,21,2,7,4.75
10,1,alike,5,22,3,2,2
10,1,all,3,23,2,1,1
10,1,allegedly,9,24,3,6,13.5
10,1,along,5,25,2,3,2.5
10,1,also,4,26,2,2,2
10,1,although,8,27,2,6,12.75
10,1,amid,4,28,1,3,2.25
10,1,angry,5,29,1,4,3
10,1,anyone,6,30,2,4,10.75
10,1,anything,8,31,3,5,4
10,1,apart,5,32,1,4,2.75
10,1,appearance,10,33,2,8,13.5
10,1,appetite,8,34,4,4,3.5
10,1,apple,5,35,3,2,2
10,1,apply,5,36,4,1,1.5
10,1,april,5,37,2,3,10.25
10,1,arbitrary,9,38,1,8,5.5
10,1,arena,5,39,2,3,2.5
10,1,array,5,40,2,3,10.25
10,1,artificial,10,41,2,8,8.75
10,1,asset,5,42,1,4,3
10,1,associated,10,43,3,7,13.25
10,1,attach,6,44,1,5,4
10,1,attempt,7,45,3,4,11.25
10,1,attend,6,46,4,2,2
10,1,attendance,10,47,6,4,3.75
10,1,attribute,9,48,3,6,12.25
10,1,audience,8,49,1,7,8
10,1,august,6,50,2,4,6.5
10,1,author,6,51,2,4,20.75
10,1,authority,9,52,6,3,4.75
10,1,away,4,53,1,3,3.25
10,1,backdrop,8,54,0,8,18.5
10,1,backwards,9,55,4,5,9.25
10,1,bad,3,56,2,1,2.5
10,1,ballot,6,57,2,4,4.75
10,1,banana,6,58,2,4,18.25
10,1,bank,4,59,3,1,1.75
10,1,bare,4,60,2,2,4.25
10,1,basketball,10,61,2,8,17.75
10,1,bean,4,62,1,3,2.5
10,1,beef,4,63,2,2,1.75
10,1,before,6,64,2,4,3
10,1,beginning,9,65,2,7,15
10,1,bent,4,66,2,2,1.75
10,1,bet,3,67,2,1,1
10,1,bias,4,68,1,3,2.25
10,1,bicycle,7,69,2,5,11.75
10,1,big,3,70,2,1,1
10,1,biological,10,71,2,8,7.75
10,1,blessing,8,72,1,7,13.75
10,1,blood,5,73,2,3,2.5
10,1,bonus,5,74,1,4,3
10,1,booking,7,75,2,5,11.75
10,1,boring,6,76,2,4,3
10,1,born,4,77,3,1,1.25
10,1,breast,6,78,1,5,3.5
10,1,breath,6,79,4,2,10
10,1,brick,5,80,2,3,2.25
10,1,briefly,7,81,3,4,3.25
10,1,broadcast,9,82,2,7,13
10,1,broadly,7,83,5,2,2.25
10,1,buck,4,84,1,3,2.25
10,1,burial,6,85,2,4,3
10,1,burst,5,86,3,2,2
10,1,button,6,87,2,4,11.5
10,1,calm,4,88,0,4,2.75
10,1,carrot,6,89,2,4,3.5
10,1,cattle,6,90,2,4,12.25
10,1,cause,5,91,2,3,2.5
10,1,cent,4,92,1,3,2.5
10,1,centre,6,93,4,2,2
10,1,champion,8,94,1,7,14.25
10,1,chaos,5,95,3,2,2.25
10,1,charge,6,96,3,3,3
10,1,cheek,5,97,2,3,2.5
10,1,chef,4,98,3,1,1.5
10,1,chest,5,99,3,2,12
10,1,cigarette,9,100,1,8,6.25
10,1,cinema,6,101,2,4,3.5
10,1,civic,5,102,2,3,12.25
10,1,claim,5,103,1,4,2.75
10,1,clarify,7,104,3,4,3.25
10,1,classic,7,105,3,4,11.75
10,1,classical,9,106,7,2,2.5
10,1,climate,7,107,2,5,4.75
10,1,clip,4,108,3,1,1.5
10,1,close,5,109,2,3,2.25
10,1,clothes,7,110,3,4,12.25
10,1,coalition,9,111,1,8,5.5
10,1,coastal,7,112,3,4,11.75
10,1,coin,4,113,2,2,1.75
10,1,coloured,8,114,2,6,4.25
10,1,comic,5,115,2,3,2.25
10,1,commander,9,116,3,6,12.75
10,1,commentary,10,117,4,6,4.75
10,1,commerce,8,118,5,3,11.75
10,1,commit,6,119,4,2,2.25
10,1,communist,9,120,4,5,4.25
10,1,complaint,9,121,3,6,4.75
10,1,complex,7,122,5,2,11
10,1,compose,7,123,4,3,2.75
10,1,comprise,8,124,4,4,3.5
10,1,compromise,10,125,5,5,12.75
10,1,computer,8,126,4,4,3.5
10,1,conception,10,127,2,8,6
10,1,concession,10,128,5,5,15.5
10,1,conclude,8,129,4,4,4
10,1,concrete,8,130,4,4,4.75
10,1,confession,10,131,3,7,19.5
10,1,conflict,8,132,4,4,6.75
10,1,confuse,7,133,4,3,3.5
10,1,confusion,9,134,6,3,14
10,1,conscience,10,135,3,7,6.25
10,1,conserve,8,136,4,4,3.75
10,1,consist,7,137,4,3,12.25
10,1,consistent,10,138,7,3,2.75
10,1,conspiracy,10,139,4,6,3.25
10,1,construct,9,140,4,5,8.75
10,1,consume,7,141,4,3,2
10,1,contact,7,142,3,4,2.75
10,1,container,9,143,5,4,8
10,1,contest,7,144,4,3,1.5
10,1,continue,8,145,4,4,1.75
10,1,contrary,8,146,4,4,1.75
10,1,convict,7,147,3,4,7.25
10,1,conviction,10,148,7,3,1.5
10,1,cooking,7,149,2,5,1.75
10,1,cooperate,9,150,3,6,7.25
10,1,copy,4,151,2,2,0.75
10,1,correlate,9,152,2,7,2.25
10,1,correspond,10,153,5,5,7.5
10,1,costume,7,154,2,5,1.75
10,1,council,7,155,2,5,1.5
10,1,crash,5,156,1,4,6.5
10,1,cream,5,157,2,3,1.25
10,1,creation,8,158,4,4,1.75
10,1,creative,8,159,6,2,1.25
10,1,creator,7,160,5,2,6.25
10,1,critical,8,161,2,6,2
10,1,critique,8,162,5,3,1.5
10,1,crop,4,163,2,2,0.75
10,1,cue,3,164,1,2,6.25
10,1,cult,4,165,2,2,0.75
10,1,custody,7,166,2,5,1.75
10,1,custom,6,167,5,1,0.75
10,1,customer,8,168,6,2,1
10,1,dad,3,169,0,3,6
10,1,dancer,6,170,2,4,1.5
10,1,dark,4,171,2,2,0.75
10,1,data,4,172,2,2,0.75
10,1,daughter,8,173,2,6,6.75
10,1,dead,4,174,1,3,1
10,1,deadline,8,175,4,4,1.5
10,1,deadly,6,176,5,1,1
10,1,debate,6,177,2,4,1.5
10,1,dedication,10,178,2,8,7.5
10,1,defend,6,179,2,4,1.25
10,1,delegation,10,180,2,8,7.75
10,1,delivery,8,181,3,5,1.75
10,1,denial,6,182,2,4,6.5
10,1,depict,6,183,2,4,1.5
10,1,descend,7,184,2,5,1.5
10,1,descent,7,185,6,1,0.75
10,1,desert,6,186,3,3,6.5
10,1,desire,6,187,3,3,1.5
10,1,desperate,9,188,3,6,2
10,1,detection,9,189,2,7,7.5
10,1,devise,6,190,2,4,1.5
10,1,diary,5,191,1,4,1.25
10,1,differ,6,192,2,4,6.5
10,1,different,9,193,6,3,1.5
10,1,directly,8,194,2,6,2
10,1,disability,10,195,2,8,324.5
10,1,disagree,8,196,4,4,3.25
10,1,distance,8,197,3,5,4.5
10,1,disturb,7,198,4,3,5.25
10,1,diverse,7,199,2,5,19.25
10,1,dog,3,200,1,2,3.5
10,1,dominance,9,201,2,7,18.25
10,1,dominate,8,202,6,2,4.25
10,1,donate,6,203,2,4,3.5
10,1,donor,5,204,3,2,3.25
10,1,door,4,205,2,2,2.75
10,1,dose,4,206,2,2,3
10,1,drain,5,207,1,4,12.25
10,1,dramatic,8,208,3,5,4.5
10,1,draw,4,209,3,1,1.25
10,1,drive,5,210,2,3,2.75
10,1,drown,5,211,2,3,10.5
10,1,drum,4,212,2,2,2
10,1,dry,3,213,2,1,1.25
10,1,dump,4,214,1,3,4.25
10,1,duty,4,215,2,2,2.5
10,1,dynamic,7,216,1,6,13.5
10,1,easily,6,217,0,6,4.5
10,1,east,4,218,3,1,1.25
10,1,eat,3,219,2,1,1.25
10,1,echo,4,220,1,3,2.5
10,1,ecological,10,221,2,8,26
10,1,economics,9,222,3,6,24.25
10,1,editorial,9,223,1,8,6
10,1,education,9,224,2,7,23
10,1,eighteen,8,225,1,7,4.75
10,1,elaborate,9,226,1,8,11.75
10,1,election,8,227,2,6,5.75
10,1,element,7,228,3,4,3.25
10,1,embed,5,229,1,4,9.75
10,1,emerge,6,230,2,4,3
10,1,emphasize,9,231,2,7,11.25
10,1,employ,6,232,3,3,2.75
10,1,empty,5,233,3,2,2
10,1,endorse,7,234,1,6,4
10,1,enforce,7,235,2,5,9.25
10,1,enquire,7,236,2,5,3.5
10,1,entire,6,237,2,4,3
10,1,entirely,8,238,6,2,8.25
10,1,equip,5,239,1,4,2.75
10,1,equivalent,10,240,4,6,4.25
10,1,era,3,241,1,2,1.5
10,1,error,5,242,2,3,8.25
10,1,essential,9,243,1,8,5.25
10,1,eternal,7,244,1,6,10.25
10,1,ethnic,6,245,2,4,3
10,1,every,5,246,1,4,2.75
10,1,everybody,9,247,5,4,9.25
10,1,everywhere,10,248,5,5,4
10,1,evolve,6,249,2,4,3
10,1,exam,4,250,1,3,8.25
10,1,excitement,10,251,2,8,5.5
10,1,exert,5,252,2,3,2.25
10,1,expect,6,253,2,4,8.75
10,1,experience,10,254,4,6,4.75
10,1,explicit,8,255,3,5,3.75
10,1,explosion,9,256,4,5,9.75
10,1,export,6,257,3,3,2.5
10,1,external,8,258,2,6,4
10,1,extract,7,259,3,4,13.5
10,1,extremely,9,260,4,5,4
10,1,factory,7,261,0,7,10.75
10,1,faith,5,262,2,3,2.25
10,1,fame,4,263,2,2,1.75
10,1,fan,3,264,2,1,1
10,1,favour,6,265,2,4,2.75
10,1,favourable,10,266,6,4,8.75
10,1,feature,7,267,1,6,4
10,1,feed,4,268,2,2,1.75
10,1,feeling,7,269,3,4,8.5
10,1,festival,8,270,2,6,4.25
10,1,fifth,5,271,1,4,2.75
10,1,fighting,8,272,2,6,10.25
10,1,figure,6,273,3,3,2.5
10,1,fill,4,274,2,2,1.75
10,1,film,4,275,3,1,1.25
10,1,filter,6,276,3,3,2.25
10,1,find,4,277,2,2,7
10,1,finger,6,278,3,3,2.5
10,1,finish,6,279,3,3,2.25
10,1,fire,4,280,2,2,1.5
10,1,firearm,7,281,4,3,2.25
10,1,firework,8,282,4,4,8.75
10,1,fish,4,283,2,2,1.75
10,1,fishing,7,284,4,3,2.5
10,1,fit,3,285,2,1,1
10,1,five,4,286,2,2,1.5
10,1,flame,5,287,1,4,8
10,1,flaw,4,288,3,1,1.25
10,1,fleet,5,289,2,3,2.25
10,1,flood,5,290,2,3,2.25
10,1,flour,5,291,3,2,1.75
10,1,fluid,5,292,2,3,8
10,1,forest,6,293,1,5,3.5
10,1,forgive,7,294,3,4,3
10,1,formal,6,295,3,3,2.5
10,1,fossil,6,296,2,4,8.25
10,1,frankly,7,297,1,6,4
10,1,freeze,6,298,2,4,3
10,1,frequently,10,299,3,7,10.75
10,1,from,4,300,2,2,1.5
10,1,fruit,5,301,2,3,2.25
10,1,fun,3,302,1,2,6.75
10,1,function,8,303,3,5,4
10,1,furious,7,304,2,5,3.5
10,1,gang,4,305,0,4,8
10,1,garden,6,306,2,4,3
10,1,generation,10,307,1,9,11.25
10,1,generous,8,308,5,3,3
10,1,gentle,6,309,3,3,2.5
10,1,gentleman,9,310,6,3,2.75
10,1,glad,4,311,1,3,2
10,1,goal,4,312,1,3,7.5
10,1,goods,5,313,2,3,2.5
10,1,graduate,8,314,1,7,4.5
10,1,guard,5,315,1,4,8.25
10,1,guideline,9,316,2,7,4.75
10,1,happy,5,317,0,5,9
10,1,harassment,10,318,2,8,5.5
10,1,hardly,6,319,3,3,2.5
10,1,hatred,6,320,2,4,9
10,1,he,2,321,1,1,1
10,1,healthcare,10,322,2,8,5.25
10,1,heating,7,323,3,4,8.75
10,1,heavily,7,324,3,4,3
10,1,hello,5,325,2,3,2.25
10,1,helmet,6,326,3,3,2.5
10,1,helpful,7,327,3,4,8.5
10,1,here,4,328,2,2,1.75
10,1,hidden,6,329,1,5,3.25
10,1,hide,4,330,3,1,1.25
10,1,himself,7,331,2,5,9
10,1,historian,9,332,2,7,4.75
10,1,history,7,333,6,1,1.5
10,1,holy,4,334,1,3,2.25
10,1,honour,6,335,2,4,8.5
10,1,horizon,7,336,2,5,3.5
10,1,host,4,337,2,2,1.5
10,1,hostility,9,338,4,5,9.5
10,1,husband,7,339,1,6,4
10,1,ignore,6,340,0,6,10
10,1,illness,7,341,1,6,4
10,1,immense,7,342,1,6,4
10,1,inadequate,10,343,1,9,12.5
10,1,incentive,9,344,2,7,11
10,1,inclined,8,345,3,5,3.75
10,1,including,9,346,4,5,4
10,1,indication,10,347,2,8,15.25
10,1,indicator,9,348,7,2,2.25
10,1,indoor,6,349,3,3,2.5
10,1,induce,6,350,3,3,8.75
10,1,indulge,7,351,4,3,2.75
10,1,infect,6,352,2,4,3
10,1,initial,7,353,2,5,3.5
10,1,inmate,6,354,2,4,9
10,1,innovative,10,355,2,8,5.5
10,1,input,5,356,2,3,8
10,1,instantly,9,357,2,7,4.75
10,1,intention,9,358,2,7,10.75
10,1,interact,8,359,4,4,3.5
10,1,interested,10,360,5,5,4
10,1,interface,9,361,5,4,9.25
10,1,interpret,9,362,5,4,4
10,1,interrupt,9,363,5,4,3.5
10,1,interview,9,364,5,4,3.5
10,1,invent,6,365,2,4,8.5
10,1,investor,8,366,4,4,3.25
10,1,invisible,9,367,3,6,4.5
10,1,ironically,10,368,1,9,11.5
10,1,isolation,9,369,1,8,11.25
10,1,jam,3,370,0,3,2
10,1,jeans,5,371,1,4,2.75
10,1,join,4,372,1,3,2.25
10,1,joint,5,373,4,1,7.25
10,1,justice,7,374,1,6,4
10,1,kidnap,6,375,0,6,3.75
10,1,killing,7,376,2,5,9.25
10,1,kind,4,377,2,2,1.5
10,1,knowledge,9,378,1,8,11.5
10,1,label,5,379,0,5,3.25
10,1,labour,6,380,3,3,2.5
10,1,ladder,6,381,2,4,3
10,1,lady,4,382,3,1,1.25
10,1,lamp,4,383,2,2,7.5
10,1,landing,7,384,2,5,3.5
10,1,lane,4,385,3,1,1
10,1,language,8,386,3,5,2.5
10,1,late,4,387,2,2,4.25
10,1,lately,6,388,4,2,1
10,1,lawyer,6,389,2,4,1.25
10,1,leave,5,390,1,4,1.25
10,1,legacy,6,391,2,4,5.25
10,1,legal,5,392,4,1,0.75
10,1,leisure,7,393,2,5,1.75
10,1,lend,4,394,2,2,0.75
10,1,let,3,395,2,1,0.5
10,1,lifetime,8,396,1,7,5.75
10,1,linger,6,397,2,4,1.5
10,1,literacy,8,398,2,6,5.5
10,1,lively,6,399,2,4,1.5
10,1,loan,4,400,1,3,1
10,1,lobby,5,401,2,3,1
10,1,lock,4,402,2,2,4.5
10,1,loom,4,403,2,2,0.75
10,1,loop,4,404,3,1,0.5
10,1,lost,4,405,2,2,0.75
10,1,luck,4,406,1,3,1
10,1,lung,4,407,2,2,0.75
10,1,magazine,8,408,0,8,6
10,1,magical,7,409,3,4,1.5
10,1,major,5,410,2,3,1
10,1,mall,4,411,2,2,4.25
10,1,management,10,412,2,8,2.5
10,1,marginal,8,413,2,6,5.5
10,1,marker,6,414,3,3,1.25
10,1,marketing,9,415,5,4,1.5
10,1,marriage,8,416,3,5,1.75
10,1,mate,4,417,2,2,4.5
10,1,meaning,7,418,1,6,2
10,1,measure,7,419,3,4,1.5
10,1,medicine,8,420,2,6,5.5
10,1,membership,10,421,2,8,2.5
10,1,mile,4,422,1,3,4.5
10,1,militant,8,423,3,5,1.75
10,1,military,8,424,6,2,1
10,1,milk,4,425,3,1,0.5
10,1,mine,4,426,2,2,0.75
10,1,miner,5,427,4,1,0.5
10,1,minimize,8,428,3,5,5.75
10,1,miracle,7,429,2,5,1.75
10,1,mobile,6,430,1,5,5.25
10,1,modest,6,431,2,4,1.25
10,1,momentum,8,432,2,6,1.75
10,1,monk,4,433,2,2,0.75
10,1,morning,7,434,2,5,5.5
10,1,motivation,10,435,2,8,2.5
10,1,motorcycle,10,436,3,7,6.25
10,1,mount,5,437,2,3,1
10,1,movement,8,438,2,6,5.5
10,1,multiply,8,439,1,7,2
10,1,myself,6,440,1,5,1.5
10,1,mystery,7,441,3,4,5.5
10,1,national,8,442,0,8,2.25
10,1,native,6,443,4,2,1
10,1,naturally,9,444,3,6,5.75
10,1,necessity,9,445,1,8,6
10,1,net,3,446,2,1,0.5
10,1,network,7,447,3,4,1.75
10,1,news,4,448,2,2,0.75
10,1,next,4,449,2,2,0.75
10,1,ninety,6,450,1,5,5.25
10,1,noble,5,451,1,4,1.25
10,1,nod,3,452,2,1,0.5
10,1,noon,4,453,2,2,0.75
10,1,notable,7,454,2,5,1.5
10,1,nowadays,8,455,2,6,5.75
10,1,number,6,456,1,5,1.5
10,1,nursery,7,457,2,5,5.5
10,1,nursing,7,458,4,3,1.5
10,1,nutrition,9,459,2,7,2.25
10,1,obtain,6,460,0,6,6
10,1,obvious,7,461,2,5,1.75
10,1,occasion,8,462,1,7,6
10,1,occasional,10,463,8,2,1.25
10,1,occurrence,10,464,3,7,2.25
10,1,offender,8,465,1,7,6
10,1,offer,5,466,4,1,0.75
10,1,offering,8,467,5,3,1.25
10,1,onto,4,468,1,3,1
10,1,open,4,469,1,3,4.75
10,1,operate,7,470,3,4,1.5
10,1,operator,8,471,6,2,1
10,1,opinion,7,472,2,5,1.75
10,1,or,2,473,1,1,4.25
10,1,order,5,474,2,3,1
10,1,organize,8,475,2,6,2
10,1,originally,10,476,2,8,6.25
10,1,our,3,477,1,2,0.75
10,1,outrage,7,478,2,5,1.5
10,1,own,3,479,1,2,0.75
10,1,oxygen,6,480,1,5,5.5
10,1,palm,4,481,0,4,1.25
10,1,pan,3,482,2,1,0.5
10,1,paper,5,483,2,3,1
10,1,parameter,9,484,2,7,6.5
10,1,parish,6,485,3,3,2.5
10,1,pass,4,486,2,2,1.5
10,1,passage,7,487,4,3,9
10,1,peak,4,488,1,3,2.25
10,1,peasant,7,489,3,4,3
10,1,penalty,7,490,2,5,3.5
10,1,pension,7,491,3,4,10
10,1,percentage,10,492,2,8,5.5
10,1,permanent,9,493,3,6,10.75
10,1,person,6,494,3,3,2.5
10,1,persuade,8,495,4,4,3.25
10,1,petition,8,496,2,6,10.5
10,1,pilot,5,497,1,4,2.75
10,1,pink,4,498,2,2,1.75
10,1,pit,3,499,2,1,1
10,1,pitch,5,500,3,2,1.75
10,1,plain,5,501,1,4,9
10,1,planet,6,502,3,3,2.5
10,1,player,6,503,3,3,2.5
10,1,plunge,6,504,2,4,3
10,1,poet,4,505,1,3,9
10,1,pop,3,506,2,1,1.25
10,1,popularity,10,507,3,7,4.75
10,1,port,4,508,2,2,1.5
10,1,portray,7,509,4,3,9.25
10,1,pose,4,510,2,2,1.75
10,1,positive,8,511,3,5,3.75
10,1,potential,9,512,2,7,11.25
10,1,powder,6,513,2,4,3
10,1,pray,4,514,1,3,2.25
10,1,preach,6,515,2,4,9
10,1,precision,9,516,3,6,4.5
10,1,prefer,6,517,3,3,2.5
10,1,preference,10,518,6,4,7
10,1,president,9,519,3,6,8.5
10,1,prevalence,10,520,3,7,5.25
10,1,prevent,7,521,4,3,9.5
10,1,price,5,522,2,3,2.75
10,1,priest,6,523,3,3,2.5
10,1,prince,6,524,3,3,3.5
10,1,princess,8,525,6,2,12.25
10,1,privilege,9,526,3,6,4.5
10,1,probably,8,527,2,6,4.25
10,1,profitable,10,528,3,7,11.25
10,1,promote,7,529,3,4,3
10,1,prosecutor,10,530,3,7,12.25
10,1,protect,7,531,3,4,3.25
10,1,protection,10,532,7,3,2.75
10,1,protocol,8,533,4,4,10.25
10,1,provide,7,534,3,4,3
10,1,provincial,10,535,5,5,4
10,1,provision,9,536,5,4,6.75
10,1,psychology,10,537,1,9,9.75
10,1,punishment,10,538,1,9,12.75
10,1,purely,6,539,2,4,3
10,1,purple,6,540,3,3,2.5
10,1,pursue,6,541,3,3,9
10,1,qualify,7,542,0,7,4.5
10,1,quarter,7,543,3,4,3
10,1,queen,5,544,2,3,8.5
10,1,question,8,545,3,5,3.75
10,1,queue,5,546,3,2,1.75
10,1,quickly,7,547,2,5,3.75
10,1,quietly,7,548,3,4,9.75
10,1,quota,5,549,2,3,2.25
10,1,racist,6,550,0,6,4
10,1,rain,4,551,2,2,8.25
10,1,rare,4,552,2,2,1.5
10,1,read,4,553,1,3,2.25
10,1,reader,6,554,4,2,1.75
10,1,real,4,555,3,1,1.25
10,1,realize,7,556,4,3,2.5
10,1,really,6,557,4,2,8.25
10,1,reasonable,10,558,3,7,5.25
10,1,rebellion,9,559,2,7,11.75
10,1,receive,7,560,2,5,3.5
10,1,recipe,6,561,3,3,2.5
10,1,red,3,562,2,1,1
10,1,register,8,563,2,6,10.75
10,1,rely,4,564,2,2,1.75
10,1,remains,7,565,2,5,4
10,1,remarkable,10,566,4,6,12.25
10,1,remote,6,567,3,3,2.5
10,1,report,6,568,2,4,2.75
10,1,reporter,8,569,6,2,2
10,1,reproduce,9,570,3,6,11
10,1,request,7,571,2,5,3.5
10,1,restraint,9,572,2,7,11.25
10,1,resume,6,573,3,3,2.75
10,1,retreat,7,574,2,5,3.5
10,1,reverse,7,575,2,5,10
10,1,rhetoric,8,576,1,7,4.75
10,1,rice,4,577,1,3,2.25
10,1,rid,3,578,2,1,1
10,1,risk,4,579,2,2,8.5
10,1,rock,4,580,1,3,2.25
10,1,romantic,8,581,2,6,4.25
10,1,rule,4,582,1,3,8.5
10,1,rumour,6,583,2,4,2
10,1,run,3,584,2,1,0.75
10,1,runner,6,585,3,3,1.25
10,1,sadly,5,586,0,5,5.75
10,1,say,3,587,2,1,0.5
10,1,scale,5,588,1,4,1.25
10,1,scope,5,589,2,3,1
10,1,sculpture,9,590,2,7,6.25
10,1,section,7,591,1,6,1.75
10,1,seize,5,592,2,3,1
10,1,seldom,6,593,2,4,5.25
10,1,self,4,594,3,1,0.75
10,1,senator,7,595,2,5,1.75
10,1,sensation,9,596,3,6,2
10,1,sensitive,9,597,4,5,6.25
10,1,sentence,8,598,3,5,1.75
10,1,set,3,599,2,1,0.5
10,1,several,7,600,2,5,6.25
10,1,shadow,6,601,1,5,1.5
10,1,shall,5,602,3,2,1
10,1,shaped,6,603,3,3,1.25
10,1,shock,5,604,2,3,5.25
10,1,short,5,605,3,2,1
10,1,should,6,606,3,3,1.25
10,1,shout,5,607,4,1,0.75
10,1,show,4,608,3,1,0.5
10,1,shrink,6,609,2,4,1.25
10,1,shrug,5,610,3,2,4.75
10,1,sigh,4,611,1,3,1
10,1,similarity,10,612,2,8,2.5
10,1,simulate,8,613,3,5,6
10,1,sing,4,614,2,2,0.75
10,1,size,4,615,2,2,0.75
10,1,skiing,6,616,1,5,5.5
10,1,skill,5,617,3,2,1
10,1,sky,3,618,2,1,0.5
10,1,slave,5,619,1,4,1.25
10,1,sleep,5,620,2,3,1
10,1,slogan,6,621,2,4,5.5
10,1,slow,4,622,3,1,0.75
10,1,smash,5,623,1,4,1.25
10,1,snap,4,624,1,3,1
10,1,soar,4,625,1,3,1
10,1,software,8,626,2,6,6.25
10,1,soldier,7,627,2,5,1.5
10,1,solely,6,628,3,3,1.25
10,1,solicitor,9,629,3,6,6.25
10,1,somewhere,9,630,2,7,2.25
10,1,son,3,631,2,1,0.5
10,1,soon,4,632,2,2,4.75
10,1,spending,8,633,1,7,2
10,1,spicy,5,634,2,3,1
10,1,spite,5,635,3,2,5.25
10,1,split,5,636,2,3,1
10,1,spoil,5,637,2,3,1
10,1,sponsor,7,638,3,4,1.25
10,1,spoon,5,639,3,2,0.75
10,1,sport,5,640,3,2,5
10,1,spy,3,641,2,1,0.5
10,1,squeeze,7,642,1,6,2
10,1,stabilize,9,643,1,8,6.5
10,1,stage,5,644,3,2,1
10,1,status,6,645,3,3,1.25
10,1,steep,5,646,2,3,1
10,1,stimulate,9,647,2,7,6.75
10,1,stream,6,648,2,4,1.5
10,1,stress,6,649,4,2,1.25
10,1,strive,6,650,3,3,1.5
10,1,structure,9,651,3,6,6.75
10,1,successive,10,652,1,9,7
10,1,suicide,7,653,2,5,1.75
10,1,sum,3,654,2,1,0.5
10,1,summit,6,655,3,3,1
10,1,superior,8,656,2,6,6
10,1,supervisor,10,657,5,5,2
10,1,supplement,10,658,3,7,6.5
10,1,supply,6,659,5,1,0.75
10,1,supporter,9,660,4,5,1.75
10,1,surface,7,661,2,5,1.5
10,1,surge,5,662,3,2,5.25
10,1,surprising,10,663,3,7,2.5
10,1,surrender,9,664,3,6,2
10,1,suspicious,10,665,2,8,6.75
10,1,sustain,7,666,3,4,1.5
10,1,swing,5,667,1,4,5.5
10,1,syndrome,8,668,1,7,2
10,1,talented,8,669,0,8,6.75
10,1,tax,3,670,2,1,0.5
10,1,teenage,7,671,1,6,1.75
10,1,teenager,8,672,7,1,0.75
10,1,tell,4,673,2,2,5
10,1,tennis,6,674,2,4,1.75
10,1,tent,4,675,3,1,0.75
10,1,terminal,8,676,2,6,1.75
10,1,testing,7,677,2,5,6
10,1,text,4,678,2,2,0.75
10,1,their,5,679,1,4,1.25
10,1,theirs,6,680,5,1,0.5
10,1,then,4,681,3,1,0.5
10,1,theology,8,682,3,5,6
10,1,there,5,683,3,2,0.75
10,1,they,4,684,3,1,0.5
10,1,thing,5,685,2,3,1.25
10,1,think,5,686,4,1,0.5
10,1,thought,7,687,2,5,6
10,1,threaten,8,688,2,6,2
10,1,throat,6,689,3,3,1.25
10,1,throughout,10,690,4,6,6.5
10,1,thursday,8,691,2,6,2
10,1,timber,6,692,1,5,5.75
10,1,tiny,4,693,2,2,0.75
10,1,tobacco,7,694,1,6,1.75
10,1,tone,4,695,2,2,0.75
10,1,touch,5,696,2,3,1
10,1,tourist,7,697,3,4,5.75
10,1,towel,5,698,2,3,1
10,1,trace,5,699,1,4,1.25
10,1,tradition,9,700,3,6,6.25
10,1,transfer,8,701,3,5,1.75
10,1,truly,5,702,2,3,1
10,1,trust,5,703,3,2,5.25
10,1,truth,5,704,3,2,1
10,1,try,3,705,2,1,0.5
10,1,turn,4,706,1,3,1
10,1,turnover,8,707,4,4,1.25
10,1,twenty,6,708,1,5,6
10,1,typically,9,709,1,8,2.5
10,1,under,5,710,0,5,5.5
10,1,unit,4,711,2,2,0.75
10,1,up,2,712,1,1,0.5
10,1,upper,5,713,2,3,1
10,1,upwards,7,714,2,5,1.5
10,1,us,2,715,1,1,4.5
10,1,used,4,716,2,2,1
10,1,variation,9,717,0,9,2.75
10,1,vast,4,718,2,2,0.75
10,1,vehicle,7,719,1,6,6.5
10,1,versus,6,720,2,4,1.5
10,1,very,4,721,3,1,0.75
10,1,village,7,722,1,6,6.25
10,1,violation,9,723,2,7,2.25
10,1,voluntary,9,724,1,8,6.75
10,1,vote,4,725,2,2,0.75
10,1,wage,4,726,0,4,1.25
10,1,ward,4,727,2,2,0.75
10,1,warm,4,728,3,1,5
10,1,we,2,729,1,1,0.5
10,1,weak,4,730,2,2,0.75
10,1,wear,4,731,3,1,0.5
10,1,weather,7,732,3,4,1.25
10,1,web,3,733,2,1,0.5
10,1,wedding,7,734,2,5,5.75
10,1,week,4,735,2,2,0.75
10,1,weekly,6,736,4,2,1
10,1,wet,3,737,2,1,0.5
10,1,wheat,5,738,1,4,1.25
10,1,whilst,6,739,2,4,6
10,1,whisper,7,740,3,4,1.5
10,1,who,3,741,2,1,0.5
10,1,widespread,10,742,1,9,7
10,1,winter,6,743,2,4,1.5
10,1,wise,4,744,2,2,1.5
10,1,withdrawal,10,745,2,8,8.75
10,1,wooden,6,746,1,5,1.5
10,1,workout,7,747,2,5,1.75
10,1,worse,5,748,3,2,6.25
10,1,wound,5,749,2,3,1.25
10,1,writing,7,750,1,6,2.25
10,1,yell,4,751,0,4,2
10,1,yours,5,752,1,4,5.75
10,1,zero,4,753,0,4,1.25
10,2,absent,6,0,0,6,6
10,2,academy,7,1,1,6,1.75
10,2,accent,6,2,2,4,1.25
10,2,acceptance,10,3,4,6,6.5
10,2,accountant,10,4,3,7,2.25
10,2,accuracy,8,5,3,5,6.25
10,2,acquire,7,6,2,5,1.75
10,2,act,3,7,2,1,0.5
10,2,action,6,8,3,3,1
10,2,activation,10,9,4,6,6.75
10,2,adhere,6,10,1,5,1.5
10,2,adult,5,11,2,3,5.75
10,2,advanced,8,12,2,6,2
10,2,affection,9,13,1,8,6.75
10,2,afford,6,14,3,3,1.25
10,2,aged,4,15,1,3,1
10,2,aid,3,16,1,2,0.75
10,2,air,3,17,2,1,0.5
10,2,aircraft,8,18,3,5,10.75
10,2,alike,5,19,1,4,52.25
10,2,all,3,20,2,1,1.5
10,2,allege,6,21,3,3,3
10,2,alliance,8,22,3,5,4.25
10,2,ambitious,9,23,1,8,14.5
10,2,angel,5,24,1,4,5
10,2,apart,5,25,1,4,11.5
10,2,apple,5,26,2,3,4.5
10,2,appoint,7,27,3,4,6
10,2,arbitrary,9,28,1,8,13
10,2,archive,7,29,2,5,4.25
10,2,array,5,30,2,3,2.75
10,2,arrival,7,31,3,4,10.25
10,2,assign,6,32,1,5,4
10,2,assignment,10,33,6,4,3.5
10,2,associated,10,34,3,7,13.5
10,2,athlete,7,35,1,6,4.75
10,2,attach,6,36,2,4,9
10,2,attend,6,37,3,3,14.5
10,2,attendance,10,38,6,4,4.25
10,2,audience,8,39,1,7,24.5
10,2,august,6,40,2,4,4.75
10,2,authority,9,41,2,7,6.5
10,2,avoid,5,42,1,4,21
10,2,aware,5,43,1,4,2.75
10,2,backwards,9,44,0,9,11
10,2,ballot,6,45,2,4,3
10,2,banana,6,46,2,4,2.75
10,2,bank,4,47,3,1,1.5
10,2,bare,4,48,2,2,1.75
10,2,basis,5,49,2,3,7.5
10,2,basketball,10,50,3,7,5
10,2,bean,4,51,1,3,2.25
10,2,bear,4,52,3,1,1
10,2,because,7,53,2,5,8.5
10,2,become,6,54,3,3,2.5
10,2,beef,4,55,2,2,1.5
10,2,before,6,56,2,4,9.25
10,2,being,5,57,2,3,2.25
10,2,bias,4,58,1,3,3.25
10,2,blast,5,59,1,4,2.75
10,2,bleed,5,60,2,3,2.25
10,2,blood,5,61,2,3,7.5
10,2,body,4,62,1,3,2.25
10,2,bond,4,63,2,2,1.75
10,2,bonus,5,64,3,2,1.75
10,2,booking,7,65,2,5,8.75
10,2,boring,6,66,2,4,3
10,2,born,4,67,3,1,1.25
10,2,bread,5,68,1,4,2.75
10,2,breast,6,69,4,2,2
10,2,breath,6,70,4,2,7.75
10,2,brick,5,71,2,3,2.25
10,2,brilliant,9,72,3,6,4.25
10,2,bring,5,73,3,2,1.75
10,2,broadband,9,74,2,7,10.25
10,2,broadcast,9,75,5,4,3.5
10,2,brother,7,76,3,4,8.25
10,2,brown,5,77,3,2,1.75
10,2,burst,5,78,1,4,2.75
10,2,bus,3,79,2,1,1
10,2,busy,4,80,3,1,1
10,2,bye,3,81,1,2,1.5
10,2,camp,4,82,0,4,7.75
10,2,capitalism,10,83,2,8,5.5
10,2,capture,7,84,3,4,3
10,2,carriage,8,85,2,6,9.25
10,2,carrot,6,86,4,2,2
10,2,cat,3,87,2,1,1
10,2,cause,5,88,2,3,2.25
10,2,cautious,8,89,3,5,8.5
10,2,champion,8,90,1,7,4.75
10,2,charge,6,91,3,3,2.5
10,2,civic,5,92,1,4,7.75
10,2,class,5,93,1,4,2.75
10,2,classic,7,94,5,2,1.75
10,2,climate,7,95,2,5,8.25
10,2,climb,5,96,4,1,1.5
10,2,close,5,97,2,3,2.25
10,2,cloth,5,98,3,2,1.75
10,2,clue,4,99,2,2,1.75
10,2,coalition,9,100,1,8,10.25
10,2,coast,5,101,3,2,1.75
10,2,coastal,7,102,5,2,2
10,2,collapse,8,103,2,6,8.75
10,2,college,7,104,4,3,2.75
10,2,colour,6,105,3,3,2.5
10,2,combine,7,106,2,5,3.5
10,2,comic,5,107,3,2,6.5
10,2,commentary,10,108,3,7,5
10,2,commit,6,109,4,2,2
10,2,commitment,10,110,6,4,3.5
10,2,communist,9,111,4,5,9.5
10,2,comparison,10,112,3,7,5
10,2,complaint,9,113,4,5,8.75
10,2,compliance,10,114,5,5,4
10,2,comprise,8,115,4,4,3.25
10,2,compromise,10,116,5,5,9.25
10,2,computer,8,117,4,4,3.25
10,2,conception,10,118,2,8,13.75
10,2,concession,10,119,5,5,260.75
10,2,conclude,8,120,4,4,1.75
10,2,concrete,8,121,4,4,1.75
10,2,confession,10,122,3,7,7
10,2,confirm,7,123,4,3,1.5
10,2,confuse,7,124,4,3,1.75
10,2,confusion,9,125,6,3,6.5
10,2,consensus,9,126,3,6,4
10,2,consistent,10,127,4,6,2.25
10,2,conspiracy,10,128,4,6,6.25
10,2,consume,7,129,4,3,1.5
10,2,consumer,8,130,7,1,1
10,2,contact,7,131,3,4,1.75
10,2,container,9,132,5,4,5.5
10,2,contender,9,133,4,5,2.75
10,2,contest,7,134,5,2,1.25
10,2,context,7,135,5,2,1.25
10,2,contract,8,136,4,4,5.25
10,2,cool,4,137,2,2,1
10,2,cop,3,138,2,1,0.5
10,2,correspond,10,139,2,8,7.75
10,2,costume,7,140,2,5,2.75
10,2,cotton,6,141,2,4,1.5
10,2,council,7,142,2,5,7
10,2,countless,9,143,4,5,4
10,2,courage,7,144,3,4,2.75
10,2,covered,7,145,2,5,7
10,2,crack,5,146,1,4,1.75
10,2,cream,5,147,2,3,1.5
10,2,creative,8,148,4,4,2.75
10,2,crown,5,149,2,3,6
10,2,crystal,7,150,2,5,6.25
10,2,cue,3,151,1,2,3
10,2,customer,8,152,2,6,13
10,2,cutting,7,153,2,5,6
10,2,dad,3,154,0,3,2.75
10,2,dancer,6,155,2,4,7.25
10,2,database,8,156,2,6,3.5
10,2,dear,4,157,1,3,1.5
10,2,debris,6,158,2,4,7
10,2,debut,5,159,3,2,2.5
10,2,decision,8,160,2,6,5.25
10,2,decorate,8,161,3,5,2.5
10,2,dedicated,9,162,2,7,9
10,2,dedication,10,163,7,3,2.5
10,2,defeat,6,164,2,4,5.5
10,2,defend,6,165,4,2,1.25
10,2,defy,4,166,3,1,0.75
10,2,delegation,10,167,2,8,3
10,2,delivery,8,168,3,5,7
10,2,depart,6,169,2,4,1.5
10,2,derive,6,170,2,4,1.5
10,2,descend,7,171,2,5,5.75
10,2,diary,5,172,1,4,1.75
10,2,dictionary,10,173,2,8,7
10,2,differ,6,174,2,4,1.5
10,2,different,9,175,6,3,1.25
10,2,dimension,9,176,2,7,8.5
10,2,direction,9,177,2,7,3
10,2,directly,8,178,6,2,1.25
10,2,disagree,8,179,2,6,6.5
10,2,discharge,9,180,3,6,2.5
10,2,disease,7,181,3,4,2.25
10,2,disrupt,7,182,3,4,8.5
10,2,distance,8,183,3,5,2
10,2,distinct,8,184,4,4,2.25
10,2,district,8,185,4,4,7.75
10,2,disturb,7,186,4,3,1.75
10,2,diverse,7,187,2,5,2
10,2,diversity,9,188,6,3,6
10,2,divert,6,189,5,1,1
10,2,divorce,7,190,3,4,2
10,2,dog,3,191,1,2,0.75
10,2,dominate,8,192,2,6,2.25
10,2,donate,6,193,2,4,8
10,2,door,4,194,2,2,1.25
10,2,dose,4,195,2,2,1
10,2,dozen,5,196,2,3,1.25
10,2,draw,4,197,1,3,7.25
10,2,drown,5,198,2,3,1.5
10,2,due,3,199,1,2,1
10,2,duty,4,200,2,2,1
10,2,each,4,201,0,4,1.5
10,2,early,5,202,2,3,7.25
10,2,easily,6,203,2,4,1.5
10,2,eastern,7,204,3,4,2.75
10,2,eat,3,205,2,1,0.5
10,2,edge,4,206,1,3,6.5
10,2,editorial,9,207,2,7,2.75
10,2,educated,8,208,2,6,2.25
10,2,educator,8,209,6,2,6.5
10,2,eighteen,8,210,1,7,3
10,2,election,8,211,1,7,7.75
10,2,electoral,9,212,5,4,2.5
10,2,element,7,213,3,4,2.25
10,2,elementary,10,214,7,3,2
10,2,emerge,6,215,1,5,6.25
10,2,emotional,9,216,2,7,2.5
10,2,endorse,7,217,1,6,5.5
10,2,energy,6,218,2,4,1.5
10,2,enhance,7,219,2,5,1.75
10,2,enrol,5,220,2,3,4.75
10,2,entire,6,221,2,4,1.5
10,2,entirely,8,222,6,2,1.25
10,2,entity,6,223,4,2,1
10,2,equal,5,224,1,4,4.75
10,2,equation,8,225,4,4,1.5
10,2,equip,5,226,3,2,1
10,2,error,5,227,1,4,1.5
10,2,escalate,8,228,1,7,6.25
10,2,escape,6,229,4,2,1.25
10,2,eternal,7,230,1,6,2.25
10,2,every,5,231,1,4,5
10,2,everybody,9,232,5,4,1.5
10,2,everyday,8,233,5,3,1.25
10,2,evolution,9,234,2,7,6
10,2,exaggerate,10,235,1,9,2.75
10,2,exam,4,236,3,1,4
10,2,example,7,237,4,3,1.5
10,2,exclude,7,238,2,5,1.5
10,2,exert,5,239,2,3,1
10,2,exotic,6,240,2,4,4.75
10,2,expected,8,241,2,6,1.75
10,2,experience,10,242,4,6,5.25
10,2,exposure,8,243,3,5,1.75
10,2,external,8,244,2,6,2.25
10,2,extract,7,245,3,4,4.75
10,2,fabulous,8,246,0,8,2.25
10,2,fact,4,247,2,2,0.75
10,2,factor,6,248,4,2,4.5
10,2,faith,5,249,2,3,1
10,2,fame,4,250,2,2,0.75
10,2,familiar,8,251,3,5,3.5
10,2,favour,6,252,2,4,8.5
10,2,favourable,10,253,6,4,3.75
10,2,favourite,9,254,6,3,3.25
10,2,feat,4,255,1,3,2.25
10,2,feather,7,256,4,3,8
10,2,feedback,8,257,2,6,4.25
10,2,fence,5,258,2,3,2.5
10,2,fill,4,259,1,3,2.25
10,2,filter,6,260,3,3,8
10,2,finish,6,261,2,4,3
10,2,fire,4,262,2,2,1.75
10,2,firearm,7,263,4,3,2.25
10,2,firework,8,264,4,4,8.75
10,2,first,5,265,3,2,2
10,2,fishing,7,266,2,5,3.5
10,2,flame,5,267,1,4,2.75
10,2,flash,5,268,3,2,7.5
10,2,flaw,4,269,3,1,1
10,2,float,5,270,2,3,2.25
10,2,flood,5,271,3,2,1.75
10,2,fluid,5,272,2,3,2.5
10,2,fold,4,273,1,3,2.25
10,2,following,9,274,3,6,10.25
10,2,fond,4,275,2,2,1.75
10,2,fool,4,276,2,2,1.75
10,2,forever,7,277,2,5,9.25
10,2,formal,6,278,3,3,2.5
10,2,formulate,9,279,4,5,4
10,2,forth,5,280,3,2,2
10,2,fossil,6,281,2,4,8.5
10,2,frankly,7,282,1,6,4.25
10,2,frequently,10,283,2,8,11.5
10,2,function,8,284,1,7,4.75
10,2,funny,5,285,3,2,2
10,2,furious,7,286,2,5,9.5
10,2,gambling,8,287,0,8,5.25
10,2,garden,6,288,2,4,8.75
10,2,gas,3,289,2,1,1
10,2,gathering,9,290,2,7,4.75
10,2,generous,8,291,1,7,10.5
10,2,ghost,5,292,1,4,2.75
10,2,goods,5,293,1,4,2.75
10,2,gorgeous,8,294,2,6,10.5
10,2,governance,10,295,2,8,5.5
10,2,gradually,9,296,1,8,10.75
10,2,graduate,8,297,6,2,2.25
10,2,great,5,298,2,3,2.25
10,2,greenhouse,10,299,3,7,10.75
10,2,guard,5,300,1,4,2.75
10,2,half,4,301,0,4,2.5
10,2,hand,4,302,2,2,7.5
10,2,happy,5,303,2,3,2.25
10,2,harassment,10,304,2,8,5.25
10,2,hardly,6,305,3,3,8.25
10,2,harmful,7,306,3,4,3.25
10,2,harmony,7,307,4,3,2.75
10,2,hatred,6,308,2,4,3
10,2,he,2,309,1,1,6.75
10,2,healthcare,10,310,2,8,5.5
10,2,heating,7,311,3,4,3.25
10,2,heavily,7,312,3,4,8.75
10,2,helmet,6,313,2,4,3
10,2,hero,4,314,2,2,1.5
10,2,hidden,6,315,1,5,9.75
10,2,hierarchy,9,316,2,7,5
10,2,hill,4,317,2,2,1.75
10,2,hockey,6,318,1,5,10.5
10,2,hold,4,319,2,2,1.75
10,2,holy,4,320,3,1,1.25
10,2,homeless,8,321,2,6,5.25
10,2,homework,8,322,4,4,11
10,2,honour,6,323,2,4,3
10,2,hope,4,324,2,2,1.75
10,2,hopefully,9,325,4,5,3.75
10,2,horizon,7,326,2,5,9.75
10,2,hostile,7,327,2,5,3.5
10,2,hostility,9,328,6,3,2.75
10,2,housing,7,329,2,5,9.5
10,2,ideology,8,330,0,8,5.75
10,2,ignore,6,331,1,5,9.75
10,2,illness,7,332,1,6,4
10,2,imagine,7,333,1,6,10.5
10,2,immense,7,334,2,5,3.75
10,2,immigrant,9,335,3,6,4.5
10,2,imminent,8,336,4,4,9.5
10,2,impress,7,337,2,5,3.75
10,2,in,2,338,1,1,1
10,2,incentive,9,339,2,7,10.5
10,2,incidence,9,340,3,6,4.5
10,2,inclined,8,341,3,5,3.75
10,2,indicator,9,342,2,7,10.75
10,2,indoor,6,343,3,3,2.5
10,2,indoors,7,344,6,1,1.5
10,2,induce,6,345,3,3,2.5
10,2,indulge,7,346,4,3,8.5
10,2,initial,7,347,2,5,3.5
10,2,inmate,6,348,2,4,3
10,2,innocent,8,349,2,6,10
10,2,insider,7,350,2,5,3.5
10,2,instantly,9,351,3,6,10.5
10,2,insult,6,352,3,3,2.5
10,2,intention,9,353,2,7,4.75
10,2,interested,10,354,4,6,10.5
10,2,interpret,9,355,5,4,3.5
10,2,intriguing,10,356,3,7,10.75
10,2,introduce,9,357,4,5,3.75
10,2,invisible,9,358,2,7,5
10,2,ironically,10,359,1,9,12.25
10,2,join,4,360,0,4,2.75
10,2,joint,5,361,4,1,1
10,2,journalist,10,362,2,8,11
10,2,kidnap,6,363,0,6,10.25
10,2,kill,4,364,2,2,1.75
10,2,kind,4,365,2,2,1.75
10,2,knowledge,9,366,1,8,5.5
10,2,label,5,367,0,5,9.25
10,2,lamp,4,368,2,2,1.75
10,2,laptop,6,369,2,4,3
10,2,late,4,370,2,2,1.75
10,2,lawsuit,7,371,2,5,9.25
10,2,lawyer,6,372,3,3,2.5
10,2,leave,5,373,1,4,2.75
10,2,lend,4,374,2,2,1.75
10,2,length,6,375,3,3,10
10,2,less,4,376,2,2,2
10,2,lesson,6,377,4,2,1.75
10,2,linger,6,378,1,5,3.5
10,2,lively,6,379,2,4,9
10,2,loop,4,380,1,3,2.25
10,2,lord,4,381,2,2,1.75
10,2,lose,4,382,2,2,1.75
10,2,lost,4,383,3,1,1.5
10,2,lovely,6,384,2,4,9.5
10,2,lower,5,385,2,3,2.25
10,2,luck,4,386,1,3,2.25
10,2,lung,4,387,2,2,1.75
10,2,mall,4,388,0,4,2.5
10,2,man,3,389,2,1,7
10,2,management,10,390,3,7,5
10,2,manifest,8,391,3,5,3.75
10,2,manner,6,392,3,3,8.75
10,2,march,5,393,2,3,2.25
10,2,marker,6,394,3,3,2.5
10,2,marketing,9,395,5,4,3.5
10,2,marriage,8,396,3,5,9.75
10,2,matching,8,397,2,6,4.25
10,2,mate,4,398,3,1,1.25
10,2,maths,5,399,3,2,1.75
10,2,maximize,8,400,2,6,10
10,2,maybe,5,401,2,3,2.5
10,2,mayor,5,402,3,2,1.75
10,2,me,2,403,1,1,0.75
10,2,means,5,404,2,3,8.25
10,2,mechanism,9,405,2,7,4.75
10,2,medical,7,406,2,5,3
10,2,medicine,8,407,5,3,5.25
10,2,meet,4,408,2,2,0.75
10,2,menu,4,409,2,2,0.75
10,2,metal,5,410,2,3,1
10,2,military,8,411,1,7,6
10,2,milk,4,412,3,1,0.75
10,2,mill,4,413,3,1,0.5
10,2,miner,5,414,2,3,1
10,2,minimize,8,415,3,5,1.75
10,2,miracle,7,416,2,5,5.25
10,2,mobile,6,417,1,5,1.5
10,2,modern,6,418,2,4,5
10,2,modest,6,419,4,2,1
10,2,momentum,8,420,2,6,1.75
10,2,monitor,7,421,2,5,1.5
10,2,monk,4,422,3,1,4.5
10,2,morality,8,423,2,6,1.75
10,2,motivation,10,424,2,8,6.25
10,2,motor,5,425,3,2,1
10,2,move,4,426,2,2,0.75
10,2,movement,8,427,4,4,1.25
10,2,multiply,8,428,1,7,5.75
10,2,musical,7,429,2,5,1.5
10,2,myself,6,430,1,5,1.5
10,2,national,8,431,0,8,6
10,2,naturally,9,432,3,6,2
10,2,naval,5,433,2,3,5
10,2,nerve,5,434,1,4,1.5
10,2,nest,4,435,2,2,0.75
10,2,net,3,436,2,1,0.5
10,2,nineteen,8,437,1,7,5.75
10,2,ninety,6,438,5,1,1
10,2,nonsense,8,439,1,7,2
10,2,noon,4,440,2,2,1
10,2,nose,4,441,2,2,4.75
10,2,notable,7,442,2,5,1.5
10,2,nowadays,8,443,2,6,2
10,2,number,6,444,1,5,5.75
10,2,nurse,5,445,2,3,1
10,2,nursing,7,446,4,3,1.25
10,2,o,1,447,0,1,0.25
10,2,obey,4,448,1,3,4.5
10,2,observe,7,449,2,5,1.5
10,2,observer,8,450,7,1,0.75
10,2,obsession,9,451,4,5,1.75
10,2,occasion,8,452,1,7,5.75
10,2,occur,5,453,3,2,1
10,2,offender,8,454,1,7,6.25
10,2,offering,8,455,4,4,2.25
10,2,onto,4,456,1,3,1.25
10,2,open,4,457,1,3,1
10,2,operate,7,458,3,4,5.25
10,2,operator,8,459,6,2,1.25
10,2,or,2,460,1,1,0.5
10,2,oral,4,461,2,2,0.75
10,2,orange,6,462,3,3,1.25
10,2,orchestra,9,463,2,7,6
10,2,order,5,464,2,3,1
10,2,organize,8,465,2,6,2
10,2,originally,10,466,2,8,6.5
10,2,our,3,467,1,2,0.75
10,2,outrage,7,468,2,5,5.5
10,2,oven,4,469,1,3,1
10,2,overly,6,470,3,3,1.25
10,2,overnight,9,471,4,5,2
10,2,overseas,8,472,4,4,5.25
10,2,own,3,473,1,2,0.75
10,2,owner,5,474,3,2,0.75
10,2,oxygen,6,475,1,5,1.5
10,2,packet,6,476,0,6,5.75
10,2,pair,4,477,2,2,0.75
10,2,pan,3,478,2,1,0.5
10,2,parent,6,479,2,4,1.25
10,2,party,5,480,3,2,0.75
10,2,pass,4,481,2,2,4.5
10,2,passing,7,482,4,3,1.5
10,2,passion,7,483,5,2,1.25
10,2,peak,4,484,1,3,1
10,2,pension,7,485,2,5,5.5
10,2,period,6,486,2,4,1.5
10,2,persuade,8,487,3,5,1.75
10,2,petition,8,488,2,6,6
10,2,photograph,10,489,1,9,2.5
10,2,physics,7,490,2,5,5.5
10,2,pill,4,491,1,3,1
10,2,pitch,5,492,2,3,1.25
10,2,plate,5,493,1,4,1.25
10,2,player,6,494,3,3,5.25
10,2,pleasure,8,495,2,6,2
10,2,poet,4,496,1,3,1
10,2,poetry,6,497,4,2,4.75
10,2,policeman,9,498,2,7,2.25
10,2,politics,8,499,4,4,1.75
10,2,popular,7,500,2,5,5.75
10,2,popularity,10,501,7,3,1.5
10,2,pose,4,502,2,2,0.75
10,2,powder,6,503,2,4,1.25
10,2,practice,8,504,1,7,6
10,2,pray,4,505,3,1,0.5
10,2,precede,7,506,2,5,2
10,2,precision,9,507,4,5,1299
10,2,prefer,6,508,3,3,1.75
10,2,preference,10,509,6,4,2
10,2,present,7,510,3,4,2
10,2,president,9,511,4,5,9.25
10,2,previous,8,512,3,5,2.25
10,2,prey,4,513,3,1,0.75
10,2,price,5,514,2,3,1.25
10,2,pride,5,515,3,2,6.5
10,2,primarily,9,516,3,6,3.75
10,2,privilege,9,517,3,6,2.5
10,2,probable,8,518,2,6,8.25
10,2,proceed,7,519,3,4,2.75
10,2,production,10,520,3,7,8.5
10,2,profession,10,521,3,7,3
10,2,profitable,10,522,4,6,8.25
10,2,promotion,9,523,3,6,2.75
10,2,pronounced,10,524,3,7,10.25
10,2,prosecutor,10,525,3,7,3
10,2,protection,10,526,3,7,7.5
10,2,protocol,8,527,4,4,2.75
10,2,provide,7,528,3,4,2
10,2,province,8,529,5,3,2
10,2,provincial,10,530,7,3,5.75
10,2,provoke,7,531,4,3,1.25
10,2,psychology,10,532,1,9,7
10,2,pub,3,533,1,2,0.75
10,2,punch,5,534,2,3,1.25
10,2,purchase,8,535,2,6,2
10,2,pursue,6,536,3,3,5.5
10,2,qualify,7,537,0,7,2
10,2,question,8,538,2,6,6
10,2,queue,5,539,3,2,1.25
10,2,quickly,7,540,2,5,1.5
10,2,quota,5,541,2,3,1.25
10,2,quote,5,542,4,1,0.75
10,2,radio,5,543,0,5,5.5
10,2,rapid,5,544,2,3,1.25
10,2,rare,4,545,2,2,0.75
10,2,raw,3,546,2,1,0.5
10,2,reading,7,547,1,6,6
10,2,real,4,548,3,1,0.75
10,2,realize,7,549,4,3,1.25
10,2,really,6,550,4,2,1
10,2,receiver,8,551,2,6,6.5
10,2,recovery,8,552,3,5,2
10,2,red,3,553,2,1,0.5
10,2,refugee,7,554,2,5,1.5
10,2,register,8,555,2,6,6.25
10,2,regret,6,556,3,3,1.25
10,2,regularly,9,557,3,6,2
10,2,regulator,9,558,6,3,5.5
10,2,relaxing,8,559,2,6,2
10,2,remarkable,10,560,2,8,6.5
10,2,remember,8,561,3,5,1.75
10,2,reminder,8,562,3,5,1.75
10,2,rental,6,563,2,4,5.5
10,2,report,6,564,2,4,1.25
10,2,reputation,10,565,3,7,6
10,2,request,7,566,2,5,1.75
10,2,respect,7,567,2,5,1.75
10,2,restraint,9,568,3,6,6
10,2,result,6,569,3,3,1.25
10,2,resume,6,570,4,2,1
10,2,rhythm,6,571,1,5,1.5
10,2,rice,4,572,1,3,5
10,2,riot,4,573,2,2,1
10,2,risk,4,574,2,2,0.75
10,2,rock,4,575,1,3,1
10,2,romantic,8,576,2,6,10.75
10,2,route,5,577,2,3,2.25
10,2,royal,5,578,2,3,2.25
10,2,rugby,5,579,1,4,3
10,2,rule,4,580,2,2,8.5
10,2,rumour,6,581,2,4,3
10,2,run,3,582,2,1,1
10,2,sad,3,583,0,3,2
10,2,salary,6,584,2,4,2.75
10,2,scale,5,585,1,4,9.25
10,2,scratch,7,586,2,5,3.5
10,2,scream,6,587,3,3,2.5
10,2,seldom,6,588,1,5,10.25
10,2,self,4,589,3,1,1.25
10,2,send,4,590,2,2,1.75
10,2,sensation,9,591,3,6,4.25
10,2,seventeen,9,592,2,7,11.5
10,2,seventy,7,593,6,1,1.75
10,2,sex,3,594,2,1,1.25
10,2,shade,5,595,1,4,2.75
10,2,shake,5,596,3,2,8.25
10,2,shall,5,597,3,2,2
10,2,shaped,6,598,3,3,2.5
10,2,sheet,5,599,2,3,2.25
10,2,shop,4,600,2,2,1.5
10,2,should,6,601,3,3,10.75
10,2,shout,5,602,4,1,1.5
10,2,show,4,603,3,1,1.25
10,2,sigh,4,604,1,3,2.25
10,2,silent,6,605,2,4,3
10,2,silly,5,606,3,2,2
10,2,similarity,10,607,2,8,12.25
10,2,sincere,7,608,2,5,3.5
10,2,sing,4,609,3,1,1.25
10,2,sir,3,610,2,1,1
10,2,sixty,5,611,2,3,10.5
10,2,skiing,6,612,1,5,3.5
10,2,slow,4,613,1,3,2.25
10,2,snap,4,614,1,3,10
10,2,soak,4,615,1,3,2.25
10,2,soft,4,616,2,2,1.75
10,2,solicitor,9,617,2,7,5
10,2,somewhere,9,618,2,7,12.75
10,2,son,3,619,2,1,1
10,2,sort,4,620,2,2,1.75
10,2,source,6,621,2,4,3
10,2,speculate,9,622,1,8,13.75
10,2,spicy,5,623,2,3,2.5
10,2,spill,5,624,3,2,2
10,2,spite,5,625,3,2,9.75
10,2,split,5,626,2,3,2.5
10,2,sponsor,7,627,2,5,3.5
10,2,spoon,5,628,3,2,2
10,2,spy,3,629,2,1,1
10,2,stabilize,9,630,1,8,12
10,2,stark,5,631,3,2,2
10,2,statement,9,632,3,6,11.25
10,2,station,7,633,4,3,2.75
10,2,strive,6,634,2,4,3
10,2,struggle,8,635,3,5,3.75
10,2,stunning,8,636,2,6,11.25
10,2,suddenly,8,637,1,7,4.5
10,2,suggestion,10,638,2,8,12
10,2,summarize,9,639,2,7,12
10,2,superb,6,640,2,4,3.5
10,2,superior,8,641,5,3,2.75
10,2,supervisor,10,642,5,5,4
10,2,supplement,10,643,3,7,13.25
10,2,surge,5,644,2,3,2.5
10,2,surprising,10,645,3,7,13
10,2,surrender,9,646,3,6,4.75
10,2,survive,7,647,3,4,3.25
10,2,suspicious,10,648,2,8,14.75
10,2,sustain,7,649,3,4,3.25
10,2,sweet,5,650,1,4,9.75
10,2,swimming,8,651,2,6,4.5
10,2,swing,5,652,3,2,2
10,2,symbol,6,653,1,5,10.5
10,2,syndrome,8,654,2,6,4.25
10,2,systematic,10,655,2,8,12
10,2,talented,8,656,0,8,5.25
10,2,tax,3,657,2,1,1.25
10,2,technique,9,658,1,8,12.25
10,2,teenager,8,659,2,6,4.25
10,2,terrain,7,660,2,5,10.5
10,2,testify,7,661,2,5,3.5
10,2,than,4,662,1,3,2.25
10,2,theatre,7,663,2,5,10.75
10,2,theft,5,664,3,2,2
10,2,theirs,6,665,3,3,4.25
10,2,them,4,666,3,1,1.75
10,2,theology,8,667,3,5,4
10,2,there,5,668,3,2,10.25
10,2,therefore,9,669,5,4,3.5
10,2,they,4,670,3,1,1.5
10,2,thick,5,671,2,3,2.75
10,2,thief,5,672,3,2,2.75
10,2,thin,4,673,3,1,1.25
10,2,think,5,674,4,1,9
10,2,though,6,675,2,4,3
10,2,threaten,8,676,2,6,4.25
10,2,threshold,9,677,4,5,11
10,2,throat,6,678,3,3,2.5
10,2,throw,5,679,4,1,1.5
10,2,timber,6,680,1,5,3.5
10,2,tired,5,681,2,3,9.5
10,2,tobacco,7,682,1,6,4.25
10,2,tomato,6,683,2,4,3
10,2,ton,3,684,2,1,1
10,2,tone,4,685,3,1,1
10,2,tongue,6,686,3,3,9.75
10,2,total,5,687,2,3,2.25
10,2,touch,5,688,2,3,2.25
10,2,towards,7,689,2,5,3.5
10,2,trace,5,690,1,4,9.5
10,2,tradition,9,691,3,6,4.5
10,2,training,8,692,3,5,10.5
10,2,transform,9,693,3,6,4.5
10,2,tremendous,10,694,2,8,13.5
10,2,tribunal,8,695,2,6,5.25
10,2,true,4,696,2,2,1.75
10,2,truly,5,697,3,2,2
10,2,trust,5,698,3,2,9
10,2,try,3,699,2,1,1
10,2,tuition,7,700,1,6,4.25
10,2,turnout,7,701,2,5,3.75
10,2,turnover,8,702,5,3,10
10,2,typical,7,703,1,6,4
10,2,understand,10,704,0,10,14
10,2,unlike,6,705,2,4,3
10,2,up,2,706,1,1,1
10,2,upper,5,707,2,3,2.25
10,2,upset,5,708,2,3,9.25
10,2,upwards,7,709,2,5,3.75
10,2,use,3,710,1,2,1.5
10,2,user,4,711,3,1,1
10,2,utterly,7,712,1,6,11.25
10,2,valid,5,713,0,5,3.25
10,2,vehicle,7,714,1,6,11.5
10,2,very,4,715,2,2,1.75
10,2,vicious,7,716,1,6,4
10,2,victim,6,717,3,3,2.75
10,2,village,7,718,2,5,10.5
10,2,violate,7,719,2,5,3.5
10,2,violation,9,720,6,3,2.5
10,2,volume,6,721,1,5,10.5
10,2,vote,4,722,2,2,1.75
10,2,want,4,723,0,4,2.75
10,2,ward,4,724,2,2,1.75
10,2,warehouse,9,725,3,6,9.25
10,2,warfare,7,726,3,4,1.5
10,2,warm,4,727,3,1,0.5
10,2,weak,4,728,1,3,1
10,2,weather,7,729,3,4,5.75
10,2,web,3,730,2,1,0.5
10,2,website,7,731,3,4,1.25
10,2,weekly,6,732,2,4,1.25
10,2,well,4,733,2,2,0.75
10,2,wet,3,734,2,1,4.75
10,2,wheat,5,735,1,4,1.25
10,2,whilst,6,736,2,4,1.5
10,2,whole,5,737,2,3,1.25
10,2,wholly,6,738,4,2,1
10,2,wide,4,739,1,3,5.25
10,2,widespread,10,740,4,6,2
10,2,winter,6,741,2,4,1.5
10,2,wish,4,742,2,2,5
10,2,withdraw,8,743,2,6,2
10,2,workout,7,744,1,6,1.75
10,2,worldwide,9,745,3,6,6.25
10,2,worst,5,746,3,2,0.75
10,2,wound,5,747,2,3,1
10,2,writing,7,748,1,6,6.25
10,2,wrong,5,749,2,3,1.5
10,2,year,4,750,0,4,1.25
10,2,yell,4,751,2,2,0.75
10,2,yesterday,9,752,2,7,6.5
10,2,yours,5,753,1,4,1.25
10,3,ability,7,0,0,7,4.5
10,3,able,4,1,2,2,0.75
10,3,abolish,7,2,2,5,6.25
10,3,abortion,8,3,3,5,1.75
10,3,about,5,4,3,2,1
10,3,absent,6,5,2,4,1.25
10,3,accent,6,6,1,5,6
10,3,access,6,7,4,2,1
10,3,accessible,10,8,6,4,1.75
10,3,account,7,9,3,4,6.75
10,3,acquire,7,10,2,5,2
10,3,act,3,11,2,1,0.5
10,3,action,6,12,3,3,1
10,3,adhere,6,13,1,5,6.5
10,3,admission,9,14,2,7,2.25
10,3,advanced,8,15,2,6,6.5
10,3,advertise,9,16,3,6,2.25
10,3,affair,6,17,1,5,1.5
10,3,affection,9,18,3,6,6.5
10,3,afford,6,19,3,3,1.25
10,3,aged,4,20,1,3,1
10,3,agent,5,21,3,2,0.75
10,3,aid,3,22,1,2,5.25
10,3,aircraft,8,23,2,6,2
10,3,alert,5,24,1,4,1.25
10,3,alignment,9,25,2,7,7.25
10,3,allege,6,26,2,4,1.5
10,3,allegedly,9,27,6,3,1.25
10,3,alliance,8,28,3,5,6.5
10,3,also,4,29,2,2,0.75
10,3,although,8,30,2,6,2
10,3,altogether,10,31,3,7,7
10,3,ambitious,9,32,1,8,2.5
10,3,amid,4,33,2,2,5.25
10,3,answer,6,34,1,5,1.75
10,3,anyone,6,35,2,4,1.25
10,3,anything,8,36,3,5,6.5
10,3,apart,5,37,1,4,1.25
10,3,appearance,10,38,2,8,7
10,3,appetite,8,39,4,4,1.75
10,3,array,5,40,1,4,1.25
10,3,arrival,7,41,3,4,1.5
10,3,article,7,42,2,5,6.25
10,3,artificial,10,43,4,6,2.25
10,3,assess,6,44,1,5,6
10,3,assignment,10,45,3,7,2.25
10,3,associated,10,46,3,7,7
10,3,attempt,7,47,1,6,2
10,3,attorney,8,48,3,5,1.75
10,3,audience,8,49,1,7,6.75
10,3,audit,5,50,4,1,0.75
10,3,august,6,51,2,4,1.25
10,3,author,6,52,2,4,5.75
10,3,authority,9,53,6,3,1.75
10,3,aware,5,54,1,4,1.25
10,3,away,4,55,3,1,0.75
10,3,bad,3,56,0,3,0.75
10,3,bake,4,57,2,2,5.25
10,3,bare,4,58,2,2,0.75
10,3,barrier,7,59,3,4,1.5
10,3,basis,5,60,2,3,1.25
10,3,basket,6,61,3,3,1.25
10,3,basketball,10,62,6,4,6.5
10,3,bear,4,63,1,3,1
10,3,because,7,64,2,5,1.75
10,3,bee,3,65,2,1,0.5
10,3,before,6,66,2,4,6.25
10,3,behind,6,67,2,4,1.5
10,3,being,5,68,2,3,1
10,3,beneath,7,69,2,5,6.25
10,3,bent,4,70,3,1,0.75
10,3,beside,6,71,2,4,1.5
10,3,bet,3,72,2,1,0.5
10,3,bicycle,7,73,1,6,6.5
10,3,biological,10,74,2,8,2.75
10,3,blanket,7,75,1,6,6.5
10,3,bleed,5,76,2,3,1
10,3,blessing,8,77,3,5,1.75
10,3,blood,5,78,2,3,1
10,3,bold,4,79,1,3,5.75
10,3,bond,4,80,2,2,1
10,3,boring,6,81,2,4,1.5
10,3,bounce,6,82,2,4,1.25
10,3,brain,5,83,1,4,5.75
10,3,branch,6,84,3,3,1.25
10,3,bread,5,85,2,3,1.25
10,3,breast,6,86,4,2,1
10,3,broadband,9,87,2,7,7.75
10,3,brother,7,88,3,4,2.25
10,3,brown,5,89,3,2,1
10,3,buck,4,90,1,3,1.25
10,3,building,8,91,2,6,6.75
10,3,burial,6,92,2,4,1.5
10,3,burst,5,93,3,2,1
10,3,bury,4,94,3,1,0.75
10,3,bus,3,95,2,1,5.25
10,3,busy,4,96,3,1,0.75
10,3,button,6,97,2,4,1.25
10,3,captain,7,98,0,7,2
10,3,capture,7,99,4,3,6.25
10,3,castle,6,100,2,4,1.5
10,3,catch,5,101,2,3,1
10,3,cattle,6,102,3,3,1.25
10,3,cause,5,103,2,3,5.75
10,3,cautious,8,104,3,5,1.75
10,3,champion,8,105,1,7,7
10,3,charge,6,106,3,3,1.25
10,3,chest,5,107,2,3,1
10,3,cigarette,9,108,1,8,7.25
10,3,civic,5,109,2,3,1.25
10,3,classical,9,110,1,8,2.25
10,3,classify,8,111,6,2,6
10,3,cleaning,8,112,2,6,2
10,3,climate,7,113,2,5,1.75
10,3,cling,5,114,3,2,1
10,3,clock,5,115,2,3,5.75
10,3,closure,7,116,3,4,1.5
10,3,cloth,5,117,3,2,1
10,3,coastal,7,118,1,6,6.5
10,3,cocktail,8,119,2,6,2
10,3,cognitive,9,120,2,7,7
10,3,coin,4,121,2,2,0.75
10,3,collapse,8,122,2,6,1.75
10,3,colour,6,123,3,3,1.25
10,3,combat,6,124,2,4,6.25
10,3,combine,7,125,4,3,1.5
10,3,comic,5,126,3,2,1
10,3,commerce,8,127,3,5,1.75
10,3,commitment,10,128,4,6,6.75
10,3,common,6,129,4,2,1.25
10,3,communist,9,130,4,5,2
10,3,compare,7,131,3,4,6.25
10,3,compelling,10,132,4,6,2.25
10,3,complain,8,133,4,4,1.75
10,3,complex,7,134,5,2,5.75
10,3,comprise,8,135,4,4,1.5
10,3,computer,8,136,4,4,1.5
10,3,conception,10,137,2,8,7.5
10,3,concession,10,138,5,5,2
10,3,confident,9,139,3,6,7
10,3,confirm,7,140,5,2,1.25
10,3,confuse,7,141,4,3,1.25
10,3,conscience,10,142,3,7,2.25
10,3,consist,7,143,4,3,6.5
10,3,constitute,10,144,4,6,2.25
10,3,consumer,8,145,4,4,1.5
10,3,container,9,146,3,6,8.75
10,3,contender,9,147,4,5,4
10,3,context,7,148,5,2,2.25
10,3,continue,8,149,4,4,11
10,3,continuous,10,150,7,3,3
10,3,contract,8,151,4,4,3.25
10,3,conviction,10,152,3,7,12.75
10,3,costume,7,153,2,5,3.5
10,3,council,7,154,2,5,3.5
10,3,courage,7,155,3,4,11.25
10,3,covered,7,156,2,5,3.5
10,3,crack,5,157,1,4,2.75
10,3,creation,8,158,2,6,12
10,3,critical,8,159,2,6,4.25
10,3,crop,4,160,2,2,1.5
10,3,crown,5,161,3,2,9.75
10,3,crystal,7,162,2,5,3.75
10,3,cult,4,163,1,3,2.25
10,3,curiosity,9,164,2,7,13
10,3,customer,8,165,2,6,4.25
10,3,cutting,7,166,2,5,16.75
10,3,dancer,6,167,0,6,448
10,3,date,4,168,2,2,1.75
10,3,dead,4,169,1,3,2.25
10,3,deadline,8,170,4,4,3.25
10,3,deadly,6,171,5,1,1.25
10,3,dear,4,172,3,1,8
10,3,debate,6,173,2,4,2.25
10,3,debut,5,174,3,2,2
10,3,decision,8,175,2,6,5
10,3,dedication,10,176,2,8,10.75
10,3,defend,6,177,2,4,3.75
10,3,defy,4,178,3,1,1.5
10,3,depart,6,179,2,4,8.25
10,3,dependence,10,180,3,7,3.5
10,3,depict,6,181,3,3,2
10,3,derive,6,182,2,4,7.75
10,3,descent,7,183,2,5,2.5
10,3,desert,6,184,3,3,3.25
10,3,desire,6,185,3,3,8.75
10,3,desperate,9,186,3,6,3
10,3,devise,6,187,2,4,4
10,3,diary,5,188,1,4,12.75
10,3,dictionary,10,189,2,8,5.5
10,3,die,3,190,2,1,0.75
10,3,differ,6,191,2,4,12.75
10,3,different,9,192,6,3,2.5
10,3,dilemma,7,193,2,5,2.5
10,3,direction,9,194,2,7,6
10,3,discourse,9,195,2,7,2.25
10,3,disease,7,196,3,4,1.75
10,3,disrupt,7,197,3,4,5.75
10,3,distract,8,198,3,5,2
10,3,district,8,199,5,3,1.5
10,3,diversity,9,200,2,7,6.25
10,3,divorce,7,201,3,4,1.5
10,3,dominance,9,202,1,8,6.5
10,3,dominate,8,203,6,2,1.25
10,3,donate,6,204,2,4,1.5
10,3,donor,5,205,3,2,1
10,3,door,4,206,2,2,1
10,3,dose,4,207,2,2,5
10,3,drag,4,208,1,3,1.25
10,3,dress,5,209,2,3,1.25
10,3,drive,5,210,2,3,1.25
10,3,driver,6,211,5,1,0.75
10,3,drum,4,212,2,2,5
10,3,dry,3,213,2,1,0.75
10,3,dull,4,214,1,3,1.25
10,3,during,6,215,2,4,1.5
10,3,duty,4,216,2,2,1
10,3,dynamic,7,217,1,6,5.5
10,3,each,4,218,0,4,1.25
10,3,easily,6,219,2,4,1.5
10,3,eat,3,220,2,1,0.5
10,3,echo,4,221,1,3,4.25
10,3,editorial,9,222,1,8,2.5
10,3,educated,8,223,2,6,5.75
10,3,efficiency,10,224,1,9,2.75
10,3,elaborate,9,225,1,8,5.75
10,3,election,8,226,2,6,2
10,3,electric,8,227,5,3,5
10,3,elevate,7,228,3,4,1.5
10,3,embed,5,229,1,4,1.25
10,3,emerge,6,230,2,4,1.5
10,3,emotional,9,231,2,7,5.75
10,3,employ,6,232,2,4,1.25
10,3,empty,5,233,3,2,1
10,3,encourage,9,234,1,8,5.75
10,3,enforce,7,235,2,5,1.75
10,3,enhance,7,236,2,5,5.25
10,3,enough,6,237,2,4,1.25
10,3,enrol,5,238,2,3,1
10,3,ensue,5,239,2,3,4.25
10,3,entire,6,240,2,4,1.75
10,3,entirely,8,241,6,2,1
10,3,entity,6,242,4,2,1
10,3,epidemic,8,243,1,7,5.5
10,3,equip,5,244,1,4,1.25
10,3,equivalent,10,245,4,6,2
10,3,erupt,5,246,1,4,5
10,3,essential,9,247,1,8,2.25
10,3,eternal,7,248,1,6,5.25
10,3,ethical,7,249,2,5,1.75
10,3,every,5,250,1,4,1.25
10,3,everyday,8,251,5,3,4.75
10,3,everywhere,10,252,5,5,2.25
10,3,evil,4,253,2,2,0.75
10,3,exaggerate,10,254,1,9,6.5
10,3,except,6,255,2,4,1.25
10,3,excess,6,256,4,2,1
10,3,excitement,10,257,3,7,5.5
10,3,exclude,7,258,3,4,1.75
10,3,exotic,6,259,2,4,1.25
10,3,expected,8,260,2,6,5.25
10,3,explicit,8,261,3,5,1.75
10,3,export,6,262,3,3,1.25
10,3,exposure,8,263,4,4,5
10,3,extra,5,264,2,3,1
10,3,extract,7,265,5,2,0.75
10,3,extremely,9,266,4,5,1.75
10,3,fairness,8,267,0,8,5.75
10,3,faith,5,268,3,2,1.25
10,3,farm,4,269,2,2,0.75
10,3,favour,6,270,2,4,4.75
10,3,favourite,9,271,6,3,1.5
10,3,feat,4,272,1,3,1
10,3,feed,4,273,2,2,0.75
10,3,feel,4,274,3,1,0.5
10,3,festival,8,275,2,6,5.25
10,3,find,4,276,1,3,1.25
10,3,finger,6,277,3,3,1.25
10,3,finish,6,278,3,3,1.25
10,3,fire,4,279,2,2,4.5
10,3,first,5,280,3,2,1.25
10,3,fish,4,281,2,2,0.75
10,3,fit,3,282,2,1,0.5
10,3,flash,5,283,1,4,1.25
10,3,flaw,4,284,3,1,0.5
10,3,float,5,285,2,3,4.5
10,3,flood,5,286,3,2,1
10,3,flour,5,287,3,2,1
10,3,fold,4,288,1,3,1
10,3,follow,6,289,3,3,1
10,3,following,9,290,6,3,4.75
10,3,fool,4,291,2,2,0.75
10,3,forecast,8,292,2,6,1.75
10,3,forge,5,293,3,2,0.75
10,3,fork,4,294,3,1,0.5
10,3,formal,6,295,3,3,4.5
10,3,forth,5,296,3,2,1
10,3,forum,5,297,3,2,1
10,3,fossil,6,298,2,4,1.25
10,3,framework,9,299,1,8,5.75
10,3,frankly,7,300,3,4,1.5
10,3,freely,6,301,2,4,1.25
10,3,freeze,6,302,4,2,4.75
10,3,frequently,10,303,3,7,2.25
10,3,from,4,304,2,2,0.75
10,3,fully,5,305,1,4,1.25
10,3,funny,5,306,2,3,5.25
10,3,furious,7,307,2,5,2
10,3,gang,4,308,0,4,1.25
10,3,garden,6,309,2,4,5
10,3,generous,8,310,1,7,3
10,3,gentle,6,311,3,3,1.5
10,3,ghost,5,312,1,4,5.25
10,3,governance,10,313,1,9,3.5
10,3,government,10,314,6,4,7
10,3,graduate,8,315,1,7,2.75
10,3,grand,5,316,3,2,2
10,3,greatly,7,317,2,5,9.75
10,3,guideline,9,318,1,8,6
10,3,hand,4,319,0,4,8.25
10,3,happy,5,320,2,3,2.25
10,3,harassment,10,321,2,8,5.5
10,3,harmony,7,322,3,4,8.75
10,3,he,2,323,1,1,1
10,3,healthcare,10,324,2,8,5.5
10,3,hear,4,325,3,1,1.25
10,3,heating,7,326,3,4,8.75
10,3,heavily,7,327,3,4,3
10,3,hello,5,328,2,3,2.25
10,3,hence,5,329,2,3,2.25
10,3,here,4,330,2,2,7.75
10,3,hero,4,331,3,1,1.5
10,3,hidden,6,332,1,5,4
10,3,hierarchy,9,333,2,7,11.25
10,3,highway,7,334,2,5,3.75
10,3,historian,9,335,2,7,5
10,3,hockey,6,336,1,5,9.5
10,3,hold,4,337,2,2,1.75
10,3,holy,4,338,3,1,1.25
10,3,homework,8,339,2,6,10.5
10,3,honour,6,340,2,4,3
10,3,hope,4,341,2,2,1.75
10,3,hopefully,9,342,4,5,4
10,3,horizon,7,343,2,5,9.5
10,3,house,5,344,2,3,2.5
10,3,housing,7,345,4,3,2.75
10,3,hungry,6,346,1,5,10
10,3,hurry,5,347,2,3,2.5
10,3,husband,7,348,2,5,3.5
10,3,ideology,8,349,0,8,11.5
10,3,if,2,350,1,1,1
10,3,illness,7,351,1,6,4
10,3,inclined,8,352,1,7,10.5
10,3,increase,8,353,3,5,3.75
10,3,indicator,9,354,2,7,11
10,3,induce,6,355,3,3,2.75
10,3,inequality,10,356,2,8,5.5
10,3,initial,7,357,2,5,10
10,3,inmate,6,358,2,4,3
10,3,innocent,8,359,2,6,11
10,3,input,5,360,2,3,2.5
10,3,insider,7,361,2,5,3.75
10,3,insight,7,362,4,3,2.75
10,3,inspire,7,363,3,4,9.25
10,3,instantly,9,364,3,6,4.5
10,3,intention,9,365,2,7,11
10,3,interact,8,366,4,4,3.5
10,3,interpret,9,367,5,4,3.5
10,3,interrupt,9,368,5,4,10
10,3,intriguing,10,369,3,7,5.25
10,3,introduce,9,370,4,5,4.25
10,3,invasion,8,371,2,6,10.5
10,3,invent,6,372,3,3,2.5
10,3,invisible,9,373,3,6,10.5
10,3,invoke,6,374,3,3,2.5
10,3,ironically,10,375,1,9,6
10,3,irrelevant,10,376,2,8,11.5
10,3,jam,3,377,0,3,2
10,3,join,4,378,1,3,2.25
10,3,journalist,10,379,2,8,11.75
10,3,july,4,380,1,3,2.25
10,3,keen,4,381,0,4,9.25
10,3,kidnap,6,382,1,5,4.25
10,3,kill,4,383,2,2,2.25
10,3,killing,7,384,4,3,3
10,3,kind,4,385,2,2,1.75
10,3,knock,5,386,1,4,10.5
10,3,label,5,387,0,5,4
10,3,lady,4,388,2,2,1.75
10,3,lamp,4,389,2,2,2
10,3,landlord,8,390,2,6,11.5
10,3,lane,4,391,3,1,1.5
10,3,language,8,392,3,5,4
10,3,laptop,6,393,2,4,10.25
10,3,late,4,394,2,2,1.75
10,3,lawyer,6,395,2,4,3.5
10,3,legal,5,396,1,4,3
10,3,leisure,7,397,2,5,12.5
10,3,lesson,6,398,2,4,4.5
10,3,let,3,399,2,1,2.25
10,3,level,5,400,2,3,2.5
10,3,lifetime,8,401,1,7,13.5
10,3,light,5,402,2,3,2.5
10,3,limit,5,403,2,3,2.75
10,3,listener,8,404,2,6,11.5
10,3,lively,6,405,2,4,3
10,3,lobby,5,406,1,4,2.75
10,3,logic,5,407,2,3,8.25
10,3,logo,4,408,3,1,1.25
10,3,loom,4,409,2,2,1.5
10,3,lord,4,410,2,2,1.75
10,3,lose,4,411,2,2,1.75
10,3,lost,4,412,3,1,1.25
10,3,luck,4,413,1,3,2.25
10,3,lung,4,414,2,2,7.75
10,3,magical,7,415,0,7,4.5
10,3,magnitude,9,416,3,6,11
10,3,major,5,417,2,3,2.25
10,3,man,3,418,2,1,1
10,3,marathon,8,419,2,6,4.25
10,3,marketing,9,420,3,6,11
10,3,marriage,8,421,3,5,4
10,3,massive,7,422,2,5,3.75
10,3,matching,8,423,2,6,10.5
10,3,mate,4,424,3,1,1.25
10,3,maths,5,425,3,2,1.75
10,3,matter,6,426,3,3,2.5
10,3,maximize,8,427,2,6,11.25
10,3,maybe,5,428,2,3,2.5
10,3,mayor,5,429,3,2,1.75
10,3,means,5,430,1,4,2.75
10,3,medical,7,431,2,5,9.5
10,3,meditation,10,432,4,6,4.75
10,3,membership,10,433,2,8,12
10,3,metaphor,8,434,2,6,4.25
10,3,migration,9,435,1,8,11.75
10,3,military,8,436,2,6,4.25
10,3,minimize,8,437,2,6,10.5
10,3,mining,6,438,4,2,2
10,3,minority,8,439,3,5,3.75
10,3,minute,6,440,3,3,9.25
10,3,miracle,7,441,2,5,3.75
10,3,mobile,6,442,1,5,3.5
10,3,mode,4,443,2,2,1.75
10,3,momentum,8,444,2,6,10.25
10,3,moral,5,445,2,3,2.25
10,3,morality,8,446,5,3,2.5
10,3,morning,7,447,3,4,9.5
10,3,motivation,10,448,2,8,5.5
10,3,motive,6,449,5,1,1.5
10,3,motorist,8,450,3,5,10
10,3,movement,8,451,2,6,4.25
10,3,musical,7,452,1,6,10
10,3,myself,6,453,1,5,3.5
10,3,mysterious,10,454,3,7,5
10,3,nail,4,455,0,4,9
10,3,national,8,456,2,6,4.25
10,3,naturally,9,457,3,6,9.75
10,3,neglect,7,458,1,6,2
10,3,network,7,459,2,5,1.75
10,3,news,4,460,2,2,4.75
10,3,nineteen,8,461,1,7,2
10,3,ninety,6,462,5,1,0.75
10,3,noon,4,463,1,3,1
10,3,nose,4,464,2,2,4.75
10,3,notable,7,465,2,5,1.75
10,3,notably,7,466,6,1,1
10,3,now,3,467,2,1,0.5
10,3,nurse,5,468,1,4,1.25
10,3,nursery,7,469,5,2,0.75
10,3,nursing,7,470,4,3,4.75
10,3,obey,4,471,0,4,1.25
10,3,object,6,472,2,4,1.25
10,3,obsession,9,473,2,7,6.25
10,3,occurrence,10,474,1,9,2.5
10,3,offer,5,475,1,4,5.25
10,3,onion,5,476,1,4,1.5
10,3,operate,7,477,1,6,5.5
10,3,operator,8,478,6,2,1.5
10,3,opinion,7,479,2,5,1.75
10,3,optimism,8,480,2,6,2
10,3,orange,6,481,1,5,5.75
10,3,ordinary,8,482,2,6,1.75
10,3,our,3,483,1,2,0.75
10,3,outrage,7,484,2,5,6
10,3,overly,6,485,1,5,1.5
10,3,overnight,9,486,4,5,5.5
10,3,overseas,8,487,4,4,1.5
10,3,owner,5,488,1,4,1.25
10,3,oxygen,6,489,1,5,5.5
10,3,pair,4,490,0,4,1.25
10,3,paper,5,491,2,3,1
10,3,parameter,9,492,2,7,6.25
10,3,parental,8,493,3,5,2
10,3,parish,6,494,3,3,1.25
10,3,pass,4,495,2,2,0.75
10,3,peasant,7,496,1,6,5.75
10,3,pension,7,497,2,5,1.5
10,3,period,6,498,2,4,1.5
10,3,person,6,499,3,3,5.25
10,3,photograph,10,500,1,9,2.75
10,3,pit,3,501,1,2,0.75
10,3,pitch,5,502,3,2,5
10,3,placement,9,503,1,8,2.25
10,3,plain,5,504,3,2,1
10,3,planet,6,505,3,3,5
10,3,pleasure,8,506,2,6,2
10,3,plunge,6,507,2,4,1.5
10,3,pole,4,508,1,3,4.75
10,3,policeman,9,509,3,6,2
10,3,politics,8,510,4,4,1.5
10,3,pool,4,511,2,2,0.75
10,3,popular,7,512,2,5,5.75
10,3,port,4,513,2,2,0.75
10,3,pose,4,514,2,2,0.75
10,3,potential,9,515,2,7,5.75
10,3,powerful,8,516,2,6,1.75
10,3,preach,6,517,1,5,1.75
10,3,precede,7,518,3,4,5.25
10,3,precision,9,519,4,5,1.75
10,3,prefer,6,520,3,3,1
10,3,premium,7,521,3,4,5.5
10,3,present,7,522,3,4,1.5
10,3,president,9,523,4,5,1.75
10,3,pretty,6,524,3,3,3
10,3,price,5,525,2,3,3
10,3,pride,5,526,3,2,0.75
10,3,priest,6,527,3,3,1.25
10,3,primarily,9,528,3,6,5.75
10,3,prince,6,529,3,3,1.25
10,3,privilege,9,530,3,6,2
10,3,probably,8,531,2,6,6
10,3,proceed,7,532,3,4,1.5
10,3,production,10,533,3,7,2.25
10,3,productive,10,534,8,2,5.5
10,3,promote,7,535,3,4,1.5
10,3,prosecutor,10,536,3,7,2.25
10,3,protect,7,537,3,4,5.25
10,3,protein,7,538,5,2,1
10,3,provide,7,539,3,4,1.25
10,3,provincial,10,540,5,5,6
10,3,publishing,10,541,1,9,2.75
10,3,purple,6,542,2,4,3.5
10,3,quarter,7,543,0,7,4.25
10,3,quickly,7,544,2,5,1.5
10,3,quietly,7,545,3,4,5.5
10,3,quote,5,546,2,3,1
10,3,racist,6,547,0,6,2
10,3,range,5,548,2,3,5
10,3,read,4,549,1,3,1
10,3,reading,7,550,4,3,1.25
10,3,realize,7,551,3,4,1.5
10,3,really,6,552,4,2,1
10,3,rebellion,9,553,2,7,6.25
10,3,receive,7,554,2,5,1.5
10,3,recession,9,555,4,5,6.25
10,3,recipient,9,556,3,6,2.25
10,3,refugee,7,557,2,5,5.5
10,3,register,8,558,2,6,2
10,3,regularly,9,559,3,6,2
10,3,relatively,10,560,2,8,7
10,3,relaxing,8,561,4,4,1.5
10,3,reliable,8,562,3,5,6.25
10,3,rely,4,563,3,1,0.75
10,3,remarkable,10,564,2,8,2.5
10,3,remote,6,565,3,3,5.25
10,3,renowned,8,566,2,6,2
10,3,rental,6,567,3,3,1.25
10,3,report,6,568,2,4,5.25
10,3,reporter,8,569,6,2,1.5
10,3,represent,9,570,3,6,2
10,3,reputation,10,571,3,7,6.5
10,3,request,7,572,2,5,1.5
10,3,respect,7,573,2,5,1.5
10,3,response,8,574,4,4,5.75
10,3,rice,4,575,1,3,1.25
10,3,riot,4,576,2,2,0.75
10,3,role,4,577,1,3,1
10,3,romantic,8,578,2,6,6
10,3,rugby,5,579,1,4,1.25
10,3,rule,4,580,2,2,0.75
10,3,run,3,581,2,1,0.5
10,3,runner,6,582,3,3,1
10,3,sad,3,583,0,3,5
10,3,saint,5,584,2,3,1
10,3,say,3,585,2,1,0.5
10,3,scope,5,586,1,4,1.25
10,3,screening,9,587,2,7,6.5
10,3,script,6,588,3,3,1.25
10,3,sculpture,9,589,2,7,6.25
10,3,sea,3,590,1,2,0.75
10,3,seize,5,591,2,3,1
10,3,senior,6,592,2,4,1.25
10,3,sensitive,9,593,3,6,6.5
10,3,sentence,8,594,3,5,1.75
10,3,session,7,595,2,5,1.5
10,3,set,3,596,2,1,0.5
10,3,seventeen,9,597,2,7,6.75
10,3,seventy,7,598,6,1,0.75
10,3,sex,3,599,2,1,0.5
10,3,shake,5,600,1,4,1.25
10,3,sheet,5,601,2,3,5.25
10,3,shocking,8,602,2,6,2
10,3,shop,4,603,3,1,0.75
10,3,shot,4,604,3,1,0.5
10,3,shrink,6,605,2,4,5.25
10,3,shrug,5,606,3,2,1
10,3,sigh,4,607,1,3,1
10,3,silence,7,608,2,5,1.5
10,3,silent,6,609,5,1,0.75
10,3,sincere,7,610,2,5,6
10,3,situation,9,611,2,7,2
10,3,sixty,5,612,2,3,5.25
10,3,size,4,613,2,2,1
10,3,skiing,6,614,1,5,1.5
10,3,slave,5,615,1,4,1.25
10,3,slow,4,616,2,2,2.75
10,3,smart,5,617,1,4,3.5
10,3,smash,5,618,3,2,1
10,3,soak,4,619,1,3,1
10,3,soccer,6,620,2,4,1.5
10,3,software,8,621,2,6,6
10,3,solely,6,622,2,4,1.25
10,3,solicitor,9,623,3,6,6.25
10,3,somewhere,9,624,2,7,2.25
10,3,son,3,625,2,1,0.5
10,3,source,6,626,2,4,5.5
10,3,spicy,5,627,1,4,1.25
10,3,split,5,628,2,3,1.25
10,3,sponsor,7,629,2,5,1.75
10,3,spoon,5,630,3,2,5.25
10,3,spy,3,631,2,1,0.5
10,3,stabilize,9,632,1,8,2.25
10,3,stadium,7,633,3,4,6
10,3,stage,5,634,3,2,1
10,3,stark,5,635,3,2,0.75
10,3,status,6,636,3,3,1
10,3,steel,5,637,2,3,1
10,3,steep,5,638,4,1,0.5
10,3,stimulate,9,639,2,7,6.5
10,3,stream,6,640,2,4,1.25
10,3,stress,6,641,4,2,1
10,3,student,7,642,2,5,5.75
10,3,stunning,8,643,3,5,2
10,3,stupid,6,644,3,3,1.25
10,3,suburb,6,645,1,5,5.5
10,3,success,7,646,2,5,1.75
10,3,successive,10,647,7,3,2.5
10,3,suffering,9,648,2,7,11.5
10,3,suggestion,10,649,2,8,5.5
10,3,sum,3,650,2,1,1
10,3,summer,6,651,3,3,9
10,3,superior,8,652,2,6,4.25
10,3,supervisor,10,653,5,5,10.75
10,3,supplement,10,654,3,7,5
10,3,supply,6,655,5,1,1.5
10,3,suppress,8,656,4,4,3.25
10,3,surface,7,657,2,5,11
10,3,surprised,9,658,3,6,5
10,3,sustain,7,659,2,5,10.75
10,3,sweet,5,660,1,4,2.75
10,3,swing,5,661,2,3,2.5
10,3,symbol,6,662,1,5,3.5
10,3,systematic,10,663,2,8,12.75
10,3,t,1,664,0,1,0.75
10,3,talented,8,665,1,7,11.5
10,3,tax,3,666,2,1,1
10,3,teach,5,667,1,4,2.75
10,3,technical,9,668,2,7,12
10,3,tell,4,669,2,2,1.75
10,3,tennis,6,670,2,4,3
10,3,tent,4,671,3,1,1.25
10,3,terminal,8,672,2,6,11.5
10,3,terrain,7,673,3,4,3.25
10,3,text,4,674,2,2,1.75
10,3,that,4,675,1,3,2.25
10,3,theatre,7,676,2,5,10.25
10,3,theft,5,677,3,2,2
10,3,their,5,678,3,2,1.75
10,3,theirs,6,679,5,1,1.25
10,3,then,4,680,3,1,1.25
10,3,theology,8,681,3,5,3.75
10,3,they,4,682,3,1,1
10,3,thick,5,683,2,3,9.25
10,3,thing,5,684,3,2,2
10,3,think,5,685,4,1,1.25
10,3,thinking,8,686,5,3,2.75
10,3,thought,7,687,2,5,10.75
10,3,thrive,6,688,2,4,3.25
10,3,throat,6,689,3,3,2.5
10,3,thursday,8,690,2,6,4.25
10,3,tiny,4,691,1,3,9.5
10,3,toll,4,692,1,3,2.25
10,3,tongue,6,693,2,4,3
10,3,total,5,694,2,3,2.25
10,3,tourist,7,695,2,5,11
10,3,towards,7,696,2,5,3.75
10,3,towel,5,697,3,2,2
10,3,toy,3,698,2,1,1
10,3,trace,5,699,1,4,10
10,3,trading,7,700,3,4,3
10,3,training,8,701,3,5,3.75
10,3,transfer,8,702,3,5,11.25
10,3,tremendous,10,703,2,8,5.5
10,3,tribunal,8,704,2,6,11.5
10,3,trillion,8,705,3,5,3.75
10,3,true,4,706,2,2,1.75
10,3,trust,5,707,3,2,2
10,3,trustee,7,708,5,2,9.75
10,3,tuesday,7,709,1,6,4
10,3,tuition,7,710,2,5,4
10,3,turn,4,711,2,2,9
10,3,typically,9,712,1,8,5.5
10,3,ultimately,10,713,0,10,14
10,3,umbrella,8,714,1,7,4.75
10,3,under,5,715,1,4,1840.5
10,3,understand,10,716,5,5,2.25
10,3,unfold,6,717,2,4,1.75
10,3,unit,4,718,2,2,1.5
10,3,unless,6,719,2,4,8.75
10,3,upwards,7,720,1,6,3.5
10,3,us,2,721,1,1,0.75
10,3,used,4,722,2,2,1.5
10,3,user,4,723,3,1,1
10,3,vast,4,724,0,4,7.25
10,3,vehicle,7,725,1,6,3.25
10,3,versus,6,726,2,4,2.5
10,3,village,7,727,1,6,8
10,3,violate,7,728,2,5,2
10,3,violation,9,729,6,3,1.75
10,3,volume,6,730,1,5,7.5
10,3,wall,4,731,0,4,1.5
10,3,warehouse,9,732,2,7,8
10,3,we,2,733,1,1,0.5
10,3,weak,4,734,2,2,1
10,3,web,3,735,2,1,0.5
10,3,website,7,736,3,4,1.75
10,3,wedding,7,737,2,5,7
10,3,week,4,738,2,2,1
10,3,weekly,6,739,4,2,1
10,3,what,4,740,1,3,1.75
10,3,wheat,5,741,2,3,1.25
10,3,where,5,742,3,2,7.5
10,3,whilst,6,743,2,4,4
10,3,wide,4,744,1,3,3.5
10,3,winter,6,745,2,4,4.5
10,3,wise,4,746,2,2,11.25
10,3,worse,5,747,1,4,2.75
10,3,worst,5,748,4,1,1.25
10,3,writing,7,749,1,6,4.5
10,3,wrong,5,750,2,3,11.25
10,3,year,4,751,0,4,2.75
10,3,yell,4,752,2,2,1.75
10,3,zero,4,753,0,4,2.75
10,4,ability,7,0,0,7,10
10,4,able,4,1,2,2,1.75
10,4,abstract,8,2,2,6,11.5
10,4,account,7,3,1,6,4
10,4,accountant,10,4,7,3,2.5
10,4,act,3,5,2,1,1
10,4,activation,10,6,3,7,12.25
10,4,advertise,9,7,1,8,12.25
10,4,affair,6,8,1,5,3.5
10,4,affection,9,9,3,6,4.25
10,4,afford,6,10,3,3,10
10,4,afraid,6,11,2,4,3
10,4,ah,2,12,1,1,0.75
10,4,air,3,13,1,2,1.5
10,4,alert,5,14,1,4,2.75
10,4,alien,5,15,2,3,10
10,4,alignment,9,16,3,6,4.75
10,4,alliance,8,17,2,6,12.5
10,4,alone,5,18,2,3,2.5
10,4,along,5,19,4,1,1.25
10,4,ambitious,9,20,1,8,5.25
10,4,amid,4,21,2,2,9.75
10,4,answer,6,22,1,5,3.5
10,4,anything,8,23,2,6,4.25
10,4,apart,5,24,1,4,10
10,4,appetite,8,25,2,6,4.25
10,4,apply,5,26,3,2,2
10,4,appoint,7,27,3,4,11
10,4,april,5,28,2,3,2.5
10,4,arbitrary,9,29,1,8,5.25
10,4,archive,7,30,2,5,11.75
10,4,armed,5,31,2,3,2.25
10,4,arrival,7,32,2,5,3.5
10,4,article,7,33,2,5,11.25
10,4,assess,6,34,1,5,3.5
10,4,assignment,10,35,3,7,12.75
10,4,associated,10,36,3,7,5
10,4,athlete,7,37,1,6,11.75
10,4,attach,6,38,2,4,3.25
10,4,august,6,39,1,5,3.5
10,4,authority,9,40,2,7,12.75
10,4,avoid,5,41,1,4,2.75
10,4,backdrop,8,42,0,8,14.5
10,4,backwards,9,43,4,5,4.25
10,4,bad,3,44,2,1,1.5
10,4,bake,4,45,2,2,1.75
10,4,ballot,6,46,2,4,10.5
10,4,barrier,7,47,2,5,3.5
10,4,basis,5,48,2,3,2.25
10,4,bean,4,49,1,3,2.25
10,4,bear,4,50,3,1,1.25
10,4,become,6,51,2,4,10.25
10,4,beneath,7,52,2,5,3.5
10,4,bent,4,53,3,1,1.25
10,4,beside,6,54,2,4,3
10,4,bet,3,55,2,1,8.5
10,4,bias,4,56,1,3,2.25
10,4,big,3,57,2,1,1
10,4,biological,10,58,2,8,5.5
10,4,blast,5,59,1,4,10.25
10,4,bleed,5,60,2,3,2.25
10,4,blend,5,61,3,2,2
10,4,blessing,8,62,3,5,4
10,4,blood,5,63,2,3,9.75
10,4,body,4,64,1,3,2.25
10,4,bold,4,65,2,2,1.75
10,4,booking,7,66,2,5,3.75
10,4,bounce,6,67,2,4,10.5
10,4,branch,6,68,1,5,3.25
10,4,bread,5,69,2,3,2.25
10,4,breast,6,70,4,2,9.25
10,4,breath,6,71,4,2,2.5
10,4,bring,5,72,2,3,2.25
10,4,broadband,9,73,2,7,4.75
10,4,broadcast,9,74,5,4,10.75
10,4,broadly,7,75,5,2,2.25
10,4,brown,5,76,3,2,2
10,4,buck,4,77,1,3,2.25
10,4,bulk,4,78,2,2,1.75
10,4,burial,6,79,2,4,10.25
10,4,burst,5,80,3,2,2
10,4,bury,4,81,3,1,1.25
10,4,bye,3,82,1,2,1.5
10,4,cabinet,7,83,0,7,12.25
10,4,capitalism,10,84,2,8,5.5
10,4,captain,7,85,3,4,3.25
10,4,capture,7,86,4,3,10.25
10,4,carriage,8,87,2,6,4.25
10,4,castle,6,88,2,4,3
10,4,catch,5,89,2,3,9.75
10,4,cent,4,90,1,3,2.25
10,4,chaos,5,91,1,4,2.75
10,4,cheek,5,92,2,3,2.25
10,4,civic,5,93,1,4,10.5
10,4,claim,5,94,1,4,2.75
10,4,clarify,7,95,3,4,3.25
10,4,class,5,96,3,2,1.75
10,4,classical,9,97,5,4,11.25
10,4,classify,8,98,6,2,2.75
10,4,climb,5,99,2,3,2.25
10,4,clinic,6,100,3,3,2.5
10,4,close,5,101,2,3,9.75
10,4,cloth,5,102,3,2,2
10,4,clothes,7,103,5,2,2
10,4,coalition,9,104,1,8,5.25
10,4,coast,5,105,3,2,9.25
10,4,cocktail,8,106,2,6,4.25
10,4,cognitive,9,107,2,7,12.25
10,4,collapse,8,108,2,6,4.25
10,4,college,7,109,4,3,2.75
10,4,coloured,8,110,3,5,11.5
10,4,combat,6,111,2,4,3
10,4,commander,9,112,3,6,4.25
10,4,commentary,10,113,4,6,12.25
10,4,commitment,10,114,4,6,4.5
10,4,common,6,115,4,2,2
10,4,communist,9,116,4,5,11.75
10,4,comparison,10,117,3,7,5
10,4,complain,8,118,4,4,12
10,4,complaint,9,119,8,1,2.75
10,4,compose,7,120,4,3,2.5
10,4,comprise,8,121,4,4,3.25
10,4,concerned,9,122,2,7,12.75
10,4,conclude,8,123,4,4,3.25
10,4,concrete,8,124,4,4,3.25
10,4,conflict,8,125,3,5,11.5
10,4,consensus,9,126,3,6,4.25
10,4,consist,7,127,4,3,2.75
10,4,consistent,10,128,7,3,9.5
10,4,constitute,10,129,4,6,2.25
10,4,consume,7,130,4,3,1.25
10,4,contact,7,131,3,4,6.25
10,4,contest,7,132,4,3,1.5
10,4,context,7,133,5,2,1.25
10,4,contrary,8,134,4,4,1.5
10,4,convict,7,135,3,4,1.5
10,4,correlate,9,136,2,7,7.25
10,4,correspond,10,137,5,5,2
10,4,corrupt,7,138,4,3,6.5
10,4,costume,7,139,2,5,2.25
10,4,council,7,140,2,5,1.75
10,4,countless,9,141,4,5,8.25
10,4,courage,7,142,3,4,2.5
10,4,crack,5,143,1,4,2
10,4,creator,7,144,2,5,8.25
10,4,critique,8,145,2,6,2.5
10,4,crop,4,146,2,2,0.75
10,4,crown,5,147,3,2,1
10,4,crystal,7,148,2,5,7
10,4,cue,3,149,1,2,0.75
10,4,cult,4,150,2,2,1
10,4,custom,6,151,2,4,1.5
10,4,cutting,7,152,2,5,6.5
10,4,data,4,153,0,4,1.25
10,4,daughter,8,154,2,6,2.25
10,4,dear,4,155,1,3,5.75
10,4,debris,6,156,2,4,1.5
10,4,debut,5,157,3,2,1
10,4,decision,8,158,2,6,8.25
10,4,decorate,8,159,3,5,2
10,4,dedication,10,160,2,8,9.5
10,4,defeat,6,161,2,4,1.5
10,4,defend,6,162,4,2,1
10,4,defensive,9,163,5,4,1.75
10,4,depart,6,164,2,4,6.5
10,4,depend,6,165,3,3,1.25
10,4,descend,7,166,2,5,1.75
10,4,descent,7,167,6,1,0.75
10,4,desert,6,168,3,3,6.25
10,4,destroy,7,169,3,4,1.75
10,4,determined,10,170,2,8,2.5
10,4,devise,6,171,2,4,6.5
10,4,dialogue,8,172,1,7,2.25
10,4,different,9,173,2,7,8
10,4,difficulty,10,174,4,6,2.5
10,4,dilemma,7,175,2,5,6.75
10,4,dimension,9,176,2,7,2.25
10,4,dip,3,177,2,1,0.5
10,4,direction,9,178,2,7,7.25
10,4,disability,10,179,2,8,2.5
10,4,disagree,8,180,4,4,6.75
10,4,discard,7,181,3,4,1.75
10,4,discharge,9,182,4,5,1.75
10,4,discourse,9,183,4,5,6.75
10,4,disease,7,184,3,4,1.5
10,4,dispute,7,185,3,4,1.5
10,4,district,8,186,3,5,6.75
10,4,disturb,7,187,4,3,1.5
10,4,diverse,7,188,2,5,1.75
10,4,divert,6,189,5,1,0.75
10,4,dominate,8,190,1,7,7.5
10,4,donate,6,191,2,4,1.5
10,4,donor,5,192,3,2,1
10,4,door,4,193,2,2,0.75
10,4,dose,4,194,2,2,0.75
10,4,dozen,5,195,2,3,6.25
10,4,drown,5,196,1,4,1.25
10,4,during,6,197,1,5,1.5
10,4,duty,4,198,2,2,6
10,4,dynamic,7,199,1,6,2
10,4,each,4,200,0,4,1.25
10,4,east,4,201,2,2,1
10,4,echo,4,202,1,3,6
10,4,ecological,10,203,2,8,2.75
10,4,economics,9,204,3,6,7.25
10,4,economy,7,205,6,1,1
10,4,educated,8,206,1,7,2.25
10,4,education,9,207,6,3,1.25
10,4,educator,8,208,6,2,6.5
10,4,efficiency,10,209,1,9,2.75
10,4,eighteen,8,210,1,7,7
10,4,elaborate,9,211,1,8,2.25
10,4,election,8,212,2,6,7
10,4,electoral,9,213,5,4,2.25
10,4,element,7,214,3,4,1.75
10,4,embed,5,215,1,4,6.5
10,4,emphasize,9,216,2,7,2.5
10,4,empire,6,217,3,3,1.5
10,4,encourage,9,218,1,8,8.25
10,4,energy,6,219,2,4,1.5
10,4,enforce,7,220,2,5,7.75
10,4,enquire,7,221,2,5,2
10,4,ensue,5,222,2,3,1.25
10,4,equation,8,223,1,7,8.75
10,4,equip,5,224,3,2,1.25
10,4,era,3,225,1,2,1
10,4,eternal,7,226,1,6,8.5
10,4,every,5,227,1,4,1.75
10,4,everybody,9,228,5,4,1.75
10,4,everyday,8,229,5,3,1.5
10,4,everywhere,10,230,5,5,8.5
10,4,evil,4,231,2,2,1
10,4,evolve,6,232,2,4,1.75
10,4,example,7,233,1,6,8.25
10,4,excess,6,234,2,4,1.75
10,4,excitement,10,235,3,7,2.75
10,4,exclude,7,236,3,4,9
10,4,exert,5,237,2,3,1.25
10,4,exotic,6,238,2,4,1.75
10,4,expected,8,239,2,6,8.5
10,4,experience,10,240,4,6,2.75
10,4,exposure,8,241,3,5,8.25
10,4,extra,5,242,2,3,1.25
10,4,extremely,9,243,4,5,1.75
10,4,fabulous,8,244,0,8,8
10,4,factor,6,245,2,4,1.5
10,4,fairness,8,246,2,6,2
10,4,fame,4,247,2,2,6
10,4,favour,6,248,2,4,1.5
10,4,feat,4,249,1,3,1
10,4,feather,7,250,4,3,1.25
10,4,feed,4,251,2,2,6
10,4,feedback,8,252,4,4,1.75
10,4,feeling,7,253,3,4,1.75
10,4,fifth,5,254,1,4,1.25
10,4,fighting,8,255,2,6,7.5
10,4,figure,6,256,3,3,1.25
10,4,fill,4,257,2,2,0.75
10,4,final,5,258,2,3,1
10,4,find,4,259,3,1,6
10,4,finger,6,260,3,3,1.25
10,4,firearm,7,261,2,5,1.5
10,4,firework,8,262,4,4,1.5
10,4,first,5,263,3,2,11.25
10,4,five,4,264,2,2,889.75
10,4,flash,5,265,1,4,3
10,4,flaw,4,266,3,1,1.5
10,4,flawed,6,267,4,2,2
10,4,fleet,5,268,2,3,2.25
10,4,fluid,5,269,2,3,9.5
10,4,fold,4,270,1,3,2.5
10,4,fond,4,271,2,2,2.25
10,4,forever,7,272,2,5,4.25
10,4,fork,4,273,3,1,1.5
10,4,format,6,274,3,3,8.5
10,4,forum,5,275,3,2,2.5
10,4,frame,5,276,1,4,3.75
10,4,franchise,9,277,3,6,4.25
10,4,frequently,10,278,2,8,10.75
10,4,funny,5,279,1,4,2.75
10,4,gambling,8,280,0,8,11.25
10,4,garden,6,281,2,4,3.25
10,4,gas,3,282,2,1,1.25
10,4,gathering,9,283,2,7,10.75
10,4,generic,7,284,1,6,2.75
10,4,generous,8,285,5,3,13
10,4,gentle,6,286,3,3,1.5
10,4,gentleman,9,287,6,3,1.5
10,4,genuine,7,288,3,4,1.75
10,4,goal,4,289,1,3,1
10,4,governance,10,290,2,8,15
10,4,government,10,291,6,4,2
10,4,gradually,9,292,1,8,12
10,4,graduate,8,293,6,2,1.25
10,4,grand,5,294,3,2,1
10,4,grass,5,295,3,2,1
10,4,great,5,296,2,3,4.5
10,4,greenhouse,10,297,3,7,2.25
10,4,guard,5,298,1,4,1.25
10,4,half,4,299,0,4,5
10,4,halt,4,300,3,1,0.5
10,4,hand,4,301,2,2,0.75
10,4,hardly,6,302,2,4,1.25
10,4,harmony,7,303,3,4,4.75
10,4,he,2,304,1,1,0.5
10,4,hear,4,305,2,2,0.75
10,4,hearing,7,306,4,3,1
10,4,heating,7,307,3,4,1.75
10,4,heavily,7,308,3,4,4.75
10,4,hello,5,309,2,3,1
10,4,here,4,310,2,2,0.75
10,4,hide,4,311,1,3,1
10,4,hierarchy,9,312,2,7,6
10,4,highway,7,313,2,5,1.75
10,4,himself,7,314,2,5,1.75
10,4,history,7,315,2,5,5.75
10,4,hobby,5,316,1,4,1.25
10,4,hockey,6,317,2,4,1.5
10,4,hold,4,318,2,2,5
10,4,holy,4,319,3,1,0.75
10,4,homeless,8,320,2,6,1.75
10,4,homework,8,321,4,4,1.5
10,4,honour,6,322,2,4,5.75
10,4,hostile,7,323,2,5,1.75
10,4,housing,7,324,2,5,1.5
10,4,husband,7,325,1,6,6
10,4,ideology,8,326,0,8,2.5
10,4,ignore,6,327,1,5,5.75
10,4,immense,7,328,1,6,1.75
10,4,impress,7,329,2,5,6
10,4,in,2,330,1,1,0.5
10,4,inclined,8,331,2,6,2
10,4,increase,8,332,3,5,6
10,4,indeed,6,333,2,4,1.5
10,4,indoor,6,334,3,3,1.25
10,4,indoors,7,335,6,1,0.75
10,4,induce,6,336,3,3,1.25
10,4,inequality,10,337,2,8,6.5
10,4,infect,6,338,2,4,1.5
10,4,infection,9,339,6,3,1.5
10,4,inhabitant,10,340,2,8,6.5
10,4,initial,7,341,2,5,1.5
10,4,injured,7,342,2,5,6
10,4,inmate,6,343,2,4,1.25
10,4,innocent,8,344,2,6,6
10,4,input,5,345,2,3,1
10,4,inspire,7,346,2,5,1.75
10,4,instantly,9,347,3,6,6
10,4,insult,6,348,3,3,1.25
10,4,intensity,9,349,2,7,2.25
10,4,intention,9,350,5,4,6
10,4,interested,10,351,4,6,2.25
10,4,interface,9,352,5,4,1.75
10,4,interrupt,9,353,5,4,6
10,4,interview,9,354,5,4,1.5
10,4,introduce,9,355,3,6,2
10,4,invasion,8,356,2,6,6.25
10,4,investor,8,357,3,5,1.75
10,4,invisible,9,358,3,6,5.5
10,4,invoke,6,359,3,3,1.25
10,4,ironically,10,360,1,9,6.75
10,4,irrelevant,10,361,2,8,2.5
10,4,isolation,9,362,1,8,5.75
10,4,jam,3,363,0,3,0.75
10,4,jeans,5,364,1,4,1.5
10,4,join,4,365,1,3,1.25
10,4,journalist,10,366,2,8,6
10,4,july,4,367,1,3,1
10,4,keen,4,368,0,4,4.75
10,4,kidnap,6,369,1,5,1.75
10,4,lady,4,370,0,4,1.25
10,4,landlord,8,371,2,6,5.5
10,4,lane,4,372,3,1,0.5
10,4,laptop,6,373,2,4,1.25
10,4,lawsuit,7,374,2,5,1.5
10,4,layout,6,375,2,4,5.25
10,4,lead,4,376,1,3,1
10,4,learn,5,377,3,2,0.75
10,4,leave,5,378,3,2,0.75
10,4,leisure,7,379,2,5,5.25
10,4,lend,4,380,2,2,1
10,4,length,6,381,3,3,1.25
10,4,level,5,382,2,3,1
10,4,liberation,10,383,1,9,6.25
10,4,light,5,384,2,3,1
10,4,likewise,8,385,2,6,5.5
10,4,linger,6,386,2,4,1.25
10,4,literacy,8,387,2,6,1.75
10,4,lively,6,388,2,4,5.25
10,4,loan,4,389,1,3,1.25
10,4,lobby,5,390,2,3,1.25
10,4,loom,4,391,2,2,0.75
10,4,loop,4,392,3,1,0.75
10,4,loss,4,393,2,2,0.75
10,4,luck,4,394,1,3,4.5
10,4,magazine,8,395,0,8,2.25
10,4,major,5,396,2,3,2.25
10,4,mall,4,397,2,2,7.5
10,4,man,3,398,2,1,1
10,4,manifest,8,399,3,5,3.5
10,4,marathon,8,400,2,6,11
10,4,marginal,8,401,3,5,4
10,4,marker,6,402,3,3,2.5
10,4,marketing,9,403,5,4,3.25
10,4,marriage,8,404,3,5,10.25
10,4,marry,5,405,4,1,1.5
10,4,maximize,8,406,2,6,4.25
10,4,maybe,5,407,2,3,9
10,4,measure,7,408,1,6,4
10,4,medical,7,409,2,5,3.75
10,4,medicine,8,410,5,3,8.75
10,4,meet,4,411,2,2,1.75
10,4,menu,4,412,2,2,1.75
10,4,metal,5,413,2,3,2.25
10,4,metaphor,8,414,4,4,3.25
10,4,migration,9,415,1,8,11.75
10,4,mile,4,416,2,2,1.75
10,4,militant,8,417,3,5,3.75
10,4,milk,4,418,3,1,7.25
10,4,minority,8,419,2,6,4.25
10,4,missile,7,420,2,5,4
10,4,mode,4,421,1,3,8.25
10,4,momentum,8,422,2,6,4.25
10,4,monk,4,423,2,2,1.75
10,4,motor,5,424,2,3,2.25
10,4,motorcycle,10,425,5,5,10
10,4,multiply,8,426,1,7,4.75
10,4,musical,7,427,2,5,10.25
10,4,myself,6,428,1,5,3.5
10,4,mystery,7,429,3,4,3.25
10,4,nail,4,430,0,4,8.75
10,4,native,6,431,2,4,3
10,4,naval,5,432,2,3,2.5
10,4,necessity,9,433,1,8,11.75
10,4,nerve,5,434,2,3,2.25
10,4,news,4,435,2,2,1.75
10,4,next,4,436,2,2,1.75
10,4,ninety,6,437,1,5,9.75
10,4,nod,3,438,1,2,1.5
10,4,nonsense,8,439,2,6,4.25
10,4,noon,4,440,2,2,1.75
10,4,nose,4,441,2,2,7.5
10,4,notable,7,442,2,5,3.5
10,4,notably,7,443,6,1,1.5
10,4,number,6,444,1,5,3.5
10,4,o,1,445,0,1,0.75
10,4,obey,4,446,1,3,8.5
10,4,object,6,447,2,4,3
10,4,observe,7,448,2,5,3.5
10,4,obsession,9,449,4,5,10.5
10,4,obtain,6,450,2,4,3
10,4,obvious,7,451,2,5,3.5
10,4,occasion,8,452,1,7,11.75
10,4,occasional,10,453,8,2,2
10,4,of,2,454,1,1,1
10,4,offer,5,455,2,3,2.25
10,4,offering,8,456,5,3,8.75
10,4,on,2,457,1,1,1
10,4,ongoing,7,458,2,5,3.5
10,4,onion,5,459,2,3,2.25
10,4,open,4,460,1,3,2.25
10,4,opinion,7,461,2,5,10.25
10,4,or,2,462,1,1,0.75
10,4,oral,4,463,2,2,1.5
10,4,orange,6,464,3,3,2.25
10,4,order,5,465,2,3,8.5
10,4,ordinary,8,466,3,5,4
10,4,organize,8,467,2,6,4.25
10,4,our,3,468,1,2,7.5
10,4,out,3,469,2,1,1
10,4,oven,4,470,1,3,2.25
10,4,overseas,8,471,3,5,3.5
10,4,own,3,472,1,2,1.5
10,4,packet,6,473,0,6,10
10,4,palm,4,474,2,2,1.75
10,4,paper,5,475,2,3,2.25
10,4,parental,8,476,2,6,10.5
10,4,pass,4,477,2,2,1.75
10,4,passage,7,478,4,3,2.5
10,4,passion,7,479,4,3,2.5
10,4,pathway,7,480,2,5,10.25
10,4,payment,7,481,2,5,3.75
10,4,peak,4,482,1,3,2.25
10,4,peasant,7,483,3,4,3
10,4,penalty,7,484,2,5,9.75
10,4,period,6,485,2,4,3
10,4,permanent,9,486,3,6,11
10,4,person,6,487,3,3,2.5
10,4,persuade,8,488,4,4,3.25
10,4,petition,8,489,2,6,10.5
10,4,phase,5,490,1,4,2.75
10,4,physics,7,491,2,5,3.75
10,4,placement,9,492,1,8,16
10,4,plate,5,493,3,2,2
10,4,pleasure,8,494,2,6,4.25
10,4,plug,4,495,2,2,8.25
10,4,plunge,6,496,3,3,2.75
10,4,poet,4,497,1,3,2.25
10,4,poetry,6,498,4,2,1.75
10,4,poisonous,9,499,2,7,11.25
10,4,pole,4,500,2,2,1.75
10,4,policeman,9,501,3,6,4.25
10,4,policy,6,502,5,1,1.5
10,4,pop,3,503,2,1,1
10,4,popular,7,504,3,4,9.25
10,4,port,4,505,2,2,1.75
10,4,pose,4,506,2,2,1.5
10,4,poverty,7,507,2,5,3.5
10,4,powder,6,508,2,4,10.25
10,4,powerful,8,509,3,5,4
10,4,pray,4,510,1,3,2.25
10,4,precede,7,511,2,5,10.25
10,4,prefer,6,512,3,3,2.5
10,4,premium,7,513,3,4,3.25
10,4,present,7,514,3,4,3
10,4,pretty,6,515,3,3,9
10,4,prevalence,10,516,3,7,5
10,4,pride,5,517,2,3,2.25
10,4,primarily,9,518,3,6,10.75
10,4,prince,6,519,3,3,2.5
10,4,prisoner,8,520,3,5,3.5
10,4,productive,10,521,2,8,12
10,4,profession,10,522,3,7,11.5
10,4,profitable,10,523,4,6,4.5
10,4,protocol,8,524,3,5,3.75
10,4,provide,7,525,3,4,9.5
10,4,province,8,526,5,3,3
10,4,psychology,10,527,1,9,12.25
10,4,pub,3,528,1,2,1.5
10,4,punishment,10,529,2,8,5.5
10,4,purchase,8,530,2,6,11
10,4,purely,6,531,3,3,2.5
10,4,pursue,6,532,3,3,2.5
10,4,quarter,7,533,0,7,11
10,4,question,8,534,2,6,4.5
10,4,queue,5,535,3,2,2
10,4,rain,4,536,0,4,9.5
10,4,range,5,537,2,3,2.25
10,4,reader,6,538,1,5,3.5
10,4,real,4,539,3,1,1.25
10,4,realize,7,540,4,3,2.5
10,4,really,6,541,4,2,8.75
10,4,reasonable,10,542,3,7,5
10,4,rebellion,9,543,2,7,11.5
10,4,receiver,8,544,2,6,4.75
10,4,recession,9,545,4,5,4
10,4,recipient,9,546,3,6,11.25
10,4,refugee,7,547,2,5,3.5
10,4,register,8,548,2,6,10.5
10,4,regret,6,549,3,3,1.5
10,4,regularly,9,550,3,6,2.25
10,4,regulator,9,551,6,3,5.75
10,4,relatively,10,552,2,8,3
10,4,reliable,8,553,3,5,6
10,4,rely,4,554,3,1,0.5
10,4,reminder,8,555,2,6,1.75
10,4,remote,6,556,3,3,1.25
10,4,renowned,8,557,2,6,6
10,4,rental,6,558,3,3,1.25
10,4,reporter,8,559,2,6,2
10,4,represent,9,560,3,6,6.25
10,4,request,7,561,2,5,1.5
10,4,result,6,562,2,4,5.75
10,4,resume,6,563,4,2,1.25
10,4,retreat,7,564,2,5,1.5
10,4,review,6,565,2,4,1.25
10,4,rhetoric,8,566,1,7,6.25
10,4,rice,4,567,1,3,1
10,4,ridiculous,10,568,2,8,6.5
10,4,riot,4,569,2,2,0.75
10,4,risk,4,570,2,2,0.75
10,4,rock,4,571,1,3,1
10,4,royal,5,572,2,3,1.25
10,4,rule,4,573,1,3,5.25
10,4,sad,3,574,0,3,1
10,4,saint,5,575,2,3,1
10,4,salary,6,576,2,4,1.25
10,4,sanction,8,577,2,6,6.25
10,4,scratch,7,578,1,6,1.75
10,4,scream,6,579,3,3,5
10,4,screening,9,580,4,5,1.75
10,4,script,6,581,3,3,1
10,4,section,7,582,1,6,6
10,4,see,3,583,2,1,0.5
10,4,seize,5,584,2,3,1
10,4,seldom,6,585,2,4,1.25
10,4,senator,7,586,2,5,6.25
10,4,senior,6,587,3,3,1.25
10,4,sentence,8,588,3,5,2
10,4,session,7,589,2,5,5.75
10,4,seventy,7,590,2,5,1.75
10,4,several,7,591,4,3,1.25
10,4,sex,3,592,2,1,0.5
10,4,shadow,6,593,1,5,5.5
10,4,shall,5,594,3,2,1
10,4,shaped,6,595,3,3,1
10,4,shine,5,596,2,3,1
10,4,shock,5,597,2,3,1
10,4,shop,4,598,3,1,0.5
10,4,shot,4,599,3,1,5
10,4,shout,5,600,3,2,1
10,4,silence,7,601,1,6,1.75
10,4,silly,5,602,3,2,1
10,4,similarity,10,603,2,8,6.75
10,4,simulate,8,604,3,5,1.75
10,4,sincere,7,605,2,5,5.75
10,4,sing,4,606,3,1,0.5
10,4,sir,3,607,2,1,0.5
10,4,situation,9,608,2,7,2.25
10,4,skill,5,609,1,4,5.5
10,4,slave,5,610,1,4,1.25
10,4,sleep,5,611,2,3,1
10,4,slogan,6,612,2,4,1.5
10,4,slot,4,613,3,1,2.75
10,4,smart,5,614,1,4,3.5
10,4,soar,4,615,1,3,1
10,4,soccer,6,616,2,4,1.5
10,4,socialist,9,617,3,6,6.75
10,4,solely,6,618,2,4,1.5
10,4,somebody,8,619,2,6,6
10,4,soon,4,620,2,2,1
10,4,span,4,621,1,3,1
10,4,spending,8,622,2,6,2
10,4,spicy,5,623,2,3,5.5
10,4,spill,5,624,3,2,1
10,4,spoil,5,625,2,3,1
10,4,sponsor,7,626,3,4,1.5
10,4,spoon,5,627,3,2,1
10,4,spy,3,628,2,1,0.5
10,4,stadium,7,629,1,6,6.25
10,4,stage,5,630,3,2,1
10,4,stark,5,631,3,2,1
10,4,station,7,632,3,4,5.5
10,4,status,6,633,4,2,1.25
10,4,steel,5,634,2,3,1.25
10,4,steep,5,635,4,1,0.5
10,4,stiff,5,636,2,3,1
10,4,struggle,8,637,2,6,6
10,4,student,7,638,2,5,1.75
10,4,stunning,8,639,3,5,1.75
10,4,stupid,6,640,3,3,5.75
10,4,style,5,641,2,3,1
10,4,suburb,6,642,1,5,1.5
10,4,suburban,8,643,6,2,1
10,4,success,7,644,2,5,6.25
10,4,successive,10,645,7,3,1.5
10,4,suffer,6,646,2,4,1.25
10,4,suicide,7,647,2,5,8.25
10,4,superb,6,648,2,4,3
10,4,superior,8,649,5,3,2.5
10,4,supervisor,10,650,5,5,12.5
10,4,supporter,9,651,3,6,5.25
10,4,surface,7,652,2,5,3.5
10,4,surge,5,653,3,2,2
10,4,surprised,9,654,3,6,11.25
10,4,surrender,9,655,3,6,4.25
10,4,survive,7,656,3,4,9.75
10,4,sustain,7,657,2,5,3.75
10,4,swing,5,658,1,4,2.75
10,4,syndrome,8,659,1,7,13
10,4,systematic,10,660,2,8,9.25
10,4,t,1,661,0,1,1
10,4,teach,5,662,1,4,12.25
10,4,technical,9,663,2,7,5.25
10,4,teenage,7,664,2,5,11
10,4,tell,4,665,2,2,1.75
10,4,tennis,6,666,2,4,3
10,4,tent,4,667,3,1,1.25
10,4,terrain,7,668,2,5,11.25
10,4,terrible,8,669,4,4,3.5
10,4,testing,7,670,2,5,3.5
10,4,text,4,671,2,2,1.75
10,4,that,4,672,1,3,9.25
10,4,theft,5,673,2,3,2.25
10,4,theirs,6,674,3,3,2.5
10,4,them,4,675,3,1,1.25
10,4,theology,8,676,3,5,10.75
10,4,there,5,677,3,2,2
10,4,thick,5,678,2,3,2.25
10,4,thief,5,679,3,2,1.75
10,4,thinking,8,680,3,5,3.75
10,4,threat,6,681,2,4,10
10,4,threaten,8,682,6,2,2.25
10,4,throat,6,683,3,3,2.5
10,4,throughout,10,684,4,6,12
10,4,throw,5,685,4,1,1.5
10,4,tired,5,686,1,4,2.75
10,4,total,5,687,1,4,2.75
10,4,touch,5,688,2,3,2.25
10,4,tourist,7,689,3,4,10.5
10,4,toy,3,690,2,1,1
10,4,trace,5,691,1,4,2.75
10,4,tradition,9,692,3,6,11
10,4,transition,10,693,3,7,5.25
10,4,tremendous,10,694,2,8,14
10,4,tribunal,8,695,2,6,4.25
10,4,trillion,8,696,3,5,4.75
10,4,troubled,8,697,2,6,12
10,4,truly,5,698,2,3,2.5
10,4,try,3,699,2,1,1
10,4,tunnel,6,700,1,5,11.5
10,4,turn,4,701,2,2,1.75
10,4,turnout,7,702,4,3,2.75
10,4,turnover,8,703,5,3,2.75
10,4,twenty,6,704,1,5,11.5
10,4,twist,5,705,2,3,2.25
10,4,type,4,706,1,3,2.5
10,4,typically,9,707,3,6,4.25
10,4,ugly,4,708,0,4,10
10,4,ultimately,10,709,1,9,6
10,4,umbrella,8,710,1,7,11.75
10,4,under,5,711,1,4,2.75
10,4,unlike,6,712,2,4,10.5
10,4,unlikely,8,713,6,2,2.5
10,4,upset,5,714,1,4,2.75
10,4,upwards,7,715,2,5,3.5
10,4,use,3,716,1,2,1.5
10,4,utterly,7,717,1,6,11.25
10,4,variation,9,718,0,9,12.75
10,4,vast,4,719,2,2,1.75
10,4,very,4,720,1,3,2.25
10,4,vicious,7,721,1,6,4
10,4,victim,6,722,3,3,9.75
10,4,village,7,723,2,5,3.75
10,4,vitamin,7,724,2,5,3.75
10,4,vote,4,725,1,3,9.25
10,4,wall,4,726,0,4,2.75
10,4,want,4,727,2,2,1.75
10,4,ward,4,728,2,2,1.75
10,4,warehouse,9,729,3,6,12
10,4,warfare,7,730,3,4,3.25
10,4,wash,4,731,2,2,1.75
10,4,we,2,732,1,1,0.75
10,4,weekly,6,733,2,4,2.75
10,4,well,4,734,2,2,8.75
10,4,wet,3,735,2,1,1
10,4,wheat,5,736,1,4,2.75
10,4,when,4,737,3,1,1.25
10,4,while,5,738,2,3,2.25
10,4,whilst,6,739,4,2,1.75
10,4,whisper,7,740,3,4,10.5
10,4,who,3,741,2,1,1
10,4,wide,4,742,1,3,2.25
10,4,wish,4,743,2,2,1.75
10,4,withdraw,8,744,2,6,11.25
10,4,worst,5,745,1,4,3
10,4,wound,5,746,2,3,2.25
10,4,writer,6,747,1,5,10.5
10,4,wrong,5,748,2,3,2.25
10,4,yell,4,749,0,4,2.75
10,4,yesterday,9,750,2,7,12.25
10,4,you,3,751,1,2,1.75
10,4,yourself,8,752,3,5,3.5
10,4,zero,4,753,0,4,2.75
10,5,ability,7,0,0,7,4.5
10,5,about,5,1,2,3,2.25
10,5,above,5,2,3,2,9.25
10,5,abroad,6,3,2,4,3
10,5,absent,6,4,2,4,2.75
10,5,academy,7,5,1,6,11.25
10,5,accent,6,6,2,4,3
10,5,acceptance,10,7,4,6,4.5
10,5,access,6,8,4,2,2
10,5,account,7,9,3,4,10.5
10,5,advance,7,10,1,6,4
10,5,affair,6,11,1,5,10.75
10,5,affection,9,12,3,6,4.75
10,5,afraid,6,13,2,4,3.25
10,5,aged,4,14,1,3,9.5
10,5,aircraft,8,15,1,7,4.75
10,5,alignment,9,16,1,8,12.5
10,5,allegedly,9,17,2,7,5
10,5,alliance,8,18,3,5,11.25
10,5,alone,5,19,2,3,2.5
10,5,altogether,10,20,2,8,5.5
10,5,ambitious,9,21,1,8,12.75
10,5,angel,5,22,1,4,2.75
10,5,angry,5,23,3,2,1.75
10,5,answer,6,24,2,4,10.5
10,5,anyone,6,25,2,4,3
10,5,anything,8,26,3,5,4
10,5,apart,5,27,1,4,9.75
10,5,appearance,10,28,2,8,5.5
10,5,apple,5,29,3,2,2
10,5,apply,5,30,4,1,1.5
10,5,april,5,31,2,3,9.25
10,5,arbitrary,9,32,1,8,5.25
10,5,article,7,33,2,5,13
10,5,assign,6,34,1,5,1.75
10,5,associated,10,35,3,7,2.5
10,5,attach,6,36,1,5,6
10,5,attack,6,37,5,1,0.5
10,5,attempt,7,38,3,4,1.5
10,5,attorney,8,39,3,5,6.5
10,5,attribute,9,40,3,6,2
10,5,audience,8,41,1,7,10
10,5,audit,5,42,4,1,1.5
10,5,august,6,43,2,4,67
10,5,author,6,44,2,4,2
10,5,autumn,6,45,3,3,2.25
10,5,away,4,46,1,3,2.25
10,5,backdrop,8,47,0,8,9
10,5,backwards,9,48,4,5,2.75
10,5,bad,3,49,2,1,0.75
10,5,ballot,6,50,2,4,6.5
10,5,become,6,51,1,5,2
10,5,bee,3,52,2,1,0.75
10,5,beginning,9,53,2,7,6.5
10,5,bend,4,54,2,2,1
10,5,beneath,7,55,3,4,1.75
10,5,bent,4,56,3,1,0.75
10,5,bet,3,57,2,1,0.5
10,5,bicycle,7,58,1,6,6.5
10,5,biology,7,59,2,5,2
10,5,blend,5,60,1,4,1.5
10,5,blessing,8,61,3,5,6.75
10,5,body,4,62,1,3,1.75
10,5,bonus,5,63,2,3,1.5
10,5,booking,7,64,2,5,11.25
10,5,boring,6,65,2,4,1.75
10,5,bread,5,66,1,4,1.75
10,5,breath,6,67,4,2,1
10,5,brick,5,68,2,3,10.5
10,5,briefly,7,69,3,4,1.75
10,5,broadband,9,70,2,7,2.5
10,5,brown,5,71,3,2,11.25
10,5,building,8,72,1,7,4.75
10,5,bulk,4,73,2,2,1.5
10,5,burial,6,74,2,4,5.25
10,5,burst,5,75,3,2,1
10,5,bury,4,76,3,1,0.75
10,5,but,3,77,2,1,0.5
10,5,button,6,78,3,3,1.25
10,5,cabin,5,79,0,5,1.75
10,5,calm,4,80,2,2,4.25
10,5,camp,4,81,2,2,0.75
10,5,captain,7,82,2,5,1.75
10,5,case,4,83,2,2,0.75
10,5,cattle,6,84,2,4,5
10,5,caution,7,85,2,5,1.75
10,5,cent,4,86,1,3,1
10,5,centre,6,87,4,2,0.75
10,5,chaos,5,88,1,4,4.75
10,5,chat,4,89,3,1,0.75
10,5,cigarette,9,90,1,8,2.5
10,5,cinema,6,91,2,4,4.75
10,5,civic,5,92,2,3,1.25
10,5,cleaning,8,93,1,7,2.25
10,5,cling,5,94,2,3,5
10,5,clip,4,95,3,1,0.75
10,5,clue,4,96,2,2,0.75
10,5,coalition,9,97,1,8,2.5
10,5,cocktail,8,98,2,6,5.5
10,5,cognitive,9,99,2,7,2.25
10,5,collapse,8,100,2,6,5.5
10,5,college,7,101,4,3,1.25
10,5,collision,9,102,4,5,2
10,5,colour,6,103,3,3,5
10,5,columnist,9,104,3,6,2
10,5,commentary,10,105,2,8,6
10,5,commerce,8,106,5,3,1.5
10,5,common,6,107,4,2,1
10,5,compelling,10,108,3,7,6
10,5,complain,8,109,4,4,1.75
10,5,complaint,9,110,8,1,0.75
10,5,completely,10,111,5,5,2
10,5,complex,7,112,6,1,1
10,5,compromise,10,113,4,6,5.75
10,5,computer,8,114,4,4,1.5
10,5,conception,10,115,2,8,6
10,5,concerned,9,116,5,4,1.75
10,5,conclude,8,117,4,4,1.5
10,5,confident,9,118,3,6,5.75
10,5,confirm,7,119,5,2,1
10,5,conflict,8,120,4,4,1.5
10,5,confuse,7,121,4,3,1.5
10,5,confusion,9,122,6,3,5.25
10,5,conscience,10,123,3,7,2.25
10,5,consensus,9,124,4,5,5.5
10,5,conspiracy,10,125,4,6,2.25
10,5,constitute,10,126,4,6,2
10,5,construct,9,127,5,4,5.25
10,5,consume,7,128,4,3,1.25
10,5,contact,7,129,3,4,1.75
10,5,container,9,130,5,4,4.75
10,5,contender,9,131,4,5,1.75
10,5,continuous,10,132,4,6,2
10,5,contract,8,133,4,4,5
10,5,contractor,10,134,8,2,1.5
10,5,contrary,8,135,6,2,1.25
10,5,conviction,10,136,3,7,2.25
10,5,cooking,7,137,2,5,5
10,5,cool,4,138,3,1,0.75
10,5,cooperate,9,139,3,6,2
10,5,cop,3,140,2,1,0.5
10,5,correlate,9,141,2,7,5.25
10,5,corrupt,7,142,4,3,1.25
10,5,costume,7,143,2,5,4.75
10,5,cotton,6,144,2,4,1.75
10,5,covered,7,145,2,5,2
10,5,cow,3,146,2,1,1
10,5,crack,5,147,1,4,6
10,5,crash,5,148,3,2,1.25
10,5,creation,8,149,2,6,2
10,5,creative,8,150,6,2,1.25
10,5,criterion,9,151,2,7,5.5
10,5,critical,8,152,4,4,1.5
10,5,criticism,9,153,6,3,1.5
10,5,crop,4,154,2,2,0.75
10,5,crown,5,155,3,2,4.25
10,5,cult,4,156,1,3,1
10,5,custom,6,157,2,4,1.5
10,5,customer,8,158,6,2,1
10,5,dancer,6,159,0,6,5
10,5,data,4,160,2,2,0.75
10,5,database,8,161,4,4,1.5
10,5,daughter,8,162,2,6,4.75
10,5,dead,4,163,1,3,1
10,5,deadline,8,164,4,4,1.25
10,5,deadly,6,165,5,1,0.5
10,5,dear,4,166,3,1,0.5
10,5,decision,8,167,2,6,5
10,5,decorate,8,168,3,5,1.75
10,5,dedicated,9,169,2,7,5.25
10,5,defeat,6,170,2,4,1.5
10,5,delegation,10,171,2,8,5.5
10,5,denial,6,172,2,4,1.25
10,5,descend,7,173,2,5,1.5
10,5,descent,7,174,6,1,0.75
10,5,desperate,9,175,3,6,5.25
10,5,destroy,7,176,3,4,1.5
10,5,detection,9,177,2,7,5.25
10,5,determined,10,178,4,6,2
10,5,diary,5,179,1,4,1.25
10,5,die,3,180,2,1,0.5
10,5,different,9,181,2,7,5.5
10,5,difficulty,10,182,4,6,2
10,5,dilemma,7,183,2,5,4.75
10,5,directly,8,184,2,6,2
10,5,directory,9,185,6,3,1.25
10,5,disagree,8,186,2,6,5
10,5,discard,7,187,3,4,2
10,5,discourse,9,188,4,5,4
10,5,disease,7,189,3,4,8
10,5,disorder,8,190,3,5,3.75
10,5,dispose,7,191,3,4,3
10,5,distance,8,192,3,5,9.25
10,5,distract,8,193,4,4,3.25
10,5,diversity,9,194,2,7,10.5
10,5,divert,6,195,5,1,1.5
10,5,divorce,7,196,3,4,3
10,5,dog,3,197,1,2,1.5
10,5,dominate,8,198,2,6,9.5
10,5,dose,4,199,2,2,1.5
10,5,dozen,5,200,2,3,2.25
10,5,drown,5,201,1,4,2.75
10,5,drum,4,202,2,2,1.75
10,5,drunk,5,203,3,2,7
10,5,dry,3,204,2,1,1
10,5,dump,4,205,1,3,2
10,5,during,6,206,2,4,3
10,5,dynamic,7,207,1,6,9.25
10,5,east,4,208,0,4,2.75
10,5,eat,3,209,2,1,1
10,5,edge,4,210,1,3,2.25
10,5,editorial,9,211,2,7,10.25
10,5,educated,8,212,2,6,4.25
10,5,education,9,213,6,3,2.75
10,5,eighteen,8,214,1,7,10.25
10,5,electoral,9,215,1,8,11
10,5,elementary,10,216,3,7,5
10,5,elevate,7,217,3,4,3.25
10,5,emerge,6,218,1,5,8.75
10,5,emphasize,9,219,2,7,5
10,5,empire,6,220,3,3,2.5
10,5,employ,6,221,3,3,9.25
10,5,endorse,7,222,1,6,4
10,5,energy,6,223,2,4,3.25
10,5,enough,6,224,2,4,9.75
10,5,enquire,7,225,2,5,3.5
10,5,enrol,5,226,2,3,2.25
10,5,ensue,5,227,2,3,10.25
10,5,epidemic,8,228,1,7,664.25
10,5,equal,5,229,1,4,2
10,5,equation,8,230,4,4,1.75
10,5,error,5,231,1,4,6.5
10,5,escalate,8,232,1,7,2.5
10,5,essential,9,233,2,7,7.25
10,5,eternal,7,234,1,6,2.25
10,5,ethic,5,235,2,3,1.5
10,5,ethical,7,236,5,2,5.25
10,5,every,5,237,1,4,1.75
10,5,everyday,8,238,5,3,1.25
10,5,everywhere,10,239,5,5,2.25
10,5,evolution,9,240,2,7,7
10,5,evolve,6,241,4,2,1
10,5,except,6,242,1,5,1.5
10,5,experience,10,243,2,8,5.75
10,5,explicit,8,244,3,5,2
10,5,extract,7,245,2,5,5
10,5,extremely,9,246,4,5,1.75
10,5,fabulous,8,247,0,8,5.5
10,5,facility,8,248,2,6,2
10,5,fact,4,249,3,1,0.75
10,5,faction,7,250,4,3,1.25
10,5,fairness,8,251,2,6,5
10,5,faith,5,252,3,2,1
10,5,fan,3,253,2,1,0.5
10,5,farm,4,254,2,2,0.75
10,5,feedback,8,255,1,7,5.5
10,5,feel,4,256,3,1,0.5
10,5,festival,8,257,2,6,1.75
10,5,fighting,8,258,1,7,5.25
10,5,figure,6,259,3,3,1.25
10,5,filter,6,260,2,4,1.75
10,5,final,5,261,2,3,4.5
10,5,find,4,262,3,1,0.75
10,5,finger,6,263,3,3,1.25
10,5,fire,4,264,2,2,0.75
10,5,firearm,7,265,4,3,1
10,5,first,5,266,3,2,0.75
10,5,fit,3,267,2,1,4
10,5,five,4,268,2,2,0.75
10,5,float,5,269,1,4,1.25
10,5,flood,5,270,3,2,1
10,5,flour,5,271,3,2,0.75
10,5,fluid,5,272,2,3,4.5
10,5,fold,4,273,1,3,1
10,5,following,9,274,3,6,2
10,5,forest,6,275,2,4,1.25
10,5,forever,7,276,4,3,4.75
10,5,forge,5,277,3,2,1
10,5,fork,4,278,3,1,0.5
10,5,formal,6,279,3,3,1
10,5,formulate,9,280,4,5,5.5
10,5,forth,5,281,3,2,1
10,5,frame,5,282,1,4,1.25
10,5,framework,9,283,5,4,1.25
10,5,franchise,9,284,3,6,5.5
10,5,frankly,7,285,4,3,1.5
10,5,freely,6,286,2,4,1.25
10,5,frequently,10,287,3,7,5.75
10,5,from,4,288,2,2,0.75
10,5,fruit,5,289,2,3,1
10,5,fully,5,290,1,4,1.25
10,5,function,8,291,2,6,5.5
10,5,fund,4,292,3,1,0.5
10,5,furious,7,293,2,5,1.5
10,5,gambling,8,294,0,8,5.75
10,5,garden,6,295,2,4,1.5
10,5,gathering,9,296,2,7,5.5
10,5,generous,8,297,1,7,2
10,5,glad,4,298,1,3,1
10,5,golden,6,299,1,5,5
10,5,goods,5,300,2,3,1.25
10,5,government,10,301,2,8,5.75
10,5,gradually,9,302,1,8,2.25
10,5,graduate,8,303,6,2,1.5
10,5,grant,5,304,3,2,4.25
10,5,grass,5,305,3,2,0.75
10,5,great,5,306,2,3,1
10,5,greenhouse,10,307,3,7,2.25
10,5,halt,4,308,0,4,4.75
10,5,hand,4,309,2,2,0.75
10,5,happy,5,310,2,3,1
10,5,hardly,6,311,2,4,1.25
10,5,harmony,7,312,3,4,4.75
10,5,hatred,6,313,2,4,1.25
10,5,he,2,314,1,1,0.25
10,5,hearing,7,315,2,5,1.5
10,5,heavily,7,316,3,4,5
10,5,help,4,317,2,2,0.75
10,5,helpful,7,318,4,3,1
10,5,hide,4,319,1,3,1
10,5,history,7,320,2,5,5
10,5,hold,4,321,1,3,1
10,5,holy,4,322,3,1,0.75
10,5,homeless,8,323,2,6,2
10,5,homework,8,324,4,4,5
10,5,honour,6,325,2,4,1.25
10,5,hopefully,9,326,2,7,6
10,5,horizon,7,327,2,5,1.75
10,5,host,4,328,2,2,0.75
10,5,hostile,7,329,4,3,1
10,5,hurry,5,330,1,4,4.75
10,5,ignore,6,331,0,6,2
10,5,immense,7,332,1,6,5.25
10,5,imminent,8,333,3,5,1.75
10,5,impact,6,334,2,4,1.25
10,5,impress,7,335,3,4,1.5
10,5,inadequate,10,336,1,9,6.5
10,5,incentive,9,337,2,7,5.75
10,5,incidence,9,338,3,6,2.25
10,5,inclined,8,339,3,5,1.75
10,5,indication,10,340,2,8,6
10,5,indigenous,10,341,4,6,2
10,5,indoor,6,342,3,3,5.75
10,5,indoors,7,343,6,1,0.75
10,5,induce,6,344,3,3,1.25
10,5,inequality,10,345,2,8,6
10,5,infection,9,346,2,7,2.25
10,5,inflation,9,347,3,6,5.5
10,5,inhabitant,10,348,2,8,2.5
10,5,initial,7,349,2,5,5.5
10,5,injured,7,350,2,5,1.75
10,5,inmate,6,351,2,4,1.25
10,5,innocent,8,352,2,6,5.5
10,5,innovative,10,353,4,6,2.5
10,5,input,5,354,2,3,1
10,5,insect,6,355,2,4,4.75
10,5,insult,6,356,3,3,1.25
10,5,interested,10,357,2,8,2.5
10,5,interpret,9,358,5,4,5.5
10,5,introduce,9,359,3,6,2
10,5,invent,6,360,2,4,1.25
10,5,ironically,10,361,1,9,7
10,5,isolation,9,362,1,8,6.25
10,5,jam,3,363,0,3,0.75
10,5,join,4,364,1,3,1
10,5,journalist,10,365,2,8,6.25
10,5,july,4,366,1,3,1
10,5,keen,4,367,0,4,1.25
10,5,kidnap,6,368,1,5,5.25
10,5,killing,7,369,2,5,2
10,5,kind,4,370,2,2,1
10,5,kiss,4,371,2,2,0.75
10,5,knock,5,372,1,4,4.75
10,5,knowledge,9,373,3,6,2
10,5,label,5,374,0,5,1.5
10,5,lady,4,375,2,2,4.5
10,5,landing,7,376,2,5,1.75
10,5,lane,4,377,3,1,0.5
10,5,language,8,378,3,5,1.75
10,5,laptop,6,379,2,4,6.75
10,5,lawyer,6,380,2,4,3
10,5,legal,5,381,1,4,2.75
10,5,length,6,382,2,4,9.25
10,5,less,4,383,2,2,1.75
10,5,liberation,10,384,1,9,5.75
10,5,lifetime,8,385,2,6,11
10,5,light,5,386,2,3,2.25
10,5,likewise,8,387,2,6,4.25
10,5,limit,5,388,2,3,8.5
10,5,listener,8,389,2,6,4
10,5,lively,6,390,2,4,2.75
10,5,lobby,5,391,1,4,9.25
10,5,lock,4,392,2,2,1.75
10,5,logic,5,393,2,3,2.25
10,5,loop,4,394,2,2,1.75
10,5,lord,4,395,2,2,1.5
10,5,lost,4,396,2,2,8
10,5,lovely,6,397,2,4,3
10,5,lung,4,398,1,3,2.25
10,5,magical,7,399,0,7,11.5
10,5,major,5,400,2,3,2.25
10,5,man,3,401,2,1,1
10,5,management,10,402,3,7,4.75
10,5,manner,6,403,3,3,8.5
10,5,marathon,8,404,2,6,4.25
10,5,marginal,8,405,3,5,3.75
10,5,marketing,9,406,3,6,10.75
10,5,marry,5,407,3,2,1.75
10,5,massive,7,408,2,5,5
10,5,matching,8,409,2,6,10.75
10,5,maths,5,410,3,2,2.25
10,5,matter,6,411,3,3,2.5
10,5,maximize,8,412,2,6,11
10,5,mayor,5,413,2,3,2.25
10,5,me,2,414,1,1,0.75
10,5,mechanism,9,415,2,7,4.75
10,5,medical,7,416,2,5,10.5
10,5,medicine,8,417,5,3,2.5
10,5,meditation,10,418,4,6,10.75
10,5,membership,10,419,2,8,5.25
10,5,metal,5,420,2,3,2.25
10,5,migration,9,421,1,8,11.75
10,5,mile,4,422,2,2,1.75
10,5,militant,8,423,3,5,3.75
10,5,milk,4,424,3,1,7.75
10,5,mine,4,425,2,2,1.75
10,5,minimize,8,426,3,5,3.75
10,5,mining,6,427,4,2,2
10,5,minute,6,428,3,3,2.5
10,5,mistake,7,429,2,5,9.5
10,5,mobile,6,430,1,5,3.5
10,5,mode,4,431,2,2,1.75
10,5,momentum,8,432,2,6,10.25
10,5,morality,8,433,2,6,4
10,5,motivation,10,434,2,8,11.75
10,5,musical,7,435,1,6,4
10,5,myself,6,436,1,5,10
10,5,mystery,7,437,3,4,3.25
10,5,national,8,438,0,8,5
10,5,naturally,9,439,3,6,10.75
10,5,naval,5,440,2,3,2.25
10,5,necessity,9,441,1,8,11.75
10,5,nest,4,442,2,2,1.75
10,5,news,4,443,2,2,1.75
10,5,noon,4,444,1,3,2.25
10,5,nose,4,445,2,2,1.75
10,5,notable,7,446,2,5,9.75
10,5,notably,7,447,6,1,1.5
10,5,nursery,7,448,1,6,4
10,5,observe,7,449,0,7,10.75
10,5,observer,8,450,7,1,1.5
10,5,obtain,6,451,2,4,3
10,5,obvious,7,452,2,5,10
10,5,occasional,10,453,1,9,5.75
10,5,occur,5,454,3,2,2
10,5,occurrence,10,455,5,5,10.75
10,5,offender,8,456,1,7,4.5
10,5,on,2,457,1,1,0.75
10,5,ongoing,7,458,2,5,9.75
10,5,onto,4,459,2,2,1.75
10,5,operate,7,460,1,6,4
10,5,operator,8,461,6,2,2
10,5,opinion,7,462,2,5,9.75
10,5,optimism,8,463,2,6,4.25
10,5,oral,4,464,1,3,8.5
10,5,orchestra,9,465,2,7,4.75
10,5,ordinary,8,466,2,6,4
10,5,originally,10,467,2,8,11.75
10,5,outrage,7,468,1,6,5
10,5,oven,4,469,1,3,9
10,5,overnight,9,470,3,6,4.5
10,5,overseas,8,471,4,4,3.25
10,5,packet,6,472,0,6,11
10,5,pair,4,473,2,2,1.75
10,5,palm,4,474,2,2,1.75
10,5,pan,3,475,2,1,1
10,5,parental,8,476,2,6,11.5
10,5,parish,6,477,3,3,2.5
10,5,party,5,478,3,2,2
10,5,passage,7,479,2,5,3.5
10,5,payment,7,480,2,5,10.5
10,5,peak,4,481,1,3,2.25
10,5,penalty,7,482,2,5,5.75
10,5,pension,7,483,3,4,11.5
10,5,people,6,484,2,4,3
10,5,percentage,10,485,2,8,13
10,5,petition,8,486,2,6,5
10,5,photograph,10,487,1,9,13.75
10,5,pill,4,488,1,3,2.25
10,5,pilot,5,489,3,2,2.5
10,5,pink,4,490,2,2,1.75
10,5,pitch,5,491,2,3,2.25
10,5,planet,6,492,1,5,12
10,5,plate,5,493,3,2,2.5
10,5,plug,4,494,2,2,3
10,5,poisonous,9,495,1,8,18
10,5,policy,6,496,2,4,3.75
10,5,politics,8,497,4,4,4.75
10,5,pop,3,498,2,1,1.5
10,5,popular,7,499,3,4,11.25
10,5,port,4,500,2,2,1.75
10,5,poverty,7,501,2,5,4
10,5,powerful,8,502,2,6,14.5
10,5,pray,4,503,1,3,2.25
10,5,precede,7,504,2,5,3.5
10,5,preference,10,505,3,7,13.25
10,5,premium,7,506,3,4,3.5
10,5,present,7,507,3,4,3.25
10,5,president,9,508,4,5,12.5
10,5,pretty,6,509,3,3,2.75
10,5,prevalence,10,510,3,7,5
10,5,prey,4,511,3,1,7.75
10,5,pride,5,512,2,3,2.25
10,5,priest,6,513,3,3,2.25
10,5,prince,6,514,3,3,2.5
10,5,princess,8,515,6,2,2.25
10,5,privilege,9,516,3,6,10.75
10,5,probable,8,517,2,6,4.25
10,5,proceed,7,518,3,4,9.75
10,5,production,10,519,3,7,4
10,5,promote,7,520,3,4,1.75
10,5,pronounce,9,521,3,6,6
10,5,prosecutor,10,522,3,7,2.25
10,5,protect,7,523,3,4,5.5
10,5,protection,10,524,7,3,1.5
10,5,protein,7,525,5,2,1.25
10,5,provincial,10,526,3,7,6
10,5,provoke,7,527,4,3,1.25
10,5,psychology,10,528,1,9,2.75
10,5,publishing,10,529,1,9,7
10,5,punch,5,530,2,3,1.25
10,5,purchase,8,531,2,6,6.25
10,5,purple,6,532,3,3,1.25
10,5,qualify,7,533,0,7,2.25
10,5,question,8,534,2,6,6.25
10,5,quickly,7,535,2,5,1.75
10,5,quietly,7,536,3,4,5.75
10,5,radio,5,537,0,5,1.5
10,5,rain,4,538,2,2,0.75
10,5,range,5,539,2,3,1
10,5,rapid,5,540,2,3,5
10,5,rare,4,541,2,2,0.75
10,5,read,4,542,1,3,1.25
10,5,reading,7,543,4,3,1
10,5,real,4,544,3,1,0.5
10,5,really,6,545,4,2,1
10,5,recipient,9,546,2,7,6.25
10,5,refugee,7,547,2,5,1.75
10,5,regret,6,548,2,4,5.25
10,5,regularly,9,549,3,6,2
10,5,regulator,9,550,6,3,1.5
10,5,reinforce,9,551,2,7,6.75
10,5,relatively,10,552,2,8,2.5
10,5,relaxing,8,553,4,4,5.75
10,5,reliable,8,554,3,5,1.75
10,5,rely,4,555,3,1,0.5
10,5,remains,7,556,2,5,1.5
10,5,remarkable,10,557,4,6,6
10,5,renowned,8,558,2,6,1.75
10,5,rental,6,559,3,3,5.25
10,5,repeated,8,560,2,6,2
10,5,report,6,561,3,3,1.25
10,5,represent,9,562,3,6,6.25
10,5,reputation,10,563,3,7,2.25
10,5,respect,7,564,2,5,5.75
10,5,result,6,565,3,3,1.25
10,5,retreat,7,566,2,5,1.75
10,5,rid,3,567,1,2,0.75
10,5,ridiculous,10,568,3,7,6.5
10,5,riot,4,569,2,2,0.75
10,5,risk,4,570,2,2,0.75
10,5,rock,4,571,1,3,1
10,5,role,4,572,2,2,5
10,5,romantic,8,573,2,6,2
10,5,rumour,6,574,1,5,1.5
10,5,run,3,575,2,1,0.5
10,5,sadly,5,576,0,5,5.5
10,5,sail,4,577,2,2,0.75
10,5,saint,5,578,3,2,1
10,5,salary,6,579,2,4,1.25
10,5,sanction,8,580,2,6,6
10,5,sandwich,8,581,3,5,1.75
10,5,say,3,582,2,1,0.5
10,5,scale,5,583,1,4,5.5
10,5,scope,5,584,2,3,1.25
10,5,sculpture,9,585,2,7,2
10,5,self,4,586,1,3,5
10,5,senator,7,587,2,5,1.75
10,5,serial,6,588,2,4,1.25
10,5,session,7,589,2,5,5.75
10,5,set,3,590,2,1,0.5
10,5,several,7,591,2,5,1.5
10,5,shade,5,592,1,4,1.25
10,5,shaped,6,593,3,3,5.5
10,5,shock,5,594,2,3,1
10,5,shocking,8,595,5,3,1.25
10,5,shop,4,596,3,1,0.5
10,5,shot,4,597,3,1,0.5
10,5,shout,5,598,3,2,0.75
10,5,show,4,599,3,1,0.5
10,5,shrink,6,600,2,4,5.5
10,5,shrug,5,601,3,2,1.25
10,5,sigh,4,602,1,3,1
10,5,silent,6,603,2,4,1.5
10,5,silly,5,604,3,2,5.75
10,5,sincere,7,605,2,5,1.75
10,5,situation,9,606,2,7,2
10,5,size,4,607,2,2,5
10,5,skill,5,608,1,4,1.25
10,5,sky,3,609,2,1,0.5
10,5,slave,5,610,1,4,1.25
10,5,slot,4,611,2,2,0.75
10,5,small,5,612,1,4,5.5
10,5,smash,5,613,3,2,1
10,5,snap,4,614,1,3,1
10,5,soak,4,615,1,3,1
10,5,soar,4,616,3,1,0.5
10,5,soccer,6,617,2,4,5.5
10,5,socialist,9,618,3,6,2.25
10,5,software,8,619,2,6,6
10,5,soldier,7,620,2,5,1.75
10,5,somebody,8,621,2,6,2
10,5,sorry,5,622,2,3,5.25
10,5,sort,4,623,3,1,0.75
10,5,span,4,624,1,3,1
10,5,squeeze,7,625,1,6,2
10,5,stark,5,626,1,4,6.25
10,5,station,7,627,3,4,1.75
10,5,status,6,628,4,2,1.25
10,5,steep,5,629,2,3,1.25
10,5,stiff,5,630,2,3,6.25
10,5,stimulate,9,631,3,6,2.25
10,5,stress,6,632,2,4,1.75
10,5,strive,6,633,3,3,1.25
10,5,student,7,634,2,5,7
10,5,stunning,8,635,3,5,1.75
10,5,stupid,6,636,3,3,1.25
10,5,style,5,637,2,3,5.75
10,5,suburb,6,638,1,5,1.5
10,5,success,7,639,2,5,1.75
10,5,suffering,9,640,2,7,6.75
10,5,suggestion,10,641,2,8,7
10,5,suicide,7,642,2,5,1.75
10,5,sum,3,643,2,1,0.5
10,5,summer,6,644,3,3,1
10,5,superb,6,645,2,4,1.25
10,5,supplement,10,646,3,7,6.75
10,5,supply,6,647,5,1,0.75
10,5,suppress,8,648,4,4,1.5
10,5,surface,7,649,2,5,6
10,5,surprised,9,650,3,6,2
10,5,surrender,9,651,3,6,6.5
10,5,sweet,5,652,1,4,1.25
10,5,swimming,8,653,2,6,2
10,5,swing,5,654,3,2,5.5
10,5,symbol,6,655,1,5,1.75
10,5,syndrome,8,656,2,6,2
10,5,systematic,10,657,2,8,7
10,5,talented,8,658,0,8,6.5
10,5,tax,3,659,2,1,0.5
10,5,technical,9,660,1,8,2.5
10,5,technique,9,661,6,3,1.25
10,5,tell,4,662,2,2,5.25
10,5,tennis,6,663,2,4,1.5
10,5,testify,7,664,2,5,1.75
10,5,text,4,665,2,2,0.75
10,5,that,4,666,1,3,5.5
10,5,their,5,667,2,3,1.25
10,5,theirs,6,668,5,1,0.75
10,5,them,4,669,3,1,0.5
10,5,then,4,670,3,1,0.5
10,5,theology,8,671,3,5,1.75
10,5,therefore,9,672,3,6,6.25
10,5,thief,5,673,2,3,1.25
10,5,think,5,674,3,2,1
10,5,thinking,8,675,5,3,1.25
10,5,third,5,676,3,2,5.25
10,5,though,6,677,2,4,1.5
10,5,thought,7,678,6,1,0.5
10,5,threat,6,679,2,4,1.25
10,5,threaten,8,680,6,2,1
10,5,threshold,9,681,4,5,6.25
10,5,thrive,6,682,3,3,1.25
10,5,throughout,10,683,3,7,6.75
10,5,thursday,8,684,2,6,2
10,5,tiny,4,685,1,3,1
10,5,tired,5,686,2,3,1.25
10,5,tobacco,7,687,1,6,6.5
10,5,tomato,6,688,2,4,1.5
10,5,tongue,6,689,2,4,5.75
10,5,total,5,690,2,3,1.25
10,5,touch,5,691,2,3,1
10,5,towards,7,692,2,5,1.5
10,5,trace,5,693,1,4,5.75
10,5,trading,7,694,3,4,1.5
10,5,tradition,9,695,5,4,1.75
10,5,training,8,696,3,5,6.25
10,5,transition,10,697,3,7,2.25
10,5,tremendous,10,698,2,8,7
10,5,truly,5,699,2,3,1
10,5,trustee,7,700,3,4,1.5
10,5,truth,5,701,3,2,1
10,5,tuesday,7,702,1,6,6
10,5,tunnel,6,703,2,4,1.5
10,5,turnover,8,704,2,6,9
10,5,twist,5,705,1,4,2.75
10,5,typical,7,706,1,6,4
10,5,ugly,4,707,0,4,10.25
10,5,umbrella,8,708,1,7,4.75
10,5,under,5,709,1,4,2.75
10,5,understand,10,710,5,5,11
10,5,unit,4,711,2,2,1.75
10,5,unless,6,712,2,4,3
10,5,unlike,6,713,3,3,2.5
10,5,upset,5,714,1,4,9.75
10,5,us,2,715,1,1,0.75
10,5,used,4,716,2,2,1.5
10,5,user,4,717,3,1,1
10,5,valid,5,718,0,5,3.25
10,5,variation,9,719,2,7,11.5
10,5,vehicle,7,720,1,6,4
10,5,versus,6,721,2,4,10
10,5,village,7,722,1,6,4.25
10,5,violation,9,723,2,7,12
10,5,vitamin,7,724,2,5,3.5
10,5,voluntary,9,725,1,8,13.5
10,5,wage,4,726,0,4,2.75
10,5,wall,4,727,2,2,1.75
10,5,want,4,728,2,2,1.75
10,5,ward,4,729,2,2,2
10,5,warehouse,9,730,3,6,12.75
10,5,we,2,731,1,1,1
10,5,weak,4,732,2,2,2
10,5,web,3,733,2,1,1
10,5,week,4,734,2,2,1.5
10,5,weekly,6,735,4,2,2.25
10,5,well,4,736,2,2,10.75
10,5,what,4,737,1,3,2.5
10,5,whisper,7,738,2,5,3.75
10,5,who,3,739,2,1,1
10,5,wide,4,740,1,3,2
10,5,widely,6,741,4,2,9.5
10,5,winter,6,742,2,4,3
10,5,wooden,6,743,1,5,3.5
10,5,worldwide,9,744,2,7,11.75
10,5,worm,4,745,3,1,1.25
10,5,worst,5,746,3,2,1.75
10,5,wound,5,747,2,3,2.25
10,5,writer,6,748,1,5,11
10,5,yell,4,749,0,4,2.75
10,5,yesterday,9,750,2,7,4.75
10,5,yours,5,751,1,4,10
10,5,yourself,8,752,5,3,2.5
10,5,zero,4,753,0,4,2.75
10,6,ability,7,0,0,7,8.75
10,6,abortion,8,1,2,6,7.75
10,6,abroad,6,2,2,4,9.5
10,6,absent,6,3,2,4,3.75
10,6,access,6,4,1,5,8
10,6,account,7,5,3,4,8.25
10,6,accuracy,8,6,3,5,4
10,6,acquire,7,7,2,5,12.5
10,6,action,6,8,2,4,3.25
10,6,activation,10,9,4,6,5
10,6,adhere,6,10,1,5,18.25
10,6,admission,9,11,2,7,47
10,6,adult,5,12,2,3,2.75
10,6,advertise,9,13,2,7,14.75
10,6,affection,9,14,1,8,7.5
10,6,agent,5,15,1,4,14
10,6,ah,2,16,1,1,1
10,6,air,3,17,1,2,2.5
10,6,alert,5,18,1,4,6.5
10,6,alignment,9,19,2,7,16.25
10,6,alike,5,20,3,2,2.75
10,6,all,3,21,2,1,1.5
10,6,allege,6,22,3,3,3.25
10,6,allegedly,9,23,6,3,3.5
10,6,alliance,8,24,3,5,13.75
10,6,allow,5,25,3,2,4.75
10,6,alone,5,26,2,3,3.25
10,6,along,5,27,4,1,2.75
10,6,altogether,10,28,2,8,15
10,6,ambitious,9,29,1,8,6.25
10,6,angel,5,30,1,4,22.75
10,6,anyone,6,31,2,4,3.75
10,6,appetite,8,32,1,7,5.5
10,6,apple,5,33,3,2,23
10,6,april,5,34,2,3,3
10,6,arena,5,35,1,4,3.5
10,6,arrival,7,36,2,5,5
10,6,article,7,37,2,5,11.75
10,6,artificial,10,38,4,6,4.5
10,6,assess,6,39,1,5,8.75
10,6,asset,5,40,4,1,1.25
10,6,assign,6,41,3,3,2.75
10,6,assignment,10,42,6,4,3.5
10,6,attach,6,43,1,5,8.25
10,6,attack,6,44,5,1,1.25
10,6,attempt,7,45,3,4,3
10,6,attend,6,46,4,2,2
10,6,attendance,10,47,6,4,3.5
10,6,attribute,9,48,3,6,10
10,6,audience,8,49,1,7,4.75
10,6,authority,9,50,2,7,9.75
10,6,aware,5,51,1,4,2.75
10,6,backdrop,8,52,0,8,10.25
10,6,backwards,9,53,4,5,3.75
10,6,banana,6,54,2,4,3
10,6,barrier,7,55,2,5,9
10,6,basis,5,56,2,3,2.25
10,6,become,6,57,1,5,3.5
10,6,beef,4,58,2,2,7
10,6,before,6,59,2,4,3
10,6,beginning,9,60,2,7,5
10,6,beneath,7,61,2,5,9
10,6,bias,4,62,1,3,2.25
10,6,blast,5,63,1,4,3.25
10,6,body,4,64,1,3,7.5
10,6,bond,4,65,2,2,1.75
10,6,boring,6,66,2,4,3.25
10,6,bounce,6,67,2,4,3.25
10,6,brain,5,68,1,4,8
10,6,brick,5,69,2,3,2.25
10,6,brilliant,9,70,3,6,4.5
10,6,bring,5,71,3,2,2
10,6,broadcast,9,72,2,7,9.75
10,6,broadly,7,73,5,2,2.25
10,6,brown,5,74,3,2,2
10,6,buck,4,75,1,3,2.25
10,6,building,8,76,2,6,9
10,6,burial,6,77,2,4,3
10,6,burst,5,78,3,2,2
10,6,bury,4,79,3,1,1.25
10,6,cabin,5,80,0,5,8
10,6,cabinet,7,81,5,2,1.75
10,6,captain,7,82,2,5,3.5
10,6,capture,7,83,4,3,7.5
10,6,carriage,8,84,2,6,4.25
10,6,case,4,85,2,2,1.75
10,6,catch,5,86,2,3,2.25
10,6,cause,5,87,2,3,12.5
10,6,caution,7,88,3,4,219.25
10,6,cautious,8,89,6,2,1.25
10,6,chance,6,90,1,5,1.75
10,6,chaos,5,91,3,2,1
10,6,chat,4,92,3,1,4.5
10,6,chest,5,93,2,3,1.25
10,6,cigarette,9,94,1,8,3
10,6,cinema,6,95,2,4,4.5
10,6,claim,5,96,1,4,1.5
10,6,class,5,97,3,2,1
10,6,classical,9,98,5,4,1.5
10,6,cling,5,99,2,3,4.25
10,6,close,5,100,2,3,1
10,6,closure,7,101,4,3,1.25
10,6,cloth,5,102,3,2,1
10,6,clue,4,103,2,2,0.75
10,6,coalition,9,104,1,8,5.25
10,6,cocktail,8,105,2,6,2
10,6,cognitive,9,106,2,7,5.25
10,6,coin,4,107,2,2,0.75
10,6,collapse,8,108,2,6,4.75
10,6,colour,6,109,3,3,1.5
10,6,combine,7,110,2,5,1.5
10,6,comic,5,111,3,2,1
10,6,commander,9,112,3,6,5.5
10,6,commit,6,113,4,2,1
10,6,commitment,10,114,6,4,1.75
10,6,common,6,115,4,2,1
10,6,communist,9,116,4,5,5
10,6,compare,7,117,3,4,1.25
10,6,complain,8,118,4,4,1.5
10,6,complex,7,119,5,2,1
10,6,compromise,10,120,4,6,5
10,6,conclude,8,121,2,6,1.75
10,6,concrete,8,122,4,4,4.75
10,6,confession,10,123,3,7,2.25
10,6,confirm,7,124,4,3,1.5
10,6,conflict,8,125,4,4,4.75
10,6,confuse,7,126,4,3,1.25
10,6,confusion,9,127,6,3,1.25
10,6,conscience,10,128,3,7,5.25
10,6,consensus,9,129,4,5,1.75
10,6,consistent,10,130,4,6,2
10,6,constitute,10,131,4,6,5
10,6,contact,7,132,3,4,1.25
10,6,contender,9,133,4,5,4.75
10,6,contest,7,134,5,2,1.25
10,6,continue,8,135,4,4,1.5
10,6,continuous,10,136,7,3,1.5
10,6,contrary,8,137,4,4,1.5
10,6,convict,7,138,3,4,4.5
10,6,cooperate,9,139,2,7,2.25
10,6,cop,3,140,2,1,0.5
10,6,copy,4,141,3,1,0.5
10,6,correspond,10,142,2,8,5.75
10,6,corrupt,7,143,4,3,1.25
10,6,council,7,144,2,5,4.75
10,6,counsellor,10,145,4,6,2.25
10,6,countless,9,146,4,5,1.75
10,6,courage,7,147,3,4,4.75
10,6,crack,5,148,1,4,1.25
10,6,crash,5,149,3,2,1
10,6,cream,5,150,2,3,1
10,6,creation,8,151,4,4,4.75
10,6,criterion,9,152,2,7,2.25
10,6,criticism,9,153,4,5,5
10,6,crop,4,154,2,2,0.75
10,6,crown,5,155,3,2,1
10,6,crystal,7,156,2,5,1.5
10,6,cult,4,157,1,3,4.25
10,6,cupboard,8,158,2,6,2
10,6,customer,8,159,2,6,1.75
10,6,dad,3,160,0,3,3.75
10,6,dark,4,161,2,2,0.75
10,6,data,4,162,2,2,0.75
10,6,date,4,163,3,1,0.5
10,6,dead,4,164,1,3,1
10,6,debut,5,165,2,3,1
10,6,decision,8,166,2,6,5.25
10,6,defeat,6,167,2,4,1.25
10,6,defend,6,168,4,2,1
10,6,defy,4,169,3,1,0.5
10,6,delegation,10,170,2,8,5.5
10,6,denial,6,171,2,4,1.25
10,6,depict,6,172,2,4,4.5
10,6,descent,7,173,2,5,1.75
10,6,desert,6,174,3,3,1.25
10,6,detection,9,175,2,7,5.75
10,6,determined,10,176,4,6,2.25
10,6,devise,6,177,2,4,1.25
10,6,dialogue,8,178,1,7,5.25
10,6,dictionary,10,179,2,8,5.5
10,6,die,3,180,2,1,0.5
10,6,differ,6,181,2,4,1.25
10,6,difficulty,10,182,4,6,2
10,6,dip,3,183,2,1,0.5
10,6,direction,9,184,2,7,5.5
10,6,directly,8,185,6,2,1
10,6,directory,9,186,6,3,1.25
10,6,disability,10,187,2,8,6
10,6,discard,7,188,3,4,1.5
10,6,discharge,9,189,4,5,5.25
10,6,discourse,9,190,4,5,2
10,6,disease,7,191,3,4,1.5
10,6,dispose,7,192,3,4,4.5
10,6,disrupt,7,193,3,4,1.5
10,6,distance,8,194,3,5,1.75
10,6,distinct,8,195,4,4,4.5
10,6,distract,8,196,4,4,1.75
10,6,disturb,7,197,4,3,1.25
10,6,diverse,7,198,2,5,1.5
10,6,divorce,7,199,3,4,4.5
10,6,dominance,9,200,1,8,2.25
10,6,dominate,8,201,6,2,1
10,6,donate,6,202,2,4,4.75
10,6,door,4,203,2,2,0.75
10,6,dozen,5,204,2,3,1
10,6,drag,4,205,1,3,1
10,6,drive,5,206,2,3,4.5
10,6,drown,5,207,2,3,1.25
10,6,dry,3,208,2,1,0.5
10,6,dull,4,209,1,3,1
10,6,dynamic,7,210,1,6,5
10,6,early,5,211,0,5,1.5
10,6,east,4,212,2,2,0.75
10,6,easy,4,213,3,1,0.75
10,6,ecological,10,214,1,9,5.75
10,6,economics,9,215,3,6,2.25
10,6,economy,7,216,6,1,1
10,6,educated,8,217,1,7,5.5
10,6,election,8,218,1,7,2
10,6,element,7,219,3,4,4.5
10,6,elementary,10,220,7,3,1.5
10,6,embed,5,221,1,4,1.25
10,6,emerge,6,222,2,4,1.25
10,6,emotional,9,223,2,7,5.25
10,6,emphasize,9,224,2,7,5.25
10,6,empire,6,225,3,3,1.25
10,6,empty,5,226,3,2,1
10,6,endorse,7,227,1,6,1.75
10,6,enhance,7,228,2,5,5
10,6,enough,6,229,2,4,1.5
10,6,enquire,7,230,2,5,1.5
10,6,enrol,5,231,2,3,4.25
10,6,entity,6,232,2,4,1.5
10,6,equation,8,233,1,7,2
10,6,equip,5,234,3,2,4.25
10,6,essential,9,235,1,8,2.75
10,6,ethic,5,236,1,4,1.25
10,6,ethical,7,237,5,2,4.25
10,6,ethnic,6,238,3,3,1.25
10,6,everybody,9,239,1,8,2.5
10,6,evil,4,240,2,2,4
10,6,evolution,9,241,2,7,2.25
10,6,evolve,6,242,4,2,1
10,6,exaggerate,10,243,1,9,6
10,6,example,7,244,3,4,1.5
10,6,excess,6,245,2,4,1.25
10,6,exclude,7,246,3,4,4.75
10,6,exert,5,247,2,3,1
10,6,exotic,6,248,2,4,1.25
10,6,expect,6,249,2,4,4.5
10,6,experience,10,250,4,6,2.25
10,6,explosion,9,251,3,6,2
10,6,export,6,252,3,3,4.25
10,6,exposure,8,253,4,4,1.5
10,6,extremely,9,254,2,7,5.75
10,6,fabulous,8,255,0,8,2.25
10,6,facility,8,256,2,6,6
10,6,faction,7,257,3,4,3.25
10,6,familiar,8,258,2,6,2.5
10,6,farm,4,259,2,2,1
10,6,favour,6,260,2,4,5.75
10,6,feature,7,261,1,6,2
10,6,feel,4,262,2,2,1
10,6,feeling,7,263,4,3,5.25
10,6,festival,8,264,2,6,2.25
10,6,fifth,5,265,1,4,1.25
10,6,figure,6,266,2,4,5.5
10,6,fill,4,267,2,2,1
10,6,film,4,268,3,1,0.5
10,6,finger,6,269,2,4,1.25
10,6,finish,6,270,3,3,1.25
10,6,fire,4,271,2,2,0.75
10,6,firearm,7,272,4,3,4.75
10,6,firework,8,273,4,4,1.75
10,6,fit,3,274,2,1,0.5
10,6,flash,5,275,1,4,1.25
10,6,flaw,4,276,3,1,0.5
10,6,fluid,5,277,2,3,4.5
10,6,fold,4,278,1,3,1
10,6,following,9,279,3,6,1.75
10,6,fond,4,280,2,2,4.25
10,6,forecast,8,281,2,6,1.75
10,6,forgive,7,282,3,4,1.5
10,6,fork,4,283,3,1,0.5
10,6,formal,6,284,3,3,5.5
10,6,fossil,6,285,2,4,3
10,6,framework,9,286,1,8,5.25
10,6,franchise,9,287,3,6,9.75
10,6,freeze,6,288,2,4,2.75
10,6,from,4,289,2,2,1.5
10,6,fruit,5,290,2,3,7.75
10,6,fully,5,291,1,4,2.75
10,6,fund,4,292,2,2,1.75
10,6,gang,4,293,0,4,2.5
10,6,generation,10,294,1,9,11.25
10,6,generous,8,295,5,3,2.75
10,6,gentle,6,296,3,3,2.5
10,6,gentleman,9,297,6,3,8.25
10,6,genuine,7,298,3,4,3.25
10,6,get,3,299,2,1,1
10,6,goal,4,300,1,3,2
10,6,golden,6,301,2,4,8.75
10,6,goods,5,302,2,3,2.25
10,6,government,10,303,2,8,5.5
10,6,gradually,9,304,1,8,11
10,6,graduate,8,305,6,2,2.25
10,6,grand,5,306,3,2,2
10,6,grant,5,307,4,1,1.5
10,6,greenhouse,10,308,2,8,11
10,6,halt,4,309,0,4,2.5
10,6,harassment,10,310,2,8,11
10,6,harmful,7,311,3,4,3.25
10,6,harmony,7,312,4,3,2.75
10,6,hear,4,313,1,3,8
10,6,heavily,7,314,3,4,3
10,6,hello,5,315,2,3,2.25
10,6,help,4,316,3,1,1.25
10,6,here,4,317,2,2,1.5
10,6,hidden,6,318,1,5,9
10,6,hide,4,319,3,1,1.25
10,6,highway,7,320,2,5,3.5
10,6,historian,9,321,2,7,10.5
10,6,history,7,322,6,1,1.75
10,6,hockey,6,323,1,5,3.75
10,6,holy,4,324,2,2,2
10,6,homeless,8,325,2,6,10.75
10,6,honour,6,326,2,4,3
10,6,hope,4,327,2,2,1.5
10,6,hopefully,9,328,4,5,10
10,6,horizon,7,329,2,5,3.5
10,6,host,4,330,2,2,1.75
10,6,hostile,7,331,4,3,2.5
10,6,hostility,9,332,6,3,2.5
10,6,housing,7,333,2,5,10.25
10,6,husband,7,334,1,6,4
10,6,ideology,8,335,0,8,11.5
10,6,if,2,336,1,1,1
10,6,ignore,6,337,1,5,3.5
10,6,imagine,7,338,1,6,10.25
10,6,immigrant,9,339,2,7,5
10,6,imminent,8,340,4,4,9
10,6,impact,6,341,2,4,3
10,6,in,2,342,1,1,0.75
10,6,increase,8,343,2,6,4
10,6,indeed,6,344,2,4,9
10,6,indication,10,345,3,7,5
10,6,indicator,9,346,7,2,2.5
10,6,indigenous,10,347,4,6,10.5
10,6,indoors,7,348,3,4,3.25
10,6,inequality,10,349,2,8,11.25
10,6,infect,6,350,2,4,3
10,6,inflation,9,351,3,6,4.5
10,6,inhabitant,10,352,2,8,11.75
10,6,initial,7,353,2,5,3.5
10,6,injured,7,354,2,5,9.25
10,6,inmate,6,355,2,4,3
10,6,input,5,356,2,3,2.25
10,6,insect,6,357,2,4,9
10,6,inspire,7,358,3,4,3.25
10,6,insult,6,359,3,3,2.75
10,6,intensity,9,360,2,7,11
10,6,interact,8,361,4,4,3.25
10,6,interface,9,362,5,4,3.5
10,6,interview,9,363,5,4,9.5
10,6,invasion,8,364,2,6,4.25
10,6,invent,6,365,3,3,2.5
10,6,investor,8,366,4,4,3.5
10,6,invisible,9,367,3,6,10.25
10,6,invoke,6,368,3,3,2.5
10,6,ironically,10,369,1,9,12
10,6,jam,3,370,0,3,2
10,6,join,4,371,1,3,2.25
10,6,joint,5,372,4,1,1.25
10,6,journalist,10,373,2,8,11.25
10,6,july,4,374,1,3,2.25
10,6,keen,4,375,0,4,2.75
10,6,kidnap,6,376,1,5,9
10,6,killing,7,377,2,5,3.75
10,6,kind,4,378,2,2,1.75
10,6,knock,5,379,1,4,8.75
10,6,knowledge,9,380,3,6,4.5
10,6,labour,6,381,0,6,10
10,6,ladder,6,382,2,4,3
10,6,landing,7,383,2,5,3.5
10,6,lane,4,384,3,1,1.25
10,6,language,8,385,3,5,14
10,6,layout,6,386,2,4,1037
10,6,lead,4,387,1,3,1.25
10,6,legacy,6,388,2,4,1.5
10,6,let,3,389,2,1,0.5
10,6,light,5,390,1,4,6.5
10,6,likewise,8,391,2,6,2.5
10,6,listener,8,392,2,6,2.5
10,6,lively,6,393,2,4,6.5
10,6,lobby,5,394,1,4,1.5
10,6,logic,5,395,2,3,1.25
10,6,logo,4,396,3,1,0.75
10,6,lord,4,397,2,2,5.5
10,6,loss,4,398,2,2,1
10,6,lost,4,399,3,1,0.75
10,6,lower,5,400,2,3,1.25
10,6,lung,4,401,1,3,1.25
10,6,magazine,8,402,0,8,7
10,6,magical,7,403,3,4,1.75
10,6,magnitude,9,404,3,6,6.5
10,6,mall,4,405,2,2,1
10,6,management,10,406,2,8,3
10,6,marathon,8,407,2,6,6.25
10,6,marginal,8,408,3,5,2.25
10,6,marker,6,409,3,3,1.5
10,6,marketing,9,410,5,4,5.75
10,6,marriage,8,411,3,5,1.75
10,6,marry,5,412,4,1,0.75
10,6,massive,7,413,2,5,1.75
10,6,matter,6,414,2,4,5.25
10,6,me,2,415,1,1,0.5
10,6,means,5,416,2,3,1
10,6,measure,7,417,3,4,1.5
10,6,medical,7,418,2,5,5.25
10,6,medicine,8,419,5,3,1.5
10,6,meet,4,420,2,2,0.75
10,6,menu,4,421,2,2,0.75
10,6,metal,5,422,2,3,1
10,6,metaphor,8,423,4,4,5.25
10,6,migration,9,424,1,8,2.25
10,6,mile,4,425,2,2,0.75
10,6,militant,8,426,3,5,5.5
10,6,mine,4,427,2,2,0.75
10,6,miner,5,428,4,1,0.5
10,6,mining,6,429,3,3,1
10,6,monk,4,430,1,3,4.5
10,6,moral,5,431,2,3,1.25
10,6,morning,7,432,3,4,1.5
10,6,motivation,10,433,2,8,6
10,6,motor,5,434,3,2,1
10,6,motorcycle,10,435,5,5,1.75
10,6,mount,5,436,2,3,1
10,6,movement,8,437,2,6,5.5
10,6,myself,6,438,1,5,1.5
10,6,mysterious,10,439,3,7,6
10,6,nail,4,440,0,4,1
10,6,national,8,441,2,6,2
10,6,naval,5,442,2,3,5
10,6,neglect,7,443,1,6,2.25
10,6,nerve,5,444,2,3,1
10,6,next,4,445,2,2,4.5
10,6,nineteen,8,446,1,7,2
10,6,ninety,6,447,5,1,0.75
10,6,nonsense,8,448,1,7,5.75
10,6,now,3,449,2,1,0.5
10,6,nowadays,8,450,3,5,1.5
10,6,number,6,451,1,5,1.5
10,6,nurse,5,452,2,3,4.75
10,6,nursery,7,453,5,2,1
10,6,nursing,7,454,4,3,1.25
10,6,observe,7,455,0,7,5.5
10,6,occur,5,456,1,4,1.25
10,6,of,2,457,1,1,0.5
10,6,offender,8,458,2,6,1.75
10,6,offer,5,459,4,1,0.5
10,6,offering,8,460,5,3,5.25
10,6,ongoing,7,461,1,6,1.75
10,6,onto,4,462,2,2,0.75
10,6,open,4,463,1,3,4.75
10,6,operate,7,464,3,4,1.5
10,6,opinion,7,465,2,5,1.75
10,6,optimism,8,466,2,6,5.5
10,6,or,2,467,1,1,0.5
10,6,oral,4,468,2,2,0.75
10,6,orange,6,469,3,3,1
10,6,orchestra,9,470,2,7,5.75
10,6,organize,8,471,2,6,1.75
10,6,our,3,472,1,2,0.75
10,6,over,4,473,1,3,1
10,6,overnight,9,474,4,5,5.5
10,6,overseas,8,475,4,4,1.5
10,6,owner,5,476,1,4,1.5
10,6,oxygen,6,477,1,5,5.5
10,6,packet,6,478,0,6,1.75
10,6,pair,4,479,2,2,0.75
10,6,palm,4,480,2,2,0.75
10,6,pan,3,481,2,1,4.25
10,6,paper,5,482,2,3,1
10,6,parish,6,483,2,4,1.25
10,6,partly,6,484,3,3,1
10,6,pass,4,485,2,2,0.75
10,6,passing,7,486,4,3,5.25
10,6,passion,7,487,5,2,1.25
10,6,pathway,7,488,2,5,1.5
10,6,payment,7,489,2,5,5.5
10,6,peasant,7,490,1,6,1.75
10,6,pension,7,491,2,5,1.75
10,6,percentage,10,492,2,8,6.25
10,6,permanent,9,493,3,6,2
10,6,person,6,494,3,3,5.25
10,6,persuade,8,495,4,4,1.75
10,6,phase,5,496,1,4,1.25
10,6,physics,7,497,2,5,5.5
10,6,pill,4,498,1,3,1
10,6,pilot,5,499,3,2,0.75
10,6,pitch,5,500,2,3,1
10,6,plain,5,501,1,4,5
10,6,plug,4,502,2,2,1
10,6,plunge,6,503,3,3,1.25
10,6,pole,4,504,1,3,1
10,6,policy,6,505,3,3,1
10,6,politics,8,506,4,4,5.5
10,6,pool,4,507,2,2,1
10,6,pop,3,508,2,1,0.5
10,6,port,4,509,2,2,0.75
10,6,portray,7,510,4,3,1
10,6,positive,8,511,2,6,5.75
10,6,potential,9,512,2,7,2.25
10,6,practice,8,513,1,7,6
10,6,pray,4,514,3,1,0.5
10,6,precede,7,515,2,5,1.5
10,6,precision,9,516,4,5,5.75
10,6,prefer,6,517,3,3,1.25
10,6,prevent,7,518,3,4,1.25
10,6,pride,5,519,2,3,1
10,6,primarily,9,520,3,6,6
10,6,princess,8,521,3,5,1.5
10,6,privilege,9,522,3,6,6
10,6,proceed,7,523,2,5,1.75
10,6,production,10,524,3,7,2.25
10,6,profitable,10,525,3,7,6.25
10,6,promote,7,526,3,4,1.25
10,6,pronounced,10,527,3,7,6
10,6,protect,7,528,3,4,1.5
10,6,protein,7,529,5,2,1
10,6,protocol,8,530,4,4,5.5
10,6,provide,7,531,3,4,1.5
10,6,province,8,532,5,3,1.25
10,6,provoke,7,533,4,3,1.25
10,6,psychology,10,534,1,9,6.75
10,6,punch,5,535,1,4,1.25
10,6,purchase,8,536,2,6,5.75
10,6,purple,6,537,3,3,1.25
10,6,qualify,7,538,0,7,2
10,6,quarter,7,539,3,4,5.5
10,6,queen,5,540,2,3,1
10,6,queue,5,541,3,2,0.75
10,6,quote,5,542,2,3,1
10,6,racist,6,543,0,6,5.75
10,6,rain,4,544,2,2,0.75
10,6,range,5,545,2,3,1
10,6,rapid,5,546,2,3,1
10,6,read,4,547,1,3,5
10,6,readily,7,548,4,3,1.25
10,6,reading,7,549,5,2,1
10,6,real,4,550,3,1,0.5
10,6,reasonable,10,551,3,7,6
10,6,receiver,8,552,2,6,2
10,6,recession,9,553,4,5,1.75
10,6,recovery,8,554,3,5,5.75
10,6,red,3,555,2,1,0.5
10,6,refuge,6,556,2,4,1.25
10,6,regularly,9,557,2,7,6.25
10,6,reinforce,9,558,2,7,2.25
10,6,relatively,10,559,2,8,6.5
10,6,relaxing,8,560,4,4,1.75
10,6,rely,4,561,3,1,0.75
10,6,remains,7,562,2,5,1.5
10,6,remember,8,563,3,5,6
10,6,reputation,10,564,2,8,2.25
10,6,request,7,565,2,5,6
10,6,respect,7,566,2,5,1.5
10,6,response,8,567,4,4,1.5
10,6,restaurant,10,568,3,7,9.5
10,6,result,6,569,3,3,2.5
10,6,retreat,7,570,2,5,9.75
10,6,reverse,7,571,2,5,3.5
10,6,review,6,572,3,3,2.5
10,6,rhetoric,8,573,1,7,11.25
10,6,rock,4,574,1,3,2.25
10,6,role,4,575,2,2,1.75
10,6,royal,5,576,2,3,2.25
10,6,rule,4,577,1,3,2
10,6,rumour,6,578,2,4,9.25
10,6,sad,3,579,0,3,2
10,6,saint,5,580,2,3,2.25
10,6,sandwich,8,581,2,6,10.75
10,6,scope,5,582,1,4,3
10,6,screening,9,583,2,7,4.75
10,6,sculpture,9,584,2,7,10.75
10,6,sea,3,585,1,2,1.5
10,6,section,7,586,2,5,9.75
10,6,see,3,587,2,1,1
10,6,send,4,588,2,2,1.5
10,6,senior,6,589,3,3,2.5
10,6,sensation,9,590,3,6,4.25
10,6,sensitive,9,591,4,5,10.5
10,6,serial,6,592,2,4,3
10,6,set,3,593,2,1,1
10,6,seventeen,9,594,2,7,11.25
10,6,several,7,595,4,3,2.75
10,6,shade,5,596,1,4,2.75
10,6,shake,5,597,3,2,2
10,6,shaped,6,598,3,3,9
10,6,sheet,5,599,2,3,2.25
10,6,shop,4,600,2,2,1.75
10,6,short,5,601,3,2,1.75
10,6,shot,4,602,3,1,1
10,6,should,6,603,3,3,2.25
10,6,shrink,6,604,2,4,9.25
10,6,shrug,5,605,3,2,2
10,6,silent,6,606,1,5,3.5
10,6,silly,5,607,3,2,1.75
10,6,similarity,10,608,2,8,12.25
10,6,sing,4,609,2,2,1.5
10,6,sir,3,610,2,1,1
10,6,situation,9,611,2,7,11.5
10,6,size,4,612,2,2,1.75
10,6,skiing,6,613,1,5,3.5
10,6,skill,5,614,3,2,1.75
10,6,sky,3,615,2,1,1
10,6,slave,5,616,1,4,10
10,6,sleep,5,617,2,3,2.25
10,6,slogan,6,618,2,4,3
10,6,slot,4,619,3,1,1.5
10,6,smart,5,620,1,4,10
10,6,smash,5,621,3,2,2
10,6,snap,4,622,1,3,2.25
10,6,soldier,7,623,1,6,10.5
10,6,somebody,8,624,2,6,4.25
10,6,somewhere,9,625,4,5,4
10,6,soon,4,626,2,2,1.75
10,6,source,6,627,2,4,9.75
10,6,span,4,628,1,3,2.25
10,6,speculate,9,629,2,7,11.25
10,6,spill,5,630,2,3,2.25
10,6,spite,5,631,3,2,2
10,6,split,5,632,2,3,2.25
10,6,sport,5,633,2,3,2.25
10,6,spot,4,634,3,1,1.25
10,6,spy,3,635,2,1,7.5
10,6,squeeze,7,636,1,6,4
10,6,stadium,7,637,1,6,4
10,6,stage,5,638,3,2,8.75
10,6,stark,5,639,3,2,2
10,6,station,7,640,3,4,3.25
10,6,status,6,641,4,2,2
10,6,steep,5,642,2,3,2.5
10,6,stiff,5,643,2,3,9.5
10,6,stimulate,9,644,3,6,4.5
10,6,stream,6,645,2,4,3.25
10,6,stress,6,646,4,2,8.75
10,6,structure,9,647,3,6,4.5
10,6,struggle,8,648,4,4,3.5
10,6,student,7,649,2,5,10.75
10,6,stunning,8,650,3,5,3.75
10,6,suburban,8,651,1,7,4.75
10,6,success,7,652,2,5,10.25
10,6,suffering,9,653,2,7,5
10,6,suicide,7,654,2,5,10.75
10,6,summer,6,655,2,4,3
10,6,summit,6,656,4,2,2
10,6,superior,8,657,2,6,11.25
10,6,supplement,10,658,3,7,5
10,6,suppress,8,659,4,4,3.5
10,6,surge,5,660,2,3,9.5
10,6,surprised,9,661,3,6,4.25
10,6,surprising,10,662,7,3,3
10,6,survive,7,663,3,4,9.75
10,6,suspicious,10,664,2,8,5.5
10,6,swimming,8,665,1,7,11.25
10,6,swing,5,666,3,2,1.75
10,6,symbol,6,667,1,5,3.5
10,6,syndrome,8,668,2,6,11.25
10,6,t,1,669,0,1,1
10,6,tax,3,670,1,2,1.75
10,6,teach,5,671,1,4,2.75
10,6,technique,9,672,2,7,11.75
10,6,teenage,7,673,2,5,3.75
10,6,tell,4,674,2,2,2
10,6,tennis,6,675,2,4,10
10,6,tenure,6,676,3,3,2.5
10,6,terrain,7,677,2,5,3.5
10,6,terrible,8,678,4,4,3.25
10,6,terrorist,9,679,4,5,11
10,6,testify,7,680,2,5,3.75
10,6,testing,7,681,5,2,2
10,6,than,4,682,1,3,11
10,6,theatre,7,683,2,5,3.5
10,6,theirs,6,684,3,3,2.75
10,6,then,4,685,3,1,2.25
10,6,therefore,9,686,3,6,12.25
10,6,they,4,687,3,1,1.25
10,6,thick,5,688,2,3,3.25
10,6,thought,7,689,2,5,4.5
10,6,throughout,10,690,2,8,13
10,6,throw,5,691,4,1,1.5
10,6,thursday,8,692,2,6,4.25
10,6,timber,6,693,1,5,10.25
10,6,tiny,4,694,2,2,1.75
10,6,tired,5,695,2,3,2.5
10,6,tobacco,7,696,1,6,10.75
10,6,ton,3,697,2,1,1
10,6,towel,5,698,2,3,2.25
10,6,trace,5,699,1,4,2.75
10,6,training,8,700,3,5,11
10,6,transfer,8,701,3,5,3.75
10,6,transition,10,702,5,5,4.25
10,6,truly,5,703,2,3,10
10,6,trust,5,704,3,2,2
10,6,trustee,7,705,5,2,2.25
10,6,try,3,706,2,1,1
10,6,tuesday,7,707,1,6,4
10,6,tuition,7,708,2,5,10.75
10,6,tunnel,6,709,2,4,3
10,6,twist,5,710,1,4,2.75
10,6,typically,9,711,1,8,12.25
10,6,ultimately,10,712,0,10,14
10,6,under,5,713,1,4,2.75
10,6,unit,4,714,2,2,1.75
10,6,unlikely,8,715,2,6,11.75
10,6,upper,5,716,1,4,2.75
10,6,us,2,717,1,1,0.75
10,6,use,3,718,2,1,1
10,6,used,4,719,3,1,1.5
10,6,valid,5,720,0,5,10.75
10,6,victim,6,721,1,5,3.5
10,6,village,7,722,2,5,3
10,6,violate,7,723,2,5,6.5
10,6,vitamin,7,724,2,5,1.75
10,6,volume,6,725,1,5,1.5
10,6,want,4,726,0,4,5.75
10,6,warfare,7,727,2,5,1.75
10,6,warm,4,728,3,1,0.75
10,6,we,2,729,1,1,0.5
10,6,weather,7,730,2,5,6
10,6,web,3,731,2,1,0.5
10,6,website,7,732,3,4,1.5
10,6,week,4,733,2,2,0.75
10,6,well,4,734,2,2,0.75
10,6,what,4,735,1,3,1
10,6,where,5,736,2,3,5.5
10,6,whilst,6,737,2,4,1.25
10,6,whole,5,738,2,3,1
10,6,winner,6,739,1,5,6.25
10,6,wish,4,740,2,2,0.75
10,6,withdrawal,10,741,2,8,2.5
10,6,wooden,6,742,1,5,5.75
10,6,workout,7,743,2,5,1.75
10,6,worm,4,744,3,1,0.75
10,6,writer,6,745,1,5,6
10,6,writing,7,746,4,3,1.5
10,6,wrong,5,747,2,3,1
10,6,year,4,748,0,4,1.25
10,6,yell,4,749,2,2,1
10,6,yesterday,9,750,2,7,7.25
10,6,yours,5,751,1,4,1.25
10,6,yourself,8,752,5,3,1
10,6,zone,4,753,0,4,7.25
10,7,ability,7,0,0,7,2
10,7,able,4,1,2,2,6.5
10,7,abortion,8,2,2,6,2
10,7,above,5,3,3,2,1.5
10,7,absent,6,4,2,4,6.75
10,7,abstract,8,5,3,5,2.5
10,7,accent,6,6,1,5,1.5
10,7,acceptance,10,7,4,6,8
10,7,access,6,8,4,2,1
10,7,accuracy,8,9,3,5,2
10,7,act,3,10,2,1,0.5
10,7,action,6,11,3,3,7.25
10,7,activation,10,12,4,6,2.25
10,7,addition,8,13,1,7,2.5
10,7,advanced,8,14,2,6,6.5
10,7,advertise,9,15,3,6,2
10,7,affair,6,16,1,5,5.75
10,7,aged,4,17,1,3,1
10,7,agent,5,18,3,2,0.75
10,7,ah,2,19,1,1,0.25
10,7,air,3,20,1,2,0.75
10,7,alert,5,21,1,4,5.75
10,7,all,3,22,2,1,0.5
10,7,allege,6,23,3,3,1.25
10,7,allegedly,9,24,6,3,1
10,7,alliance,8,25,3,5,6.25
10,7,allow,5,26,3,2,1
10,7,alone,5,27,2,3,1
10,7,also,4,28,2,2,0.75
10,7,ambitious,9,29,1,8,7
10,7,amid,4,30,2,2,0.75
10,7,angel,5,31,1,4,1.25
10,7,angry,5,32,3,2,1
10,7,answer,6,33,2,4,6.75
10,7,apart,5,34,1,4,1.5
10,7,appoint,7,35,2,5,2
10,7,april,5,36,2,3,1.25
10,7,arbitrary,9,37,1,8,6.75
10,7,arena,5,38,2,3,1.25
10,7,artificial,10,39,2,8,7.25
10,7,asset,5,40,1,4,1.25
10,7,assignment,10,41,3,7,7.5
10,7,associated,10,42,3,7,2.25
10,7,athlete,7,43,1,6,6.25
10,7,attach,6,44,2,4,1.5
10,7,attempt,7,45,3,4,1.5
10,7,attend,6,46,4,2,1
10,7,audit,5,47,1,4,5.75
10,7,authority,9,48,2,7,2.25
10,7,avoid,5,49,1,4,1.25
10,7,awkward,7,50,1,6,6.5
10,7,back,4,51,0,4,1.25
10,7,bake,4,52,2,2,0.75
10,7,ballot,6,53,2,4,6
10,7,banana,6,54,2,4,1.25
10,7,barrier,7,55,2,5,1.5
10,7,basket,6,56,2,4,6
10,7,bean,4,57,1,3,1
10,7,because,7,58,2,5,1.5
10,7,become,6,59,3,3,1.25
10,7,beef,4,60,2,2,6.5
10,7,beginning,9,61,2,7,2.75
10,7,being,5,62,2,3,1.5
10,7,bent,4,63,2,2,5
10,7,bicycle,7,64,1,6,5.25
10,7,blast,5,65,1,4,1.25
10,7,bleed,5,66,2,3,1.5
10,7,blessing,8,67,3,5,8.25
10,7,bold,4,68,1,3,1.25
10,7,booking,7,69,2,5,1.75
10,7,born,4,70,2,2,7
10,7,branch,6,71,1,5,1.5
10,7,bread,5,72,2,3,1.75
10,7,breath,6,73,4,2,1
10,7,briefly,7,74,2,5,8
10,7,brilliant,9,75,3,6,2.25
10,7,bring,5,76,3,2,1
10,7,broad,5,77,2,3,5.5
10,7,broadband,9,78,5,4,1.75
10,7,broadcast,9,79,5,4,1.75
10,7,broadly,7,80,5,2,1.25
10,7,buck,4,81,1,3,1
10,7,building,8,82,2,6,6.75
10,7,bulk,4,83,2,2,0.75
10,7,burial,6,84,2,4,1.5
10,7,burst,5,85,3,2,5.75
10,7,bury,4,86,3,1,0.75
10,7,but,3,87,2,1,0.5
10,7,button,6,88,3,3,1
10,7,bye,3,89,1,2,0.75
10,7,cabin,5,90,0,5,1.5
10,7,cabinet,7,91,5,2,6
10,7,camp,4,92,2,2,0.75
10,7,capitalism,10,93,2,8,4.75
10,7,capture,7,94,3,4,7.25
10,7,cat,3,95,2,1,0.5
10,7,catch,5,96,3,2,0.75
10,7,cause,5,97,2,3,1
10,7,chance,6,98,1,5,1.5
10,7,chaos,5,99,3,2,5.5
10,7,charge,6,100,3,3,1.25
10,7,chat,4,101,3,1,0.5
10,7,cheek,5,102,2,3,1
10,7,chest,5,103,3,2,0.75
10,7,claim,5,104,1,4,6
10,7,clarify,7,105,3,4,1.5
10,7,class,5,106,3,2,0.75
10,7,classical,9,107,5,4,1.5
10,7,classify,8,108,6,2,5.75
10,7,cleaning,8,109,2,6,2
10,7,climate,7,110,2,5,1.75
10,7,cling,5,111,3,2,1
10,7,clinic,6,112,4,2,6
10,7,clip,4,113,3,1,0.75
10,7,clock,5,114,2,3,1
10,7,clothes,7,115,3,4,1.5
10,7,clothing,8,116,5,3,1.25
10,7,coast,5,117,1,4,6.25
10,7,coastal,7,118,5,2,1
10,7,cocktail,8,119,2,6,2
10,7,cognitive,9,120,2,7,7.25
10,7,college,7,121,2,5,1.5
10,7,combat,6,122,2,4,10.5
10,7,commentary,10,123,3,7,267.75
10,7,commerce,8,124,5,3,5.5
10,7,commitment,10,125,4,6,9.5
10,7,compare,7,126,3,4,22.75
10,7,compelling,10,127,4,6,11
10,7,complain,8,128,4,4,7.25
10,7,complaint,9,129,8,1,13.5
10,7,completely,10,130,5,5,6
10,7,comprise,8,131,4,4,4.5
10,7,compromise,10,132,5,5,15
10,7,conception,10,133,2,8,6
10,7,concession,10,134,5,5,11.5
10,7,conclude,8,135,4,4,4
10,7,concrete,8,136,4,4,4
10,7,confession,10,137,3,7,14.75
10,7,confident,9,138,4,5,4.5
10,7,conflict,8,139,4,4,3.75
10,7,confuse,7,140,4,3,17.25
10,7,conserve,8,141,3,5,5.5
10,7,constitute,10,142,4,6,6.25
10,7,contact,7,143,3,4,19.25
10,7,container,9,144,5,4,4.25
10,7,contender,9,145,4,5,4.25
10,7,contest,7,146,5,2,2.25
10,7,contract,8,147,4,4,8.5
10,7,contractor,10,148,8,2,2.5
10,7,convert,7,149,3,4,3
10,7,cooking,7,150,2,5,9
10,7,cooperate,9,151,3,6,4.25
10,7,cop,3,152,2,1,1
10,7,copy,4,153,3,1,1
10,7,correlate,9,154,2,7,10.25
10,7,correspond,10,155,5,5,4
10,7,costume,7,156,2,5,3.5
10,7,cotton,6,157,2,4,8.5
10,7,council,7,158,2,5,3.5
10,7,counsellor,10,159,4,6,10.5
10,7,covered,7,160,2,5,3.5
10,7,crash,5,161,1,4,2.75
10,7,creation,8,162,2,6,9.75
10,7,criterion,9,163,2,7,4.75
10,7,criticism,9,164,4,5,9.75
10,7,critique,8,165,5,3,2.5
10,7,crystal,7,166,2,5,2.25
10,7,cue,3,167,1,2,1
10,7,cure,4,168,2,2,1
10,7,custom,6,169,2,4,5
10,7,customer,8,170,6,2,1
10,7,dad,3,171,0,3,1
10,7,date,4,172,2,2,0.75
10,7,deadline,8,173,1,7,5.75
10,7,deadly,6,174,5,1,0.75
10,7,dear,4,175,3,1,0.75
10,7,deck,4,176,2,2,0.75
10,7,dedicated,9,177,2,7,5.75
10,7,dedication,10,178,7,3,1.75
10,7,defend,6,179,2,4,1.5
10,7,defy,4,180,3,1,0.75
10,7,delegation,10,181,2,8,6.5
10,7,delivery,8,182,3,5,2.25
10,7,denial,6,183,2,4,1.5
10,7,dependence,10,184,2,8,6.25
10,7,dependent,9,185,8,1,1
10,7,derive,6,186,2,4,1.5
10,7,descend,7,187,2,5,5.25
10,7,desert,6,188,3,3,1.25
10,7,desperate,9,189,3,6,2
10,7,detail,6,190,2,4,5
10,7,detection,9,191,3,6,2.25
10,7,determined,10,192,4,6,5.75
10,7,devise,6,193,2,4,1.5
10,7,dictionary,10,194,1,9,6.25
10,7,different,9,195,2,7,2.25
10,7,difficulty,10,196,4,6,5.75
10,7,dilemma,7,197,2,5,1.75
10,7,dip,3,198,2,1,0.5
10,7,disability,10,199,2,8,5.5
10,7,disagree,8,200,4,4,1.5
10,7,discharge,9,201,3,6,2
10,7,disease,7,202,3,4,4.75
10,7,dispose,7,203,3,4,1.5
10,7,district,8,204,3,5,1.75
10,7,disturb,7,205,4,3,4.5
10,7,diverse,7,206,2,5,1.5
10,7,diversity,9,207,6,3,1.25
10,7,divorce,7,208,3,4,1.75
10,7,dominate,8,209,1,7,5.25
10,7,donate,6,210,2,4,1.5
10,7,donor,5,211,3,2,1
10,7,dozen,5,212,2,3,4
10,7,drain,5,213,1,4,1.25
10,7,driver,6,214,2,4,1.25
10,7,drown,5,215,2,3,1
10,7,drum,4,216,2,2,4
10,7,drunk,5,217,3,2,1
10,7,dry,3,218,2,1,0.5
10,7,dull,4,219,1,3,0.75
10,7,dump,4,220,2,2,0.75
10,7,early,5,221,0,5,4.5
10,7,easily,6,222,2,4,1.25
10,7,easy,4,223,3,1,0.5
10,7,eat,3,224,2,1,0.5
10,7,ecological,10,225,1,9,5.5
10,7,economy,7,226,3,4,1.5
10,7,edge,4,227,1,3,1
10,7,education,9,228,2,7,5.5
10,7,efficiency,10,229,1,9,2.5
10,7,eighteen,8,230,1,7,5.75
10,7,election,8,231,1,7,2
10,7,electric,8,232,5,3,4.75
10,7,elementary,10,233,3,7,2.25
10,7,elevate,7,234,3,4,1.5
10,7,else,4,235,2,2,4
10,7,empire,6,236,1,5,1.5
10,7,enforce,7,237,1,6,1.75
10,7,enough,6,238,2,4,4.75
10,7,ensue,5,239,2,3,1.25
10,7,entirely,8,240,2,6,2.25
10,7,entity,6,241,4,2,4.25
10,7,epidemic,8,242,1,7,2.25
10,7,equal,5,243,1,4,1.25
10,7,equation,8,244,4,4,4.75
10,7,equip,5,245,3,2,1
10,7,equivalent,10,246,4,6,2
10,7,era,3,247,1,2,0.75
10,7,error,5,248,2,3,4.25
10,7,erupt,5,249,2,3,1
10,7,escape,6,250,1,5,1.5
10,7,essential,9,251,2,7,5.5
10,7,every,5,252,1,4,1.25
10,7,everybody,9,253,5,4,1.25
10,7,everyday,8,254,5,3,4.25
10,7,everywhere,10,255,5,5,1.75
10,7,evil,4,256,2,2,0.75
10,7,evolve,6,257,2,4,1.25
10,7,exaggerate,10,258,1,9,6
10,7,example,7,259,3,4,1.5
10,7,except,6,260,2,4,4.75
10,7,excitement,10,261,3,7,2.25
10,7,exotic,6,262,2,4,1.25
10,7,export,6,263,2,4,4.75
10,7,facility,8,264,0,8,4.25
10,7,fact,4,265,3,1,1.25
10,7,factor,6,266,4,2,7.25
10,7,fame,4,267,2,2,1.75
10,7,farm,4,268,2,2,1.5
10,7,favour,6,269,2,4,2.75
10,7,feat,4,270,1,3,2
10,7,feature,7,271,4,3,7.75
10,7,feed,4,272,2,2,1.75
10,7,feedback,8,273,4,4,3
10,7,fence,5,274,2,3,2.25
10,7,fifth,5,275,1,4,8.25
10,7,figure,6,276,2,4,2.75
10,7,filter,6,277,2,4,2.75
10,7,finish,6,278,2,4,2.75
10,7,firework,8,279,2,6,9.25
10,7,fit,3,280,2,1,1
10,7,five,4,281,2,2,1.5
10,7,fleet,5,282,1,4,2.75
10,7,float,5,283,2,3,7.5
10,7,follow,6,284,1,5,3.25
10,7,fond,4,285,2,2,1.75
10,7,fool,4,286,2,2,1.5
10,7,forecast,8,287,2,6,9.25
10,7,forest,6,288,4,2,2
10,7,forever,7,289,4,3,2.75
10,7,forgive,7,290,3,4,3.25
10,7,formal,6,291,3,3,8
10,7,formulate,9,292,4,5,4
10,7,framework,9,293,1,8,10.75
10,7,frankly,7,294,3,4,3
10,7,freely,6,295,2,4,2.75
10,7,fully,5,296,1,4,2.75
10,7,funny,5,297,2,3,7.75
10,7,furious,7,298,2,5,3.5
10,7,gang,4,299,0,4,2.75
10,7,garden,6,300,2,4,8.25
10,7,gas,3,301,2,1,1
10,7,gathering,9,302,2,7,4.75
10,7,gentle,6,303,1,5,9.5
10,7,genuine,7,304,3,4,3.75
10,7,glad,4,305,1,3,2.75
10,7,golden,6,306,1,5,9
10,7,goods,5,307,2,3,2.25
10,7,governance,10,308,2,8,5.25
10,7,government,10,309,6,4,9
10,7,gradually,9,310,1,8,5.25
10,7,graduate,8,311,6,2,2.25
10,7,grain,5,312,3,2,7.25
10,7,grant,5,313,3,2,2
10,7,greatly,7,314,2,5,3.5
10,7,greenhouse,10,315,3,7,10.5
10,7,guard,5,316,1,4,2.75
10,7,guideline,9,317,2,7,4.75
10,7,half,4,318,0,4,8.25
10,7,halt,4,319,3,1,1
10,7,hardly,6,320,2,4,3
10,7,hardware,8,321,4,4,3.25
10,7,harmful,7,322,3,4,9
10,7,healthcare,10,323,1,9,5.75
10,7,hear,4,324,3,1,1.25
10,7,hearing,7,325,4,3,8
10,7,heavily,7,326,3,4,3
10,7,hello,5,327,2,3,2.25
10,7,hence,5,328,2,3,2.25
10,7,here,4,329,2,2,7.25
10,7,hero,4,330,3,1,1.25
10,7,hide,4,331,1,3,2
10,7,hill,4,332,2,2,1.75
10,7,himself,7,333,2,5,3.5
10,7,historian,9,334,2,7,10
10,7,hockey,6,335,1,5,3.25
10,7,holy,4,336,2,2,1.75
10,7,homework,8,337,2,6,9.75
10,7,hopefully,9,338,2,7,4.5
10,7,host,4,339,2,2,7
10,7,house,5,340,2,3,2.25
10,7,hungry,6,341,1,5,3.25
10,7,hurry,5,342,2,3,2.25
10,7,husband,7,343,2,5,9
10,7,illness,7,344,0,7,4.5
10,7,imagine,7,345,1,6,9.5
10,7,immense,7,346,2,5,3.5
10,7,immigrant,9,347,3,6,4.5
10,7,imminent,8,348,4,4,9
10,7,impress,7,349,2,5,3.5
10,7,incidence,9,350,1,8,11
10,7,including,9,351,3,6,4.25
10,7,increase,8,352,3,5,9.5
10,7,indication,10,353,2,8,5.5
10,7,indicator,9,354,7,2,2.25
10,7,indigenous,10,355,4,6,12.5
10,7,indulge,7,356,3,4,3
10,7,industrial,10,357,4,6,4.5
10,7,inflation,9,358,2,7,10.5
10,7,innocent,8,359,2,6,4
10,7,innovative,10,360,4,6,10.5
10,7,insect,6,361,2,4,2.75
10,7,insight,7,362,3,4,3
10,7,inspire,7,363,3,4,9
10,7,insult,6,364,3,3,2.5
10,7,interested,10,365,2,8,11.25
10,7,interpret,9,366,5,4,3.5
10,7,interrupt,9,367,5,4,3.25
10,7,introduce,9,368,3,6,9.75
10,7,invasion,8,369,2,6,4.25
10,7,invisible,9,370,3,6,4.25
10,7,invitation,10,371,4,6,10.25
10,7,invoke,6,372,3,3,2.25
10,7,ironically,10,373,1,9,12.25
10,7,irrelevant,10,374,2,8,5.5
10,7,isolation,9,375,1,8,11
10,7,join,4,376,0,4,2.5
10,7,joint,5,377,4,1,1
10,7,journalist,10,378,2,8,11
10,7,july,4,379,1,3,2.25
10,7,keen,4,380,0,4,2.5
10,7,kidnap,6,381,1,5,9
10,7,kill,4,382,2,2,1.75
10,7,kiss,4,383,2,2,1.75
10,7,lane,4,384,0,4,2.5
10,7,laptop,6,385,2,4,8.75
10,7,late,4,386,2,2,1.75
10,7,lawsuit,7,387,2,5,3.5
10,7,lawyer,6,388,3,3,2.25
10,7,leave,5,389,1,4,8.5
10,7,less,4,390,2,2,1.75
10,7,lesson,6,391,4,2,1.75
10,7,let,3,392,2,1,1
10,7,level,5,393,2,3,2.25
10,7,liberation,10,394,1,9,12
10,7,lifetime,8,395,2,6,4.25
10,7,light,5,396,2,3,8
10,7,limit,5,397,2,3,2.25
10,7,listener,8,398,2,6,4
10,7,literacy,8,399,2,6,10.25
10,7,lobby,5,400,1,4,3
10,7,lock,4,401,2,2,2
10,7,logo,4,402,2,2,2
10,7,loom,4,403,2,2,9
10,7,lord,4,404,2,2,1.5
10,7,lose,4,405,2,2,1.5
10,7,lost,4,406,3,1,1
10,7,lung,4,407,1,3,2
10,7,magazine,8,408,0,8,11.25
10,7,major,5,409,2,3,2.25
10,7,mall,4,410,2,2,1.5
10,7,man,3,411,2,1,1
10,7,manifest,8,412,3,5,9.25
10,7,manner,6,413,3,3,2.5
10,7,march,5,414,2,3,2.25
10,7,marker,6,415,3,3,2.25
10,7,marriage,8,416,3,5,10
10,7,massive,7,417,2,5,3.5
10,7,mate,4,418,2,2,1.5
10,7,maths,5,419,3,2,1.75
10,7,matter,6,420,3,3,8.25
10,7,maximize,8,421,2,6,4.25
10,7,me,2,422,1,1,1
10,7,means,5,423,2,3,2.25
10,7,medical,7,424,2,5,8.5
10,7,medicine,8,425,5,3,1.75
10,7,membership,10,426,2,8,2.5
10,7,menu,4,427,2,2,4.25
10,7,migration,9,428,1,8,2.25
10,7,mile,4,429,2,2,1
10,7,militant,8,430,3,5,5.5
10,7,milk,4,431,3,1,0.5
10,7,minimize,8,432,2,6,2
10,7,minor,5,433,3,2,1
10,7,minute,6,434,3,3,4.75
10,7,miracle,7,435,2,5,1.75
10,7,missile,7,436,2,5,1.5
10,7,mobile,6,437,1,5,5.25
10,7,mode,4,438,2,2,0.75
10,7,modest,6,439,4,2,0.75
10,7,momentum,8,440,2,6,1.75
10,7,monitor,7,441,2,5,5
10,7,morning,7,442,2,5,1.5
10,7,motor,5,443,2,3,1
10,7,movement,8,444,2,6,5.75
10,7,multiply,8,445,1,7,2
10,7,mutual,6,446,2,4,5.25
10,7,myself,6,447,1,5,1.5
10,7,mysterious,10,448,3,7,5.75
10,7,national,8,449,0,8,2.25
10,7,native,6,450,4,2,1
10,7,naturally,9,451,3,6,5.5
10,7,naval,5,452,2,3,1
10,7,network,7,453,1,6,1.75
10,7,nineteen,8,454,1,7,5.75
10,7,ninety,6,455,5,1,0.75
10,7,noble,5,456,1,4,1.25
10,7,nod,3,457,2,1,0.5
10,7,nurse,5,458,1,4,5
10,7,nursery,7,459,5,2,1
10,7,nursing,7,460,4,3,1.25
10,7,o,1,461,0,1,0.25
10,7,object,6,462,1,5,5.25
10,7,observer,8,463,2,6,2
10,7,obsession,9,464,4,5,1.75
10,7,obtain,6,465,2,4,5.25
10,7,obvious,7,466,2,5,1.5
10,7,occasion,8,467,1,7,5.75
10,7,occasional,10,468,8,2,1.25
10,7,occur,5,469,3,2,0.75
10,7,offering,8,470,1,7,2
10,7,on,2,471,1,1,0.25
10,7,ongoing,7,472,2,5,5.5
10,7,onto,4,473,2,2,0.75
10,7,open,4,474,1,3,1
10,7,opinion,7,475,2,5,5.5
10,7,orchestra,9,476,1,8,2.25
10,7,order,5,477,2,3,1
10,7,organize,8,478,2,6,5.75
10,7,out,3,479,1,2,0.75
10,7,oven,4,480,1,3,1
10,7,overnight,9,481,3,6,5.75
10,7,overseas,8,482,4,4,1.75
10,7,own,3,483,1,2,0.75
10,7,oxygen,6,484,1,5,1.5
10,7,packet,6,485,0,6,6
10,7,pair,4,486,2,2,1
10,7,pan,3,487,2,1,0.5
10,7,parameter,9,488,2,7,10.75
10,7,parent,6,489,3,3,1105.75
10,7,parish,6,490,3,3,2.25
10,7,party,5,491,3,2,1.75
10,7,passage,7,492,2,5,2.75
10,7,peak,4,493,1,3,7.25
10,7,peasant,7,494,3,4,1.75
10,7,penalty,7,495,2,5,2
10,7,people,6,496,2,4,6.25
10,7,permanent,9,497,2,7,2.5
10,7,persuade,8,498,3,5,2.25
10,7,phase,5,499,1,4,6
10,7,pill,4,500,1,3,1.25
10,7,pilot,5,501,3,2,1
10,7,pink,4,502,2,2,1
10,7,planet,6,503,1,5,6.5
10,7,plate,5,504,3,2,1.25
10,7,pleasure,8,505,2,6,2.75
10,7,plug,4,506,2,2,1.5
10,7,plunge,6,507,3,3,6.25
10,7,poetry,6,508,1,5,1.75
10,7,poisonous,9,509,2,7,7.25
10,7,pole,4,510,2,2,1
10,7,policeman,9,511,3,6,2.5
10,7,policy,6,512,5,1,1
10,7,pool,4,513,2,2,1
10,7,popular,7,514,2,5,6.25
10,7,portray,7,515,2,5,2
10,7,positive,8,516,2,6,6.5
10,7,potential,9,517,2,7,2.5
10,7,poverty,7,518,2,5,1.75
10,7,powder,6,519,2,4,5.25
10,7,pray,4,520,1,3,1
10,7,precede,7,521,2,5,1.5
10,7,precision,9,522,4,5,5.75
10,7,prefer,6,523,3,3,1.25
10,7,present,7,524,3,4,1.5
10,7,pretty,6,525,3,3,1.25
10,7,previous,8,526,3,5,5.75
10,7,prince,6,527,2,4,1.25
10,7,princess,8,528,6,2,1
10,7,prison,6,529,3,3,1.25
10,7,privilege,9,530,3,6,5.75
10,7,probable,8,531,2,6,2
10,7,proceed,7,532,3,4,6
10,7,production,10,533,3,7,2.5
10,7,profession,10,534,3,7,6
10,7,profitable,10,535,4,6,2
10,7,prosecutor,10,536,3,7,6.25
10,7,protect,7,537,3,4,1.5
10,7,protection,10,538,7,3,1.25
10,7,province,8,539,3,5,5.5
10,7,provision,9,540,5,4,1.75
10,7,provoke,7,541,4,3,1.25
10,7,psychology,10,542,1,9,6.5
10,7,pub,3,543,1,2,0.75
10,7,punch,5,544,2,3,1
10,7,purchase,8,545,2,6,5.75
10,7,purely,6,546,3,3,1.25
10,7,purple,6,547,3,3,1.25
10,7,queen,5,548,0,5,1.5
10,7,question,8,549,3,5,6
10,7,quickly,7,550,2,5,1.5
10,7,quota,5,551,2,3,1
10,7,quote,5,552,4,1,0.75
10,7,rain,4,553,0,4,5.25
10,7,reader,6,554,1,5,1.5
10,7,real,4,555,3,1,0.5
10,7,really,6,556,4,2,1
10,7,reasonable,10,557,3,7,6
10,7,rebellion,9,558,2,7,2
10,7,receiver,8,559,2,6,6
10,7,refuge,6,560,2,4,1.5
10,7,register,8,561,2,6,1.75
10,7,regret,6,562,3,3,5.25
10,7,regularly,9,563,3,6,2
10,7,reinforce,9,564,2,7,6.25
10,7,relatively,10,565,2,8,2.5
10,7,relaxing,8,566,4,4,5.5
10,7,rely,4,567,3,1,0.5
10,7,remains,7,568,2,5,1.5
10,7,reminder,8,569,3,5,1.75
10,7,repeated,8,570,2,6,9.5
10,7,report,6,571,3,3,2.5
10,7,reporter,8,572,6,2,2.25
10,7,represent,9,573,3,6,10.75
10,7,reproduce,9,574,4,5,4
10,7,request,7,575,2,5,3.5
10,7,respect,7,576,2,5,10
10,7,restaurant,10,577,3,7,5
10,7,restraint,9,578,4,5,10.25
10,7,reverse,7,579,2,5,3.5
10,7,rice,4,580,1,3,2
10,7,rid,3,581,2,1,1
10,7,ridiculous,10,582,3,7,11.25
10,7,risk,4,583,2,2,1.5
10,7,royal,5,584,1,4,2.75
10,7,rugby,5,585,1,4,9.75
10,7,rule,4,586,2,2,1.75
10,7,run,3,587,2,1,1
10,7,runner,6,588,3,3,2.25
10,7,sad,3,589,0,3,2.25
10,7,sail,4,590,2,2,1.75
10,7,sandwich,8,591,2,6,11
10,7,scratch,7,592,1,6,4
10,7,scream,6,593,3,3,9.5
10,7,screening,9,594,4,5,4
10,7,sculpture,9,595,2,7,4.75
10,7,sea,3,596,1,2,8.5
10,7,see,3,597,2,1,1
10,7,seize,5,598,2,3,2.25
10,7,sensitive,9,599,2,7,5.5
10,7,serial,6,600,2,4,10.75
10,7,session,7,601,2,5,3.5
10,7,seventeen,9,602,2,7,11.5
10,7,seventy,7,603,6,1,2
10,7,shade,5,604,1,4,2.75
10,7,shadow,6,605,4,2,1.75
10,7,shaped,6,606,3,3,2.5
10,7,shine,5,607,2,3,8.75
10,7,shop,4,608,2,2,1.5
10,7,short,5,609,3,2,1.75
10,7,shot,4,610,3,1,1
10,7,should,6,611,3,3,2.25
10,7,shout,5,612,4,1,1.25
10,7,show,4,613,3,1,1
10,7,sigh,4,614,1,3,8.25
10,7,silence,7,615,2,5,3.5
10,7,silent,6,616,5,1,1.25
10,7,sir,3,617,2,1,1
10,7,situation,9,618,2,7,11
10,7,size,4,619,2,2,1.75
10,7,skiing,6,620,1,5,3.25
10,7,sky,3,621,2,1,1
10,7,slave,5,622,1,4,2.75
10,7,slogan,6,623,2,4,9.5
10,7,slot,4,624,3,1,1.25
10,7,soccer,6,625,1,5,3.25
10,7,society,7,626,3,4,10
10,7,software,8,627,2,6,4.25
10,7,soldier,7,628,2,5,3.5
10,7,solely,6,629,3,3,9
10,7,solicitor,9,630,3,6,4.25
10,7,somebody,8,631,2,6,4
10,7,somewhere,9,632,4,5,10.75
10,7,son,3,633,2,1,1
10,7,sort,4,634,2,2,1.5
10,7,spicy,5,635,1,4,2.75
10,7,spill,5,636,3,2,4.75
10,7,spite,5,637,3,2,5.25
10,7,spoil,5,638,2,3,2.25
10,7,spot,4,639,3,1,1
10,7,squeeze,7,640,1,6,3.75
10,7,stabilize,9,641,1,8,12
10,7,stage,5,642,3,2,1.75
10,7,station,7,643,3,4,3.25
10,7,stress,6,644,2,4,9.5
10,7,strive,6,645,3,3,2.5
10,7,stunning,8,646,2,6,4
10,7,style,5,647,2,3,8.75
10,7,successive,10,648,1,9,5.75
10,7,suddenly,8,649,2,6,11
10,7,suffer,6,650,2,4,2.75
10,7,suffering,9,651,6,3,2.5
10,7,sum,3,652,2,1,1
10,7,summarize,9,653,3,6,11.25
10,7,summer,6,654,4,2,2
10,7,summit,6,655,4,2,2
10,7,superior,8,656,2,6,13
10,7,sustain,7,657,2,5,4.25
10,7,sweet,5,658,1,4,3.25
10,7,swing,5,659,2,3,2.5
10,7,systematic,10,660,1,9,12.5
10,7,t,1,661,0,1,0.75
10,7,talented,8,662,1,7,11
10,7,teach,5,663,1,4,2.75
10,7,technical,9,664,2,7,4.75
10,7,teenage,7,665,2,5,10.5
10,7,teenager,8,666,7,1,1.25
10,7,tell,4,667,2,2,1.5
10,7,tent,4,668,2,2,1.5
10,7,terminal,8,669,2,6,10.75
10,7,terrain,7,670,3,4,3.25
10,7,terrible,8,671,4,4,3.25
10,7,terrorist,9,672,4,5,10.75
10,7,that,4,673,1,3,2.25
10,7,theatre,7,674,2,5,3.5
10,7,theology,8,675,3,5,11.25
10,7,therefore,9,676,3,6,4.5
10,7,they,4,677,3,1,1.25
10,7,thick,5,678,2,3,2.25
10,7,thin,4,679,3,1,1
10,7,think,5,680,4,1,7.75
10,7,thinking,8,681,5,3,2.75
10,7,though,6,682,2,4,3
10,7,threat,6,683,2,4,2.75
10,7,thrive,6,684,3,3,9
10,7,throughout,10,685,3,7,5
10,7,throw,5,686,4,1,1.5
10,7,timber,6,687,1,5,10
10,7,tiny,4,688,2,2,1.75
10,7,tired,5,689,2,3,2.25
10,7,tobacco,7,690,1,6,3.75
10,7,tomato,6,691,2,4,9.75
10,7,tongue,6,692,2,4,2.75
10,7,total,5,693,2,3,2.25
10,7,touch,5,694,2,3,2.25
10,7,tourist,7,695,3,4,9.75
10,7,towards,7,696,2,5,3.5
10,7,towel,5,697,3,2,1.75
10,7,toy,3,698,2,1,1
10,7,trace,5,699,1,4,9.25
10,7,trading,7,700,3,4,3
10,7,tradition,9,701,5,4,3.25
10,7,training,8,702,3,5,10.25
10,7,transfer,8,703,3,5,3.75
10,7,transform,9,704,6,3,2.75
10,7,transition,10,705,5,5,11.5
10,7,tremendous,10,706,2,8,5.25
10,7,true,4,707,2,2,1.5
10,7,trustee,7,708,3,4,12.5
10,7,try,3,709,2,1,1.25
10,7,tuesday,7,710,1,6,4.75
10,7,tunnel,6,711,2,4,3.5
10,7,turn,4,712,2,2,9.5
10,7,turnover,8,713,4,4,3.25
10,7,twenty,6,714,1,5,3.5
10,7,twist,5,715,2,3,2.5
10,7,typically,9,716,1,8,12
10,7,ultimately,10,717,0,10,13.5
10,7,under,5,718,1,4,2.75
10,7,unit,4,719,2,2,1.75
10,7,up,2,720,1,1,0.75
10,7,upset,5,721,2,3,2.25
10,7,upwards,7,722,2,5,10.5
10,7,used,4,723,1,3,2
10,7,utterly,7,724,1,6,10.75
10,7,vehicle,7,725,0,7,4.5
10,7,very,4,726,2,2,1.75
10,7,village,7,727,1,6,8.25
10,7,violate,7,728,2,5,1.75
10,7,violation,9,729,6,3,1.25
10,7,vitamin,7,730,2,5,6
10,7,voluntary,9,731,1,8,2.5
10,7,wage,4,732,0,4,1.25
10,7,wall,4,733,2,2,5.25
10,7,warehouse,9,734,2,7,2.25
10,7,warfare,7,735,3,4,1.5
10,7,warm,4,736,3,1,4.75
10,7,wash,4,737,2,2,0.75
10,7,weak,4,738,1,3,1
10,7,website,7,739,2,5,1.75
10,7,wheat,5,740,1,4,5.75
10,7,who,3,741,2,1,0.5
10,7,widespread,10,742,1,9,2.5
10,7,winner,6,743,2,4,5.75
10,7,winter,6,744,3,3,1.25
10,7,wise,4,745,2,2,0.75
10,7,withdrawal,10,746,2,8,7
10,7,wooden,6,747,1,5,1.5
10,7,workout,7,748,2,5,1.5
10,7,wrong,5,749,1,4,5.75
10,7,year,4,750,0,4,1.25
10,7,yell,4,751,2,2,0.75
10,7,yesterday,9,752,2,7,6.5
10,7,yourself,8,753,1,7,2
10,8,able,4,0,0,4,5.5
10,8,abolish,7,1,2,5,1.75
10,8,about,5,2,3,2,1
10,8,absent,6,3,2,4,1.25
10,8,abstract,8,4,3,5,6.25
10,8,academy,7,5,1,6,1.75
10,8,accent,6,6,2,4,6.25
10,8,acceptance,10,7,4,6,2.25
10,8,access,6,8,4,2,1
10,8,account,7,9,3,4,1.5
10,8,accountant,10,10,7,3,5.75
10,8,accuracy,8,11,3,5,1.75
10,8,acquire,7,12,2,5,1.5
10,8,action,6,13,2,4,6
10,8,activation,10,14,4,6,2.25
10,8,addition,8,15,1,7,7
10,8,adult,5,16,2,3,1
10,8,advanced,8,17,2,6,2
10,8,advertise,9,18,3,6,7.75
10,8,affair,6,19,1,5,1.75
10,8,affection,9,20,3,6,7.75
10,8,afford,6,21,3,3,1.5
10,8,aged,4,22,1,3,1.25
10,8,ah,2,23,1,1,0.5
10,8,alert,5,24,1,4,1.5
10,8,alien,5,25,2,3,6.25
10,8,alignment,9,26,3,6,2
10,8,alliance,8,27,2,6,2
10,8,alone,5,28,2,3,5.75
10,8,along,5,29,4,1,0.75
10,8,although,8,30,2,6,2.25
10,8,altogether,10,31,3,7,7
10,8,amid,4,32,1,3,1
10,8,angel,5,33,1,4,1.25
10,8,anyone,6,34,2,4,6
10,8,anything,8,35,3,5,2
10,8,apart,5,36,1,4,1.25
10,8,appoint,7,37,2,5,6.25
10,8,arena,5,38,1,4,1.25
10,8,array,5,39,2,3,1
10,8,arrival,7,40,3,4,1.5
10,8,article,7,41,2,5,6.25
10,8,artificial,10,42,4,6,2.25
10,8,asset,5,43,1,4,5.75
10,8,assignment,10,44,3,7,2.25
10,8,attach,6,45,1,5,1.5
10,8,attend,6,46,3,3,5.75
10,8,audit,5,47,1,4,1.25
10,8,august,6,48,2,4,1.25
10,8,author,6,49,2,4,5.75
10,8,autumn,6,50,3,3,1.25
10,8,aware,5,51,1,4,1.25
10,8,away,4,52,3,1,0.75
10,8,back,4,53,0,4,1.25
10,8,ballot,6,54,2,4,6
10,8,barrier,7,55,2,5,1.5
10,8,basis,5,56,2,3,1
10,8,bean,4,57,1,3,5.75
10,8,bear,4,58,3,1,0.75
10,8,because,7,59,2,5,1.5
10,8,become,6,60,3,3,1.25
10,8,bee,3,61,2,1,0.5
10,8,before,6,62,2,4,5.75
10,8,behind,6,63,2,4,1.25
10,8,being,5,64,2,3,1
10,8,bend,4,65,2,2,0.75
10,8,bent,4,66,3,1,0.5
10,8,beside,6,67,2,4,6
10,8,bicycle,7,68,1,6,1.75
10,8,big,3,69,2,1,0.5
10,8,blanket,7,70,1,6,6.25
10,8,blast,5,71,3,2,1
10,8,bleed,5,72,2,3,1
10,8,blood,5,73,2,3,1
10,8,bold,4,74,1,3,1
10,8,bond,4,75,2,2,5.5
10,8,bonus,5,76,3,2,1
10,8,booking,7,77,2,5,1.5
10,8,born,4,78,2,2,0.75
10,8,bounce,6,79,2,4,6
10,8,brain,5,80,1,4,1.25
10,8,brick,5,81,2,3,1
10,8,briefly,7,82,3,4,1.5
10,8,brilliant,9,83,3,6,6.75
10,8,broad,5,84,2,3,1
10,8,broadband,9,85,5,4,1.5
10,8,broadly,7,86,5,2,5.5
10,8,brother,7,87,3,4,1.5
10,8,brown,5,88,3,2,0.75
10,8,burial,6,89,1,5,1.75
10,8,bus,3,90,2,1,0.5
10,8,busy,4,91,3,1,5.25
10,8,cabin,5,92,0,5,1.5
10,8,capitalism,10,93,2,8,2.75
10,8,cattle,6,94,2,4,6.5
10,8,caution,7,95,2,5,1.5
10,8,chance,6,96,1,5,6.75
10,8,charge,6,97,3,3,1.25
10,8,chat,4,98,3,1,0.5
10,8,chest,5,99,2,3,1.25
10,8,cinema,6,100,1,5,2.75
10,8,claim,5,101,1,4,6
10,8,classical,9,102,3,6,2
10,8,clinic,6,103,2,4,1.5
10,8,clip,4,104,3,1,5.25
10,8,clock,5,105,2,3,1
10,8,close,5,106,3,2,1
10,8,clue,4,107,2,2,0.75
10,8,coalition,9,108,1,8,7.75
10,8,coast,5,109,3,2,1
10,8,coastal,7,110,5,2,1
10,8,coin,4,111,2,2,0.75
10,8,collapse,8,112,2,6,6.75
10,8,colour,6,113,3,3,1.25
10,8,coloured,8,114,6,2,1
10,8,columnist,9,115,3,6,2
10,8,combine,7,116,2,5,6.5
10,8,communist,9,117,3,6,2.5
10,8,comparison,10,118,3,7,8
10,8,complain,8,119,4,4,2
10,8,completely,10,120,5,5,2.25
10,8,compliance,10,121,5,5,8
10,8,computer,8,122,4,4,1.75
10,8,conception,10,123,2,8,8.25
10,8,concerned,9,124,5,4,2
10,8,conclude,8,125,4,4,1.75
10,8,concrete,8,126,4,4,7
10,8,confession,10,127,3,7,2.5
10,8,confirm,7,128,4,3,1.5
10,8,conflict,8,129,4,4,7
10,8,consensus,9,130,3,6,2.25
10,8,conserve,8,131,5,3,1.25
10,8,consistent,10,132,4,6,7
10,8,conspiracy,10,133,4,6,2
10,8,consume,7,134,4,3,1.25
10,8,contact,7,135,3,4,6.25
10,8,container,9,136,5,4,1.75
10,8,contender,9,137,4,5,2
10,8,context,7,138,5,2,1
10,8,continue,8,139,4,4,6.25
10,8,continuous,10,140,7,3,1.5
10,8,contrary,8,141,4,4,1.5
10,8,convert,7,142,3,4,6.25
10,8,convict,7,143,4,3,1.25
10,8,conviction,10,144,7,3,1.5
10,8,cooperate,9,145,2,7,7.5
10,8,copy,4,146,2,2,1.5
10,8,correlate,9,147,2,7,4.5
10,8,correspond,10,148,5,5,11.25
10,8,corrupt,7,149,4,3,2.75
10,8,costume,7,150,2,5,3.5
10,8,cotton,6,151,2,4,2.75
10,8,courage,7,152,2,5,11
10,8,covered,7,153,2,5,3.5
10,8,crash,5,154,1,4,2.75
10,8,crazy,5,155,3,2,9.5
10,8,cream,5,156,2,3,2.25
10,8,creation,8,157,4,4,3
10,8,creative,8,158,6,2,2
10,8,criterion,9,159,2,7,522.5
10,8,crown,5,160,2,3,3
10,8,cue,3,161,1,2,2
10,8,cupboard,8,162,2,6,5
10,8,custom,6,163,2,4,13.75
10,8,dad,3,164,0,3,3.5
10,8,data,4,165,2,2,3
10,8,database,8,166,4,4,5.25
10,8,date,4,167,3,1,2
10,8,dead,4,168,1,3,12
10,8,deadly,6,169,4,2,2.25
10,8,dear,4,170,3,1,2.5
10,8,debate,6,171,2,4,5.5
10,8,debut,5,172,3,2,2.75
10,8,decision,8,173,2,6,14.5
10,8,dedicated,9,174,2,7,9
10,8,defeat,6,175,2,4,12.5
10,8,defend,6,176,4,2,2.25
10,8,define,6,177,3,3,2.75
10,8,defy,4,178,3,1,1.25
10,8,delivery,8,179,2,6,4.5
10,8,depend,6,180,2,4,11
10,8,depict,6,181,3,3,2.75
10,8,descend,7,182,2,5,3.75
10,8,desire,6,183,3,3,20
10,8,detection,9,184,2,7,6
10,8,determined,10,185,4,6,23.25
10,8,dialogue,8,186,1,7,3
10,8,diary,5,187,3,2,1.25
10,8,dictionary,10,188,2,8,13.75
10,8,die,3,189,2,1,0.5
10,8,differ,6,190,2,4,1.75
10,8,dilemma,7,191,2,5,9
10,8,dimension,9,192,2,7,2.5
10,8,dip,3,193,2,1,0.5
10,8,direction,9,194,2,7,5.75
10,8,directly,8,195,6,2,1.5
10,8,directory,9,196,6,3,1.75
10,8,discard,7,197,2,5,1.75
10,8,discharge,9,198,4,5,6.25
10,8,discourse,9,199,4,5,2
10,8,disease,7,200,3,4,1.5
10,8,disorder,8,201,3,5,5.75
10,8,distance,8,202,3,5,1.75
10,8,district,8,203,4,4,1.75
10,8,diversity,9,204,2,7,6
10,8,divorce,7,205,3,4,1.5
10,8,doctrine,8,206,1,7,5.75
10,8,donate,6,207,2,4,1.5
10,8,donor,5,208,3,2,1
10,8,door,4,209,2,2,0.75
10,8,dose,4,210,2,2,3.75
10,8,dozen,5,211,2,3,1.25
10,8,drive,5,212,1,4,1.25
10,8,driver,6,213,5,1,0.5
10,8,drown,5,214,2,3,1
10,8,drug,4,215,2,2,3.75
10,8,drunk,5,216,3,2,1
10,8,dry,3,217,2,1,0.5
10,8,dump,4,218,1,3,1
10,8,during,6,219,2,4,1.25
10,8,dynamic,7,220,1,6,5.25
10,8,each,4,221,0,4,1.5
10,8,easily,6,222,2,4,1.75
10,8,eastern,7,223,3,4,4.75
10,8,easy,4,224,3,1,0.75
10,8,eat,3,225,2,1,0.5
10,8,economy,7,226,1,6,1.75
10,8,editorial,9,227,1,8,5.5
10,8,elaborate,9,228,1,8,2.25
10,8,election,8,229,2,6,5
10,8,electric,8,230,5,3,1.5
10,8,element,7,231,3,4,1.5
10,8,elementary,10,232,7,3,4.75
10,8,else,4,233,2,2,0.75
10,8,emphasize,9,234,1,8,2.25
10,8,empire,6,235,3,3,4.5
10,8,encourage,9,236,1,8,2.25
10,8,enforce,7,237,2,5,4.75
10,8,enough,6,238,2,4,1.25
10,8,enrol,5,239,2,3,1
10,8,epidemic,8,240,1,7,5.25
10,8,equal,5,241,1,4,1.25
10,8,equip,5,242,3,2,0.75
10,8,era,3,243,1,2,0.75
10,8,error,5,244,2,3,1
10,8,escape,6,245,1,5,4.75
10,8,essential,9,246,2,7,2.25
10,8,eternal,7,247,1,6,5
10,8,ethic,5,248,2,3,1
10,8,ethnic,6,249,3,3,1.25
10,8,every,5,250,1,4,1.25
10,8,everybody,9,251,5,4,5
10,8,everywhere,10,252,5,5,1.75
10,8,exam,4,253,1,3,1
10,8,explicit,8,254,2,6,5.25
10,8,explosion,9,255,4,5,2
10,8,exposure,8,256,3,5,5
10,8,external,8,257,2,6,2
10,8,extra,5,258,3,2,1
10,8,fact,4,259,0,4,1.25
10,8,faction,7,260,4,3,4.75
10,8,factory,7,261,4,3,1.25
10,8,faith,5,262,2,3,1
10,8,farm,4,263,2,2,0.75
10,8,feather,7,264,1,6,5.25
10,8,feel,4,265,2,2,0.75
10,8,feeling,7,266,4,3,1.25
10,8,fifth,5,267,1,4,1.25
10,8,fill,4,268,2,2,4
10,8,film,4,269,3,1,0.75
10,8,finish,6,270,2,4,1.25
10,8,firearm,7,271,2,5,1.5
10,8,firework,8,272,4,4,4.75
10,8,first,5,273,3,2,1
10,8,fishing,7,274,2,5,1.5
10,8,five,4,275,2,2,0.75
10,8,float,5,276,1,4,4.5
10,8,flour,5,277,3,2,1
10,8,fold,4,278,1,3,1
10,8,following,9,279,3,6,2.25
10,8,fond,4,280,2,2,4.25
10,8,forecast,8,281,2,6,2
10,8,forever,7,282,4,3,1.25
10,8,forge,5,283,3,2,0.75
10,8,formulate,9,284,3,6,5.5
10,8,forth,5,285,3,2,0.75
10,8,forum,5,286,3,2,0.75
10,8,frame,5,287,1,4,1.25
10,8,framework,9,288,5,4,5
10,8,franchise,9,289,3,6,2
10,8,freeze,6,290,2,4,1.25
10,8,frequently,10,291,3,7,5.5
10,8,from,4,292,2,2,0.75
10,8,fruit,5,293,2,3,1
10,8,function,8,294,1,7,5.5
10,8,fund,4,295,3,1,0.75
10,8,garden,6,296,0,6,1.75
10,8,gas,3,297,2,1,0.5
10,8,generic,7,298,1,6,5
10,8,gentle,6,299,3,3,1
10,8,gentleman,9,300,6,3,1.25
10,8,genuine,7,301,3,4,4.5
10,8,get,3,302,2,1,0.5
10,8,gorgeous,8,303,1,7,2
10,8,government,10,304,2,8,5.75
10,8,graduate,8,305,1,7,2
10,8,grain,5,306,3,2,1
10,8,grant,5,307,3,2,4.25
10,8,grass,5,308,3,2,0.75
10,8,greenhouse,10,309,2,8,2.25
10,8,guard,5,310,1,4,4.5
10,8,guideline,9,311,2,7,2
10,8,halt,4,312,0,4,1
10,8,hardly,6,313,2,4,4.75
10,8,hardware,8,314,4,4,1.5
10,8,harmony,7,315,3,4,1.5
10,8,hear,4,316,1,3,4.25
10,8,hearing,7,317,4,3,1
10,8,heavily,7,318,3,4,1.25
10,8,hello,5,319,2,3,1
10,8,helmet,6,320,3,3,4.75
10,8,helpful,7,321,3,4,1.5
10,8,hide,4,322,1,3,1
10,8,hierarchy,9,323,2,7,5.75
10,8,himself,7,324,2,5,1.75
10,8,historian,9,325,2,7,2
10,8,hold,4,326,1,3,4.5
10,8,homeless,8,327,2,6,2
10,8,homework,8,328,4,4,1.5
10,8,hope,4,329,2,2,4
10,8,hopefully,9,330,4,5,1.75
10,8,horizon,7,331,2,5,1.5
10,8,hostile,7,332,2,5,5
10,8,house,5,333,2,3,1
10,8,hurry,5,334,1,4,1.25
10,8,if,2,335,0,2,0.5
10,8,ignore,6,336,1,5,5
10,8,immense,7,337,1,6,1.75
10,8,immigrant,9,338,3,6,5.5
10,8,imminent,8,339,4,4,1.5
10,8,impact,6,340,2,4,1.25
10,8,in,2,341,1,1,0.5
10,8,inadequate,10,342,2,8,6
10,8,incentive,9,343,2,7,2
10,8,including,9,344,3,6,5.5
10,8,increase,8,345,3,5,1.75
10,8,indeed,6,346,2,4,4.75
10,8,indigenous,10,347,3,7,2.25
10,8,indoors,7,348,3,4,1.25
10,8,industrial,10,349,3,7,5.75
10,8,inequality,10,350,2,8,2.5
10,8,inflation,9,351,2,7,5.75
10,8,initial,7,352,2,5,1.5
10,8,innovative,10,353,2,8,6
10,8,insect,6,354,2,4,1.25
10,8,insider,7,355,3,4,5
10,8,insight,7,356,4,3,1.5
10,8,inspire,7,357,3,4,1.25
10,8,insult,6,358,3,3,1
10,8,intention,9,359,2,7,5.5
10,8,interface,9,360,4,5,1.75
10,8,interpret,9,361,5,4,1.5
10,8,interview,9,362,5,4,5
10,8,investor,8,363,2,6,1.75
10,8,invitation,10,364,3,7,5.75
10,8,jam,3,365,0,3,0.75
10,8,jeans,5,366,1,4,1.25
10,8,kill,4,367,0,4,2.75
10,8,kind,4,368,2,2,2.75
10,8,knock,5,369,1,4,1.25
10,8,knowledge,9,370,3,6,2
10,8,label,5,371,0,5,5
10,8,ladder,6,372,2,4,1.5
10,8,lady,4,373,3,1,0.5
10,8,landing,7,374,2,5,5.25
10,8,lane,4,375,3,1,0.75
10,8,laptop,6,376,2,4,1.25
10,8,late,4,377,2,2,0.75
10,8,lawsuit,7,378,2,5,1.5
10,8,layout,6,379,2,4,5
10,8,lead,4,380,1,3,1
10,8,learn,5,381,3,2,0.75
10,8,legacy,6,382,2,4,1.25
10,8,leisure,7,383,2,5,5.25
10,8,lend,4,384,2,2,1.5
10,8,length,6,385,3,3,2.5
10,8,let,3,386,2,1,1
10,8,level,5,387,2,3,2.25
10,8,light,5,388,1,4,8.25
10,8,listener,8,389,2,6,4
10,8,lively,6,390,2,4,2.75
10,8,lobby,5,391,1,4,8.5
10,8,lock,4,392,2,2,1.75
10,8,logic,5,393,2,3,2.25
10,8,logo,4,394,3,1,1.25
10,8,loop,4,395,2,2,1.75
10,8,lost,4,396,2,2,7.25
10,8,lovely,6,397,2,4,2.75
10,8,lung,4,398,1,3,2
10,8,magazine,8,399,0,8,11
10,8,magical,7,400,3,4,3
10,8,major,5,401,2,3,2.25
10,8,manifest,8,402,2,6,9.75
10,8,marginal,8,403,2,6,4.25
10,8,marker,6,404,3,3,2.5
10,8,maths,5,405,2,3,8
10,8,matter,6,406,3,3,2.5
10,8,maximize,8,407,2,6,4
10,8,mayor,5,408,2,3,2.25
10,8,me,2,409,1,1,0.75
10,8,meaning,7,410,2,5,9.5
10,8,mechanism,9,411,2,7,5
10,8,medicine,8,412,2,6,10
10,8,membership,10,413,2,8,5.25
10,8,metal,5,414,2,3,8
10,8,militant,8,415,1,7,4.5
10,8,military,8,416,6,2,2
10,8,mine,4,417,2,2,1.75
10,8,miner,5,418,4,1,7
10,8,minimize,8,419,3,5,3.75
10,8,mining,6,420,4,2,2
10,8,minor,5,421,3,2,1.75
10,8,minority,8,422,5,3,2.5
10,8,miracle,7,423,2,5,9.5
10,8,mobile,6,424,1,5,3.25
10,8,modest,6,425,2,4,3
10,8,momentum,8,426,2,6,10.5
10,8,monitor,7,427,2,5,3.5
10,8,monk,4,428,3,1,1.25
10,8,morality,8,429,2,6,9.75
10,8,morning,7,430,3,4,3
10,8,motivation,10,431,2,8,11.25
10,8,motive,6,432,5,1,1.75
10,8,motor,5,433,3,2,1.75
10,8,mount,5,434,2,3,2.25
10,8,move,4,435,2,2,1.5
10,8,musical,7,436,1,6,11
10,8,myself,6,437,1,5,3.5
10,8,mysterious,10,438,3,7,10.75
10,8,nail,4,439,0,4,2.5
10,8,native,6,440,2,4,3
10,8,naturally,9,441,3,6,10.25
10,8,nerve,5,442,1,4,2.75
10,8,nest,4,443,2,2,1.75
10,8,network,7,444,2,5,3.5
10,8,news,4,445,2,2,7.25
10,8,next,4,446,2,2,1.75
10,8,nineteen,8,447,1,7,4.5
10,8,noble,5,448,1,4,9
10,8,notable,7,449,2,5,3.5
10,8,notably,7,450,6,1,1.5
10,8,now,3,451,2,1,1
10,8,nowadays,8,452,3,5,3.5
10,8,nursery,7,453,1,6,10
10,8,o,1,454,0,1,0.75
10,8,obey,4,455,1,3,2
10,8,observe,7,456,2,5,9.25
10,8,obsession,9,457,4,5,4
10,8,obvious,7,458,2,5,3.5
10,8,occasion,8,459,1,7,10.5
10,8,occasional,10,460,8,2,2
10,8,offender,8,461,1,7,10.5
10,8,offer,5,462,4,1,1.5
10,8,offering,8,463,5,3,3
10,8,on,2,464,1,1,1
10,8,ongoing,7,465,2,5,3.5
10,8,onion,5,466,2,3,8.25
10,8,onto,4,467,2,2,1.5
10,8,open,4,468,1,3,2
10,8,operate,7,469,3,4,3
10,8,opposition,10,470,2,8,12
10,8,optimism,8,471,2,6,4
10,8,or,2,472,1,1,0.75
10,8,orange,6,473,2,4,8.75
10,8,ordinary,8,474,2,6,4
10,8,organize,8,475,2,6,4
10,8,our,3,476,1,2,7.5
10,8,out,3,477,2,1,1
10,8,overnight,9,478,1,8,5
10,8,own,3,479,1,2,1.5
10,8,oxygen,6,480,1,5,9.25
10,8,packet,6,481,0,6,3.75
10,8,pair,4,482,2,2,1.75
10,8,palm,4,483,2,2,7.5
10,8,pan,3,484,2,1,1
10,8,parameter,9,485,2,7,4.75
10,8,parental,8,486,3,5,9.75
10,8,partly,6,487,3,3,2.5
10,8,pass,4,488,2,2,1.5
10,8,passing,7,489,4,3,2.25
10,8,passion,7,490,5,2,1.75
10,8,payment,7,491,2,5,9.75
10,8,people,6,492,1,5,3.25
10,8,period,6,493,2,4,3
10,8,permanent,9,494,3,6,10.25
10,8,petition,8,495,2,6,4
10,8,photograph,10,496,1,9,12
10,8,physics,7,497,2,5,3.5
10,8,pilot,5,498,1,4,9
10,8,pink,4,499,2,2,1.75
10,8,placement,9,500,1,8,5.25
10,8,plain,5,501,3,2,1.75
10,8,planet,6,502,3,3,8.5
10,8,plate,5,503,3,2,1.75
10,8,player,6,504,3,3,2.25
10,8,pocket,6,505,1,5,3.25
10,8,poet,4,506,2,2,7.5
10,8,pool,4,507,2,2,1.5
10,8,popular,7,508,2,5,3.5
10,8,portray,7,509,2,5,3.25
10,8,positive,8,510,2,6,10.25
10,8,powerful,8,511,2,6,4
10,8,practice,8,512,1,7,10.75
10,8,precision,9,513,2,7,4.75
10,8,preference,10,514,3,7,12.5
10,8,premium,7,515,3,4,3.25
10,8,prepare,7,516,3,4,3
10,8,prevalence,10,517,3,7,11.25
10,8,previous,8,518,4,4,3.25
10,8,price,5,519,2,3,2.25
10,8,primarily,9,520,3,6,10.5
10,8,prince,6,521,3,3,2.25
10,8,prison,6,522,3,3,2.25
10,8,prisoner,8,523,6,2,8
10,8,probable,8,524,2,6,4
10,8,productive,10,525,3,7,5
10,8,profession,10,526,3,7,11
10,8,promotion,9,527,3,6,4.25
10,8,pronounce,9,528,3,6,11
10,8,pronounced,10,529,9,1,1.75
10,8,prosecutor,10,530,3,7,4.75
10,8,provide,7,531,3,4,9.25
10,8,provision,9,532,5,4,3.25
10,8,provoke,7,533,4,3,2.5
10,8,publishing,10,534,1,9,16.25
10,8,purchase,8,535,2,6,4.25
10,8,pursue,6,536,3,3,9
10,8,qualify,7,537,0,7,4.5
10,8,question,8,538,2,6,9.5
10,8,quickly,7,539,2,5,1.75
10,8,radio,5,540,0,5,1.5
10,8,rain,4,541,2,2,0.75
10,8,random,6,542,2,4,5.25
10,8,range,5,543,3,2,0.75
10,8,rapid,5,544,2,3,1
10,8,rare,4,545,2,2,0.75
10,8,reader,6,546,1,5,5.5
10,8,reading,7,547,4,3,1.25
10,8,realize,7,548,3,4,1.5
10,8,receive,7,549,2,5,5.5
10,8,receiver,8,550,7,1,1
10,8,recipient,9,551,3,6,2
10,8,recovery,8,552,3,5,1.75
10,8,refuge,6,553,2,4,5.5
10,8,register,8,554,2,6,2
10,8,regret,6,555,3,3,1.25
10,8,regularly,9,556,3,6,6.25
10,8,relatively,10,557,2,8,2.5
10,8,rely,4,558,3,1,4.75
10,8,repeated,8,559,2,6,2
10,8,report,6,560,3,3,1.25
10,8,reporter,8,561,6,2,1
10,8,reproduce,9,562,3,6,5.75
10,8,request,7,563,2,5,1.75
10,8,response,8,564,2,6,6
10,8,restaurant,10,565,3,7,2.25
10,8,restraint,9,566,4,5,2
10,8,resume,6,567,3,3,5.75
10,8,review,6,568,2,4,1.25
10,8,rhetoric,8,569,1,7,6
10,8,rice,4,570,1,3,1
10,8,rid,3,571,2,1,0.5
10,8,riot,4,572,2,2,0.75
10,8,risk,4,573,2,2,0.75
10,8,rock,4,574,1,3,0.75
10,8,royal,5,575,2,3,5
10,8,rule,4,576,1,3,1
10,8,rumour,6,577,2,4,1.5
10,8,run,3,578,2,1,0.5
10,8,runner,6,579,3,3,1
10,8,sadly,5,580,0,5,5.5
10,8,sail,4,581,2,2,0.75
10,8,sanction,8,582,2,6,2
10,8,sandwich,8,583,3,5,5.75
10,8,scope,5,584,1,4,1.25
10,8,scratch,7,585,2,5,1.75
10,8,scream,6,586,3,3,5.25
10,8,sea,3,587,1,2,0.75
10,8,see,3,588,2,1,0.5
10,8,seldom,6,589,2,4,1.25
10,8,senator,7,590,2,5,5.25
10,8,send,4,591,3,1,0.75
10,8,senior,6,592,3,3,1.25
10,8,sensation,9,593,3,6,2
10,8,sensitive,9,594,4,5,6
10,8,sentence,8,595,3,5,1.75
10,8,session,7,596,2,5,1.5
10,8,set,3,597,2,1,0.5
10,8,seventeen,9,598,2,7,6.25
10,8,several,7,599,4,3,1.25
10,8,sex,3,600,2,1,0.5
10,8,shade,5,601,1,4,5.5
10,8,shadow,6,602,4,2,1
10,8,shall,5,603,3,2,0.75
10,8,shaped,6,604,3,3,1
10,8,shocking,8,605,2,6,5.75
10,8,shop,4,606,3,1,0.5
10,8,shot,4,607,3,1,0.5
10,8,should,6,608,3,3,1
10,8,shout,5,609,4,1,0.5
10,8,show,4,610,3,1,0.5
10,8,shrink,6,611,2,4,1.25
10,8,shrug,5,612,3,2,5
10,8,sigh,4,613,1,3,1
10,8,silent,6,614,2,4,1.25
10,8,simulate,8,615,2,6,6
10,8,sincere,7,616,2,5,1.5
10,8,sixty,5,617,2,3,1
10,8,skill,5,618,1,4,1.25
10,8,slave,5,619,1,4,5.5
10,8,sleep,5,620,2,3,1
10,8,slot,4,621,2,2,0.75
10,8,small,5,622,1,4,1.25
10,8,smart,5,623,3,2,5
10,8,smash,5,624,3,2,1
10,8,snap,4,625,1,3,1
10,8,soak,4,626,1,3,1.25
10,8,soar,4,627,3,1,0.75
10,8,soccer,6,628,2,4,5.25
10,8,soft,4,629,2,2,0.75
10,8,software,8,630,4,4,1.5
10,8,solicitor,9,631,2,7,6.25
10,8,somewhere,9,632,2,7,2.5
10,8,source,6,633,2,4,1.5
10,8,spending,8,634,1,7,6.25
10,8,spoil,5,635,2,3,1
10,8,sponsor,7,636,3,4,1.5
10,8,sport,5,637,3,2,5
10,8,squeeze,7,638,1,6,1.75
10,8,stadium,7,639,1,6,1.75
10,8,stage,5,640,3,2,5.25
10,8,statement,9,641,3,6,2
10,8,status,6,642,4,2,1
10,8,stiff,5,643,2,3,1
10,8,stimulate,9,644,3,6,9.75
10,8,stress,6,645,2,4,3
10,8,structure,9,646,3,6,11
10,8,stupid,6,647,2,4,3
10,8,style,5,648,2,3,2.25
10,8,suburban,8,649,1,7,11.25
10,8,successive,10,650,2,8,5.5
10,8,suffering,9,651,2,7,11.75
10,8,summarize,9,652,2,7,4.75
10,8,superb,6,653,2,4,2.75
10,8,superior,8,654,5,3,9.25
10,8,surprised,9,655,2,7,4.75
10,8,surrender,9,656,3,6,10.75
10,8,survive,7,657,3,4,3
10,8,suspicious,10,658,2,8,12.75
10,8,systematic,10,659,1,9,5.75
10,8,t,1,660,0,1,0.75
10,8,tax,3,661,1,2,1.5
10,8,teach,5,662,1,4,1623
10,8,technique,9,663,2,7,4.25
10,8,teenage,7,664,2,5,3
10,8,terrorist,9,665,2,7,9.25
10,8,testify,7,666,2,5,2
10,8,testing,7,667,5,2,1.25
10,8,text,4,668,2,2,6.5
10,8,theatre,7,669,1,6,2.25
10,8,theirs,6,670,3,3,1.5
10,8,them,4,671,3,1,0.75
10,8,there,5,672,3,2,6.25
10,8,thick,5,673,2,3,1.25
10,8,thinking,8,674,3,5,2
10,8,though,6,675,2,4,1.75
10,8,thought,7,676,6,1,5.75
10,8,threaten,8,677,2,6,2.25
10,8,throughout,10,678,3,7,2.75
10,8,throw,5,679,4,1,5.75
10,8,thursday,8,680,2,6,2.25
10,8,timber,6,681,1,5,1.75
10,8,tiny,4,682,2,2,6.25
10,8,tobacco,7,683,1,6,2.25
10,8,toll,4,684,2,2,1
10,8,ton,3,685,2,1,0.75
10,8,tongue,6,686,3,3,1.5
10,8,total,5,687,2,3,6.25
10,8,towel,5,688,2,3,1.25
10,8,trading,7,689,1,6,2.25
10,8,training,8,690,3,5,7
10,8,transform,9,691,3,6,2.25
10,8,tremendous,10,692,2,8,8
10,8,tribunal,8,693,2,6,2.25
10,8,trillion,8,694,3,5,6.75
10,8,troubled,8,695,2,6,2.25
10,8,truly,5,696,2,3,1.25
10,8,trust,5,697,3,2,1
10,8,trustee,7,698,5,2,1
10,8,truth,5,699,3,2,5
10,8,try,3,700,2,1,0.5
10,8,turn,4,701,1,3,1
10,8,turnover,8,702,4,4,1.25
10,8,twenty,6,703,1,5,5.75
10,8,type,4,704,1,3,1
10,8,typical,7,705,3,4,1.25
10,8,ugly,4,706,0,4,1.25
10,8,ultimately,10,707,1,9,7
10,8,umbrella,8,708,1,7,6.75
10,8,under,5,709,1,4,1.25
10,8,unit,4,710,2,2,0.75
10,8,unless,6,711,2,4,1.5
10,8,unlike,6,712,3,3,5.5
10,8,unlikely,8,713,6,2,1.25
10,8,upwards,7,714,1,6,1.75
10,8,us,2,715,1,1,0.5
10,8,used,4,716,2,2,0.75
10,8,utterly,7,717,1,6,6.25
10,8,vehicle,7,718,0,7,2
10,8,versus,6,719,2,4,5.75
10,8,very,4,720,3,1,0.75
10,8,victim,6,721,1,5,1.5
10,8,village,7,722,2,5,1.75
10,8,violation,9,723,2,7,6.75
10,8,vote,4,724,1,3,1
10,8,wall,4,725,0,4,5.5
10,8,want,4,726,2,2,0.75
10,8,ward,4,727,2,2,0.75
10,8,warfare,7,728,3,4,1.25
10,8,warm,4,729,3,1,0.5
10,8,wash,4,730,2,2,0.75
10,8,weak,4,731,1,3,5.5
10,8,weather,7,732,3,4,1.5
10,8,website,7,733,2,5,1.75
10,8,weekly,6,734,2,4,5.75
10,8,well,4,735,2,2,0.75
10,8,wheat,5,736,1,4,1.25
10,8,where,5,737,3,2,1
10,8,while,5,738,2,3,1
10,8,whilst,6,739,4,2,5.5
10,8,whisper,7,740,3,4,1.75
10,8,who,3,741,2,1,0.75
10,8,wholly,6,742,3,3,1
10,8,winter,6,743,1,5,6
10,8,wise,4,744,2,2,0.75
10,8,wish,4,745,3,1,0.5
10,8,withdraw,8,746,2,6,2
10,8,wooden,6,747,1,5,6.5
10,8,worm,4,748,2,2,0.75
10,8,worse,5,749,3,2,1
10,8,writing,7,750,1,6,2
10,8,wrong,5,751,2,3,5.5
10,8,yesterday,9,752,0,9,2.75
10,8,yours,5,753,1,4,1.25
10,9,able,4,0,0,4,1.25
10,9,abolish,7,1,2,5,1.5
10,9,about,5,2,3,2,3
10,9,abroad,6,3,2,4,3.75
10,9,abstract,8,4,2,6,1.75
10,9,accent,6,5,1,5,6
10,9,acceptance,10,6,4,6,2
10,9,access,6,7,4,2,1
10,9,according,9,8,3,6,6.25
10,9,account,7,9,4,3,1.25
10,9,accountant,10,10,7,3,1.25
10,9,accuracy,8,11,3,5,1.5
10,9,addition,8,12,1,7,6.75
10,9,adhere,6,13,2,4,1.5
10,9,admission,9,14,2,7,7
10,9,advance,7,15,2,5,1.5
10,9,advanced,8,16,7,1,0.75
10,9,advertise,9,17,3,6,6.5
10,9,afraid,6,18,1,5,1.75
10,9,air,3,19,1,2,0.75
10,9,aircraft,8,20,3,5,6.5
10,9,alert,5,21,1,4,1.5
10,9,alike,5,22,2,3,1.75
10,9,all,3,23,2,1,1
10,9,allegedly,9,24,3,6,8.25
10,9,allow,5,25,3,2,1
10,9,also,4,26,2,2,0.75
10,9,amid,4,27,1,3,1.25
10,9,angel,5,28,1,4,1.5
10,9,anyone,6,29,2,4,7.5
10,9,apart,5,30,1,4,1.25
10,9,appetite,8,31,2,6,8
10,9,apply,5,32,3,2,1
10,9,april,5,33,2,3,1.5
10,9,arbitrary,9,34,1,8,2.75
10,9,arena,5,35,2,3,7.5
10,9,article,7,36,2,5,1.75
10,9,artificial,10,37,4,6,8
10,9,asset,5,38,1,4,1.25
10,9,associated,10,39,3,7,2.25
10,9,attack,6,40,1,5,6
10,9,attempt,7,41,3,4,1.5
10,9,attendance,10,42,4,6,2.25
10,9,audit,5,43,1,4,6
10,9,august,6,44,2,4,1.5
10,9,authority,9,45,2,7,6.5
10,9,autumn,6,46,3,3,1.25
10,9,aware,5,47,1,4,1.25
10,9,backdrop,8,48,0,8,6.75
10,9,ballot,6,49,2,4,1.25
10,9,bare,4,50,2,2,0.75
10,9,barrier,7,51,3,4,1.5
10,9,basket,6,52,2,4,6
10,9,basketball,10,53,6,4,1.75
10,9,because,7,54,1,6,1.75
10,9,become,6,55,3,3,6
10,9,beef,4,56,2,2,0.75
10,9,behind,6,57,2,4,1.25
10,9,being,5,58,2,3,1
10,9,beneath,7,59,2,5,6.25
10,9,bent,4,60,3,1,0.75
10,9,beside,6,61,2,4,1.25
10,9,bicycle,7,62,1,6,6.5
10,9,big,3,63,2,1,0.5
10,9,biological,10,64,2,8,2.5
10,9,biology,7,65,6,1,0.75
10,9,blanket,7,66,1,6,6.25
10,9,bleed,5,67,2,3,1.25
10,9,blend,5,68,3,2,1
10,9,blessing,8,69,3,5,1.75
10,9,blood,5,70,2,3,5.75
10,9,bonus,5,71,1,4,1.25
10,9,brick,5,72,1,4,1.25
10,9,brilliant,9,73,3,6,7
10,9,broadcast,9,74,2,7,2.25
10,9,buck,4,75,1,3,1
10,9,building,8,76,2,6,6.5
10,9,bulk,4,77,2,2,0.75
10,9,burial,6,78,2,4,1.25
10,9,burst,5,79,3,2,3
10,9,bury,4,80,3,1,3
10,9,busy,4,81,2,2,0.75
10,9,but,3,82,2,1,0.5
10,9,capture,7,83,0,7,2
10,9,carriage,8,84,2,6,6.75
10,9,carrot,6,85,4,2,1
10,9,cat,3,86,2,1,0.5
10,9,catch,5,87,3,2,1
10,9,cattle,6,88,3,3,1.5
10,9,cause,5,89,2,3,6.25
10,9,caution,7,90,3,4,1.75
10,9,cautious,8,91,6,2,1.25
10,9,cent,4,92,1,3,1.5
10,9,chef,4,93,1,3,6.25
10,9,cigarette,9,94,1,8,2.5
10,9,class,5,95,1,4,1.25
10,9,climb,5,96,2,3,6
10,9,cling,5,97,3,2,1
10,9,clinic,6,98,4,2,1.75
10,9,clock,5,99,2,3,2.25
10,9,cloth,5,100,3,2,1.75
10,9,clue,4,101,2,2,1.75
10,9,coast,5,102,1,4,9.75
10,9,cocktail,8,103,2,6,4
10,9,cognitive,9,104,2,7,12
10,9,collapse,8,105,2,6,4
10,9,college,7,106,4,3,2.5
10,9,collision,9,107,4,5,11.25
10,9,colour,6,108,3,3,2.5
10,9,coloured,8,109,6,2,2
10,9,combine,7,110,2,5,3.5
10,9,comic,5,111,3,2,9
10,9,commentary,10,112,3,7,4.75
10,9,commerce,8,113,5,3,2.75
10,9,commitment,10,114,4,6,11.75
10,9,common,6,115,4,2,2
10,9,compare,7,116,3,4,3
10,9,compelling,10,117,4,6,12.5
10,9,complain,8,118,4,4,3.25
10,9,compliance,10,119,5,5,4.25
10,9,conception,10,120,2,8,15
10,9,concerned,9,121,5,4,3.75
10,9,concession,10,122,5,5,14
10,9,concrete,8,123,4,4,3.5
10,9,confident,9,124,3,6,4.5
10,9,confirm,7,125,5,2,10.5
10,9,confuse,7,126,4,3,2.75
10,9,confusion,9,127,6,3,3
10,9,consensus,9,128,3,6,4.25
10,9,consistent,10,129,4,6,12
10,9,construct,9,130,4,5,3.75
10,9,contest,7,131,3,4,10.25
10,9,context,7,132,5,2,2.25
10,9,continue,8,133,4,4,3.25
10,9,convict,7,134,3,4,3
10,9,cooking,7,135,2,5,11.5
10,9,cool,4,136,3,1,1.25
10,9,cop,3,137,2,1,1
10,9,copy,4,138,3,1,1
10,9,correlate,9,139,2,7,4.5
10,9,correspond,10,140,5,5,12
10,9,cotton,6,141,2,4,3.25
10,9,council,7,142,2,5,3.75
10,9,cow,3,143,2,1,14.25
10,9,crack,5,144,1,4,2.75
10,9,crazy,5,145,3,2,2.25
10,9,cream,5,146,2,3,2.75
10,9,creative,8,147,4,4,12.25
10,9,creator,7,148,5,2,2.75
10,9,critical,8,149,2,6,4.5
10,9,critique,8,150,5,3,3.25
10,9,curiosity,9,151,1,8,13.25
10,9,custom,6,152,2,4,3
10,9,cutting,7,153,2,5,11.25
10,9,dancer,6,154,0,6,4
10,9,date,4,155,2,2,1.75
10,9,daughter,8,156,2,6,11.5
10,9,deadline,8,157,1,7,4.5
10,9,deadly,6,158,5,1,1.25
10,9,debate,6,159,2,4,10.25
10,9,decision,8,160,2,6,4
10,9,deck,4,161,3,1,1.25
10,9,dedication,10,162,2,8,13.25
10,9,defend,6,163,2,4,3
10,9,delegation,10,164,2,8,5.5
10,9,delivery,8,165,3,5,11
10,9,depart,6,166,2,4,2.75
10,9,depict,6,167,3,3,2.25
10,9,derive,6,168,2,4,10.25
10,9,descent,7,169,2,5,3.5
10,9,desire,6,170,3,3,2.5
10,9,detail,6,171,2,4,10.25
10,9,determined,10,172,3,7,5
10,9,devise,6,173,2,4,2.75
10,9,dialogue,8,174,1,7,12.25
10,9,diary,5,175,3,2,2
10,9,die,3,176,2,1,1
10,9,dilemma,7,177,2,5,3.75
10,9,directory,9,178,2,7,12
10,9,disagree,8,179,2,6,4
10,9,disease,7,180,3,4,10.5
10,9,disrupt,7,181,3,4,3
10,9,distance,8,182,3,5,3.5
10,9,diversity,9,183,2,7,12.25
10,9,doctrine,8,184,1,7,4.5
10,9,dominance,9,185,2,7,12.5
10,9,dominate,8,186,6,2,2
10,9,donate,6,187,2,4,3
10,9,donor,5,188,3,2,9.5
10,9,door,4,189,2,2,1.5
10,9,dose,4,190,2,2,1.5
10,9,dozen,5,191,2,3,2.25
10,9,drag,4,192,1,3,2
10,9,drain,5,193,3,2,1.75
10,9,dramatic,8,194,3,5,11.25
10,9,draw,4,195,3,1,1
10,9,drive,5,196,2,3,2.25
10,9,driver,6,197,5,1,1
10,9,drum,4,198,2,2,1.5
10,9,dry,3,199,2,1,0.75
10,9,due,3,200,1,2,9
10,9,dull,4,201,2,2,1.75
10,9,during,6,202,2,4,2.75
10,9,early,5,203,0,5,3.25
10,9,easily,6,204,2,4,10.5
10,9,east,4,205,3,1,1.5
10,9,easy,4,206,3,1,1.25
10,9,ecological,10,207,1,9,17
10,9,economics,9,208,3,6,4.75
10,9,economy,7,209,6,1,2.25
10,9,edge,4,210,1,3,2.25
10,9,editorial,9,211,2,7,14.75
10,9,education,9,212,2,7,5
10,9,efficiency,10,213,1,9,15
10,9,eighteen,8,214,1,7,12.25
10,9,electoral,9,215,1,8,5.75
10,9,electric,8,216,5,3,2.5
10,9,else,4,217,2,2,1.75
10,9,emerge,6,218,1,5,11
10,9,emphasize,9,219,2,7,4.75
10,9,empire,6,220,3,3,10.25
10,9,empty,5,221,3,2,2
10,9,encourage,9,222,1,8,5.25
10,9,endorse,7,223,2,5,11.5
10,9,energy,6,224,2,4,3
10,9,enforce,7,225,2,5,3.25
10,9,enhance,7,226,2,5,11.25
10,9,enough,6,227,2,4,2.75
10,9,ensue,5,228,2,3,2.25
10,9,entity,6,229,2,4,10.75
10,9,equal,5,230,1,4,2.75
10,9,equip,5,231,3,2,1.75
10,9,error,5,232,1,4,2.75
10,9,erupt,5,233,2,3,9.25
10,9,escalate,8,234,1,7,2.5
10,9,escape,6,235,4,2,1
10,9,eternal,7,236,1,6,7
10,9,ethical,7,237,2,5,1.75
10,9,every,5,238,1,4,1.25
10,9,everybody,9,239,5,4,6.5
10,9,everyday,8,240,5,3,1.5
10,9,everywhere,10,241,5,5,1.75
10,9,exaggerate,10,242,1,9,8
10,9,example,7,243,3,4,1.5
10,9,except,6,244,2,4,1.5
10,9,excess,6,245,4,2,6.25
10,9,excitement,10,246,3,7,2.5
10,9,exclude,7,247,3,4,1.5
10,9,exert,5,248,2,3,11.75
10,9,expect,6,249,2,4,379
10,9,explosion,9,250,3,6,3.5
10,9,export,6,251,3,3,2
10,9,exposure,8,252,4,4,9.25
10,9,extra,5,253,2,3,2.5
10,9,extremely,9,254,4,5,4.25
10,9,fabulous,8,255,0,8,9.75
10,9,facility,8,256,2,6,3
10,9,fact,4,257,3,1,1
10,9,faction,7,258,4,3,7.25
10,9,factory,7,259,4,3,3.25
10,9,fame,4,260,2,2,2
10,9,familiar,8,261,3,5,4
10,9,fan,3,262,2,1,1.25
10,9,favourable,10,263,2,8,12.5
10,9,feature,7,264,1,6,3.75
10,9,feed,4,265,2,2,11.25
10,9,feel,4,266,3,1,1.75
10,9,feeling,7,267,4,3,3.75
10,9,fence,5,268,2,3,2.75
10,9,festival,8,269,2,6,20
10,9,figure,6,270,1,5,4
10,9,fill,4,271,2,2,2
10,9,film,4,272,3,1,1.75
10,9,final,5,273,2,3,2.75
10,9,firework,8,274,2,6,17.25
10,9,fish,4,275,2,2,1.75
10,9,flame,5,276,1,4,2.75
10,9,flaw,4,277,3,1,1.25
10,9,fleet,5,278,2,3,7.75
10,9,flood,5,279,2,3,2.25
10,9,fluid,5,280,2,3,2.25
10,9,fold,4,281,1,3,2
10,9,follow,6,282,3,3,8.25
10,9,following,9,283,6,3,3
10,9,fond,4,284,2,2,1.75
10,9,forecast,8,285,2,6,4.25
10,9,forever,7,286,4,3,8.5
10,9,forge,5,287,3,2,1.75
10,9,forgive,7,288,4,3,2.75
10,9,fork,4,289,3,1,1
10,9,formal,6,290,3,3,2.5
10,9,format,6,291,5,1,1.25
10,9,formulate,9,292,4,5,9.75
10,9,fossil,6,293,2,4,3
10,9,freely,6,294,1,5,3.25
10,9,fruit,5,295,2,3,8.5
10,9,function,8,296,1,7,7
10,9,funny,5,297,3,2,2
10,9,gang,4,298,0,4,10
10,9,gathering,9,299,2,7,5
10,9,generic,7,300,1,6,10.5
10,9,generous,8,301,5,3,3
10,9,gentleman,9,302,3,6,4.75
10,9,get,3,303,2,1,1
10,9,ghost,5,304,1,4,9
10,9,glad,4,305,1,3,2
10,9,golden,6,306,1,5,3.25
10,9,gorgeous,8,307,2,6,10.5
10,9,governance,10,308,2,8,5.5
10,9,government,10,309,6,4,9.75
10,9,gradually,9,310,1,8,5
10,9,graduate,8,311,6,2,2.25
10,9,grand,5,312,3,2,2.25
10,9,grant,5,313,4,1,1.5
10,9,grass,5,314,3,2,8
10,9,great,5,315,2,3,2.25
10,9,greenhouse,10,316,3,7,5
10,9,guideline,9,317,1,8,11.25
10,9,hand,4,318,0,4,2.75
10,9,happy,5,319,2,3,2.5
10,9,hardly,6,320,2,4,9
10,9,hardware,8,321,4,4,3.25
10,9,harmful,7,322,3,4,3
10,9,harmony,7,323,4,3,8.5
10,9,he,2,324,1,1,1
10,9,hear,4,325,2,2,2
10,9,hearing,7,326,4,3,2.5
10,9,help,4,327,2,2,1.75
10,9,helpful,7,328,4,3,2.5
10,9,hidden,6,329,1,5,9
10,9,hide,4,330,3,1,1.25
10,9,hobby,5,331,1,4,2.75
10,9,holy,4,332,2,2,1.75
10,9,homeless,8,333,2,6,9.75
10,9,homework,8,334,4,4,3.5
10,9,honour,6,335,2,4,3
10,9,hope,4,336,2,2,7.5
10,9,host,4,337,2,2,1.75
10,9,hostility,9,338,4,5,3.75
10,9,house,5,339,2,3,2.25
10,9,hungry,6,340,1,5,8.75
10,9,husband,7,341,2,5,3.5
10,9,if,2,342,0,2,1.5
10,9,immense,7,343,1,6,9.5
10,9,impress,7,344,2,5,3.75
10,9,inadequate,10,345,1,9,11.5
10,9,incentive,9,346,2,7,5
10,9,incidence,9,347,3,6,10
10,9,increase,8,348,3,5,3.5
10,9,indigenous,10,349,2,8,10.75
10,9,industrial,10,350,3,7,4.75
10,9,infect,6,351,2,4,2.75
10,9,inhabitant,10,352,2,8,11
10,9,injured,7,353,2,5,3.5
10,9,inmate,6,354,2,4,8.25
10,9,innocent,8,355,2,6,4
10,9,innovative,10,356,4,6,10
10,9,insider,7,357,2,5,3.75
10,9,inspire,7,358,3,4,3.25
10,9,intention,9,359,2,7,10.5
10,9,interact,8,360,4,4,3.25
10,9,interface,9,361,5,4,3.5
10,9,interrupt,9,362,5,4,9.5
10,9,interview,9,363,5,4,3.5
10,9,introduce,9,364,3,6,4.25
10,9,invent,6,365,2,4,8.5
10,9,invisible,9,366,3,6,4.25
10,9,invitation,10,367,4,6,4.5
10,9,ironically,10,368,1,9,11.5
10,9,jeans,5,369,0,5,9.25
10,9,join,4,370,1,3,2.25
10,9,joint,5,371,4,1,1
10,9,justice,7,372,1,6,4
10,9,kill,4,373,0,4,8.5
10,9,kind,4,374,2,2,1.75
10,9,ladder,6,375,0,6,3.75
10,9,lady,4,376,3,1,1.25
10,9,landlord,8,377,2,6,9.75
10,9,late,4,378,2,2,1.75
10,9,lawsuit,7,379,2,5,3.5
10,9,layout,6,380,2,4,8.5
10,9,lead,4,381,1,3,2.25
10,9,learn,5,382,3,2,2
10,9,leave,5,383,3,2,2
10,9,legacy,6,384,2,4,3
10,9,leisure,7,385,2,5,9.25
10,9,lend,4,386,2,2,1.75
10,9,length,6,387,3,3,2.25
10,9,lesson,6,388,2,4,2.75
10,9,let,3,389,2,1,1
10,9,level,5,390,2,3,8.25
10,9,liberation,10,391,1,9,5.75
10,9,likewise,8,392,2,6,10
10,9,limit,5,393,2,3,2.25
10,9,linger,6,394,2,4,2.75
10,9,loan,4,395,1,3,7.75
10,9,lobby,5,396,2,3,2.5
10,9,lord,4,397,2,2,1.75
10,9,lose,4,398,2,2,1.5
10,9,loss,4,399,3,1,1.25
10,9,luck,4,400,1,3,2
10,9,magical,7,401,0,7,10.25
10,9,magnitude,9,402,3,6,4.25
10,9,major,5,403,2,3,11.25
10,9,mall,4,404,2,2,1.75
10,9,management,10,405,2,8,5.25
10,9,marginal,8,406,2,6,10.75
10,9,marker,6,407,3,3,2.75
10,9,marketing,9,408,5,4,3.75
10,9,marriage,8,409,3,5,9.75
10,9,marry,5,410,4,1,1.5
10,9,matching,8,411,2,6,4.25
10,9,mayor,5,412,2,3,2.25
10,9,me,2,413,1,1,0.75
10,9,meaning,7,414,2,5,9.5
10,9,means,5,415,4,1,1.5
10,9,mechanism,9,416,2,7,5.25
10,9,meet,4,417,2,2,7.5
10,9,membership,10,418,2,8,5
10,9,menu,4,419,2,2,1
10,9,metaphor,8,420,2,6,5.75
10,9,migration,9,421,1,8,2.5
10,9,mile,4,422,2,2,1
10,9,militant,8,423,3,5,5.75
10,9,milk,4,424,3,1,0.5
10,9,mill,4,425,3,1,0.5
10,9,miner,5,426,2,3,1
10,9,minority,8,427,3,5,5.25
10,9,minute,6,428,3,3,1
10,9,missile,7,429,2,5,1.5
10,9,mistake,7,430,3,4,5
10,9,mobile,6,431,1,5,1.5
10,9,mode,4,432,2,2,0.75
10,9,modern,6,433,4,2,0.75
10,9,modest,6,434,4,2,0.75
10,9,moral,5,435,2,3,4.5
10,9,morality,8,436,5,3,1.25
10,9,motivation,10,437,2,8,2.25
10,9,motive,6,438,5,1,0.75
10,9,motor,5,439,3,2,4.5
10,9,motorist,8,440,5,3,1.25
10,9,mount,5,441,2,3,1
10,9,movement,8,442,2,6,5.5
10,9,multiply,8,443,1,7,2
10,9,native,6,444,0,6,1.75
10,9,naturally,9,445,3,6,5.5
10,9,naval,5,446,2,3,1
10,9,necessity,9,447,1,8,6
10,9,nerve,5,448,2,3,1
10,9,news,4,449,2,2,0.75
10,9,next,4,450,2,2,0.75
10,9,nineteen,8,451,1,7,5.75
10,9,ninety,6,452,5,1,0.75
10,9,noble,5,453,1,4,1.25
10,9,nod,3,454,2,1,0.5
10,9,nose,4,455,2,2,0.75
10,9,notable,7,456,2,5,5.25
10,9,notably,7,457,6,1,1
10,9,nowadays,8,458,2,6,2
10,9,number,6,459,1,5,5.25
10,9,nurse,5,460,2,3,1
10,9,nutrition,9,461,2,7,2
10,9,obey,4,462,0,4,5
10,9,object,6,463,2,4,1.25
10,9,observer,8,464,2,6,1.75
10,9,obsession,9,465,4,5,5.75
10,9,obtain,6,466,2,4,1.25
10,9,occasion,8,467,1,7,5.75
10,9,occasional,10,468,8,2,1.25
10,9,occur,5,469,3,2,0.75
10,9,occurrence,10,470,5,5,1.5
10,9,offender,8,471,1,7,5.75
10,9,offer,5,472,4,1,0.75
10,9,ongoing,7,473,1,6,1.75
10,9,optimism,8,474,1,7,6
10,9,or,2,475,1,1,0.5
10,9,oral,4,476,2,2,0.75
10,9,orange,6,477,3,3,1
10,9,orchestra,9,478,2,7,6
10,9,oven,4,479,1,3,1
10,9,over,4,480,3,1,0.5
10,9,overly,6,481,4,2,0.75
10,9,overnight,9,482,4,5,5.25
10,9,pair,4,483,0,4,1
10,9,pan,3,484,2,1,0.5
10,9,paper,5,485,2,3,1
10,9,parental,8,486,2,6,5.5
10,9,parish,6,487,3,3,1.25
10,9,pass,4,488,2,2,0.75
10,9,passage,7,489,4,3,1.25
10,9,passion,7,490,4,3,1
10,9,pathway,7,491,2,5,5.75
10,9,payment,7,492,2,5,1.5
10,9,pension,7,493,1,6,5.5
10,9,people,6,494,2,4,1.25
10,9,percentage,10,495,2,8,6
10,9,permanent,9,496,3,6,2
10,9,photograph,10,497,1,9,6.5
10,9,pilot,5,498,1,4,1.25
10,9,placement,9,499,1,8,6.25
10,9,player,6,500,3,3,1.5
10,9,pleasure,8,501,2,6,2
10,9,plug,4,502,2,2,0.75
10,9,plunge,6,503,3,3,5
10,9,poisonous,9,504,1,8,2.25
10,9,politics,8,505,2,6,5.75
10,9,pop,3,506,2,1,0.5
10,9,port,4,507,2,2,0.75
10,9,portray,7,508,4,3,1
10,9,pose,4,509,2,2,0.75
10,9,positive,8,510,3,5,5.5
10,9,potential,9,511,2,7,2
10,9,poverty,7,512,2,5,1.5
10,9,powder,6,513,2,4,5.25
10,9,prefer,6,514,1,5,1.5
10,9,premium,7,515,3,4,1.5
10,9,previous,8,516,3,5,5.75
10,9,price,5,517,2,3,1
10,9,priest,6,518,3,3,1.25
10,9,primarily,9,519,3,6,8
10,9,prince,6,520,3,3,2.5
10,9,princess,8,521,6,2,2
10,9,proceed,7,522,2,5,3.5
10,9,profession,10,523,3,7,11
10,9,profitable,10,524,4,6,4.5
10,9,promote,7,525,3,4,9.5
10,9,pronounce,9,526,3,6,4.25
10,9,protection,10,527,3,7,11.75
10,9,protocol,8,528,4,4,3.25
10,9,provide,7,529,3,4,3
10,9,province,8,530,5,3,2.5
10,9,provision,9,531,5,4,10
10,9,provoke,7,532,4,3,2.5
10,9,psychology,10,533,1,9,12.25
10,9,pub,3,534,1,2,1.5
10,9,publishing,10,535,3,7,4.75
10,9,purple,6,536,2,4,9.75
10,9,pursue,6,537,3,3,2.5
10,9,qualify,7,538,0,7,4.5
10,9,queue,5,539,2,3,8.75
10,9,quietly,7,540,2,5,3.5
10,9,rain,4,541,0,4,2.75
10,9,range,5,542,2,3,2.25
10,9,rare,4,543,2,2,7.75
10,9,raw,3,544,2,1,1
10,9,reader,6,545,1,5,3.5
10,9,readily,7,546,4,3,2.5
10,9,reading,7,547,5,2,2.25
10,9,realize,7,548,3,4,9.5
10,9,really,6,549,4,2,2
10,9,receiver,8,550,2,6,4
10,9,recession,9,551,4,5,10.25
10,9,recipe,6,552,3,3,2.5
10,9,recipient,9,553,5,4,3.25
10,9,recovery,8,554,3,5,10
10,9,red,3,555,2,1,1
10,9,refuge,6,556,2,4,2.75
10,9,refugee,7,557,6,1,1.25
10,9,regret,6,558,2,4,2.75
10,9,regularly,9,559,3,6,10.5
10,9,regulator,9,560,6,3,3
10,9,relatively,10,561,2,8,12
10,9,relaxing,8,562,4,4,3.25
10,9,release,7,563,3,4,3
10,9,reliable,8,564,3,5,10
10,9,remarkable,10,565,2,8,5.75
10,9,remember,8,566,3,5,10.25
10,9,reminder,8,567,3,5,3.75
10,9,repeated,8,568,2,6,4
10,9,reporter,8,569,3,5,9.75
10,9,reproduce,9,570,3,6,4.25
10,9,respect,7,571,2,5,9.75
10,9,response,8,572,4,4,3.25
10,9,result,6,573,3,3,2.5
10,9,resume,6,574,4,2,2
10,9,retreat,7,575,2,5,10.5
10,9,rhythm,6,576,1,5,3.25
10,9,ridiculous,10,577,1,9,12.25
10,9,riot,4,578,2,2,1.75
10,9,rock,4,579,1,3,2
10,9,role,4,580,2,2,1.75
10,9,royal,5,581,2,3,2.25
10,9,rugby,5,582,1,4,9.25
10,9,rule,4,583,2,2,1.75
10,9,run,3,584,2,1,1
10,9,runner,6,585,3,3,2.25
10,9,sail,4,586,0,4,2.75
10,9,saint,5,587,3,2,8.5
10,9,scale,5,588,1,4,2.75
10,9,scope,5,589,2,3,2.5
10,9,scratch,7,590,2,5,3.5
10,9,script,6,591,3,3,9.5
10,9,sculpture,9,592,2,7,5.25
10,9,see,3,593,1,2,1.5
10,9,seize,5,594,2,3,8.75
10,9,seldom,6,595,2,4,3
10,9,sensation,9,596,2,7,4.75
10,9,set,3,597,2,1,1
10,9,seventy,7,598,2,5,10
10,9,several,7,599,4,3,2.75
10,9,shade,5,600,1,4,2.75
10,9,shadow,6,601,4,2,8.25
10,9,shock,5,602,2,3,2.25
10,9,shop,4,603,3,1,1.25
10,9,should,6,604,3,3,2.75
10,9,shout,5,605,4,1,1.5
10,9,shrug,5,606,2,3,2.25
10,9,sigh,4,607,1,3,9.25
10,9,silence,7,608,2,5,3.5
10,9,silent,6,609,5,1,1.5
10,9,silly,5,610,3,2,1.75
10,9,similarity,10,611,2,8,12.5
10,9,simulate,8,612,3,5,3.75
10,9,sincere,7,613,2,5,10
10,9,sing,4,614,3,1,1.25
10,9,situation,9,615,2,7,4.75
10,9,sixty,5,616,2,3,2.25
10,9,skill,5,617,1,4,9.25
10,9,sleep,5,618,1,4,2.75
10,9,slot,4,619,2,2,1.75
10,9,slow,4,620,3,1,1.25
10,9,smart,5,621,1,4,2.75
10,9,smash,5,622,3,2,8.75
10,9,soar,4,623,1,3,2.25
10,9,soccer,6,624,2,4,2
10,9,soldier,7,625,2,5,6.25
10,9,solely,6,626,3,3,1.25
10,9,somewhere,9,627,2,7,2.25
10,9,son,3,628,2,1,0.5
10,9,sorry,5,629,2,3,5.25
10,9,source,6,630,2,4,1.25
10,9,span,4,631,1,3,1
10,9,speculate,9,632,2,7,6.25
10,9,spending,8,633,3,5,1.75
10,9,spite,5,634,2,3,1
10,9,split,5,635,2,3,1
10,9,spoil,5,636,2,3,5.25
10,9,spot,4,637,3,1,0.75
10,9,squeeze,7,638,1,6,1.75
10,9,stadium,7,639,1,6,6
10,9,stage,5,640,3,2,1
10,9,station,7,641,3,4,1.5
10,9,steel,5,642,2,3,1
10,9,steep,5,643,4,1,0.5
10,9,stress,6,644,2,4,5.5
10,9,structure,9,645,3,6,2.25
10,9,struggle,8,646,4,4,1.75
10,9,stupid,6,647,2,4,5.75
10,9,style,5,648,2,3,1.25
10,9,suddenly,8,649,1,7,2.25
10,9,suffering,9,650,2,7,6.5
10,9,suicide,7,651,2,5,1.75
10,9,summer,6,652,2,4,5.5
10,9,summit,6,653,4,2,1
10,9,superior,8,654,2,6,1.75
10,9,supervisor,10,655,5,5,6
10,9,supplement,10,656,3,7,2.5
10,9,supporter,9,657,4,5,1.75
10,9,suppress,8,658,4,4,6
10,9,surface,7,659,2,5,1.5
10,9,surprised,9,660,3,6,6
10,9,surprising,10,661,7,3,1.75
10,9,suspicious,10,662,2,8,2.5
10,9,sweet,5,663,1,4,5.5
10,9,swimming,8,664,2,6,2
10,9,t,1,665,0,1,0.25
10,9,teach,5,666,1,4,1.25
10,9,technical,9,667,2,7,6.25
10,9,technique,9,668,6,3,1.25
10,9,teenager,8,669,2,6,6
10,9,tell,4,670,2,2,0.75
10,9,tennis,6,671,2,4,1.25
10,9,terminal,8,672,2,6,6
10,9,terrible,8,673,3,5,1.75
10,9,testify,7,674,2,5,1.5
10,9,testing,7,675,5,2,1
10,9,their,5,676,1,4,5.5
10,9,theirs,6,677,5,1,0.5
10,9,theology,8,678,3,5,1.75
10,9,there,5,679,3,2,0.75
10,9,therefore,9,680,5,4,5.75
10,9,thick,5,681,2,3,1
10,9,thief,5,682,3,2,0.75
10,9,thinking,8,683,3,5,1.75
10,9,thrive,6,684,2,4,6
10,9,throat,6,685,3,3,1.25
10,9,tiny,4,686,1,3,1
10,9,tomato,6,687,1,5,6
10,9,ton,3,688,2,1,0.75
10,9,tone,4,689,3,1,0.5
10,9,tourist,7,690,2,5,1.5
10,9,towards,7,691,2,5,1.5
10,9,toy,3,692,2,1,4.75
10,9,trace,5,693,1,4,1.25
10,9,trading,7,694,3,4,1.5
10,9,tradition,9,695,5,4,1.75
10,9,training,8,696,3,5,6
10,9,transfer,8,697,3,5,1.5
10,9,transform,9,698,6,3,1.25
10,9,transition,10,699,5,5,6.25
10,9,tribunal,8,700,2,6,2
10,9,trillion,8,701,3,5,6
10,9,truly,5,702,2,3,1.25
10,9,trust,5,703,3,2,1
10,9,trustee,7,704,5,2,1
10,9,truth,5,705,3,2,0.75
10,9,try,3,706,2,1,0.5
10,9,tuesday,7,707,1,6,6.25
10,9,tuition,7,708,2,5,1.75
10,9,turn,4,709,2,2,0.75
10,9,turnout,7,710,4,3,1
10,9,turnover,8,711,5,3,5.75
10,9,ugly,4,712,0,4,1.25
10,9,ultimately,10,713,1,9,7.5
10,9,umbrella,8,714,1,7,2
10,9,unlikely,8,715,1,7,6.25
10,9,up,2,716,1,1,0.5
10,9,upset,5,717,2,3,1
10,9,user,4,718,1,3,0.75
10,9,utterly,7,719,1,6,6
10,9,variation,9,720,0,9,2.5
10,9,versus,6,721,1,5,6.25
10,9,vicious,7,722,1,6,1.75
10,9,victim,6,723,3,3,1.25
10,9,village,7,724,2,5,6
10,9,volume,6,725,1,5,1.5
10,9,voluntary,9,726,4,5,1.75
10,9,wage,4,727,0,4,5.75
10,9,warehouse,9,728,2,7,2.25
10,9,warfare,7,729,3,4,6
10,9,warm,4,730,3,1,0.5
10,9,wash,4,731,2,2,0.75
10,9,we,2,732,1,1,0.25
10,9,weak,4,733,2,2,0.75
10,9,wedding,7,734,2,5,1.5
10,9,weekly,6,735,2,4,6
10,9,wet,3,736,2,1,0.5
10,9,when,4,737,1,3,1
10,9,where,5,738,3,2,0.75
10,9,whilst,6,739,2,4,1.25
10,9,who,3,740,2,1,4.75
10,9,wholly,6,741,3,3,1.25
10,9,wish,4,742,1,3,1
10,9,wooden,6,743,1,5,1.5
10,9,workout,7,744,2,5,6.25
10,9,worldwide,9,745,3,6,2.25
10,9,worm,4,746,3,1,0.75
10,9,worst,5,747,3,2,0.75
10,9,wound,5,748,2,3,5.5
10,9,writing,7,749,1,6,1.75
10,9,wrong,5,750,2,3,1
10,9,yell,4,751,0,4,5.5
10,9,yesterday,9,752,2,7,2.25
10,9,zone,4,753,0,4,1.25
11,0,able,4,0,0,4,1.25
11,0,abolish,7,1,2,5,1.75
11,0,abortion,8,2,3,5,6
11,0,about,5,3,3,2,0.75
11,0,above,5,4,3,2,0.75
11,0,abstract,8,5,2,6,1.75
11,0,academy,7,6,1,6,6.25
11,0,acceptance,10,7,2,8,6.75
11,0,access,6,8,4,2,1.25
11,0,accessible,10,9,6,4,1.75
11,0,according,9,10,3,6,2
11,0,action,6,11,2,4,5.75
11,0,addition,8,12,1,7,2
11,0,adhere,6,13,2,4,6.25
11,0,affair,6,14,1,5,1.75
11,0,afford,6,15,3,3,1.25
11,0,afraid,6,16,2,4,1.5
11,0,aged,4,17,1,3,5.25
11,0,agent,5,18,3,2,1
11,0,ah,2,19,1,1,0.5
11,0,aid,3,20,1,2,0.75
11,0,air,3,21,2,1,0.5
11,0,aircraft,8,22,3,5,1.75
11,0,alien,5,23,1,4,5.5
11,0,alike,5,24,3,2,1
11,0,allege,6,25,2,4,1.25
11,0,alliance,8,26,3,5,6
11,0,allow,5,27,3,2,1
11,0,although,8,28,2,6,2
11,0,amid,4,29,1,3,1
11,0,answer,6,30,1,5,6
11,0,anyone,6,31,2,4,1.5
11,0,apart,5,32,1,4,1.25
11,0,appearance,10,33,2,8,7.25
11,0,apple,5,34,3,2,1
11,0,appointment,11,35,3,8,7.5
11,0,appropriate,11,36,3,8,2.5
11,0,arbitrary,9,37,1,8,7
11,0,arena,5,38,2,3,1
11,0,assess,6,39,1,5,1.5
11,0,assign,6,40,3,3,10.5
11,0,association,11,41,3,8,89
11,0,attack,6,42,1,5,5
11,0,attend,6,43,3,3,13
11,0,attendance,10,44,6,4,8
11,0,attribute,9,45,3,6,5.25
11,0,audience,8,46,1,7,14.75
11,0,audit,5,47,4,1,1.75
11,0,authority,9,48,2,7,7.75
11,0,autumn,6,49,3,3,12.75
11,0,avoid,5,50,1,4,3.5
11,0,aware,5,51,1,4,3.5
11,0,away,4,52,3,1,1.5
11,0,awkward,7,53,2,5,12.75
11,0,back,4,54,0,4,3.5
11,0,backwards,9,55,4,5,4.5
11,0,bad,3,56,2,1,1.75
11,0,bare,4,57,2,2,10.75
11,0,barrier,7,58,3,4,4
11,0,basis,5,59,2,3,3.25
11,0,basketball,10,60,3,7,22.5
11,0,bean,4,61,1,3,3
11,0,bear,4,62,3,1,1.5
11,0,because,7,63,2,5,4.5
11,0,become,6,64,3,3,18.25
11,0,being,5,65,2,3,3
11,0,bet,3,66,2,1,1.25
11,0,bias,4,67,1,3,2.75
11,0,bicycle,7,68,2,5,4.25
11,0,biological,10,69,2,8,13.5
11,0,biology,7,70,6,1,1.75
11,0,blanket,7,71,1,6,8.75
11,0,blast,5,72,3,2,2
11,0,bleed,5,73,2,3,2.25
11,0,blessing,8,74,3,5,3.75
11,0,blood,5,75,2,3,7.25
11,0,bond,4,76,1,3,2.25
11,0,boring,6,77,2,4,3
11,0,born,4,78,3,1,1.5
11,0,bounce,6,79,2,4,3
11,0,brain,5,80,1,4,7.75
11,0,brilliant,9,81,2,7,4.75
11,0,broad,5,82,2,3,2.25
11,0,broadband,9,83,5,4,8.75
11,0,broadcast,9,84,5,4,3.5
11,0,brother,7,85,3,4,4.25
11,0,buck,4,86,1,3,7.5
11,0,building,8,87,2,6,4.25
11,0,bulk,4,88,2,2,1.75
11,0,burial,6,89,2,4,3
11,0,bus,3,90,2,1,6.5
11,0,but,3,91,2,1,1.25
11,0,cabinet,7,92,0,7,4.5
11,0,capitalism,10,93,2,8,11
11,0,captain,7,94,3,4,3.25
11,0,carriage,8,95,2,6,4.25
11,0,case,4,96,2,2,7
11,0,castle,6,97,3,3,2.5
11,0,cautious,8,98,2,6,4
11,0,centre,6,99,1,5,8.25
11,0,champion,8,100,1,7,4.5
11,0,charge,6,101,3,3,2.5
11,0,chat,4,102,3,1,6.75
11,0,cigarette,9,103,1,8,5.75
11,0,cinema,6,104,2,4,3.25
11,0,civic,5,105,2,3,7.75
11,0,classic,7,106,1,6,4.25
11,0,classical,9,107,7,2,2
11,0,cleaning,8,108,2,6,9.5
11,0,climate,7,109,2,5,3.5
11,0,cling,5,110,3,2,2
11,0,close,5,111,2,3,2.25
11,0,closure,7,112,4,3,8.5
11,0,cloth,5,113,3,2,2
11,0,clothes,7,114,5,2,2
11,0,coalition,9,115,1,8,12
11,0,coast,5,116,3,2,1.75
11,0,coincidence,11,117,2,9,6
11,0,collapse,8,118,2,6,9.5
11,0,college,7,119,4,3,2.75
11,0,collision,9,120,4,5,3.75
11,0,colour,6,121,3,3,8.25
11,0,columnist,9,122,3,6,4.25
11,0,combat,6,123,2,4,2.75
11,0,combination,11,124,4,7,10.75
11,0,combine,7,125,6,1,1.75
11,0,commander,9,126,3,6,4.25
11,0,commentary,10,127,4,6,10
11,0,commit,6,128,4,2,2
11,0,comparison,10,129,3,7,4.75
11,0,competitive,11,130,4,7,10
11,0,completely,10,131,4,6,4.25
11,0,complex,7,132,6,1,6.5
11,0,comprise,8,133,4,4,3.25
11,0,computer,8,134,4,4,3
11,0,conception,10,135,2,8,10.75
11,0,concerned,9,136,5,4,3.25
11,0,concession,10,137,5,5,4
11,0,conclude,8,138,4,4,8.5
11,0,confirm,7,139,3,4,3
11,0,conflict,8,140,4,4,3.25
11,0,conscience,10,141,3,7,10
11,0,consist,7,142,4,3,2.75
11,0,consistent,10,143,7,3,2.75
11,0,consolidate,11,144,4,7,10.5
11,0,conspiracy,10,145,4,6,4.5
11,0,consume,7,146,4,3,2.5
11,0,consumer,8,147,7,1,1.5
11,0,contact,7,148,3,4,8.5
11,0,container,9,149,5,4,3.25
11,0,contest,7,150,4,3,2.5
11,0,context,7,151,5,2,2.25
11,0,continue,8,152,4,4,8.5
11,0,contractor,10,153,4,6,4.5
11,0,convict,7,154,3,4,3
11,0,conviction,10,155,7,3,8
11,0,correspond,10,156,2,8,5.25
11,0,corrupt,7,157,4,3,8
11,0,costume,7,158,2,5,3.5
11,0,council,7,159,2,5,3.5
11,0,cow,3,160,2,1,1
11,0,crack,5,161,1,4,8
11,0,cream,5,162,2,3,2.25
11,0,creation,8,163,4,4,3.25
11,0,creator,7,164,5,2,2
11,0,critical,8,165,2,6,9.5
11,0,critique,8,166,5,3,2.75
11,0,crop,4,167,2,2,1.75
11,0,crystal,7,168,2,5,8.5
11,0,curiosity,9,169,1,8,5.25
11,0,custody,7,170,2,5,3.5
11,0,customer,8,171,5,3,8
11,0,dad,3,172,0,3,2
11,0,dancer,6,173,2,4,2.75
11,0,dark,4,174,2,2,1.5
11,0,data,4,175,2,2,5.75
11,0,database,8,176,4,4,1.75
11,0,date,4,177,3,1,0.5
11,0,daughter,8,178,2,6,1.75
11,0,deadline,8,179,1,7,5.25
11,0,deadly,6,180,5,1,0.75
11,0,debris,6,181,2,4,1.5
11,0,debut,5,182,3,2,1
11,0,deck,4,183,2,2,3.75
11,0,declaration,11,184,3,8,2.75
11,0,decorate,8,185,3,5,1.75
11,0,dedication,10,186,2,8,6.25
11,0,denial,6,187,2,4,1.5
11,0,depart,6,188,2,4,5.5
11,0,dependence,10,189,3,7,3.5
11,0,dependent,9,190,8,1,1.25
11,0,descend,7,191,2,5,5.75
11,0,descent,7,192,6,1,1
11,0,description,11,193,4,7,2.5
11,0,desperately,11,194,3,8,6
11,0,determined,10,195,2,8,2.5
11,0,development,11,196,2,9,6
11,0,devise,6,197,3,3,1.25
11,0,dictionary,10,198,1,9,307.75
11,0,die,3,199,2,1,0.75
11,0,differently,11,200,2,9,3.25
11,0,dimension,9,201,2,7,7.25
11,0,dip,3,202,2,1,0.75
11,0,discard,7,203,2,5,2
11,0,discharge,9,204,4,5,7
11,0,discourse,9,205,4,5,3
11,0,dispose,7,206,3,4,2.25
11,0,disrupt,7,207,3,4,6.5
11,0,distance,8,208,3,5,2
11,0,distinct,8,209,4,4,1.75
11,0,distinction,11,210,8,3,4.75
11,0,distinctive,11,211,9,2,1.75
11,0,disturb,7,212,4,3,1.25
11,0,diverse,7,213,2,5,1.5
11,0,diversity,9,214,6,3,4.75
11,0,divert,6,215,5,1,0.75
11,0,divorce,7,216,3,4,1.5
11,0,doctrine,8,217,1,7,2
11,0,documentary,11,218,3,8,6
11,0,dominance,9,219,2,7,5.25
11,0,donor,5,220,2,3,1
11,0,door,4,221,2,2,0.75
11,0,dose,4,222,2,2,0.75
11,0,drag,4,223,1,3,1
11,0,draw,4,224,3,1,0.5
11,0,dress,5,225,2,3,4.25
11,0,drive,5,226,2,3,1
11,0,driver,6,227,5,1,0.5
11,0,drown,5,228,2,3,1
11,0,drug,4,229,2,2,0.75
11,0,dry,3,230,2,1,0.25
11,0,due,3,231,1,2,4
11,0,dull,4,232,2,2,0.75
11,0,during,6,233,2,4,1.25
11,0,each,4,234,0,4,1
11,0,early,5,235,2,3,4.5
11,0,easy,4,236,2,2,0.75
11,0,eat,3,237,2,1,0.5
11,0,echo,4,238,1,3,1
11,0,ecological,10,239,2,8,5.75
11,0,edge,4,240,1,3,1
11,0,editorial,9,241,2,7,2
11,0,educated,8,242,2,6,5
11,0,elementary,10,243,1,9,2.5
11,0,elevate,7,244,3,4,4.75
11,0,emerge,6,245,1,5,1.5
11,0,emotionally,11,246,2,9,6
11,0,endorsement,11,247,1,10,2.75
11,0,enforce,7,248,2,5,5.25
11,0,enough,6,249,2,4,1.5
11,0,enquire,7,250,2,5,3.75
11,0,entire,6,251,2,4,8
11,0,entirely,8,252,6,2,2
11,0,epidemic,8,253,1,7,4.5
11,0,equal,5,254,1,4,8.25
11,0,equation,8,255,4,4,3
11,0,erupt,5,256,1,4,2.75
11,0,escalate,8,257,1,7,10
11,0,eternal,7,258,1,6,4
11,0,ethical,7,259,2,5,9.25
11,0,ethnic,6,260,3,3,2.5
11,0,everybody,9,261,1,8,5.25
11,0,everywhere,10,262,5,5,9.25
11,0,evil,4,263,2,2,1.5
11,0,exam,4,264,1,3,2.25
11,0,example,7,265,4,3,2.25
11,0,excess,6,266,2,4,8.5
11,0,excitement,10,267,3,7,4.75
11,0,exclude,7,268,3,4,8.5
11,0,exert,5,269,2,3,2.25
11,0,exotic,6,270,2,4,2.75
11,0,expect,6,271,2,4,2.75
11,0,experience,10,272,4,6,10
11,0,explicit,8,273,3,5,3.75
11,0,explosion,9,274,4,5,11.75
11,0,export,6,275,3,3,2.5
11,0,exposure,8,276,4,4,3.25
11,0,external,8,277,2,6,13.5
11,0,extra,5,278,3,2,1.75
11,0,fabulous,8,279,0,8,5
11,0,fact,4,280,2,2,1.75
11,0,factory,7,281,4,3,8.25
11,0,fairness,8,282,2,6,4.25
11,0,faith,5,283,3,2,2
11,0,familiar,8,284,2,6,9.75
11,0,fan,3,285,2,1,1
11,0,favour,6,286,2,4,2.75
11,0,favourable,10,287,6,4,3
11,0,feather,7,288,1,6,9.5
11,0,feel,4,289,2,2,1.75
11,0,festival,8,290,2,6,4
11,0,fifth,5,291,1,4,8
11,0,figure,6,292,2,4,3
11,0,fill,4,293,2,2,1.75
11,0,film,4,294,3,1,1.25
11,0,find,4,295,2,2,1.75
11,0,fire,4,296,2,2,7.25
11,0,firearm,7,297,4,3,3
11,0,firework,8,298,4,4,3.25
11,0,fit,3,299,2,1,1
11,0,flame,5,300,1,4,2.75
11,0,flawed,6,301,3,3,8.25
11,0,float,5,302,2,3,2.25
11,0,flood,5,303,3,2,1.75
11,0,fold,4,304,1,3,2
11,0,fond,4,305,2,2,1.75
11,0,forecast,8,306,2,6,9.5
11,0,forest,6,307,4,2,2
11,0,forgive,7,308,3,4,3
11,0,frame,5,309,1,4,8.25
11,0,franchise,9,310,3,6,4.25
11,0,frankly,7,311,4,3,2.5
11,0,frightening,11,312,2,9,11.5
11,0,from,4,313,2,2,1.75
11,0,fully,5,314,1,4,3
11,0,fund,4,315,2,2,7.25
11,0,fundraising,11,316,4,7,5.25
11,0,furious,7,317,2,5,3.5
11,0,gang,4,318,0,4,8.25
11,0,generation,10,319,1,9,5.75
11,0,gentleman,9,320,3,6,10
11,0,genuine,7,321,3,4,3
11,0,get,3,322,2,1,1
11,0,ghost,5,323,1,4,2.75
11,0,glad,4,324,1,3,7.75
11,0,goods,5,325,1,4,2.75
11,0,gorgeous,8,326,2,6,4
11,0,gradually,9,327,1,8,11
11,0,graduate,8,328,6,2,2.25
11,0,grand,5,329,3,2,1.75
11,0,grandparent,11,330,5,6,10.5
11,0,grant,5,331,4,1,1.5
11,0,grass,5,332,3,2,1.75
11,0,greatly,7,333,2,5,3.5
11,0,guard,5,334,1,4,8.75
11,0,guideline,9,335,2,7,4.75
11,0,halt,4,336,0,4,2.5
11,0,hand,4,337,2,2,7
11,0,harmony,7,338,2,5,3.5
11,0,healthcare,10,339,1,9,11.25
11,0,hearing,7,340,3,4,3
11,0,heavily,7,341,3,4,3
11,0,hello,5,342,2,3,2.25
11,0,helmet,6,343,3,3,8
11,0,help,4,344,3,1,1.25
11,0,hidden,6,345,1,5,3.25
11,0,hierarchy,9,346,2,7,10.25
11,0,highway,7,347,2,5,3.5
11,0,himself,7,348,2,5,3.5
11,0,historian,9,349,2,7,10.25
11,0,hobby,5,350,1,4,2.75
11,0,hockey,6,351,2,4,8.25
11,0,holy,4,352,2,2,1.5
11,0,homework,8,353,2,6,4
11,0,hope,4,354,2,2,1.5
11,0,hostility,9,355,2,7,10.25
11,0,housing,7,356,2,5,3.75
11,0,hungry,6,357,1,5,9.25
11,0,hurry,5,358,2,3,2.25
11,0,ignore,6,359,0,6,3.75
11,0,illness,7,360,1,6,10.25
11,0,imagine,7,361,1,6,4
11,0,immigrant,9,362,2,7,10.75
11,0,imminent,8,363,4,4,3.5
11,0,impact,6,364,2,4,3.25
11,0,impress,7,365,3,4,3.25
11,0,in,2,366,1,1,6.75
11,0,incentive,9,367,2,7,4.5
11,0,increase,8,368,3,5,3.5
11,0,indeed,6,369,2,4,8.5
11,0,indicator,9,370,3,6,4.25
11,0,indoor,6,371,3,3,2.5
11,0,induce,6,372,3,3,8.75
11,0,infect,6,373,2,4,3
11,0,inflation,9,374,3,6,4.25
11,0,injured,7,375,2,5,9.25
11,0,innovative,10,376,2,8,5.25
11,0,insect,6,377,2,4,8.5
11,0,inspiration,11,378,3,8,5.5
11,0,inspire,7,379,6,1,1.5
11,0,instantly,9,380,3,6,10.25
11,0,institution,11,381,4,7,5.25
11,0,insult,6,382,3,3,2.5
11,0,intensity,9,383,2,7,10.5
11,0,intention,9,384,5,4,3.25
11,0,interested,10,385,4,6,10.25
11,0,interpret,9,386,5,4,3.5
11,0,interview,9,387,5,4,3.5
11,0,introduce,9,388,3,6,10.25
11,0,investigate,11,389,2,9,6
11,0,invisible,9,390,3,6,10.25
11,0,invitation,10,391,4,6,4.5
11,0,involvement,11,392,3,8,11.25
11,0,irrelevant,10,393,1,9,11.5
11,0,jeans,5,394,0,5,3.25
11,0,joint,5,395,1,4,2.75
11,0,july,4,396,1,3,2.25
11,0,kidnap,6,397,0,6,9.25
11,0,killing,7,398,2,5,2.25
11,0,knowledge,9,399,1,8,6.25
11,0,ladder,6,400,0,6,1.75
11,0,landing,7,401,2,5,5.5
11,0,landlord,8,402,4,4,1.5
11,0,lane,4,403,3,1,0.5
11,0,language,8,404,3,5,1.5
11,0,laptop,6,405,2,4,4.75
11,0,layout,6,406,2,4,1.5
11,0,lead,4,407,1,3,1
11,0,leap,4,408,3,1,0.5
11,0,learn,5,409,3,2,0.75
11,0,leave,5,410,3,2,4.5
11,0,legislation,11,411,2,9,2.5
11,0,leisure,7,412,2,5,5.25
11,0,less,4,413,2,2,0.75
11,0,lesson,6,414,4,2,0.75
11,0,level,5,415,2,3,1
11,0,lifetime,8,416,1,7,5.75
11,0,linger,6,417,2,4,1.25
11,0,lively,6,418,2,4,1.25
11,0,loan,4,419,1,3,1
11,0,lock,4,420,2,2,4.5
11,0,logo,4,421,2,2,0.75
11,0,loom,4,422,2,2,0.75
11,0,loop,4,423,3,1,0.5
11,0,lord,4,424,2,2,0.75
11,0,lose,4,425,2,2,0.75
11,0,loss,4,426,3,1,0.5
11,0,lovely,6,427,2,4,5
11,0,lower,5,428,2,3,1
11,0,luck,4,429,1,3,1
11,0,magical,7,430,0,7,6
11,0,magnitude,9,431,3,6,2
11,0,mall,4,432,2,2,0.75
11,0,man,3,433,2,1,0.5
11,0,management,10,434,3,7,5.75
11,0,manifest,8,435,3,5,1.75
11,0,manner,6,436,3,3,1.25
11,0,marathon,8,437,2,6,5.75
11,0,marketing,9,438,3,6,2
11,0,massive,7,439,2,5,5.5
11,0,mate,4,440,2,2,0.75
11,0,maximize,8,441,2,6,1.75
11,0,mayor,5,442,2,3,4.75
11,0,meaning,7,443,1,6,2
11,0,means,5,444,4,1,0.75
11,0,mechanism,9,445,2,7,5.75
11,0,meet,4,446,2,2,0.75
11,0,membership,10,447,2,8,2.25
11,0,migration,9,448,1,8,6.25
11,0,militant,8,449,2,6,2
11,0,military,8,450,6,2,1
11,0,mill,4,451,3,1,4.5
11,0,mine,4,452,2,2,0.75
11,0,miner,5,453,4,1,0.5
11,0,mining,6,454,3,3,1
11,0,minute,6,455,3,3,1
11,0,miracle,7,456,2,5,5.5
11,0,mode,4,457,1,3,1
11,0,modern,6,458,4,2,0.75
11,0,monitor,7,459,2,5,1.5
11,0,motivation,10,460,2,8,6.5
11,0,motive,6,461,5,1,0.75
11,0,motor,5,462,3,2,1
11,0,motorcycle,10,463,5,5,5.5
11,0,motorist,8,464,5,3,1.5
11,0,mount,5,465,2,3,1
11,0,move,4,466,2,2,0.75
11,0,movement,8,467,4,4,1.25
11,0,multiply,8,468,1,7,6.25
11,0,musical,7,469,2,5,1.75
11,0,mysterious,10,470,1,9,6.5
11,0,naturally,9,471,0,9,6.5
11,0,necessity,9,472,1,8,2.25
11,0,neglect,7,473,2,5,5.5
11,0,net,3,474,2,1,0.5
11,0,network,7,475,3,4,1.25
11,0,next,4,476,2,2,0.75
11,0,noble,5,477,1,4,1.25
11,0,noon,4,478,2,2,4.5
11,0,nose,4,479,2,2,0.75
11,0,notable,7,480,2,5,1.5
11,0,notably,7,481,6,1,0.5
11,0,nowadays,8,482,2,6,5.5
11,0,number,6,483,1,5,1.5
11,0,nurse,5,484,2,3,1
11,0,nursing,7,485,4,3,1.25
11,0,object,6,486,0,6,5.5
11,0,observe,7,487,2,5,1.5
11,0,obsession,9,488,4,5,6
11,0,obvious,7,489,2,5,1.75
11,0,occasional,10,490,1,9,6.5
11,0,of,2,491,1,1,0.5
11,0,offender,8,492,2,6,1.75
11,0,on,2,493,1,1,0.25
11,0,ongoing,7,494,2,5,5.25
11,0,operator,8,495,1,7,2
11,0,opposition,10,496,2,8,6.5
11,0,oral,4,497,1,3,1
11,0,orientation,11,498,2,9,6.5
11,0,originally,10,499,3,7,2.25
11,0,pair,4,500,0,4,1.25
11,0,palm,4,501,2,2,4.75
11,0,parent,6,502,2,4,1.25
11,0,parental,8,503,6,2,1
11,0,parish,6,504,3,3,1
11,0,partly,6,505,3,3,1
11,0,partnership,11,506,4,7,6
11,0,pathway,7,507,2,5,1.5
11,0,payment,7,508,2,5,5.5
11,0,peak,4,509,1,3,1
11,0,people,6,510,2,4,1.25
11,0,percentage,10,511,2,8,6.25
11,0,period,6,512,3,3,1.25
11,0,permanent,9,513,3,6,5.75
11,0,permanently,11,514,9,2,2
11,0,person,6,515,3,3,1.25
11,0,petition,8,516,2,6,1.75
11,0,phase,5,517,1,4,5.5
11,0,photograph,10,518,2,8,2.5
11,0,pilot,5,519,1,4,5.25
11,0,pit,3,520,2,1,0.5
11,0,plain,5,521,1,4,1.25
11,0,planet,6,522,3,3,1
11,0,player,6,523,3,3,1
11,0,pleasure,8,524,2,6,5.75
11,0,plunge,6,525,2,4,1.25
11,0,pocket,6,526,1,5,1.5
11,0,policy,6,527,2,4,5.25
11,0,politics,8,528,4,4,1.5
11,0,pool,4,529,2,2,0.75
11,0,portray,7,530,2,5,5.25
11,0,pose,4,531,2,2,0.75
11,0,poverty,7,532,2,5,1.5
11,0,powder,6,533,2,4,1.25
11,0,powerful,8,534,3,5,5.5
11,0,practice,8,535,1,7,2
11,0,pray,4,536,3,1,0.5
11,0,preach,6,537,2,4,5.25
11,0,precede,7,538,3,4,1.5
11,0,precision,9,539,4,5,1.75
11,0,prefer,6,540,3,3,5
11,0,preference,10,541,6,4,2
11,0,premium,7,542,3,4,1.5
11,0,president,9,543,3,6,6
11,0,pretty,6,544,3,3,1.25
11,0,prison,6,545,2,4,1.25
11,0,prisoner,8,546,6,2,0.75
11,0,privilege,9,547,3,6,6
11,0,problematic,11,548,2,9,2.5
11,0,production,10,549,3,7,6.5
11,0,productive,10,550,8,2,1.25
11,0,pronounced,10,551,3,7,6
11,0,prosecutor,10,552,3,7,2.25
11,0,protect,7,553,3,4,1.25
11,0,protection,10,554,7,3,5.5
11,0,provide,7,555,3,4,1.5
11,0,provincial,10,556,5,5,1.75
11,0,pub,3,557,1,2,0.75
11,0,publication,11,558,3,8,6.75
11,0,purely,6,559,2,4,1.25
11,0,purple,6,560,3,3,1.25
11,0,qualify,7,561,0,7,6.25
11,0,quarter,7,562,3,4,1.5
11,0,question,8,563,2,6,6
11,0,quietly,7,564,2,5,1.5
11,0,quote,5,565,2,3,1
11,0,random,6,566,0,6,5.75
11,0,rare,4,567,2,2,0.75
11,0,reader,6,568,1,5,1.5
11,0,real,4,569,3,1,0.5
11,0,realize,7,570,4,3,5.5
11,0,reasonable,10,571,3,7,2.25
11,0,receiver,8,572,2,6,6
11,0,recession,9,573,4,5,1.75
11,0,recipient,9,574,3,6,2
11,0,refuge,6,575,2,4,5.5
11,0,register,8,576,2,6,2
11,0,reinforce,9,577,2,7,6.25
11,0,relatively,10,578,2,8,2.5
11,0,reliability,11,579,3,8,6.75
11,0,rely,4,580,3,1,0.5
11,0,remains,7,581,2,5,1.5
11,0,reminder,8,582,3,5,5.75
11,0,renowned,8,583,2,6,2
11,0,rental,6,584,3,3,1.25
11,0,repeated,8,585,2,6,7.25
11,0,replacement,11,586,3,8,5.5
11,0,reproduce,9,587,3,6,11
11,0,restoration,11,588,2,9,6
11,0,retreat,7,589,2,5,10.25
11,0,review,6,590,2,4,3
11,0,rhythm,6,591,1,5,3.25
11,0,rid,3,592,1,2,8
11,0,riot,4,593,2,2,1.75
11,0,role,4,594,1,3,2
11,0,royal,5,595,2,3,2.25
11,0,rugby,5,596,1,4,9.25
11,0,run,3,597,2,1,1
11,0,sadly,5,598,0,5,3.25
11,0,sail,4,599,2,2,1.75
11,0,sandwich,8,600,2,6,10.5
11,0,scope,5,601,1,4,2.75
11,0,screening,9,602,2,7,4.75
11,0,script,6,603,3,3,9.25
11,0,sculpture,9,604,2,7,4.75
11,0,see,3,605,1,2,1.5
11,0,seldom,6,606,2,4,9.5
11,0,sensation,9,607,2,7,4.75
11,0,serial,6,608,2,4,2.75
11,0,session,7,609,2,5,10
11,0,set,3,610,2,1,1
11,0,several,7,611,2,5,3.5
11,0,shake,5,612,1,4,2.75
11,0,shaped,6,613,3,3,9
11,0,shine,5,614,2,3,2.25
11,0,short,5,615,2,3,2.25
11,0,shot,4,616,3,1,1
11,0,shout,5,617,3,2,1.75
11,0,show,4,618,3,1,1
11,0,shrug,5,619,2,3,9
11,0,significant,11,620,1,10,6.25
11,0,silence,7,621,2,5,10.5
11,0,silent,6,622,5,1,1.5
11,0,simulate,8,623,2,6,4.25
11,0,sincere,7,624,2,5,10.5
11,0,sir,3,625,2,1,1
11,0,situation,9,626,2,7,4.75
11,0,size,4,627,2,2,1.75
11,0,skill,5,628,1,4,9.5
11,0,sky,3,629,2,1,1
11,0,slave,5,630,1,4,2.75
11,0,slogan,6,631,2,4,3
11,0,slot,4,632,3,1,1.25
11,0,slow,4,633,3,1,7.75
11,0,small,5,634,1,4,2.75
11,0,smart,5,635,3,2,1.75
11,0,smash,5,636,3,2,1.75
11,0,soak,4,637,1,3,2.25
11,0,society,7,638,2,5,10.5
11,0,software,8,639,2,6,4.25
11,0,soldier,7,640,2,5,10.75
11,0,solely,6,641,3,3,2.5
11,0,solicitor,9,642,3,6,4.25
11,0,somebody,8,643,2,6,10.75
11,0,soon,4,644,2,2,1.75
11,0,sorry,5,645,2,3,2.25
11,0,span,4,646,1,3,2
11,0,speculate,9,647,2,7,11.25
11,0,spending,8,648,3,5,3.75
11,0,spicy,5,649,2,3,2.25
11,0,spite,5,650,3,2,8.5
11,0,split,5,651,2,3,2.25
11,0,sponsor,7,652,2,5,3.25
11,0,spoon,5,653,3,2,1.75
11,0,spot,4,654,3,1,1
11,0,spy,3,655,2,1,0.75
11,0,stark,5,656,1,4,10
11,0,station,7,657,3,4,3
11,0,status,6,658,4,2,2
11,0,stiff,5,659,2,3,2.25
11,0,stream,6,660,2,4,9.5
11,0,strive,6,661,3,3,2.5
11,0,student,7,662,2,5,3.5
11,0,stupid,6,663,3,3,9.25
11,0,successive,10,664,1,9,5.75
11,0,suddenly,8,665,2,6,11.25
11,0,suffering,9,666,2,7,5
11,0,suggestion,10,667,2,8,12
11,0,summer,6,668,2,4,2.75
11,0,summit,6,669,4,2,2
11,0,superior,8,670,2,6,11
11,0,supermarket,11,671,5,6,4.75
11,0,supervision,11,672,5,6,11.5
11,0,supervisor,10,673,8,2,3
11,0,supplement,10,674,3,7,4.75
11,0,supporter,9,675,4,5,11
11,0,surface,7,676,2,5,3.5
11,0,surge,5,677,3,2,1.75
11,0,surprised,9,678,3,6,11
11,0,surrender,9,679,3,6,4.25
11,0,survive,7,680,3,4,3
11,0,suspicious,10,681,2,8,12.5
11,0,symbol,6,682,1,5,3.25
11,0,sympathetic,11,683,3,8,12.5
11,0,syndrome,8,684,2,6,4
11,0,systematic,10,685,2,8,12.75
11,0,tag,3,686,0,3,2
11,0,talented,8,687,2,6,11
11,0,tax,3,688,2,1,1
11,0,teach,5,689,1,4,2.75
11,0,technique,9,690,2,7,4.75
11,0,teenage,7,691,2,5,10.5
11,0,teenager,8,692,7,1,1.75
11,0,temporarily,11,693,2,9,13
11,0,tenure,6,694,2,4,2.75
11,0,terminal,8,695,2,6,4
11,0,terrible,8,696,3,5,10.5
11,0,terrorist,9,697,4,5,4
11,0,testify,7,698,2,5,3.5
11,0,testing,7,699,5,2,9
11,0,text,4,700,2,2,1.75
11,0,than,4,701,1,3,2.25
11,0,that,4,702,3,1,1
11,0,theatre,7,703,2,5,3.5
11,0,there,5,704,3,2,1.75
11,0,they,4,705,3,1,8
11,0,thief,5,706,2,3,2.25
11,0,thin,4,707,3,1,1.25
11,0,third,5,708,3,2,1.75
11,0,though,6,709,2,4,3
11,0,threat,6,710,2,4,10.5
11,0,threaten,8,711,6,2,2.5
11,0,threshold,9,712,4,5,4
11,0,throat,6,713,3,3,2.5
11,0,throw,5,714,4,1,1.5
11,0,thursday,8,715,2,6,11.25
11,0,toll,4,716,1,3,2
11,0,ton,3,717,2,1,1
11,0,tone,4,718,3,1,1
11,0,tongue,6,719,3,3,9
11,0,total,5,720,2,3,2.25
11,0,tourist,7,721,2,5,3.5
11,0,towel,5,722,2,3,2.25
11,0,toy,3,723,2,1,1
11,0,trace,5,724,1,4,9.75
11,0,trading,7,725,3,4,3
11,0,tradition,9,726,5,4,3.25
11,0,transaction,11,727,3,8,12.5
11,0,transition,10,728,5,5,4
11,0,transparent,11,729,5,6,11.5
11,0,tremendous,10,730,2,8,5.25
11,0,troubled,8,731,2,6,11.25
11,0,trust,5,732,2,3,2.25
11,0,trustee,7,733,5,2,2
11,0,try,3,734,2,1,1
11,0,tuesday,7,735,1,6,10.75
11,0,tuition,7,736,2,5,3.25
11,0,turn,4,737,2,2,1.25
11,0,turnover,8,738,4,4,1.75
11,0,twenty,6,739,1,5,1790.25
11,0,type,4,740,1,3,2.25
11,0,typical,7,741,3,4,4.75
11,0,typically,9,742,7,2,3.5
11,0,under,5,743,0,5,14.5
11,0,understand,10,744,5,5,4
11,0,unless,6,745,2,4,3
11,0,unlike,6,746,3,3,12
11,0,unlikely,8,747,6,2,3.5
11,0,upset,5,748,1,4,3.75
11,0,use,3,749,1,2,3.25
11,0,user,4,750,3,1,2
11,0,utterly,7,751,1,6,16.25
11,0,victim,6,752,0,6,4.75
11,0,violation,9,753,2,7,18.5
11,0,vitamin,7,754,2,5,3.75
11,0,wage,4,755,0,4,2.75
11,0,wall,4,756,2,2,1.75
11,0,ward,4,757,2,2,10.5
11,0,warfare,7,758,3,4,3.25
11,0,wear,4,759,1,3,2.25
11,0,web,3,760,2,1,1.25
11,0,website,7,761,3,4,12.25
11,0,week,4,762,2,2,1.75
11,0,weekly,6,763,4,2,1.75
11,0,well,4,764,2,2,2.75
11,0,wet,3,765,2,1,1.5
11,0,wheat,5,766,1,4,3.25
11,0,when,4,767,3,1,1.75
11,0,where,5,768,3,2,10.75
11,0,while,5,769,2,3,2.25
11,0,who,3,770,2,1,1
11,0,whole,5,771,3,2,2.5
11,0,wholly,6,772,4,2,3
11,0,widely,6,773,1,5,15.75
11,0,winter,6,774,2,4,3
11,0,wise,4,775,2,2,1.75
11,0,withdraw,8,776,2,6,5
11,0,workout,7,777,1,6,12.5
11,0,worldwide,9,778,3,6,7
11,0,wound,5,779,2,3,10.75
11,0,writer,6,780,1,5,3.25
11,0,year,4,781,0,4,2.25
11,0,yell,4,782,2,2,1.25
11,0,yesterday,9,783,2,7,7
11,0,you,3,784,1,2,0.75
11,0,yourself,8,785,3,5,1.5
11,0,zero,4,786,0,4,5.75
11,1,able,4,0,0,4,1.25
11,1,abortion,8,1,2,6,6.5
11,1,above,5,2,3,2,1
11,1,abroad,6,3,2,4,1.25
11,1,absent,6,4,2,4,1.25
11,1,acceptance,10,5,1,9,7.25
11,1,access,6,6,4,2,1
11,1,according,9,7,3,6,6.75
11,1,accountable,11,8,4,7,2.5
11,1,accountant,10,9,8,2,1.25
11,1,accuracy,8,10,3,5,6.5
11,1,action,6,11,2,4,1.25
11,1,adhere,6,12,1,5,1.5
11,1,adult,5,13,2,3,5.75
11,1,advance,7,14,2,5,1.5
11,1,advanced,8,15,7,1,0.75
11,1,advertising,11,16,3,8,7.25
11,1,affair,6,17,1,5,1.5
11,1,affection,9,18,3,6,2
11,1,afford,6,19,3,3,6
11,1,alert,5,20,1,4,1.25
11,1,allege,6,21,2,4,1.5
11,1,although,8,22,2,6,6.5
11,1,answer,6,23,1,5,1.5
11,1,appearance,10,24,1,9,7.5
11,1,appetite,8,25,4,4,1.75
11,1,apple,5,26,3,2,1
11,1,appropriate,11,27,3,8,7.25
11,1,arbitrary,9,28,1,8,2.25
11,1,archive,7,29,2,5,6.25
11,1,armed,5,30,2,3,1
11,1,arrival,7,31,2,5,1.5
11,1,article,7,32,2,5,6.5
11,1,artificial,10,33,4,6,2.25
11,1,assign,6,34,1,5,6.25
11,1,assignment,10,35,6,4,1.75
11,1,associated,10,36,3,7,2.25
11,1,athlete,7,37,1,6,6.5
11,1,attach,6,38,2,4,1.5
11,1,attack,6,39,5,1,0.75
11,1,attempt,7,40,3,4,1.25
11,1,attend,6,41,4,2,5.5
11,1,attendance,10,42,6,4,1.75
11,1,attribute,9,43,3,6,2
11,1,audience,8,44,1,7,6.75
11,1,avoid,5,45,1,4,1.25
11,1,aware,5,46,1,4,1.25
11,1,away,4,47,3,1,5.5
11,1,backwards,9,48,0,9,2.75
11,1,ballot,6,49,2,4,1.5
11,1,banana,6,50,2,4,6.25
11,1,bank,4,51,3,1,0.5
11,1,bare,4,52,2,2,0.75
11,1,barrier,7,53,3,4,1.5
11,1,basket,6,54,2,4,6
11,1,bean,4,55,1,3,1
11,1,bear,4,56,3,1,0.75
11,1,because,7,57,2,5,1.75
11,1,become,6,58,3,3,6.25
11,1,beef,4,59,2,2,0.75
11,1,before,6,60,2,4,1.25
11,1,bend,4,61,2,2,0.75
11,1,beneath,7,62,3,4,1.25
11,1,bent,4,63,3,1,5.25
11,1,beside,6,64,2,4,1.25
11,1,bias,4,65,1,3,1
11,1,big,3,66,2,1,0.5
11,1,blanket,7,67,1,6,6.5
11,1,blessing,8,68,2,6,2
11,1,body,4,69,1,3,1
11,1,bold,4,70,2,2,1
11,1,bonus,5,71,2,3,6.25
11,1,boring,6,72,2,4,1.5
11,1,brain,5,73,1,4,1.25
11,1,bread,5,74,2,3,1
11,1,breast,6,75,4,2,5.75
11,1,breath,6,76,4,2,1
11,1,brilliant,9,77,2,7,2.25
11,1,bring,5,78,3,2,1
11,1,broadband,9,79,2,7,7
11,1,broadcast,9,80,5,4,1.75
11,1,brother,7,81,3,4,6.25
11,1,brown,5,82,3,2,1
11,1,bulk,4,83,1,3,1
11,1,burial,6,84,2,4,1.25
11,1,burst,5,85,3,2,1
11,1,bury,4,86,3,1,0.5
11,1,bus,3,87,2,1,0.5
11,1,button,6,88,2,4,6.5
11,1,bye,3,89,1,2,0.75
11,1,calm,4,90,0,4,1.25
11,1,captain,7,91,2,5,6.5
11,1,capture,7,92,4,3,1.75
11,1,case,4,93,2,2,0.75
11,1,cat,3,94,2,1,0.5
11,1,cause,5,95,2,3,1
11,1,cent,4,96,1,3,5.75
11,1,centre,6,97,4,2,1
11,1,chaos,5,98,1,4,1.25
11,1,charge,6,99,3,3,1.25
11,1,cigarette,9,100,1,8,7.25
11,1,circulation,11,101,2,9,2.75
11,1,civic,5,102,2,3,6.25
11,1,class,5,103,1,4,1.25
11,1,classic,7,104,5,2,0.75
11,1,classify,8,105,6,2,1
11,1,cleaning,8,106,2,6,6.5
11,1,climate,7,107,2,5,1.5
11,1,climb,5,108,4,1,0.75
11,1,cling,5,109,3,2,1
11,1,clip,4,110,3,1,0.5
11,1,clock,5,111,2,3,5.75
11,1,cloth,5,112,3,2,1
11,1,clothes,7,113,5,2,1
11,1,clue,4,114,2,2,0.75
11,1,coalition,9,115,1,8,7.25
11,1,coast,5,116,3,2,0.75
11,1,cocktail,8,117,2,6,2
11,1,cognitive,9,118,2,7,7.25
11,1,college,7,119,2,5,1.75
11,1,combination,11,120,2,9,8
11,1,combine,7,121,6,1,1
11,1,commit,6,122,3,3,1.25
11,1,common,6,123,4,2,1
11,1,compare,7,124,3,4,6
11,1,compelling,10,125,4,6,2.25
11,1,complain,8,126,4,4,1.75
11,1,complaint,9,127,8,1,0.75
11,1,completely,10,128,5,5,7
11,1,compliance,10,129,5,5,2
11,1,compromise,10,130,4,6,7.25
11,1,computer,8,131,4,4,1.75
11,1,concentrate,11,132,2,9,7.5
11,1,conception,10,133,5,5,2
11,1,concerned,9,134,5,4,1.5
11,1,concession,10,135,5,5,6.75
11,1,conclude,8,136,4,4,1.5
11,1,confident,9,137,3,6,2
11,1,confirm,7,138,5,2,1
11,1,confuse,7,139,4,3,6.25
11,1,consecutive,11,140,3,8,2.5
11,1,consist,7,141,4,3,1.25
11,1,consolidate,11,142,4,7,7.5
11,1,construct,9,143,4,5,2
11,1,consume,7,144,4,3,6.25
11,1,container,9,145,3,6,2
11,1,context,7,146,4,3,1.25
11,1,continue,8,147,4,4,6.25
11,1,contractor,10,148,4,6,2
11,1,cooperate,9,149,2,7,7.25
11,1,copy,4,150,2,2,0.75
11,1,corporation,11,151,2,9,2.75
11,1,correspond,10,152,3,7,7.5
11,1,cotton,6,153,2,4,1.25
11,1,council,7,154,2,5,6.75
11,1,counsellor,10,155,4,6,2.5
11,1,countless,9,156,4,5,2
11,1,countryside,11,157,5,6,7.5
11,1,covered,7,158,2,5,1.75
11,1,crack,5,159,1,4,1.25
11,1,crazy,5,160,3,2,6.25
11,1,cream,5,161,2,3,1.25
11,1,creation,8,162,4,4,1.75
11,1,critical,8,163,2,6,10
11,1,criticism,9,164,6,3,3
11,1,critique,8,165,5,3,3
11,1,crop,4,166,2,2,1.5
11,1,crown,5,167,3,2,1.75
11,1,crystal,7,168,2,5,15.25
11,1,cue,3,169,1,2,1.5
11,1,cult,4,170,2,2,1.75
11,1,cupboard,8,171,2,6,4.25
11,1,curiosity,9,172,2,7,13
11,1,custody,7,173,2,5,3.5
11,1,customer,8,174,5,3,10.75
11,1,database,8,175,0,8,5
11,1,date,4,176,3,1,1.25
11,1,daughter,8,177,2,6,12.5
11,1,deadly,6,178,1,5,3.25
11,1,debate,6,179,2,4,2.75
11,1,debris,6,180,3,3,10.5
11,1,debut,5,181,3,2,2
11,1,decision,8,182,2,6,4
11,1,declaration,11,183,3,8,13.25
11,1,dedicated,9,184,2,7,4.75
11,1,defensive,9,185,2,7,12.5
11,1,define,6,186,3,3,2.5
11,1,depend,6,187,2,4,2.75
11,1,dependence,10,188,6,4,11
11,1,dependent,9,189,8,1,2
11,1,depict,6,190,3,3,2.5
11,1,desert,6,191,2,4,2.75
11,1,desire,6,192,3,3,2.5
11,1,desperate,9,193,3,6,13
11,1,desperately,11,194,9,2,2.5
11,1,destroy,7,195,3,4,3
11,1,detail,6,196,2,4,11.25
11,1,determined,10,197,3,7,5
11,1,die,3,198,1,2,1.5
11,1,differently,11,199,2,9,14.25
11,1,difficulty,10,200,4,6,4.5
11,1,directory,9,201,2,7,14.25
11,1,disability,10,202,2,8,5.5
11,1,discard,7,203,3,4,12.75
11,1,discharge,9,204,4,5,3.75
11,1,disorder,8,205,3,5,3.75
11,1,dispute,7,206,3,4,13.5
11,1,disrupt,7,207,3,4,3
11,1,distance,8,208,3,5,3.5
11,1,distinctive,11,209,4,7,18
11,1,distract,8,210,4,4,3.25
11,1,disturb,7,211,4,3,2.5
11,1,diverse,7,212,2,5,11.75
11,1,divert,6,213,5,1,1.25
11,1,divorce,7,214,3,4,3
11,1,dog,3,215,1,2,1.5
11,1,dominance,9,216,2,7,12.75
11,1,dominate,8,217,6,2,2.25
11,1,donor,5,218,2,3,2.25
11,1,drain,5,219,1,4,11.25
11,1,dramatic,8,220,3,5,3.75
11,1,draw,4,221,3,1,1
11,1,drown,5,222,2,3,2.25
11,1,drug,4,223,2,2,1.5
11,1,drum,4,224,3,1,1
11,1,eastern,7,225,0,7,12.5
11,1,easy,4,226,3,1,1.25
11,1,eat,3,227,2,1,1
11,1,echo,4,228,1,3,2
11,1,ecological,10,229,2,8,13.75
11,1,economics,9,230,3,6,4.5
11,1,edge,4,231,1,3,10.5
11,1,educated,8,232,2,6,4
11,1,educator,8,233,6,2,2.25
11,1,efficiency,10,234,1,9,561.75
11,1,election,8,235,1,7,7.25
11,1,electoral,9,236,5,4,17
11,1,element,7,237,3,4,4
11,1,else,4,238,2,2,3.25
11,1,emotional,9,239,1,8,18.75
11,1,emotionally,11,240,9,2,5
11,1,emphasize,9,241,2,7,8.75
11,1,empire,6,242,3,3,4.5
11,1,employ,6,243,3,3,14.25
11,1,encourage,9,244,1,8,9.5
11,1,encouraging,11,245,8,3,4.5
11,1,endorse,7,246,2,5,14.25
11,1,enough,6,247,2,4,4
11,1,enrol,5,248,2,3,3
11,1,ensue,5,249,2,3,16
11,1,entire,6,250,2,4,5.25
11,1,entity,6,251,4,2,3.5
11,1,epidemic,8,252,1,7,30
11,1,equal,5,253,1,4,5.75
11,1,equip,5,254,3,2,3.25
11,1,era,3,255,1,2,4
11,1,escape,6,256,1,5,25
11,1,essential,9,257,2,7,7.5
11,1,eternal,7,258,1,6,5.25
11,1,ethic,5,259,2,3,22
11,1,ethical,7,260,5,2,3.25
11,1,ethnic,6,261,3,3,5
11,1,everybody,9,262,1,8,19.5
11,1,everyday,8,263,5,3,3.75
11,1,evil,4,264,2,2,2.25
11,1,evolution,9,265,2,7,12
11,1,exaggerate,10,266,1,9,5.75
11,1,exam,4,267,3,1,1.25
11,1,example,7,268,4,3,9
11,1,except,6,269,2,4,3
11,1,excess,6,270,4,2,2
11,1,excitement,10,271,3,7,11
11,1,exclude,7,272,3,4,3.25
11,1,exert,5,273,2,3,2.25
11,1,expected,8,274,2,6,4
11,1,expenditure,11,275,4,7,11.25
11,1,experience,10,276,4,6,4.5
11,1,explosion,9,277,3,6,10
11,1,export,6,278,3,3,2.5
11,1,exposure,8,279,4,4,3.25
11,1,external,8,280,2,6,9.5
11,1,extract,7,281,3,4,3.25
11,1,extremely,9,282,4,5,4
11,1,factory,7,283,0,7,10
11,1,fairness,8,284,2,6,4
11,1,fame,4,285,2,2,7.75
11,1,fan,3,286,2,1,1
11,1,fascinating,11,287,2,9,6
11,1,favourable,10,288,2,8,10.75
11,1,favourite,9,289,6,3,2.75
11,1,feather,7,290,1,6,9.5
11,1,feed,4,291,2,2,1.75
11,1,feedback,8,292,4,4,3
11,1,feel,4,293,3,1,1
11,1,fifth,5,294,1,4,2.75
11,1,fighting,8,295,2,6,9.75
11,1,figure,6,296,3,3,2.5
11,1,filter,6,297,2,4,2.75
11,1,final,5,298,2,3,7.75
11,1,finger,6,299,3,3,2.5
11,1,finish,6,300,3,3,2.5
11,1,fire,4,301,2,2,1.5
11,1,firearm,7,302,4,3,2.25
11,1,first,5,303,3,2,7.5
11,1,fish,4,304,2,2,1.75
11,1,fishing,7,305,4,3,2.5
11,1,flash,5,306,1,4,2.75
11,1,fleet,5,307,2,3,2.25
11,1,float,5,308,2,3,7.75
11,1,flood,5,309,3,2,1.75
11,1,fluid,5,310,2,3,2.25
11,1,fold,4,311,1,3,2.25
11,1,follow,6,312,3,3,9.25
11,1,forge,5,313,2,3,2.25
11,1,fork,4,314,3,1,1.25
11,1,formal,6,315,3,3,2.5
11,1,format,6,316,5,1,1.5
11,1,formulate,9,317,4,5,10
11,1,forth,5,318,3,2,2
11,1,forum,5,319,3,2,1.75
11,1,framework,9,320,1,8,5
11,1,frankly,7,321,3,4,7.5
11,1,freely,6,322,2,4,1.5
11,1,frequently,10,323,3,7,6.5
11,1,from,4,324,2,2,1
11,1,fully,5,325,1,4,1.25
11,1,fundraising,11,326,2,9,6.75
11,1,gas,3,327,0,3,1
11,1,generation,10,328,1,9,6
11,1,generic,7,329,5,2,1.25
11,1,generous,8,330,5,3,1.25
11,1,get,3,331,2,1,0.5
11,1,goal,4,332,1,3,1
11,1,governance,10,333,2,8,6
11,1,grant,5,334,1,4,1.25
11,1,grass,5,335,3,2,1.25
11,1,great,5,336,2,3,1.5
11,1,greatly,7,337,5,2,5.5
11,1,greenhouse,10,338,3,7,2.75
11,1,half,4,339,0,4,1.5
11,1,halt,4,340,3,1,5.75
11,1,happy,5,341,2,3,1.25
11,1,harassment,10,342,2,8,2.75
11,1,harmful,7,343,3,4,6.5
11,1,harmony,7,344,4,3,1.75
11,1,hatred,6,345,2,4,1.5
11,1,he,2,346,1,1,0.5
11,1,hearing,7,347,2,5,6.5
11,1,heavily,7,348,3,4,1.75
11,1,helmet,6,349,2,4,1.5
11,1,help,4,350,3,1,1.25
11,1,hence,5,351,2,3,5.75
11,1,hero,4,352,2,2,1
11,1,himself,7,353,1,6,2.25
11,1,history,7,354,2,5,1.75
11,1,hobby,5,355,1,4,6.5
11,1,hold,4,356,2,2,1
11,1,homeless,8,357,2,6,2.25
11,1,homework,8,358,4,4,6.5
11,1,hope,4,359,2,2,0.75
11,1,hopefully,9,360,4,5,2
11,1,hostile,7,361,2,5,6.5
11,1,hostility,9,362,6,3,2
11,1,hurry,5,363,1,4,1.25
11,1,husband,7,364,2,5,2
11,1,ideological,11,365,0,11,8.25
11,1,if,2,366,1,1,0.5
11,1,ignore,6,367,1,5,6
11,1,imagine,7,368,1,6,2.25
11,1,immigrant,9,369,2,7,7.25
11,1,impact,6,370,2,4,1.5
11,1,impress,7,371,3,4,1.5
11,1,increase,8,372,1,7,7.5
11,1,indication,10,373,2,8,3
11,1,indoor,6,374,3,3,5.75
11,1,induce,6,375,3,3,1.5
11,1,indulge,7,376,4,3,1.5
11,1,inequality,10,377,2,8,7.75
11,1,infect,6,378,2,4,1.25
11,1,infection,9,379,6,3,1.25
11,1,inflation,9,380,3,6,5.75
11,1,initial,7,381,2,5,1.75
11,1,injured,7,382,2,5,1.5
11,1,innocent,8,383,2,6,5.5
11,1,innovative,10,384,4,6,2
11,1,insider,7,385,2,5,5.5
11,1,insight,7,386,4,3,1.5
11,1,inspiration,11,387,3,8,2.5
11,1,inspire,7,388,6,1,1
11,1,instantly,9,389,3,6,6.5
11,1,institution,11,390,4,7,2.5
11,1,intention,9,391,2,7,6
11,1,interested,10,392,4,6,2
11,1,interpret,9,393,5,4,5.5
11,1,interview,9,394,5,4,1.5
11,1,intriguing,10,395,3,7,2.25
11,1,invent,6,396,2,4,5.5
11,1,invisible,9,397,3,6,2
11,1,invitation,10,398,4,6,6
11,1,involvement,11,399,3,8,2.5
11,1,ironically,10,400,1,9,6.25
11,1,isolation,9,401,1,8,2.25
11,1,jam,3,402,0,3,4.75
11,1,join,4,403,1,3,1
11,1,journalist,10,404,2,8,6
11,1,keen,4,405,0,4,1.25
11,1,kidnap,6,406,1,5,1.5
11,1,kill,4,407,2,2,1
11,1,killing,7,408,4,3,4.75
11,1,kind,4,409,2,2,1
11,1,kiss,4,410,2,2,1
11,1,knock,5,411,1,4,1.25
11,1,label,5,412,0,5,5.75
11,1,labour,6,413,3,3,1.25
11,1,ladder,6,414,2,4,1.75
11,1,language,8,415,2,6,2
11,1,late,4,416,2,2,5.25
11,1,lately,6,417,4,2,1
11,1,layout,6,418,2,4,1.5
11,1,leave,5,419,1,4,1.25
11,1,legacy,6,420,2,4,5.5
11,1,legal,5,421,4,1,0.75
11,1,legislation,11,422,3,8,2.5
11,1,leisure,7,423,2,5,6.25
11,1,lend,4,424,2,2,0.75
11,1,let,3,425,2,1,0.5
11,1,level,5,426,2,3,1
11,1,light,5,427,1,4,1.25
11,1,lively,6,428,2,4,5.75
11,1,loan,4,429,1,3,1
11,1,loop,4,430,2,2,1
11,1,lord,4,431,2,2,0.75
11,1,lose,4,432,2,2,1
11,1,loss,4,433,3,1,4.5
11,1,lost,4,434,3,1,0.75
11,1,lower,5,435,2,3,1.25
11,1,magnitude,9,436,0,9,7
11,1,major,5,437,2,3,1.25
11,1,man,3,438,2,1,0.5
11,1,management,10,439,3,7,2.25
11,1,manifest,8,440,3,5,5.75
11,1,manner,6,441,3,3,1.25
11,1,marathon,8,442,2,6,1.75
11,1,marginal,8,443,3,5,5.75
11,1,marketing,9,444,3,6,2
11,1,marry,5,445,3,2,0.75
11,1,massive,7,446,2,5,5.25
11,1,mate,4,447,2,2,0.75
11,1,mathematics,11,448,3,8,2.5
11,1,maths,5,449,4,1,4.5
11,1,maybe,5,450,2,3,1.25
11,1,measure,7,451,1,6,1.75
11,1,meet,4,452,2,2,0.75
11,1,menu,4,453,2,2,4.5
11,1,metal,5,454,2,3,1
11,1,militant,8,455,1,7,2.25
11,1,military,8,456,6,2,1
11,1,milk,4,457,3,1,0.75
11,1,mill,4,458,3,1,4.25
11,1,mine,4,459,2,2,0.75
11,1,mining,6,460,3,3,1
11,1,minority,8,461,3,5,1.5
11,1,mistake,7,462,2,5,5.25
11,1,monitor,7,463,1,6,1.75
11,1,morning,7,464,2,5,1.75
11,1,motorist,8,465,2,6,5.5
11,1,mount,5,466,2,3,1
11,1,mountain,8,467,5,3,1
11,1,move,4,468,2,2,4.25
11,1,movement,8,469,4,4,1.5
11,1,musical,7,470,1,6,1.75
11,1,mutual,6,471,2,4,5.5
11,1,myself,6,472,1,5,1.5
11,1,mysterious,10,473,3,7,2.25
11,1,mystery,7,474,6,1,4.5
11,1,nail,4,475,0,4,1.25
11,1,naturally,9,476,2,7,2
11,1,necessity,9,477,1,8,6
11,1,nest,4,478,2,2,0.75
11,1,net,3,479,2,1,0.5
11,1,network,7,480,3,4,1.25
11,1,news,4,481,2,2,4.5
11,1,next,4,482,2,2,0.75
11,1,nineteen,8,483,1,7,2
11,1,nonsense,8,484,1,7,6
11,1,noon,4,485,2,2,1
11,1,nose,4,486,2,2,1
11,1,nowadays,8,487,2,6,7
11,1,nursery,7,488,1,6,2.25
11,1,o,1,489,0,1,0.25
11,1,obey,4,490,1,3,1
11,1,obvious,7,491,2,5,6
11,1,occasional,10,492,1,9,2.75
11,1,occur,5,493,3,2,1
11,1,occurrence,10,494,5,5,6.25
11,1,offender,8,495,1,7,2.25
11,1,offering,8,496,4,4,5.5
11,1,onion,5,497,1,4,1.25
11,1,open,4,498,1,3,1
11,1,operate,7,499,3,4,1.25
11,1,opinion,7,500,2,5,5.5
11,1,or,2,501,1,1,0.5
11,1,orchestra,9,502,2,7,4.5
11,1,order,5,503,2,3,8.5
11,1,organize,8,504,2,6,4
11,1,our,3,505,1,2,1.5
11,1,out,3,506,2,1,1
11,1,overly,6,507,1,5,9.25
11,1,overseas,8,508,4,4,3.25
11,1,own,3,509,1,2,1.5
11,1,palm,4,510,0,4,2.5
11,1,paper,5,511,2,3,8.5
11,1,parameter,9,512,2,7,4.75
11,1,parent,6,513,3,3,2.5
11,1,parish,6,514,3,3,8.75
11,1,partnership,11,515,3,8,5.5
11,1,party,5,516,4,1,1.5
11,1,passage,7,517,2,5,10
11,1,peak,4,518,1,3,2.25
11,1,peasant,7,519,3,4,3
11,1,people,6,520,2,4,9.25
11,1,period,6,521,2,4,3
11,1,permanent,9,522,3,6,4.25
11,1,person,6,523,3,3,2.5
11,1,photography,11,524,1,10,12.75
11,1,pit,3,525,1,2,1.5
11,1,planet,6,526,1,5,9.5
11,1,plug,4,527,2,2,1.75
11,1,plunge,6,528,3,3,2.5
11,1,poet,4,529,1,3,2
11,1,poetry,6,530,4,2,1.75
11,1,policy,6,531,2,4,9
11,1,politics,8,532,4,4,3.25
11,1,pop,3,533,2,1,1
11,1,port,4,534,2,2,1.5
11,1,potential,9,535,2,7,11.25
11,1,poverty,7,536,2,5,3.5
11,1,powder,6,537,2,4,3
11,1,precede,7,538,1,6,10.25
11,1,premium,7,539,3,4,3
11,1,present,7,540,3,4,9.75
11,1,president,9,541,4,5,4
11,1,prevalence,10,542,3,7,5.25
11,1,prevent,7,543,4,3,9.5
11,1,prey,4,544,3,1,1.25
11,1,pride,5,545,2,3,2.5
11,1,prison,6,546,3,3,3
11,1,prisoner,8,547,6,2,2.5
11,1,privilege,9,548,3,6,14
11,1,problematic,11,549,2,9,7
11,1,proceed,7,550,3,4,13.25
11,1,production,10,551,3,7,5.75
11,1,productive,10,552,8,2,2.25
11,1,promote,7,553,3,4,9.75
11,1,promotion,9,554,6,3,2.75
11,1,pronounce,9,555,3,6,4.25
11,1,pronounced,10,556,9,1,1.5
11,1,prosecutor,10,557,3,7,11
11,1,provincial,10,558,3,7,4.75
11,1,provision,9,559,5,4,9.75
11,1,psychology,10,560,1,9,5.75
11,1,publication,11,561,1,10,13
11,1,publishing,10,562,5,5,10.5
11,1,punch,5,563,2,3,2.25
11,1,purple,6,564,2,4,2.75
11,1,pursue,6,565,3,3,2.5
11,1,quarter,7,566,0,7,12
11,1,queen,5,567,2,3,2.25
11,1,question,8,568,3,5,3.75
11,1,quickly,7,569,2,5,10
11,1,quote,5,570,2,3,2.25
11,1,racist,6,571,0,6,4
11,1,random,6,572,2,4,9.5
11,1,range,5,573,3,2,1.75
11,1,rapid,5,574,2,3,2.25
11,1,rare,4,575,2,2,1.5
11,1,raw,3,576,2,1,0.75
11,1,reading,7,577,1,6,10.5
11,1,real,4,578,3,1,1.25
11,1,realize,7,579,4,3,2.5
11,1,recession,9,580,2,7,11
11,1,recipe,6,581,3,3,2.75
11,1,recipient,9,582,5,4,3.25
11,1,recovery,8,583,3,5,3.75
11,1,regret,6,584,2,4,9.25
11,1,regularly,9,585,3,6,4.25
11,1,regulator,9,586,6,3,3
11,1,reinforce,9,587,2,7,11.25
11,1,relatively,10,588,2,8,13.5
11,1,relaxing,8,589,4,4,4
11,1,release,7,590,3,4,3.75
11,1,reliability,11,591,3,8,15
11,1,rely,4,592,3,1,1.5
11,1,reminder,8,593,2,6,4.75
11,1,renowned,8,594,2,6,11.25
11,1,rental,6,595,3,3,2.5
11,1,repeated,8,596,2,6,4
11,1,reporter,8,597,3,5,10.25
11,1,represent,9,598,3,6,4.25
11,1,reproduce,9,599,4,5,10.25
11,1,residential,11,600,2,9,6
11,1,restraint,9,601,3,6,11
11,1,resume,6,602,3,3,2.5
11,1,reverse,7,603,2,5,3.5
11,1,review,6,604,3,3,2.25
11,1,risk,4,605,1,3,8.75
11,1,role,4,606,1,3,2
11,1,romantic,8,607,2,6,4.25
11,1,rugby,5,608,1,4,9.25
11,1,rule,4,609,2,2,1.75
11,1,runner,6,610,2,4,3
11,1,sandwich,8,611,0,8,11.75
11,1,say,3,612,2,1,1.25
11,1,scale,5,613,1,4,3
11,1,scope,5,614,2,3,2.25
11,1,scratch,7,615,2,5,10
11,1,scream,6,616,3,3,2.5
11,1,screening,9,617,4,5,3.75
11,1,sculpture,9,618,2,7,11.75
11,1,see,3,619,1,2,1.5
11,1,seldom,6,620,2,4,3
11,1,self,4,621,3,1,1.5
11,1,send,4,622,2,2,1.75
11,1,sensation,9,623,3,6,11
11,1,sentence,8,624,3,5,3.75
11,1,session,7,625,2,5,10
11,1,several,7,626,2,5,3.5
11,1,sex,3,627,2,1,1
11,1,shall,5,628,1,4,2.75
11,1,shaped,6,629,3,3,9.25
11,1,shine,5,630,2,3,2.25
11,1,shop,4,631,2,2,1.5
11,1,shot,4,632,3,1,1
11,1,should,6,633,3,3,2.25
11,1,shrink,6,634,2,4,10
11,1,shrug,5,635,3,2,3.5
11,1,significant,11,636,1,10,6.75
11,1,silence,7,637,2,5,12.25
11,1,silent,6,638,5,1,1.5
11,1,silly,5,639,3,2,2.25
11,1,sir,3,640,2,1,1
11,1,situation,9,641,2,7,13.25
11,1,sixty,5,642,2,3,2.5
11,1,skill,5,643,1,4,2.75
11,1,sky,3,644,2,1,1
11,1,slave,5,645,1,4,9.75
11,1,sleep,5,646,2,3,1.5
11,1,slogan,6,647,2,4,1.5
11,1,small,5,648,1,4,1.25
11,1,soak,4,649,1,3,5.25
11,1,socialist,9,650,2,7,2.25
11,1,society,7,651,4,3,1.25
11,1,solicitor,9,652,2,7,6.25
11,1,son,3,653,2,1,0.5
11,1,sorry,5,654,2,3,1
11,1,sort,4,655,3,1,0.5
11,1,source,6,656,2,4,5.5
11,1,span,4,657,1,3,1
11,1,spicy,5,658,2,3,1
11,1,spill,5,659,3,2,0.75
11,1,spite,5,660,3,2,0.75
11,1,split,5,661,2,3,5
11,1,sponsor,7,662,2,5,2
11,1,spoon,5,663,3,2,1
11,1,stabilize,9,664,1,8,6.5
11,1,stage,5,665,3,2,1
11,1,stark,5,666,3,2,0.75
11,1,steep,5,667,2,3,1
11,1,strive,6,668,2,4,1.25
11,1,struggle,8,669,3,5,6.25
11,1,style,5,670,2,3,1
11,1,suburban,8,671,1,7,6.25
11,1,success,7,672,2,5,1.75
11,1,successive,10,673,7,3,1.5
11,1,suffer,6,674,2,4,1.25
11,1,sum,3,675,2,1,4.75
11,1,summarize,9,676,3,6,2
11,1,summit,6,677,4,2,1
11,1,superior,8,678,2,6,6
11,1,supermarket,11,679,5,6,2.25
11,1,supervision,11,680,5,6,2.25
11,1,supplement,10,681,3,7,6.5
11,1,supporter,9,682,4,5,1.75
11,1,surface,7,683,2,5,5.75
11,1,surprising,10,684,3,7,2.25
11,1,survive,7,685,3,4,5.5
11,1,sweet,5,686,1,4,1.25
11,1,swing,5,687,2,3,1
11,1,symbol,6,688,1,5,1.5
11,1,technical,9,689,0,9,7.25
11,1,tennis,6,690,2,4,1.5
11,1,tent,4,691,3,1,0.75
11,1,tenure,6,692,3,3,5.25
11,1,terminal,8,693,2,6,1.75
11,1,terrain,7,694,3,4,1.5
11,1,terrorist,9,695,4,5,6.25
11,1,testing,7,696,2,5,1.75
11,1,than,4,697,1,3,1
11,1,theft,5,698,2,3,5.5
11,1,their,5,699,3,2,1
11,1,theirs,6,700,5,1,0.75
11,1,them,4,701,3,1,0.5
11,1,theology,8,702,3,5,1.5
11,1,there,5,703,3,2,0.75
11,1,therefore,9,704,5,4,6
11,1,they,4,705,3,1,0.5
11,1,thick,5,706,2,3,1
11,1,thin,4,707,3,1,0.5
11,1,though,6,708,2,4,1.25
11,1,thought,7,709,6,1,4.75
11,1,threat,6,710,2,4,1.5
11,1,threaten,8,711,6,2,1
11,1,thrive,6,712,3,3,1
11,1,throat,6,713,3,3,1
11,1,throughout,10,714,4,6,6.75
11,1,timber,6,715,1,5,1.5
11,1,toll,4,716,1,3,1
11,1,tomato,6,717,2,4,6
11,1,tone,4,718,2,2,0.75
11,1,tongue,6,719,3,3,1.25
11,1,total,5,720,2,3,1
11,1,touch,5,721,2,3,5.75
11,1,tourist,7,722,3,4,1.5
11,1,towards,7,723,2,5,1.75
11,1,trace,5,724,1,4,6
11,1,trading,7,725,3,4,1.75
11,1,tradition,9,726,5,4,1.75
11,1,transform,9,727,3,6,7.25
11,1,trillion,8,728,2,6,2.25
11,1,truly,5,729,2,3,1.25
11,1,trust,5,730,3,2,1
11,1,trustee,7,731,5,2,6.25
11,1,try,3,732,2,1,0.5
11,1,tuesday,7,733,1,6,2
11,1,tuition,7,734,2,5,1.75
11,1,turn,4,735,2,2,5.5
11,1,turnout,7,736,4,3,1.25
11,1,turnover,8,737,5,3,1.25
11,1,twenty,6,738,1,5,1.5
11,1,twist,5,739,2,3,5.5
11,1,ugly,4,740,0,4,1.25
11,1,under,5,741,1,4,1.25
11,1,understand,10,742,5,5,6.25
11,1,unfortunate,11,743,2,9,2.75
11,1,unit,4,744,2,2,0.75
11,1,unless,6,745,2,4,6
11,1,unlike,6,746,3,3,1.25
11,1,upset,5,747,1,4,1.25
11,1,upwards,7,748,2,5,6.5
11,1,us,2,749,1,1,0.5
11,1,user,4,750,2,2,0.75
11,1,variation,9,751,0,9,7
11,1,vast,4,752,2,2,0.75
11,1,vicious,7,753,1,6,1.75
11,1,victim,6,754,3,3,1.25
11,1,village,7,755,2,5,6.25
11,1,vitamin,7,756,2,5,1.75
11,1,volume,6,757,1,5,1.5
11,1,voluntary,9,758,4,5,6.25
11,1,wage,4,759,0,4,1.25
11,1,warehouse,9,760,2,7,6.75
11,1,we,2,761,1,1,0.5
11,1,weak,4,762,2,2,0.75
11,1,wear,4,763,3,1,0.5
11,1,weather,7,764,3,4,1.25
11,1,week,4,765,2,2,0.75
11,1,wet,3,766,2,1,0.5
11,1,wheat,5,767,1,4,6
11,1,whilst,6,768,2,4,1.25
11,1,whole,5,769,2,3,1.25
11,1,wide,4,770,1,3,5.5
11,1,widely,6,771,4,2,1.25
11,1,withdrawal,10,772,2,8,2.5
11,1,wooden,6,773,1,5,5.75
11,1,workout,7,774,2,5,1.75
11,1,worldwide,9,775,3,6,2
11,1,worse,5,776,3,2,5.5
11,1,worst,5,777,4,1,0.75
11,1,wound,5,778,2,3,1
11,1,writer,6,779,1,5,1.5
11,1,wrong,5,780,2,3,1.25
11,1,year,4,781,0,4,2082
11,1,yell,4,782,2,2,1.75
11,1,yours,5,783,1,4,3
11,1,yourself,8,784,5,3,2.75
11,1,zero,4,785,0,4,13.75
11,1,zone,4,786,1,3,2.5
11,2,able,4,0,0,4,3.75
11,2,about,5,1,2,3,8
11,2,abstract,8,2,2,6,21.5
11,2,acceptance,10,3,1,9,14.75
11,2,according,9,4,3,6,4.25
11,2,acquire,7,5,2,5,3.5
11,2,admission,9,6,1,8,13.75
11,2,advance,7,7,2,5,3.5
11,2,advanced,8,8,7,1,1.5
11,2,advertise,9,9,3,6,13.5
11,2,affection,9,10,1,8,7.25
11,2,afford,6,11,3,3,11.25
11,2,afraid,6,12,2,4,3
11,2,aged,4,13,1,3,2.75
11,2,agent,5,14,3,2,2
11,2,aid,3,15,1,2,10.75
11,2,air,3,16,2,1,1.25
11,2,alert,5,17,1,4,2.75
11,2,alignment,9,18,2,7,4.75
11,2,alike,5,19,3,2,10.25
11,2,allegedly,9,20,2,7,4.75
11,2,alliance,8,21,3,5,3.75
11,2,allow,5,22,3,2,10.5
11,2,alone,5,23,2,3,3
11,2,although,8,24,2,6,4.25
11,2,altogether,10,25,3,7,13.5
11,2,amid,4,26,1,3,2.25
11,2,angel,5,27,1,4,2.75
11,2,answer,6,28,2,4,11.25
11,2,anyone,6,29,2,4,3
11,2,apart,5,30,1,4,2.75
11,2,appetite,8,31,2,6,11.25
11,2,apple,5,32,3,2,1.75
11,2,appoint,7,33,3,4,3
11,2,appropriate,11,34,3,8,12.75
11,2,arbitrary,9,35,1,8,5.5
11,2,armed,5,36,2,3,10.5
11,2,arrival,7,37,2,5,6.25
11,2,artificial,10,38,2,8,6
11,2,assess,6,39,1,5,11.75
11,2,asset,5,40,4,1,1.25
11,2,assign,6,41,3,3,2.5
11,2,association,11,42,3,8,13.5
11,2,athlete,7,43,1,6,4
11,2,attach,6,44,2,4,3
11,2,attend,6,45,3,3,10.25
11,2,attendance,10,46,6,4,3.25
11,2,attribute,9,47,3,6,4.25
11,2,audit,5,48,1,4,9.25
11,2,august,6,49,2,4,1.5
11,2,authority,9,50,2,7,6.75
11,2,avoid,5,51,1,4,1.25
11,2,away,4,52,1,3,1
11,2,awkward,7,53,2,5,1.75
11,2,backdrop,8,54,0,8,7
11,2,bake,4,55,2,2,0.75
11,2,ballot,6,56,2,4,1.5
11,2,bank,4,57,2,2,5.5
11,2,bare,4,58,2,2,0.75
11,2,barrier,7,59,3,4,1.5
11,2,basis,5,60,2,3,1
11,2,bean,4,61,1,3,5.75
11,2,become,6,62,2,4,1.5
11,2,bee,3,63,2,1,0.5
11,2,beef,4,64,3,1,0.5
11,2,beginning,9,65,2,7,2
11,2,being,5,66,2,3,5.5
11,2,beneath,7,67,2,5,1.5
11,2,bias,4,68,1,3,1
11,2,big,3,69,2,1,0.5
11,2,blanket,7,70,1,6,6.5
11,2,blend,5,71,2,3,1
11,2,bond,4,72,1,3,1
11,2,bonus,5,73,3,2,0.75
11,2,born,4,74,2,2,5.5
11,2,branch,6,75,1,5,1.5
11,2,breast,6,76,2,4,1.5
11,2,breath,6,77,4,2,1
11,2,brick,5,78,2,3,5.75
11,2,briefly,7,79,3,4,1.5
11,2,bring,5,80,3,2,1
11,2,broad,5,81,2,3,1
11,2,broadband,9,82,5,4,6.25
11,2,broadcast,9,83,5,4,1.75
11,2,broadly,7,84,5,2,1
11,2,building,8,85,1,7,6.5
11,2,bureaucracy,11,86,2,9,2.75
11,2,bus,3,87,2,1,0.5
11,2,button,6,88,2,4,6.25
11,2,bye,3,89,1,2,0.75
11,2,cabinet,7,90,0,7,2
11,2,calm,4,91,2,2,0.75
11,2,capitalism,10,92,2,8,7.5
11,2,carriage,8,93,2,6,2
11,2,case,4,94,2,2,5.75
11,2,cat,3,95,2,1,0.5
11,2,catch,5,96,3,2,0.75
11,2,caution,7,97,2,5,1.5
11,2,cautious,8,98,6,2,1
11,2,cent,4,99,1,3,5.5
11,2,centre,6,100,4,2,1
11,2,champion,8,101,1,7,2
11,2,chat,4,102,3,1,0.5
11,2,cheek,5,103,2,3,5.75
11,2,chef,4,104,3,1,0.75
11,2,circulation,11,105,1,10,3
11,2,civic,5,106,2,3,5.75
11,2,claim,5,107,1,4,1.25
11,2,class,5,108,3,2,1
11,2,classical,9,109,5,4,1.5
11,2,classify,8,110,6,2,5.5
11,2,climb,5,111,2,3,1.25
11,2,clinic,6,112,3,3,1.25
11,2,close,5,113,2,3,1
11,2,closure,7,114,4,3,1.25
11,2,clothes,7,115,3,4,7.25
11,2,coalition,9,116,1,8,2.75
11,2,coast,5,117,3,2,1
11,2,coastal,7,118,5,2,6.25
11,2,collision,9,119,2,7,2.25
11,2,colour,6,120,3,3,1.25
11,2,columnist,9,121,3,6,7
11,2,combat,6,122,2,4,1.25
11,2,commander,9,123,3,6,6.75
11,2,commentary,10,124,4,6,2.25
11,2,commerce,8,125,5,3,1.5
11,2,commit,6,126,4,2,1
11,2,compare,7,127,3,4,6.5
11,2,comparison,10,128,6,4,1.75
11,2,compelling,10,129,4,6,2
11,2,competition,11,130,5,6,7.5
11,2,competitive,11,131,9,2,1.5
11,2,complain,8,132,4,4,1.5
11,2,complaint,9,133,8,1,0.75
11,2,compose,7,134,4,3,5.75
11,2,comprise,8,135,4,4,1.5
11,2,conception,10,136,2,8,2.5
11,2,concerned,9,137,5,4,6.5
11,2,conclude,8,138,4,4,1.5
11,2,conflict,8,139,3,5,1.75
11,2,confusion,9,140,4,5,6.5
11,2,consecutive,11,141,3,8,2.5
11,2,consist,7,142,4,3,6.25
11,2,consistent,10,143,7,3,1.5
11,2,conspiracy,10,144,4,6,2
11,2,constitute,10,145,4,6,7.25
11,2,consume,7,146,4,3,1.25
11,2,consumer,8,147,7,1,0.75
11,2,contest,7,148,3,4,1.5
11,2,continue,8,149,4,4,6.25
11,2,contractor,10,150,4,6,2
11,2,contributor,11,151,5,6,2.5
11,2,convict,7,152,3,4,6.25
11,2,cook,4,153,2,2,1
11,2,cooking,7,154,4,3,1.25
11,2,cool,4,155,3,1,0.75
11,2,cooperate,9,156,3,6,6.75
11,2,correspond,10,157,2,8,2.5
11,2,corrupt,7,158,4,3,6
11,2,costume,7,159,2,5,1.75
11,2,counsellor,10,160,2,8,2.5
11,2,countless,9,161,4,5,6.75
11,2,countryside,11,162,5,6,2.25
11,2,cow,3,163,2,1,0.5
11,2,crazy,5,164,1,4,6.5
11,2,creative,8,165,2,6,2
11,2,creator,7,166,5,2,1.25
11,2,critical,8,167,2,6,7
11,2,criticism,9,168,6,3,1.5
11,2,crop,4,169,2,2,0.75
11,2,cult,4,170,1,3,1
11,2,cure,4,171,2,2,0.75
11,2,curiosity,9,172,3,6,7
11,2,custody,7,173,2,5,1.5
11,2,custom,6,174,5,1,0.75
11,2,cutting,7,175,2,5,6.5
11,2,dad,3,176,0,3,1
11,2,dancer,6,177,2,4,1.5
11,2,dark,4,178,2,2,0.75
11,2,database,8,179,2,6,7.25
11,2,dead,4,180,1,3,1
11,2,deadly,6,181,4,2,0.75
11,2,dear,4,182,3,1,0.5
11,2,debate,6,183,2,4,6
11,2,debris,6,184,3,3,1.25
11,2,debut,5,185,3,2,0.75
11,2,decision,8,186,2,6,1.75
11,2,deck,4,187,3,1,0.5
11,2,dedication,10,188,2,8,7.25
11,2,defeat,6,189,2,4,1.25
11,2,defensive,9,190,4,5,7
11,2,defy,4,191,3,1,0.75
11,2,delegation,10,192,2,8,2.5
11,2,denial,6,193,2,4,6.25
11,2,depict,6,194,2,4,1.25
11,2,desert,6,195,2,4,1.5
11,2,desire,6,196,3,3,6.25
11,2,desperate,9,197,3,6,2.25
11,2,destroy,7,198,3,4,1.75
11,2,detail,6,199,2,4,6.75
11,2,detection,9,200,3,6,2
11,2,determined,10,201,4,6,2
11,2,devise,6,202,2,4,6.5
11,2,die,3,203,1,2,0.75
11,2,differently,11,204,2,9,8.75
11,2,difficulty,10,205,4,6,2.75
11,2,direction,9,206,2,7,8.25
11,2,directly,8,207,6,2,1.5
11,2,directory,9,208,6,3,1.75
11,2,disagree,8,209,2,6,2.25
11,2,discard,7,210,3,4,7.75
11,2,disorder,8,211,3,5,2
11,2,district,8,212,3,5,2
11,2,disturb,7,213,4,3,7.25
11,2,diversity,9,214,2,7,2.75
11,2,divert,6,215,5,1,1.25
11,2,doctrine,8,216,1,7,8.5
11,2,documentary,11,217,3,8,3
11,2,dominate,8,218,2,6,14
11,2,donor,5,219,2,3,4
11,2,dose,4,220,2,2,2
11,2,dozen,5,221,2,3,2.75
11,2,drag,4,222,1,3,13
11,2,driver,6,223,2,4,6
11,2,drown,5,224,2,3,2.75
11,2,drum,4,225,2,2,2
11,2,due,3,226,1,2,1.75
11,2,dull,4,227,2,2,11.25
11,2,during,6,228,2,4,3.5
11,2,duty,4,229,2,2,1.75
11,2,early,5,230,0,5,3.5
11,2,east,4,231,2,2,11
11,2,easy,4,232,3,1,1.25
11,2,eat,3,233,2,1,1
11,2,economics,9,234,1,8,5.25
11,2,edge,4,235,1,3,2
11,2,educated,8,236,2,6,14
11,2,education,9,237,6,3,2.75
11,2,elaborate,9,238,1,8,16.25
11,2,elementary,10,239,2,8,7.5
11,2,elevate,7,240,3,4,16.5
11,2,embarrassed,11,241,1,10,6.25
11,2,empire,6,242,2,4,11
11,2,enforce,7,243,1,6,4.25
11,2,enhance,7,244,2,5,3.5
11,2,enquire,7,245,2,5,13.25
11,2,entire,6,246,2,4,3.25
11,2,entirely,8,247,6,2,2.25
11,2,entity,6,248,4,2,2.25
11,2,equip,5,249,1,4,12.75
11,2,era,3,250,1,2,1.5
11,2,error,5,251,2,3,2.5
11,2,escalate,8,252,1,7,15
11,2,essential,9,253,2,7,5.5
11,2,eternal,7,254,1,6,14.5
11,2,ethic,5,255,2,3,2.5
11,2,ethnic,6,256,3,3,2.75
11,2,everywhere,10,257,1,9,17
11,2,evolve,6,258,2,4,3.25
11,2,exaggerate,10,259,1,9,26.25
11,2,exam,4,260,3,1,719.75
11,2,example,7,261,4,3,3.25
11,2,excess,6,262,2,4,3.5
11,2,excitement,10,263,3,7,15
11,2,exert,5,264,2,3,3.75
11,2,expected,8,265,2,6,9.25
11,2,explicit,8,266,3,5,16.5
11,2,explosion,9,267,4,5,7.25
11,2,export,6,268,3,3,3.25
11,2,exposure,8,269,4,4,4.25
11,2,external,8,270,2,6,14.75
11,2,extract,7,271,3,4,4
11,2,fabulous,8,272,0,8,16
11,2,facility,8,273,2,6,7.5
11,2,faction,7,274,3,4,13.25
11,2,factor,6,275,4,2,2.25
11,2,fame,4,276,2,2,2
11,2,familiar,8,277,3,5,4
11,2,fan,3,278,2,1,1
11,2,fascinating,11,279,2,9,17.75
11,2,favour,6,280,2,4,4.5
11,2,feather,7,281,1,6,14
11,2,feature,7,282,4,3,3.25
11,2,feed,4,283,2,2,2
11,2,feedback,8,284,4,4,3.75
11,2,feel,4,285,3,1,1.5
11,2,fence,5,286,2,3,11.5
11,2,fighting,8,287,1,7,7.25
11,2,fill,4,288,2,2,2.75
11,2,film,4,289,3,1,2.75
11,2,final,5,290,2,3,11
11,2,firework,8,291,2,6,4.75
11,2,fishing,7,292,2,5,4
11,2,five,4,293,2,2,7.25
11,2,flame,5,294,1,4,2.75
11,2,flash,5,295,3,2,1.75
11,2,flaw,4,296,3,1,1.25
11,2,flawed,6,297,4,2,2
11,2,float,5,298,2,3,7.5
11,2,flour,5,299,3,2,2
11,2,fold,4,300,1,3,2.25
11,2,fond,4,301,2,2,1.75
11,2,fool,4,302,2,2,1.75
11,2,forecast,8,303,2,6,9.75
11,2,forest,6,304,4,2,2.25
11,2,forever,7,305,4,3,2.75
11,2,forge,5,306,3,2,2.5
11,2,formal,6,307,3,3,2.5
11,2,formulate,9,308,4,5,9.5
11,2,forth,5,309,3,2,2
11,2,frame,5,310,1,4,2.75
11,2,franchise,9,311,3,6,10.25
11,2,freeze,6,312,2,4,3
11,2,frightening,11,313,2,9,12.5
11,2,from,4,314,2,2,1.5
11,2,fruit,5,315,2,3,2.25
11,2,fully,5,316,1,4,2.75
11,2,fundraising,11,317,2,9,12
11,2,furious,7,318,2,5,3.5
11,2,furthermore,11,319,3,8,11.75
11,2,gang,4,320,0,4,2.75
11,2,generation,10,321,1,9,13.5
11,2,generous,8,322,5,3,2.75
11,2,gentle,6,323,3,3,2.5
11,2,genuine,7,324,3,4,9.75
11,2,get,3,325,2,1,1
11,2,golden,6,326,1,5,3.25
11,2,gorgeous,8,327,2,6,4.25
11,2,governance,10,328,2,8,11.25
11,2,government,10,329,6,4,3.5
11,2,graduate,8,330,1,7,11.5
11,2,grain,5,331,3,2,2
11,2,grandmother,11,332,3,8,12.25
11,2,great,5,333,2,3,2.25
11,2,greatly,7,334,5,2,1.75
11,2,greenhouse,10,335,3,7,11.5
11,2,guard,5,336,1,4,2.75
11,2,guideline,9,337,2,7,5
11,2,half,4,338,0,4,10.5
11,2,halt,4,339,3,1,1
11,2,hardly,6,340,2,4,3
11,2,hardware,8,341,4,4,3.25
11,2,harmful,7,342,3,4,9.25
11,2,hatred,6,343,2,4,3
11,2,healthcare,10,344,1,9,11.75
11,2,hear,4,345,3,1,1.25
11,2,heating,7,346,3,4,3
11,2,heavily,7,347,3,4,3
11,2,hello,5,348,2,3,2.25
11,2,hero,4,349,2,2,7.75
11,2,hierarchy,9,350,1,8,5
11,2,highway,7,351,2,5,9.5
11,2,hill,4,352,2,2,1.75
11,2,holy,4,353,1,3,2.25
11,2,homeless,8,354,2,6,4.25
11,2,homework,8,355,4,4,9.5
11,2,hope,4,356,2,2,1.75
11,2,horizon,7,357,2,5,3.5
11,2,housing,7,358,2,5,9.25
11,2,husband,7,359,1,6,4.5
11,2,ideological,11,360,0,11,13.5
11,2,if,2,361,1,1,1
11,2,imagine,7,362,1,6,4
11,2,imminent,8,363,2,6,9.75
11,2,impact,6,364,2,4,3
11,2,incentive,9,365,1,8,11.25
11,2,incidence,9,366,3,6,4.25
11,2,inclined,8,367,3,5,3.75
11,2,indicator,9,368,2,7,10.5
11,2,induce,6,369,3,3,2.5
11,2,indulge,7,370,4,3,3
11,2,industrial,10,371,4,6,12.25
11,2,infect,6,372,2,4,3.25
11,2,infection,9,373,6,3,3
11,2,initial,7,374,2,5,11.5
11,2,injured,7,375,2,5,3.75
11,2,inmate,6,376,2,4,3
11,2,innocent,8,377,2,6,11.75
11,2,input,5,378,2,3,2.5
11,2,insect,6,379,2,4,3
11,2,inspiration,11,380,3,8,12
11,2,inspire,7,381,6,1,1.75
11,2,instantly,9,382,3,6,10.5
11,2,insult,6,383,3,3,2.5
11,2,intensity,9,384,2,7,4.75
11,2,intention,9,385,5,4,11.5
11,2,interactive,11,386,4,7,6
11,2,interested,10,387,5,5,4.75
11,2,interview,9,388,5,4,12.75
11,2,invasion,8,389,2,6,4.5
11,2,invent,6,390,3,3,3.25
11,2,investor,8,391,4,4,8.75
11,2,invitation,10,392,3,7,2.75
11,2,irrelevant,10,393,1,9,8
11,2,jeans,5,394,0,5,1.5
11,2,july,4,395,1,3,1.25
11,2,justice,7,396,2,5,5.5
11,2,keen,4,397,0,4,1.25
11,2,kind,4,398,1,3,1
11,2,kiss,4,399,2,2,4.5
11,2,knock,5,400,1,4,1.5
11,2,knowledge,9,401,3,6,2
11,2,labour,6,402,0,6,5.5
11,2,ladder,6,403,2,4,1.25
11,2,lamp,4,404,2,2,0.75
11,2,landlord,8,405,2,6,5.5
11,2,language,8,406,3,5,1.75
11,2,late,4,407,2,2,0.75
11,2,lawyer,6,408,2,4,1.25
11,2,lead,4,409,1,3,4.75
11,2,leave,5,410,3,2,1
11,2,legacy,6,411,2,4,1.25
11,2,legal,5,412,4,1,0.75
11,2,legislation,11,413,3,8,6.25
11,2,leisure,7,414,2,5,1.5
11,2,lend,4,415,2,2,0.75
11,2,less,4,416,2,2,0.75
11,2,level,5,417,2,3,5
11,2,light,5,418,1,4,1.25
11,2,linger,6,419,2,4,1.5
11,2,listener,8,420,2,6,5.75
11,2,literacy,8,421,2,6,1.75
11,2,lively,6,422,2,4,1.25
11,2,loom,4,423,1,3,4.75
11,2,loop,4,424,3,1,0.75
11,2,lose,4,425,2,2,0.75
11,2,loss,4,426,3,1,0.5
11,2,luck,4,427,1,3,1
11,2,lung,4,428,2,2,0.75
11,2,magical,7,429,0,7,5.5
11,2,major,5,430,2,3,1
11,2,mall,4,431,2,2,0.75
11,2,man,3,432,2,1,0.5
11,2,management,10,433,3,7,5.75
11,2,manner,6,434,3,3,1.25
11,2,marginal,8,435,2,6,1.75
11,2,marketing,9,436,3,6,5.75
11,2,mate,4,437,2,2,0.75
11,2,matter,6,438,3,3,1
11,2,mayor,5,439,2,3,4.75
11,2,me,2,440,1,1,0.5
11,2,means,5,441,2,3,1
11,2,mechanism,9,442,2,7,2
11,2,medical,7,443,2,5,5.25
11,2,medicine,8,444,5,3,1.25
11,2,membership,10,445,2,8,6
11,2,metal,5,446,2,3,1.25
11,2,metaphor,8,447,4,4,1.5
11,2,military,8,448,1,7,5.75
11,2,mine,4,449,2,2,0.75
11,2,miner,5,450,4,1,0.5
11,2,minimize,8,451,3,5,1.5
11,2,minor,5,452,3,2,0.75
11,2,minute,6,453,3,3,5
11,2,mode,4,454,1,3,1
11,2,modest,6,455,4,2,1
11,2,momentum,8,456,2,6,2
11,2,morning,7,457,2,5,5.25
11,2,motive,6,458,2,4,1.25
11,2,motorcycle,10,459,3,7,6
11,2,mount,5,460,2,3,1
11,2,movement,8,461,2,6,1.75
11,2,multiply,8,462,1,7,6
11,2,musical,7,463,2,5,1.5
11,2,national,8,464,0,8,6
11,2,native,6,465,4,2,1
11,2,naval,5,466,2,3,1
11,2,necessity,9,467,1,8,6.25
11,2,neglect,7,468,2,5,1.5
11,2,net,3,469,2,1,0.5
11,2,network,7,470,3,4,1.25
11,2,news,4,471,2,2,4.5
11,2,next,4,472,2,2,0.75
11,2,nineteen,8,473,1,7,2
11,2,nonsense,8,474,1,7,6
11,2,noon,4,475,2,2,0.75
11,2,notable,7,476,2,5,1.5
11,2,number,6,477,1,5,5.5
11,2,nurse,5,478,2,3,1
11,2,nursery,7,479,5,2,0.75
11,2,nursing,7,480,4,3,1
11,2,nutrition,9,481,2,7,6.25
11,2,object,6,482,0,6,1.75
11,2,obsession,9,483,2,7,6
11,2,obtain,6,484,2,4,1.25
11,2,occasional,10,485,1,9,6.5
11,2,occurrence,10,486,3,7,2.5
11,2,offer,5,487,1,4,1.25
11,2,offering,8,488,5,3,5.25
11,2,onion,5,489,1,4,1.25
11,2,open,4,490,1,3,1
11,2,operate,7,491,3,4,5
11,2,opposition,10,492,2,8,2.75
11,2,or,2,493,1,1,0.5
11,2,oral,4,494,2,2,0.75
11,2,out,3,495,1,2,0.75
11,2,overseas,8,496,1,7,6
11,2,owner,5,497,1,4,1.25
11,2,packet,6,498,0,6,5.5
11,2,palm,4,499,2,2,0.75
11,2,paper,5,500,2,3,1
11,2,parameter,9,501,2,7,5.75
11,2,parent,6,502,3,3,1.25
11,2,parish,6,503,3,3,1
11,2,partly,6,504,3,3,1
11,2,partnership,11,505,4,7,6.5
11,2,party,5,506,4,1,0.75
11,2,pathway,7,507,2,5,1.5
11,2,payment,7,508,2,5,6.25
11,2,peasant,7,509,1,6,2
11,2,penalty,7,510,2,5,1.75
11,2,pension,7,511,3,4,5.5
11,2,percentage,10,512,2,8,2.25
11,2,period,6,513,3,3,5.25
11,2,permanent,9,514,3,6,2
11,2,permanently,11,515,9,2,1.25
11,2,petition,8,516,2,6,5.75
11,2,photograph,10,517,1,9,2.75
11,2,pill,4,518,1,3,1
11,2,pilot,5,519,3,2,5.25
11,2,pitch,5,520,2,3,1.25
11,2,plate,5,521,1,4,1.25
11,2,pleasure,8,522,2,6,6.5
11,2,plunge,6,523,2,4,1.5
11,2,pocket,6,524,1,5,1.5
11,2,poet,4,525,2,2,0.75
11,2,poetry,6,526,4,2,5.25
11,2,pole,4,527,2,2,0.75
11,2,policeman,9,528,3,6,2
11,2,pool,4,529,2,2,0.75
11,2,popular,7,530,2,5,6.5
11,2,positive,8,531,2,6,2
11,2,precede,7,532,1,6,6.25
11,2,preference,10,533,3,7,3
11,2,premium,7,534,3,4,1.5
11,2,president,9,535,3,6,6.75
11,2,prevalence,10,536,3,7,2.5
11,2,previous,8,537,4,4,6.75
11,2,prey,4,538,3,1,0.75
11,2,price,5,539,2,3,1
11,2,primarily,9,540,3,6,2.25
11,2,princess,8,541,3,5,6.25
11,2,probably,8,542,2,6,2
11,2,productive,10,543,3,7,6.25
11,2,profession,10,544,3,7,2.25
11,2,promote,7,545,3,4,5.25
11,2,promotion,9,546,6,3,1.75
11,2,protect,7,547,3,4,1.5
11,2,protection,10,548,7,3,1.25
11,2,protein,7,549,5,2,1.25
11,2,protocol,8,550,4,4,5.75
11,2,provide,7,551,3,4,1.5
11,2,province,8,552,5,3,1.25
11,2,provision,9,553,5,4,5.75
11,2,provoke,7,554,4,3,1.25
11,2,psychology,10,555,1,9,3.25
11,2,publication,11,556,1,10,7.25
11,2,punch,5,557,2,3,1.25
11,2,purely,6,558,2,4,5.5
11,2,purple,6,559,3,3,1.25
11,2,pursue,6,560,3,3,1.25
11,2,quarter,7,561,0,7,6
11,2,queen,5,562,2,3,1.25
11,2,quickly,7,563,2,5,1.5
11,2,quote,5,564,2,3,1
11,2,racist,6,565,0,6,6
11,2,radio,5,566,2,3,1.25
11,2,rapid,5,567,2,3,1
11,2,rare,4,568,2,2,0.75
11,2,raw,3,569,2,1,4.5
11,2,reader,6,570,1,5,1.5
11,2,reading,7,571,4,3,1.25
11,2,realize,7,572,3,4,1.5
11,2,reasonable,10,573,3,7,6.25
11,2,rebellion,9,574,2,7,2
11,2,recession,9,575,2,7,6.5
11,2,recipe,6,576,3,3,2.25
11,2,recipient,9,577,5,4,10.25
11,2,recovery,8,578,3,5,3.75
11,2,red,3,579,2,1,1
11,2,refuge,6,580,2,4,3
11,2,regret,6,581,2,4,10
11,2,relaxing,8,582,2,6,4.25
11,2,release,7,583,3,4,3
11,2,rely,4,584,3,1,1.5
11,2,remember,8,585,2,6,10.75
11,2,remote,6,586,3,3,2.5
11,2,renowned,8,587,2,6,10.75
11,2,rental,6,588,3,3,2.5
11,2,repeated,8,589,2,6,4
11,2,replacement,11,590,3,8,12
11,2,reporter,8,591,3,5,3.75
11,2,request,7,592,2,5,3.5
11,2,residential,11,593,2,9,12.75
11,2,respect,7,594,3,4,3.25
11,2,restoration,11,595,3,8,12.25
11,2,restraint,9,596,4,5,4
11,2,result,6,597,3,3,9
11,2,retreat,7,598,2,5,3.5
11,2,reverse,7,599,2,5,4.25
11,2,review,6,600,3,3,11.5
11,2,rhetoric,8,601,1,7,4.75
11,2,rhythm,6,602,2,4,3.25
11,2,rice,4,603,1,3,10.5
11,2,ridiculous,10,604,2,8,5.75
11,2,risk,4,605,2,2,1.75
11,2,rock,4,606,1,3,11
11,2,rugby,5,607,1,4,3
11,2,rumour,6,608,2,4,3
11,2,run,3,609,2,1,1.5
11,2,sail,4,610,0,4,9.5
11,2,scale,5,611,1,4,2.75
11,2,scope,5,612,2,3,2.25
11,2,scratch,7,613,2,5,3.5
11,2,screening,9,614,3,6,11.25
11,2,script,6,615,3,3,2.5
11,2,sculpture,9,616,2,7,11.5
11,2,seize,5,617,1,4,2.75
11,2,self,4,618,2,2,1.75
11,2,send,4,619,2,2,2
11,2,sensation,9,620,3,6,13.75
11,2,sensitive,9,621,4,5,6.75
11,2,serial,6,622,2,4,3.25
11,2,seventy,7,623,2,5,12
11,2,several,7,624,4,3,3
11,2,shade,5,625,1,4,3
11,2,shadow,6,626,4,2,1.75
11,2,shaped,6,627,3,3,10.75
11,2,shine,5,628,2,3,2.25
11,2,short,5,629,2,3,2.25
11,2,shot,4,630,3,1,1.25
11,2,shrink,6,631,2,4,2.75
11,2,sigh,4,632,1,3,8.75
11,2,significant,11,633,3,8,5.5
11,2,silence,7,634,2,5,10.75
11,2,similarity,10,635,2,8,5.25
11,2,simulate,8,636,3,5,10.5
11,2,sincere,7,637,2,5,3.5
11,2,sing,4,638,3,1,1.25
11,2,size,4,639,2,2,1.75
11,2,skiing,6,640,1,5,10.25
11,2,skill,5,641,3,2,2
11,2,sky,3,642,2,1,1
11,2,sleep,5,643,1,4,2.75
11,2,slogan,6,644,2,4,3
11,2,slow,4,645,3,1,1.25
11,2,small,5,646,1,4,9.75
11,2,smart,5,647,3,2,2.25
11,2,smash,5,648,3,2,2.25
11,2,snap,4,649,1,3,2.5
11,2,soak,4,650,1,3,10.25
11,2,soft,4,651,2,2,1.75
11,2,somewhere,9,652,2,7,5.25
11,2,son,3,653,2,1,1
11,2,sort,4,654,2,2,1.75
11,2,span,4,655,1,3,9.25
11,2,speculate,9,656,2,7,4.75
11,2,spite,5,657,2,3,2.25
11,2,spoil,5,658,2,3,9
11,2,spoon,5,659,3,2,1.75
11,2,spy,3,660,2,1,1
11,2,stadium,7,661,1,6,4
11,2,statistical,11,662,3,8,12.25
11,2,status,6,663,4,2,2
11,2,steep,5,664,2,3,2.25
11,2,stimulate,9,665,2,7,11.75
11,2,stream,6,666,2,4,2.75
11,2,struggle,8,667,3,5,3.75
11,2,student,7,668,2,5,10.5
11,2,stupid,6,669,3,3,2.5
11,2,style,5,670,2,3,2.25
11,2,suburban,8,671,1,7,11.25
11,2,successive,10,672,2,8,5.5
11,2,suggestion,10,673,2,8,12.25
11,2,suicide,7,674,2,5,3.5
11,2,sum,3,675,2,1,1
11,2,summer,6,676,3,3,9
11,2,summit,6,677,4,2,2
11,2,supervision,11,678,2,9,6
11,2,supply,6,679,3,3,9.25
11,2,supporter,9,680,4,5,4
11,2,surge,5,681,2,3,2.25
11,2,surprising,10,682,3,7,12
11,2,surrender,9,683,3,6,4.25
11,2,suspicious,10,684,2,8,12.25
11,2,swimming,8,685,1,7,4.5
11,2,swing,5,686,3,2,1.75
11,2,symbol,6,687,1,5,10.25
11,2,teach,5,688,0,5,3.25
11,2,technique,9,689,2,7,11.75
11,2,teenager,8,690,2,6,4
11,2,tell,4,691,2,2,1.5
11,2,tent,4,692,2,2,1.5
11,2,tenure,6,693,3,3,10.25
11,2,terminal,8,694,2,6,5
11,2,terrorist,9,695,3,6,12.75
11,2,testify,7,696,2,5,4
11,2,testing,7,697,5,2,2
11,2,text,4,698,2,2,1.75
11,2,theft,5,699,1,4,9.5
11,2,them,4,700,3,1,1.25
11,2,then,4,701,3,1,1
11,2,theology,8,702,3,5,3.5
11,2,there,5,703,3,2,1.5
11,2,therefore,9,704,5,4,9.75
11,2,thick,5,705,2,3,2.25
11,2,thing,5,706,3,2,1.75
11,2,thinking,8,707,4,4,3.25
11,2,third,5,708,3,2,1.75
11,2,though,6,709,2,4,9.5
11,2,threaten,8,710,2,6,4.25
11,2,throat,6,711,3,3,2.5
11,2,throughout,10,712,4,6,11.75
11,2,timber,6,713,1,5,3.5
11,2,tiny,4,714,2,2,1.75
11,2,tired,5,715,2,3,9.25
11,2,toll,4,716,1,3,2.25
11,2,tomato,6,717,2,4,3
11,2,ton,3,718,2,1,1
11,2,tongue,6,719,3,3,2.25
11,2,touch,5,720,2,3,9.5
11,2,tourist,7,721,3,4,2.75
11,2,towards,7,722,2,5,2
11,2,trace,5,723,1,4,5.5
11,2,tradition,9,724,3,6,2
11,2,transaction,11,725,3,8,6.75
11,2,transparent,11,726,5,6,2.25
11,2,tribunal,8,727,2,6,2
11,2,trillion,8,728,3,5,6.5
11,2,trust,5,729,2,3,1
11,2,tuesday,7,730,1,6,1.75
11,2,tunnel,6,731,2,4,5.75
11,2,turn,4,732,2,2,0.75
11,2,turnover,8,733,4,4,1.5
11,2,twenty,6,734,1,5,5.75
11,2,typically,9,735,1,8,2.5
11,2,ugly,4,736,0,4,1.25
11,2,ultimately,10,737,1,9,7.25
11,2,umbrella,8,738,1,7,6.5
11,2,understand,10,739,1,9,2.75
11,2,unfold,6,740,2,4,5.75
11,2,unfortunate,11,741,4,7,2.5
11,2,unless,6,742,2,4,1.25
11,2,unlike,6,743,3,3,6
11,2,unlikely,8,744,6,2,1.25
11,2,up,2,745,1,1,0.5
11,2,upset,5,746,2,3,1
11,2,us,2,747,1,1,0.25
11,2,use,3,748,2,1,0.5
11,2,utterly,7,749,1,6,6.25
11,2,versus,6,750,0,6,1.75
11,2,very,4,751,3,1,0.75
11,2,vicious,7,752,1,6,6.5
11,2,victim,6,753,3,3,1.25
11,2,violate,7,754,2,5,1.75
11,2,violation,9,755,6,3,1.25
11,2,vitamin,7,756,2,5,6
11,2,volume,6,757,1,5,1.5
11,2,ward,4,758,0,4,5.75
11,2,warfare,7,759,3,4,1.5
11,2,warm,4,760,3,1,0.5
11,2,we,2,761,1,1,0.25
11,2,weak,4,762,2,2,0.75
11,2,wear,4,763,3,1,0.5
11,2,weather,7,764,3,4,6.25
11,2,web,3,765,2,1,0.75
11,2,website,7,766,3,4,1.75
11,2,wedding,7,767,2,5,1.75
11,2,week,4,768,2,2,1
11,2,where,5,769,1,4,6.75
11,2,whisper,7,770,2,5,1.75
11,2,who,3,771,2,1,0.5
11,2,wholly,6,772,3,3,1
11,2,winner,6,773,1,5,6
11,2,winter,6,774,3,3,1.25
11,2,wise,4,775,2,2,0.75
11,2,workout,7,776,1,6,9.5
11,2,worse,5,777,3,2,2.5
11,2,worst,5,778,4,1,2006.25
11,2,writer,6,779,1,5,2
11,2,wrong,5,780,2,3,1.25
11,2,year,4,781,0,4,1.5
11,2,yell,4,782,2,2,8.75
11,2,you,3,783,1,2,1
11,2,yourself,8,784,3,5,2
11,2,zero,4,785,0,4,1.5
11,2,zone,4,786,1,3,12.25
11,3,abolish,7,0,0,7,2.25
11,3,abortion,8,1,3,5,7.5
11,3,abroad,6,2,2,4,1.5
11,3,academy,7,3,1,6,2.25
11,3,acceptance,10,4,2,8,8.25
11,3,access,6,5,4,2,1.25
11,3,acquire,7,6,2,5,7.5
11,3,act,3,7,2,1,0.5
11,3,action,6,8,3,3,1.25
11,3,activation,10,9,4,6,2.5
11,3,addition,8,10,1,7,7.75
11,3,adhere,6,11,2,4,1.75
11,3,adult,5,12,2,3,1.75
11,3,advanced,8,13,2,6,8.25
11,3,affair,6,14,1,5,2
11,3,affection,9,15,3,6,7.75
11,3,aged,4,16,1,3,1.25
11,3,aid,3,17,1,2,0.75
11,3,alien,5,18,1,4,1.5
11,3,all,3,19,2,1,0.75
11,3,allege,6,20,3,3,6.75
11,3,alone,5,21,2,3,1.5
11,3,along,5,22,4,1,0.75
11,3,also,4,23,2,2,1
11,3,ambitious,9,24,1,8,8.25
11,3,answer,6,25,1,5,1.75
11,3,anyone,6,26,2,4,1.75
11,3,apart,5,27,1,4,6.75
11,3,appearance,10,28,2,8,3
11,3,apple,5,29,3,2,1.25
11,3,appoint,7,30,3,4,7.25
11,3,appropriate,11,31,3,8,3.25
11,3,april,5,32,2,3,1.25
11,3,arbitrary,9,33,1,8,8
11,3,arena,5,34,2,3,1.25
11,3,article,7,35,2,5,7
11,3,artificial,10,36,4,6,3
11,3,asset,5,37,1,4,1.25
11,3,assignment,10,38,3,7,7
11,3,associated,10,39,3,7,2.25
11,3,athlete,7,40,1,6,6.5
11,3,attach,6,41,2,4,1.5
11,3,attack,6,42,5,1,0.75
11,3,attempt,7,43,3,4,6
11,3,attend,6,44,4,2,1.25
11,3,attendance,10,45,6,4,1.75
11,3,audit,5,46,1,4,1.25
11,3,august,6,47,2,4,6
11,3,author,6,48,2,4,1.5
11,3,autumn,6,49,3,3,1.25
11,3,avoid,5,50,1,4,1.25
11,3,aware,5,51,1,4,6.75
11,3,backdrop,8,52,0,8,2.75
11,3,backwards,9,53,4,5,8
11,3,bake,4,54,2,2,0.75
11,3,bank,4,55,2,2,0.75
11,3,bare,4,56,2,2,0.75
11,3,basket,6,57,2,4,1.25
11,3,bee,3,58,1,2,5.25
11,3,beef,4,59,3,1,0.5
11,3,before,6,60,2,4,1.25
11,3,being,5,61,2,3,1
11,3,bend,4,62,2,2,0.75
11,3,bet,3,63,2,1,0.5
11,3,bias,4,64,1,3,5.75
11,3,big,3,65,2,1,0.5
11,3,blanket,7,66,1,6,1.75
11,3,blend,5,67,2,3,1
11,3,blood,5,68,2,3,5.75
11,3,bold,4,69,1,3,1
11,3,bounce,6,70,2,4,1.5
11,3,brain,5,71,1,4,1.25
11,3,breast,6,72,2,4,6.25
11,3,breath,6,73,4,2,1
11,3,briefly,7,74,2,5,1.75
11,3,broadcast,9,75,2,7,7
11,3,broadly,7,76,5,2,1.25
11,3,brother,7,77,3,4,1.5
11,3,burst,5,78,1,4,1.25
11,3,bury,4,79,3,1,5.5
11,3,bus,3,80,2,1,0.5
11,3,but,3,81,2,1,0.5
11,3,button,6,82,3,3,1
11,3,cabin,5,83,0,5,1.5
11,3,capitalism,10,84,2,8,8.5
11,3,captain,7,85,3,4,1.5
11,3,carrot,6,86,2,4,6.25
11,3,case,4,87,2,2,0.75
11,3,cat,3,88,2,1,0.5
11,3,catch,5,89,3,2,0.75
11,3,cattle,6,90,3,3,1
11,3,cautious,8,91,2,6,6.75
11,3,cent,4,92,1,3,1
11,3,centre,6,93,4,2,0.75
11,3,chance,6,94,1,5,1.5
11,3,chaos,5,95,3,2,1
11,3,charge,6,96,3,3,6
11,3,chat,4,97,3,1,0.5
11,3,cheek,5,98,2,3,1
11,3,chef,4,99,3,1,0.5
11,3,chest,5,100,3,2,0.75
11,3,classic,7,101,1,6,6.75
11,3,classical,9,102,7,2,1.25
11,3,classify,8,103,6,2,1
11,3,cleaning,8,104,2,6,2
11,3,clip,4,105,2,2,5.75
11,3,clock,5,106,2,3,1.25
11,3,cloth,5,107,3,2,1
11,3,clue,4,108,2,2,0.75
11,3,coalition,9,109,1,8,7.5
11,3,coast,5,110,3,2,1
11,3,coastal,7,111,5,2,1
11,3,coincidence,11,112,2,9,7.5
11,3,collapse,8,113,2,6,2
11,3,college,7,114,4,3,2.75
11,3,collision,9,115,4,5,11.75
11,3,combination,11,116,2,9,6
11,3,combine,7,117,6,1,1.5
11,3,commander,9,118,3,6,12
11,3,commentary,10,119,4,6,4.5
11,3,commerce,8,120,5,3,10.25
11,3,commitment,10,121,4,6,4.5
11,3,common,6,122,4,2,2
11,3,compare,7,123,3,4,3
11,3,complain,8,124,4,4,10.75
11,3,complaint,9,125,8,1,1.75
11,3,completely,10,126,5,5,4
11,3,compliance,10,127,5,5,11.75
11,3,compose,7,128,4,3,2.5
11,3,comprise,8,129,4,4,3.25
11,3,computer,8,130,4,4,3
11,3,conception,10,131,2,8,15.25
11,3,concrete,8,132,4,4,4
11,3,confession,10,133,3,7,15.75
11,3,confident,9,134,4,5,5
11,3,confirm,7,135,5,2,2.75
11,3,confusion,9,136,4,5,14.25
11,3,consecutive,11,137,3,8,6.75
11,3,consensus,9,138,5,4,13.75
11,3,conserve,8,139,5,3,3.5
11,3,consist,7,140,4,3,3.25
11,3,constitute,10,141,4,6,5.5
11,3,consume,7,142,4,3,13
11,3,contact,7,143,3,4,3.75
11,3,container,9,144,5,4,3.25
11,3,contender,9,145,4,5,12
11,3,contest,7,146,5,2,2.25
11,3,context,7,147,5,2,2.25
11,3,continuous,10,148,4,6,4.5
11,3,contrary,8,149,4,4,11.75
11,3,convict,7,150,3,4,3
11,3,conviction,10,151,7,3,2.75
11,3,cooking,7,152,2,5,11.25
11,3,corporation,11,153,2,9,6
11,3,correspond,10,154,3,7,12.75
11,3,council,7,155,2,5,3.5
11,3,counsellor,10,156,4,6,12.25
11,3,countless,9,157,4,5,4
11,3,countryside,11,158,5,6,4.75
11,3,courage,7,159,3,4,10.75
11,3,crash,5,160,1,4,2.75
11,3,crazy,5,161,3,2,2
11,3,creation,8,162,2,6,11.75
11,3,criterion,9,163,2,7,4.75
11,3,critical,8,164,4,4,3.25
11,3,criticism,9,165,6,3,10.75
11,3,crop,4,166,2,2,1.75
11,3,crown,5,167,3,2,1.75
11,3,cult,4,168,1,3,2
11,3,cupboard,8,169,2,6,13.25
11,3,cure,4,170,2,2,2
11,3,custody,7,171,2,5,4.25
11,3,custom,6,172,5,1,1.5
11,3,customer,8,173,6,2,2.5
11,3,cutting,7,174,2,5,13.25
11,3,dad,3,175,0,3,2.5
11,3,dancer,6,176,2,4,3.5
11,3,data,4,177,2,2,2
11,3,database,8,178,4,4,13.75
11,3,date,4,179,3,1,1.5
11,3,dead,4,180,1,3,2.5
11,3,deadly,6,181,4,2,2
11,3,debris,6,182,2,4,3.25
11,3,decision,8,183,2,6,14
11,3,decorate,8,184,3,5,4.25
11,3,dedication,10,185,2,8,18.75
11,3,defeat,6,186,2,4,3.25
11,3,defend,6,187,4,2,2.25
11,3,define,6,188,3,3,7.25
11,3,delegation,10,189,2,8,11.25
11,3,delivery,8,190,3,5,4
11,3,depend,6,191,2,4,12.25
11,3,depict,6,192,3,3,2.75
11,3,description,11,193,2,9,13.75
11,3,detection,9,194,2,7,2.5
11,3,determined,10,195,4,6,7.5
11,3,development,11,196,2,9,2.75
11,3,dialogue,8,197,1,7,7.5
11,3,diary,5,198,3,2,1
11,3,dictionary,10,199,2,8,2.5
11,3,differently,11,200,2,9,8.25
11,3,difficulty,10,201,4,6,7.5
11,3,dilemma,7,202,2,5,1.75
11,3,dimension,9,203,2,7,2.25
11,3,direction,9,204,2,7,7.5
11,3,directly,8,205,6,2,1.25
11,3,disability,10,206,2,8,7.75
11,3,disagree,8,207,4,4,1.5
11,3,discharge,9,208,3,6,2
11,3,discourse,9,209,4,5,7.25
11,3,disease,7,210,3,4,1.5
11,3,dispute,7,211,3,4,1.5
11,3,disrupt,7,212,3,4,6.75
11,3,distance,8,213,3,5,1.75
11,3,distinct,8,214,4,4,1.75
11,3,distinction,11,215,8,3,7.25
11,3,diversity,9,216,2,7,2.5
11,3,dog,3,217,1,2,0.75
11,3,dominance,9,218,2,7,8
11,3,donor,5,219,2,3,1.5
11,3,dose,4,220,2,2,0.75
11,3,draw,4,221,1,3,1
11,3,dress,5,222,2,3,7
11,3,drive,5,223,2,3,1.25
11,3,driver,6,224,5,1,0.75
11,3,drug,4,225,2,2,0.75
11,3,due,3,226,1,2,0.75
11,3,dull,4,227,2,2,0.75
11,3,dump,4,228,2,2,6.25
11,3,duty,4,229,2,2,1
11,3,dynamic,7,230,1,6,2
11,3,early,5,231,0,5,7.25
11,3,easily,6,232,2,4,1.5
11,3,east,4,233,3,1,0.75
11,3,eat,3,234,2,1,0.5
11,3,ecological,10,235,1,9,8.75
11,3,economy,7,236,3,4,1.75
11,3,editorial,9,237,1,8,8.25
11,3,education,9,238,2,7,2.5
11,3,educator,8,239,6,2,1.25
11,3,efficiency,10,240,1,9,8.75
11,3,elaborate,9,241,1,8,2.5
11,3,electoral,9,242,2,7,8
11,3,element,7,243,3,4,1.5
11,3,elementary,10,244,7,3,1.5
11,3,elevate,7,245,3,4,7
11,3,else,4,246,2,2,0.75
11,3,emotional,9,247,1,8,8
11,3,emotionally,11,248,9,2,1.5
11,3,empire,6,249,2,4,1.25
11,3,employ,6,250,3,3,1.25
11,3,empty,5,251,3,2,1
11,3,encouraging,11,252,1,10,593
11,3,endorsement,11,253,2,9,11.75
11,3,energy,6,254,2,4,13.75
11,3,enough,6,255,2,4,3.5
11,3,ensue,5,256,2,3,2.75
11,3,entirely,8,257,2,6,12.75
11,3,entity,6,258,4,2,2.75
11,3,epidemic,8,259,1,7,5.5
11,3,equal,5,260,1,4,13.75
11,3,equip,5,261,3,2,3.25
11,3,equivalent,10,262,4,6,7.75
11,3,era,3,263,1,2,2.75
11,3,error,5,264,2,3,13.25
11,3,erupt,5,265,2,3,4
11,3,eternal,7,266,1,6,7
11,3,everyday,8,267,1,7,23.25
11,3,evil,4,268,2,2,2
11,3,evolve,6,269,2,4,3.5
11,3,example,7,270,1,6,29.75
11,3,except,6,271,2,4,4.5
11,3,excess,6,272,4,2,2.5
11,3,excitement,10,273,3,7,28.25
11,3,exclude,7,274,3,4,4.75
11,3,exert,5,275,2,3,2.75
11,3,expected,8,276,2,6,23.25
11,3,experience,10,277,4,6,4.75
11,3,explosion,9,278,3,6,10.25
11,3,external,8,279,2,6,4.25
11,3,extra,5,280,3,2,2
11,3,extremely,9,281,4,5,9.75
11,3,fabulous,8,282,0,8,5
11,3,facility,8,283,2,6,10.5
11,3,fact,4,284,3,1,1.25
11,3,factor,6,285,4,2,2
11,3,factory,7,286,6,1,1.25
11,3,fairness,8,287,2,6,4
11,3,faith,5,288,3,2,1.75
11,3,familiar,8,289,2,6,10
11,3,fascinating,11,290,2,9,12.25
11,3,favourable,10,291,2,8,5.25
11,3,feather,7,292,1,6,10
11,3,feedback,8,293,2,6,4.25
11,3,feeling,7,294,3,4,3.25
11,3,fence,5,295,2,3,8.5
11,3,fifth,5,296,1,4,2.75
11,3,fighting,8,297,2,6,4.25
11,3,fill,4,298,2,2,1.75
11,3,film,4,299,3,1,6.5
11,3,final,5,300,2,3,2.25
11,3,finish,6,301,3,3,2.5
11,3,fire,4,302,2,2,1.5
11,3,firearm,7,303,4,3,2.25
11,3,firework,8,304,4,4,8.75
11,3,fishing,7,305,2,5,3.5
11,3,flame,5,306,1,4,2.75
11,3,flash,5,307,3,2,1.75
11,3,flawed,6,308,3,3,8
11,3,fleet,5,309,2,3,2.25
11,3,fold,4,310,1,3,2
11,3,follow,6,311,3,3,2.25
11,3,fool,4,312,2,2,7
11,3,forever,7,313,2,5,3.5
11,3,forge,5,314,3,2,1.75
11,3,fork,4,315,3,1,1
11,3,formal,6,316,3,3,2.25
11,3,format,6,317,5,1,1.25
11,3,forum,5,318,3,2,7.25
11,3,fossil,6,319,2,4,3
11,3,framework,9,320,1,8,5.25
11,3,frightening,11,321,2,9,11.75
11,3,function,8,322,1,7,10
11,3,fund,4,323,3,1,1.25
11,3,fundraising,11,324,4,7,5
11,3,funny,5,325,3,2,1.75
11,3,furious,7,326,2,5,9
11,3,gang,4,327,0,4,1.75
11,3,garden,6,328,2,4,1.75
11,3,gas,3,329,2,1,0.75
11,3,generation,10,330,1,9,6.25
11,3,generic,7,331,5,2,1.25
11,3,get,3,332,2,1,0.75
11,3,ghost,5,333,1,4,4.75
11,3,glad,4,334,1,3,1
11,3,golden,6,335,1,5,1.5
11,3,governance,10,336,2,8,6
11,3,gradually,9,337,1,8,2.25
11,3,graduate,8,338,6,2,4.75
11,3,grand,5,339,3,2,1
11,3,grandparent,11,340,5,6,2
11,3,grass,5,341,3,2,0.75
11,3,greenhouse,10,342,2,8,6
11,3,guideline,9,343,1,8,2.25
11,3,half,4,344,0,4,4.75
11,3,halt,4,345,3,1,0.5
11,3,hardly,6,346,2,4,1.25
11,3,he,2,347,1,1,0.5
11,3,healthcare,10,348,2,8,6
11,3,hear,4,349,3,1,0.75
11,3,hearing,7,350,4,3,1.25
11,3,hello,5,351,2,3,1
11,3,hence,5,352,2,3,5
11,3,hero,4,353,2,2,1
11,3,hide,4,354,1,3,1
11,3,himself,7,355,2,5,1.75
11,3,history,7,356,2,5,5.5
11,3,hobby,5,357,1,4,1.25
11,3,hockey,6,358,2,4,1.25
11,3,hold,4,359,2,2,1
11,3,holy,4,360,3,1,4.25
11,3,homeless,8,361,2,6,2
11,3,horizon,7,362,2,5,1.5
11,3,host,4,363,2,2,0.75
11,3,hostile,7,364,4,3,5
11,3,hostility,9,365,6,3,1.5
11,3,hurry,5,366,1,4,1.25
11,3,ideology,8,367,0,8,6
11,3,if,2,368,1,1,0.5
11,3,imagine,7,369,1,6,1.75
11,3,imminent,8,370,2,6,5.5
11,3,inadequate,10,371,1,9,2.5
11,3,incidence,9,372,2,7,5.75
11,3,increase,8,373,3,5,1.75
11,3,indication,10,374,2,8,6.25
11,3,indicator,9,375,7,2,1.25
11,3,indigenous,10,376,4,6,5.5
11,3,induce,6,377,3,3,1.25
11,3,indulge,7,378,4,3,1.25
11,3,infect,6,379,2,4,1.25
11,3,inflation,9,380,3,6,5.75
11,3,inmate,6,381,2,4,1.5
11,3,innocent,8,382,2,6,1.75
11,3,input,5,383,2,3,4.75
11,3,insider,7,384,2,5,1.5
11,3,insight,7,385,4,3,1.25
11,3,inspiration,11,386,3,8,6
11,3,instantly,9,387,3,6,2
11,3,institution,11,388,4,7,6
11,3,intensity,9,389,2,7,2
11,3,intention,9,390,5,4,5.25
11,3,interface,9,391,4,5,1.75
11,3,interpret,9,392,5,4,1.5
11,3,investigate,11,393,2,9,6.25
11,3,invisible,9,394,3,6,2
11,3,involvement,11,395,3,8,6
11,3,ironically,10,396,1,9,6.75
11,3,jeans,5,397,0,5,1.5
11,3,join,4,398,1,3,1
11,3,joint,5,399,4,1,0.5
11,3,journalist,10,400,2,8,6.25
11,3,july,4,401,1,3,1
11,3,justice,7,402,2,5,1.5
11,3,kidnap,6,403,0,6,5.5
11,3,kill,4,404,2,2,0.75
11,3,kind,4,405,2,2,1
11,3,knock,5,406,1,4,5
11,3,knowledge,9,407,3,6,2.25
11,3,label,5,408,0,5,1.5
11,3,labour,6,409,3,3,5
11,3,ladder,6,410,2,4,1.25
11,3,lady,4,411,3,1,0.75
11,3,lamp,4,412,2,2,0.75
11,3,landing,7,413,2,5,1.5
11,3,lane,4,414,3,1,4.25
11,3,language,8,415,3,5,1.75
11,3,laptop,6,416,2,4,1.25
11,3,late,4,417,2,2,0.75
11,3,lawsuit,7,418,2,5,5.25
11,3,layout,6,419,2,4,1.25
11,3,learn,5,420,1,4,1.25
11,3,legacy,6,421,2,4,6.75
11,3,legal,5,422,4,1,1.25
11,3,leisure,7,423,2,5,3.5
11,3,length,6,424,2,4,2.75
11,3,let,3,425,2,1,1
11,3,listener,8,426,1,7,10.5
11,3,literacy,8,427,2,6,4.25
11,3,logic,5,428,1,4,8.75
11,3,logo,4,429,3,1,1.25
11,3,loom,4,430,2,2,1.75
11,3,loop,4,431,3,1,1.25
11,3,lord,4,432,2,2,1.75
11,3,lost,4,433,2,2,1.75
11,3,lovely,6,434,2,4,8.75
11,3,luck,4,435,1,3,2.25
11,3,lung,4,436,2,2,1.75
11,3,magazine,8,437,0,8,11
11,3,magical,7,438,3,4,3
11,3,magnitude,9,439,3,6,4.25
11,3,mall,4,440,2,2,1.75
11,3,man,3,441,2,1,8.25
11,3,manifest,8,442,3,5,3.75
11,3,marathon,8,443,2,6,4.25
11,3,marginal,8,444,3,5,10
11,3,marketing,9,445,3,6,4.5
11,3,marriage,8,446,3,5,10.25
11,3,marry,5,447,4,1,1.5
11,3,massive,7,448,2,5,3.5
11,3,matching,8,449,2,6,4.25
11,3,mathematics,11,450,3,8,11.75
11,3,maths,5,451,4,1,1.5
11,3,maximize,8,452,2,6,10.25
11,3,maybe,5,453,2,3,2.5
11,3,mayor,5,454,3,2,2
11,3,me,2,455,1,1,0.75
11,3,means,5,456,2,3,2.25
11,3,mechanism,9,457,2,7,13
11,3,meet,4,458,2,2,1.75
11,3,menu,4,459,2,2,1.5
11,3,metal,5,460,2,3,2.25
11,3,mile,4,461,1,3,8.5
11,3,militant,8,462,3,5,3.75
11,3,milk,4,463,3,1,1
11,3,mine,4,464,2,2,1.75
11,3,minimize,8,465,3,5,3.75
11,3,minor,5,466,3,2,8.5
11,3,minority,8,467,5,3,2.75
11,3,minute,6,468,3,3,2.5
11,3,miracle,7,469,2,5,3.5
11,3,missile,7,470,2,5,9.5
11,3,mobile,6,471,1,5,3.5
11,3,mode,4,472,2,2,1.75
11,3,momentum,8,473,2,6,10
11,3,monitor,7,474,2,5,3.5
11,3,moral,5,475,2,3,2.25
11,3,morning,7,476,3,4,9.25
11,3,mount,5,477,2,3,2.25
11,3,mountain,8,478,5,3,2.5
11,3,musical,7,479,1,6,10.25
11,3,mutual,6,480,2,4,3
11,3,mystery,7,481,1,6,4.25
11,3,nail,4,482,0,4,8.75
11,3,neglect,7,483,1,6,4
11,3,nerve,5,484,2,3,2.25
11,3,news,4,485,2,2,1.75
11,3,ninety,6,486,1,5,9.75
11,3,noble,5,487,1,4,2.75
11,3,nod,3,488,2,1,1
11,3,nose,4,489,2,2,1.75
11,3,notable,7,490,2,5,9.5
11,3,number,6,491,1,5,3.5
11,3,nursery,7,492,2,5,3.5
11,3,nursing,7,493,4,3,9
11,3,nutrition,9,494,2,7,5.5
11,3,object,6,495,0,6,10.5
11,3,obsession,9,496,2,7,4.75
11,3,obtain,6,497,2,4,3
11,3,obvious,7,498,2,5,9.75
11,3,occasion,8,499,1,7,4.5
11,3,occur,5,500,3,2,1.75
11,3,of,2,501,1,1,7
11,3,on,2,502,1,1,0.75
11,3,onion,5,503,2,3,2.25
11,3,onto,4,504,2,2,1.5
11,3,operate,7,505,1,6,4
11,3,operator,8,506,6,2,8.5
11,3,opinion,7,507,2,5,3.75
11,3,oral,4,508,1,3,2
11,3,orchestra,9,509,2,7,11
11,3,ordinary,8,510,2,6,4.25
11,3,organize,8,511,2,6,10.5
11,3,orientation,11,512,2,9,6
11,3,out,3,513,1,2,1.5
11,3,outrage,7,514,3,4,9.25
11,3,over,4,515,1,3,2.25
11,3,overnight,9,516,4,5,3.75
11,3,overseas,8,517,4,4,9.5
11,3,pair,4,518,0,4,2.75
11,3,palm,4,519,2,2,1.75
11,3,pan,3,520,2,1,1
11,3,paper,5,521,2,3,2.25
11,3,parameter,9,522,2,7,10.75
11,3,parent,6,523,3,3,2.5
11,3,partly,6,524,3,3,2.5
11,3,party,5,525,4,1,1.25
11,3,peasant,7,526,1,6,10.25
11,3,pension,7,527,2,5,3.75
11,3,permanent,9,528,2,7,10.75
11,3,permanently,11,529,9,2,2
11,3,person,6,530,3,3,1.5
11,3,persuade,8,531,4,4,1.75
11,3,petition,8,532,2,6,5.75
11,3,photography,11,533,1,10,6.75
11,3,physics,7,534,2,5,1.75
11,3,pit,3,535,1,2,0.75
11,3,placement,9,536,1,8,6.25
11,3,plain,5,537,3,2,1
11,3,planet,6,538,3,3,1.25
11,3,player,6,539,3,3,1
11,3,pocket,6,540,1,5,5.5
11,3,poet,4,541,2,2,0.75
11,3,poetry,6,542,4,2,0.75
11,3,poisonous,9,543,2,7,2
11,3,policy,6,544,2,4,5.25
11,3,popularity,10,545,2,8,2.25
11,3,portray,7,546,2,5,5.5
11,3,potential,9,547,2,7,2
11,3,powder,6,548,2,4,5.25
11,3,pray,4,549,1,3,1
11,3,precede,7,550,2,5,1.5
11,3,prefer,6,551,3,3,1.25
11,3,present,7,552,3,4,5.5
11,3,pretty,6,553,3,3,1.25
11,3,prevent,7,554,3,4,1.5
11,3,previous,8,555,4,4,1.75
11,3,pride,5,556,2,3,5
11,3,primarily,9,557,3,6,2
11,3,prince,6,558,3,3,1.25
11,3,prison,6,559,3,3,5
11,3,prisoner,8,560,6,2,1.25
11,3,privilege,9,561,3,6,2
11,3,probable,8,562,2,6,6
11,3,problematic,11,563,4,7,2.25
11,3,production,10,564,3,7,6.25
11,3,productive,10,565,8,2,1.25
11,3,promotion,9,566,3,6,2
11,3,pronounce,9,567,3,6,6
11,3,protect,7,568,3,4,1.5
11,3,protocol,8,569,4,4,1.5
11,3,provincial,10,570,3,7,6.5
11,3,pub,3,571,1,2,0.75
11,3,publication,11,572,3,8,6.5
11,3,publishing,10,573,5,5,2
11,3,purely,6,574,2,4,1.25
11,3,purple,6,575,3,3,1.25
11,3,pursue,6,576,3,3,5.5
11,3,qualify,7,577,0,7,2
11,3,quietly,7,578,2,5,5.75
11,3,quota,5,579,2,3,1
11,3,random,6,580,0,6,1.75
11,3,raw,3,581,2,1,0.5
11,3,read,4,582,1,3,4.75
11,3,reader,6,583,4,2,1.25
11,3,readily,7,584,4,3,1.25
11,3,reading,7,585,5,2,1
11,3,reasonable,10,586,3,7,6.25
11,3,rebellion,9,587,2,7,2.25
11,3,receiver,8,588,2,6,6.25
11,3,recipe,6,589,3,3,1.25
11,3,recovery,8,590,3,5,1.75
11,3,register,8,591,2,6,6
11,3,reinforce,9,592,2,7,2.25
11,3,relaxing,8,593,2,6,6.25
11,3,remains,7,594,2,5,2
11,3,remote,6,595,3,3,1.25
11,3,renowned,8,596,2,6,6
11,3,rental,6,597,3,3,1.25
11,3,reporter,8,598,2,6,2
11,3,represent,9,599,3,6,6.25
11,3,respect,7,600,2,5,2
11,3,response,8,601,4,4,1.5
11,3,restraint,9,602,3,6,6
11,3,result,6,603,3,3,1.25
11,3,rice,4,604,1,3,1
11,3,ridiculous,10,605,2,8,6.5
11,3,rock,4,606,1,3,1
11,3,role,4,607,2,2,0.75
11,3,route,5,608,2,3,1
11,3,royal,5,609,2,3,5.25
11,3,rugby,5,610,1,4,1.25
11,3,rule,4,611,2,2,0.75
11,3,sad,3,612,0,3,0.75
11,3,sanction,8,613,2,6,6
11,3,scope,5,614,1,4,1.25
11,3,scratch,7,615,2,5,1.75
11,3,scream,6,616,3,3,7.5
11,3,screening,9,617,4,5,4
11,3,script,6,618,3,3,2.5
11,3,section,7,619,1,6,10.75
11,3,see,3,620,2,1,1
11,3,seldom,6,621,2,4,2.75
11,3,senator,7,622,2,5,3.5
11,3,send,4,623,3,1,4
11,3,senior,6,624,3,3,6.25
11,3,sensation,9,625,3,6,4.5
11,3,sensitive,9,626,4,5,11
11,3,set,3,627,2,1,1
11,3,seventy,7,628,2,5,3.5
11,3,several,7,629,4,3,2.5
11,3,shake,5,630,1,4,9.75
11,3,shall,5,631,3,2,2
11,3,shaped,6,632,3,3,2.5
11,3,sheet,5,633,2,3,2.75
11,3,shocking,8,634,2,6,12.25
11,3,shop,4,635,3,1,1.5
11,3,shot,4,636,3,1,1.25
11,3,should,6,637,3,3,2.25
11,3,shout,5,638,4,1,1.25
11,3,show,4,639,3,1,1
11,3,shrink,6,640,2,4,2.75
11,3,significant,11,641,1,10,13.25
11,3,silence,7,642,2,5,6.75
11,3,silly,5,643,3,2,5.75
11,3,skill,5,644,1,4,2.75
11,3,slogan,6,645,1,5,3.25
11,3,slot,4,646,3,1,1.25
11,3,slow,4,647,3,1,1
11,3,smart,5,648,1,4,9.75
11,3,smash,5,649,3,2,1.75
11,3,soccer,6,650,1,5,3.25
11,3,society,7,651,3,4,10
11,3,soft,4,652,2,2,1.75
11,3,software,8,653,4,4,3
11,3,solely,6,654,2,4,3
11,3,solicitor,9,655,3,6,11
11,3,somewhere,9,656,2,7,4.75
11,3,son,3,657,2,1,1
11,3,soon,4,658,2,2,9.25
11,3,sorry,5,659,2,3,2.5
11,3,sort,4,660,3,1,1.25
11,3,span,4,661,1,3,2
11,3,spill,5,662,2,3,2.25
11,3,spite,5,663,3,2,1.75
11,3,sponsor,7,664,2,5,10.25
11,3,spoon,5,665,3,2,2
11,3,sport,5,666,3,2,1.75
11,3,stage,5,667,1,4,2.75
11,3,stark,5,668,3,2,8.75
11,3,statement,9,669,3,6,4.25
11,3,station,7,670,4,3,2.5
11,3,statistical,11,671,5,6,11.75
11,3,status,6,672,4,2,2
11,3,stimulate,9,673,2,7,4.75
11,3,stress,6,674,2,4,9.5
11,3,structure,9,675,3,6,4.5
11,3,struggle,8,676,4,4,3.5
11,3,stunning,8,677,2,6,11.25
11,3,suburb,6,678,1,5,3.5
11,3,suburban,8,679,6,2,2
11,3,suffer,6,680,2,4,9.5
11,3,suffering,9,681,6,3,2.75
11,3,sum,3,682,2,1,1
11,3,summer,6,683,3,3,2.25
11,3,summit,6,684,4,2,1.75
11,3,superior,8,685,2,6,11
11,3,supervision,11,686,5,6,4.75
11,3,supervisor,10,687,8,2,2.75
11,3,supply,6,688,3,3,10.75
11,3,suppress,8,689,4,4,4.25
11,3,surface,7,690,2,5,4.75
11,3,surprised,9,691,3,6,14.25
11,3,surrender,9,692,3,6,4.25
11,3,suspicious,10,693,2,8,12.5
11,3,sweet,5,694,1,4,2.75
11,3,sympathetic,11,695,1,10,13.25
11,3,syndrome,8,696,2,6,4.25
11,3,t,1,697,0,1,0.75
11,3,tax,3,698,1,2,1.5
11,3,technical,9,699,1,8,12.25
11,3,technique,9,700,6,3,2.75
11,3,teenager,8,701,2,6,11.75
11,3,temporarily,11,702,2,9,6
11,3,tennis,6,703,2,4,9.75
11,3,text,4,704,2,2,2
11,3,that,4,705,1,3,2.25
11,3,theft,5,706,2,3,2.25
11,3,theirs,6,707,3,3,2.5
11,3,then,4,708,3,1,8
11,3,theology,8,709,3,5,3.75
11,3,there,5,710,3,2,1.75
11,3,they,4,711,3,1,1
11,3,thin,4,712,2,2,1.5
11,3,thing,5,713,4,1,1
11,3,think,5,714,4,1,1
11,3,thinking,8,715,5,3,9.75
11,3,third,5,716,3,2,1.75
11,3,threat,6,717,2,4,2.75
11,3,threshold,9,718,4,5,10.5
11,3,thrive,6,719,3,3,2.5
11,3,thursday,8,720,2,6,4.5
11,3,tiny,4,721,1,3,2.25
11,3,tired,5,722,2,3,8
11,3,tobacco,7,723,1,6,2
11,3,tomato,6,724,2,4,1.5
11,3,ton,3,725,2,1,0.5
11,3,tone,4,726,3,1,4.75
11,3,tongue,6,727,3,3,1.25
11,3,total,5,728,2,3,1
11,3,tourist,7,729,2,5,1.5
11,3,towards,7,730,2,5,6
11,3,toy,3,731,2,1,0.5
11,3,trace,5,732,1,4,1.25
11,3,tradition,9,733,3,6,6.5
11,3,traditional,11,734,9,2,1.5
11,3,transaction,11,735,3,8,2.5
11,3,transfer,8,736,5,3,5.5
11,3,transform,9,737,6,3,1.5
11,3,true,4,738,2,2,0.75
11,3,truly,5,739,3,2,0.75
11,3,tuition,7,740,1,6,6.25
11,3,tunnel,6,741,2,4,1.5
11,3,twist,5,742,1,4,1.25
11,3,typically,9,743,1,8,7
11,3,umbrella,8,744,0,8,2.5
11,3,under,5,745,1,4,6.25
11,3,unfold,6,746,2,4,1.75
11,3,unlike,6,747,2,4,1.75
11,3,up,2,748,1,1,0.5
11,3,upper,5,749,2,3,1
11,3,upset,5,750,2,3,6.75
11,3,upwards,7,751,2,5,2
11,3,user,4,752,1,3,1.25
11,3,utterly,7,753,1,6,7.25
11,3,valid,5,754,0,5,1.5
11,3,variation,9,755,2,7,6.75
11,3,vast,4,756,2,2,0.75
11,3,vehicle,7,757,1,6,1.75
11,3,versus,6,758,2,4,1.5
11,3,very,4,759,3,1,5.25
11,3,vicious,7,760,1,6,1.75
11,3,victim,6,761,3,3,1.25
11,3,violation,9,762,2,7,7
11,3,vitamin,7,763,2,5,1.75
11,3,wage,4,764,0,4,1.25
11,3,warehouse,9,765,2,7,6.75
11,3,warm,4,766,3,1,0.75
11,3,weak,4,767,1,3,1
11,3,wear,4,768,3,1,0.5
11,3,weather,7,769,3,4,5.5
11,3,website,7,770,2,5,1.75
11,3,well,4,771,2,2,0.75
11,3,when,4,772,1,3,1.25
11,3,whisper,7,773,2,5,6
11,3,who,3,774,2,1,0.5
11,3,wide,4,775,1,3,1
11,3,widespread,10,776,4,6,1.75
11,3,winter,6,777,2,4,5.75
11,3,wise,4,778,2,2,0.75
11,3,withdraw,8,779,2,6,1.75
11,3,wooden,6,780,1,5,6
11,3,worldwide,9,781,2,7,2.25
11,3,worse,5,782,3,2,1
11,3,writing,7,783,1,6,6.25
11,3,yell,4,784,0,4,1.25
11,3,you,3,785,1,2,0.75
11,3,zone,4,786,0,4,9.75
11,4,able,4,0,0,4,3
11,4,abolish,7,1,2,5,3
11,4,abortion,8,2,3,5,6.5
11,4,about,5,3,3,2,1.25
11,4,above,5,4,3,2,1.25
11,4,abroad,6,5,2,4,1.75
11,4,acceptance,10,6,1,9,7.5
11,4,according,9,7,3,6,2.5
11,4,accuracy,8,8,3,5,5.5
11,4,action,6,9,2,4,1.5
11,4,activation,10,10,4,6,2.5
11,4,addition,8,11,1,7,6.25
11,4,admission,9,12,2,7,2.75
11,4,advanced,8,13,2,6,6.5
11,4,advertise,9,14,3,6,2.5
11,4,advertising,11,15,8,3,5.75
11,4,affection,9,16,1,8,4.5
11,4,aged,4,17,1,3,1.5
11,4,agent,5,18,3,2,6.5
11,4,aid,3,19,1,2,1
11,4,aircraft,8,20,2,6,3.5
11,4,alert,5,21,1,4,1.75
11,4,alien,5,22,2,3,5.75
11,4,alignment,9,23,3,6,3.75
11,4,alike,5,24,3,2,1.75
11,4,allege,6,25,2,4,8.25
11,4,alliance,8,26,3,5,4.25
11,4,along,5,27,2,3,1.5
11,4,ambitious,9,28,1,8,51
11,4,angel,5,29,1,4,3
11,4,answer,6,30,2,4,2.75
11,4,anyone,6,31,2,4,1.75
11,4,anything,8,32,3,5,6
11,4,appearance,10,33,1,9,2.75
11,4,appetite,8,34,4,4,5
11,4,apple,5,35,3,2,1
11,4,appropriate,11,36,3,8,2.75
11,4,april,5,37,2,3,4.75
11,4,array,5,38,1,4,1.5
11,4,arrival,7,39,3,4,1.5
11,4,article,7,40,2,5,5
11,4,attach,6,41,1,5,1.75
11,4,attempt,7,42,3,4,1.5
11,4,attend,6,43,4,2,1.25
11,4,attendance,10,44,6,4,5.25
11,4,audit,5,45,1,4,1.25
11,4,august,6,46,2,4,1.5
11,4,autumn,6,47,2,4,5
11,4,aware,5,48,1,4,1.25
11,4,awkward,7,49,2,5,1.75
11,4,backdrop,8,50,0,8,6
11,4,ballot,6,51,2,4,1.5
11,4,banana,6,52,2,4,4.75
11,4,bare,4,53,2,2,1
11,4,basketball,10,54,2,8,2.5
11,4,bean,4,55,1,3,1
11,4,because,7,56,2,5,4.75
11,4,beef,4,57,2,2,0.75
11,4,before,6,58,2,4,1.25
11,4,beginning,9,59,2,7,5.75
11,4,bend,4,60,2,2,0.75
11,4,bent,4,61,3,1,0.5
11,4,bet,3,62,2,1,0.5
11,4,bias,4,63,1,3,1
11,4,bicycle,7,64,2,5,4.75
11,4,biology,7,65,2,5,1.75
11,4,blend,5,66,1,4,1.75
11,4,body,4,67,1,3,5
11,4,bond,4,68,2,2,1
11,4,bonus,5,69,3,2,1
11,4,born,4,70,2,2,0.75
11,4,brain,5,71,1,4,1.25
11,4,bread,5,72,2,3,4
11,4,brilliant,9,73,2,7,2.25
11,4,broadband,9,74,2,7,5.25
11,4,broadcast,9,75,5,4,1.75
11,4,broadly,7,76,5,2,1.25
11,4,brown,5,77,3,2,1
11,4,buck,4,78,1,3,1
11,4,building,8,79,2,6,4.75
11,4,bulk,4,80,2,2,0.75
11,4,burial,6,81,2,4,1.25
11,4,button,6,82,2,4,4
11,4,calm,4,83,0,4,1.25
11,4,capitalism,10,84,2,8,5.25
11,4,carrot,6,85,2,4,1.5
11,4,case,4,86,2,2,0.75
11,4,castle,6,87,3,3,1
11,4,cat,3,88,2,1,0.5
11,4,champion,8,89,1,7,5
11,4,chance,6,90,3,3,1.25
11,4,charge,6,91,3,3,1.25
11,4,chat,4,92,3,1,0.5
11,4,cheek,5,93,2,3,3.75
11,4,chest,5,94,3,2,1
11,4,cigarette,9,95,1,8,4.25
11,4,cinema,6,96,2,4,8
11,4,circulation,11,97,2,9,6.25
11,4,claim,5,98,1,4,7.75
11,4,class,5,99,3,2,1.75
11,4,classic,7,100,5,2,2
11,4,classical,9,101,7,2,2
11,4,climb,5,102,2,3,2.25
11,4,clinic,6,103,3,3,2.5
11,4,close,5,104,2,3,7
11,4,closure,7,105,4,3,2.5
11,4,clue,4,106,2,2,1.75
11,4,coalition,9,107,1,8,10.25
11,4,coastal,7,108,3,4,3.25
11,4,coin,4,109,2,2,1.75
11,4,collision,9,110,2,7,9.75
11,4,columnist,9,111,3,6,4.5
11,4,combination,11,112,2,9,11
11,4,commerce,8,113,3,5,3.75
11,4,commitment,10,114,4,6,9.75
11,4,communist,9,115,4,5,4
11,4,competition,11,116,3,8,5.5
11,4,completely,10,117,4,6,9.5
11,4,compromise,10,118,4,6,4.5
11,4,computer,8,119,4,4,8.25
11,4,conception,10,120,2,8,5.5
11,4,concerned,9,121,5,4,8.25
11,4,concession,10,122,5,5,4.25
11,4,concrete,8,123,4,4,3.25
11,4,confession,10,124,3,7,10
11,4,confident,9,125,4,5,4
11,4,confirm,7,126,5,2,2.25
11,4,confuse,7,127,4,3,2.75
11,4,confusion,9,128,6,3,8.5
11,4,consensus,9,129,3,6,4.25
11,4,conserve,8,130,5,3,2.75
11,4,consistent,10,131,4,6,9.5
11,4,conspiracy,10,132,4,6,4.5
11,4,constitute,10,133,4,6,9.5
11,4,continue,8,134,3,5,3.75
11,4,contract,8,135,4,4,3.25
11,4,contrary,8,136,6,2,7.25
11,4,convert,7,137,3,4,3
11,4,convict,7,138,4,3,2.5
11,4,conviction,10,139,7,3,2.75
11,4,cook,4,140,2,2,1.5
11,4,cop,3,141,2,1,6
11,4,correspond,10,142,2,8,5.75
11,4,council,7,143,2,5,3.75
11,4,courage,7,144,3,4,8.25
11,4,cow,3,145,2,1,1
11,4,crack,5,146,1,4,2.75
11,4,crash,5,147,3,2,1.75
11,4,creation,8,148,2,6,9.5
11,4,creator,7,149,5,2,2.5
11,4,critical,8,150,2,6,4.25
11,4,critique,8,151,5,3,7.75
11,4,crown,5,152,2,3,2.5
11,4,cue,3,153,1,2,1.5
11,4,cult,4,154,2,2,1.75
11,4,cupboard,8,155,2,6,9
11,4,custom,6,156,2,4,3
11,4,customer,8,157,6,2,2.25
11,4,dark,4,158,0,4,2.75
11,4,data,4,159,2,2,1.75
11,4,database,8,160,4,4,8.75
11,4,date,4,161,3,1,1.25
11,4,daughter,8,162,2,6,4.25
11,4,deadline,8,163,1,7,344.25
11,4,dear,4,164,3,1,0.75
11,4,debate,6,165,2,4,1.5
11,4,debris,6,166,3,3,1.5
11,4,debut,5,167,3,2,1
11,4,decision,8,168,2,6,7
11,4,declaration,11,169,3,8,3.5
11,4,decorate,8,170,3,5,6
11,4,dedicated,9,171,2,7,3.25
11,4,dedication,10,172,7,3,2
11,4,defeat,6,173,2,4,5.25
11,4,defy,4,174,3,1,0.75
11,4,delivery,8,175,2,6,2
11,4,depart,6,176,2,4,4.5
11,4,description,11,177,2,9,3
11,4,desert,6,178,3,3,1.25
11,4,desperate,9,179,3,6,5.25
11,4,deteriorate,11,180,2,9,6
11,4,determined,10,181,5,5,2
11,4,dictionary,10,182,1,9,5.75
11,4,dilemma,7,183,2,5,1.75
11,4,direction,9,184,2,7,2.25
11,4,directory,9,185,6,3,4.75
11,4,disability,10,186,2,8,2.25
11,4,discard,7,187,3,4,4.75
11,4,discharge,9,188,4,5,2
11,4,dispute,7,189,3,4,1.5
11,4,disturb,7,190,3,4,4.5
11,4,diversity,9,191,2,7,2.25
11,4,divert,6,192,5,1,0.75
11,4,divorce,7,193,3,4,1.5
11,4,doctrine,8,194,1,7,5.25
11,4,dog,3,195,2,1,0.5
11,4,dominance,9,196,2,7,5.25
11,4,dozen,5,197,2,3,1.25
11,4,drive,5,198,1,4,1.25
11,4,driver,6,199,5,1,0.5
11,4,drum,4,200,2,2,0.75
11,4,drunk,5,201,3,2,1
11,4,dry,3,202,2,1,3.5
11,4,due,3,203,1,2,0.75
11,4,dump,4,204,2,2,0.75
11,4,duty,4,205,2,2,0.75
11,4,each,4,206,0,4,1.25
11,4,early,5,207,2,3,4.25
11,4,east,4,208,2,2,0.75
11,4,easy,4,209,3,1,0.5
11,4,edge,4,210,1,3,1
11,4,efficiency,10,211,1,9,5.75
11,4,eighteen,8,212,1,7,2
11,4,elaborate,9,213,1,8,5.75
11,4,electoral,9,214,2,7,2.25
11,4,electric,8,215,5,3,1.5
11,4,embarrassed,11,216,1,10,6.75
11,4,embed,5,217,3,2,1
11,4,emerge,6,218,2,4,4.75
11,4,emotional,9,219,2,7,2.25
11,4,emotionally,11,220,9,2,1
11,4,emphasize,9,221,2,7,5.5
11,4,employ,6,222,3,3,1.25
11,4,encouraging,11,223,1,10,6.25
11,4,endorsement,11,224,2,9,2.75
11,4,energy,6,225,2,4,4.5
11,4,enforce,7,226,2,5,1.5
11,4,enhance,7,227,2,5,1.75
11,4,enquire,7,228,2,5,5
11,4,entirely,8,229,2,6,1.75
11,4,equip,5,230,1,4,4.5
11,4,era,3,231,1,2,0.75
11,4,error,5,232,2,3,1
11,4,erupt,5,233,2,3,1
11,4,escalate,8,234,1,7,5.25
11,4,escape,6,235,4,2,1.25
11,4,essential,9,236,2,7,2.25
11,4,ethic,5,237,1,4,4.75
11,4,ethical,7,238,5,2,1
11,4,ethnic,6,239,3,3,1.25
11,4,everybody,9,240,1,8,5.75
11,4,everywhere,10,241,5,5,2
11,4,evil,4,242,2,2,0.75
11,4,evolution,9,243,2,7,5.5
11,4,exam,4,244,1,3,1
11,4,exert,5,245,2,3,1
11,4,expect,6,246,2,4,1.25
11,4,experience,10,247,4,6,5.5
11,4,explicit,8,248,3,5,1.75
11,4,explosion,9,249,4,5,5.25
11,4,exposure,8,250,3,5,1.75
11,4,external,8,251,2,6,1.75
11,4,extra,5,252,3,2,4.5
11,4,extract,7,253,5,2,1
11,4,extremely,9,254,4,5,1.75
11,4,fairness,8,255,0,8,5.75
11,4,faith,5,256,3,2,1
11,4,fame,4,257,2,2,1
11,4,familiar,8,258,3,5,1.75
11,4,fan,3,259,2,1,0.5
11,4,favourite,9,260,2,7,5.5
11,4,feature,7,261,1,6,1.75
11,4,feedback,8,262,2,6,5.25
11,4,feel,4,263,3,1,0.75
11,4,feeling,7,264,4,3,1.25
11,4,fifth,5,265,1,4,1.25
11,4,fighting,8,266,2,6,5.25
11,4,fill,4,267,2,2,0.75
11,4,filter,6,268,3,3,1
11,4,final,5,269,2,3,1
11,4,find,4,270,3,1,4
11,4,finish,6,271,3,3,1.25
11,4,first,5,272,2,3,1
11,4,fish,4,273,2,2,0.75
11,4,fishing,7,274,4,3,1
11,4,flame,5,275,1,4,4.5
11,4,flash,5,276,3,2,1
11,4,flaw,4,277,3,1,0.5
11,4,flawed,6,278,4,2,0.75
11,4,float,5,279,2,3,1
11,4,flood,5,280,3,2,0.75
11,4,flour,5,281,3,2,4.25
11,4,fluid,5,282,2,3,1
11,4,following,9,283,1,8,2.25
11,4,fond,4,284,2,2,4.25
11,4,forecast,8,285,2,6,2
11,4,forest,6,286,4,2,1
11,4,forever,7,287,4,3,1.25
11,4,forge,5,288,3,2,4.25
11,4,forgive,7,289,4,3,1.25
11,4,fork,4,290,3,1,0.5
11,4,format,6,291,3,3,1
11,4,formulate,9,292,4,5,1.75
11,4,framework,9,293,1,8,5.75
11,4,franchise,9,294,3,6,2.25
11,4,frankly,7,295,4,3,5
11,4,freely,6,296,2,4,1.5
11,4,freeze,6,297,4,2,1
11,4,frequently,10,298,3,7,8.75
11,4,from,4,299,2,2,1.75
11,4,fully,5,300,1,4,3
11,4,fun,3,301,2,1,1
11,4,furious,7,302,2,5,9
11,4,furthermore,11,303,3,8,5.75
11,4,gambling,8,304,0,8,10.75
11,4,gang,4,305,2,2,1.75
11,4,gas,3,306,2,1,1
11,4,generation,10,307,1,9,11.75
11,4,generic,7,308,5,2,2.25
11,4,gentle,6,309,3,3,2.5
11,4,glad,4,310,1,3,2.25
11,4,goods,5,311,1,4,10.5
11,4,government,10,312,2,8,5.75
11,4,gradually,9,313,1,8,11
11,4,graduate,8,314,6,2,2.5
11,4,grandmother,11,315,3,8,5.5
11,4,grass,5,316,3,2,7.75
11,4,greatly,7,317,2,5,3.75
11,4,half,4,318,0,4,2.75
11,4,halt,4,319,3,1,1.25
11,4,hand,4,320,2,2,7.25
11,4,hardly,6,321,2,4,3
11,4,harmful,7,322,3,4,3.25
11,4,harmony,7,323,4,3,2.5
11,4,he,2,324,1,1,0.75
11,4,hearing,7,325,2,5,9.25
11,4,heating,7,326,3,4,3.25
11,4,heavily,7,327,3,4,3.25
11,4,hello,5,328,2,3,8.25
11,4,helpful,7,329,3,4,3.25
11,4,hence,5,330,2,3,2.25
11,4,here,4,331,2,2,1.5
11,4,hero,4,332,3,1,1
11,4,hide,4,333,1,3,8.25
11,4,highway,7,334,2,5,3.75
11,4,hill,4,335,2,2,1.75
11,4,himself,7,336,2,5,3.5
11,4,history,7,337,2,5,9
11,4,hobby,5,338,1,4,2.75
11,4,holy,4,339,2,2,1.75
11,4,homework,8,340,2,6,10
11,4,honour,6,341,2,4,3
11,4,hope,4,342,2,2,1.75
11,4,horizon,7,343,2,5,9
11,4,hostile,7,344,2,5,3.75
11,4,housing,7,345,2,5,3.75
11,4,husband,7,346,1,6,9.75
11,4,ideological,11,347,0,11,13
11,4,ideology,8,348,7,1,1.75
11,4,if,2,349,1,1,1
11,4,immigrant,9,350,1,8,5.25
11,4,imminent,8,351,4,4,8.75
11,4,impress,7,352,2,5,3.75
11,4,in,2,353,1,1,0.75
11,4,inadequate,10,354,2,8,11
11,4,indeed,6,355,2,4,3
11,4,indigenous,10,356,3,7,5
11,4,indoor,6,357,3,3,8.25
11,4,indoors,7,358,6,1,2
11,4,induce,6,359,3,3,2.5
11,4,industrial,10,360,4,6,4.75
11,4,infection,9,361,2,7,12
11,4,inmate,6,362,2,4,3.5
11,4,innocent,8,363,2,6,11
11,4,input,5,364,2,3,2.25
11,4,insider,7,365,2,5,3.5
11,4,insight,7,366,4,3,2.5
11,4,inspire,7,367,3,4,9
11,4,instantly,9,368,3,6,4.25
11,4,institution,11,369,4,7,11
11,4,insult,6,370,3,3,2.5
11,4,intensity,9,371,2,7,4.75
11,4,interactive,11,372,4,7,11.75
11,4,interested,10,373,5,5,4
11,4,interface,9,374,5,4,9.5
11,4,interpret,9,375,5,4,3.5
11,4,interrupt,9,376,5,4,3.25
11,4,intriguing,10,377,3,7,10.75
11,4,introduce,9,378,4,5,4
11,4,invent,6,379,2,4,3
11,4,investigate,11,380,4,7,11.25
11,4,ironically,10,381,1,9,11.5
11,4,irrelevant,10,382,2,8,5.5
11,4,jeans,5,383,0,5,9.25
11,4,joint,5,384,1,4,2.75
11,4,journalist,10,385,2,8,5.5
11,4,july,4,386,1,3,12.25
11,4,justice,7,387,2,5,3.75
11,4,keen,4,388,0,4,2.75
11,4,kind,4,389,1,3,8
11,4,knock,5,390,1,4,2.75
11,4,label,5,391,0,5,3.25
11,4,labour,6,392,3,3,2.5
11,4,landing,7,393,2,5,9.5
11,4,laptop,6,394,2,4,3
11,4,late,4,395,2,2,1.75
11,4,lately,6,396,4,2,1.75
11,4,lawyer,6,397,2,4,8.75
11,4,learn,5,398,1,4,3
11,4,leave,5,399,3,2,2
11,4,legacy,6,400,2,4,3
11,4,legal,5,401,4,1,7.25
11,4,legislation,11,402,3,8,6
11,4,lend,4,403,2,2,1.75
11,4,less,4,404,2,2,1.75
11,4,lesson,6,405,4,2,8.5
11,4,let,3,406,2,1,1.25
11,4,light,5,407,1,4,3.5
11,4,literacy,8,408,2,6,5
11,4,lock,4,409,1,3,9.75
11,4,logo,4,410,2,2,2
11,4,loss,4,411,2,2,1.75
11,4,lovely,6,412,2,4,3
11,4,lower,5,413,2,3,2.25
11,4,luck,4,414,1,3,8
11,4,lung,4,415,2,2,1.75
11,4,magazine,8,416,0,8,5.25
11,4,magical,7,417,3,4,9.5
11,4,magnitude,9,418,3,6,4.25
11,4,man,3,419,2,1,1
11,4,management,10,420,3,7,10.5
11,4,manifest,8,421,3,5,3.75
11,4,marathon,8,422,2,6,10.5
11,4,march,5,423,3,2,2
11,4,marker,6,424,3,3,2.5
11,4,marry,5,425,3,2,1.75
11,4,massive,7,426,2,5,3.5
11,4,mate,4,427,2,2,7.5
11,4,maximize,8,428,2,6,4.25
11,4,maybe,5,429,2,3,2.25
11,4,mayor,5,430,3,2,2
11,4,means,5,431,1,4,8.75
11,4,mechanism,9,432,2,7,5
11,4,medicine,8,433,2,6,10.5
11,4,meet,4,434,2,2,1.75
11,4,menu,4,435,2,2,1.5
11,4,metal,5,436,2,3,2.25
11,4,metaphor,8,437,4,4,9
11,4,migration,9,438,1,8,5.25
11,4,militant,8,439,2,6,10
11,4,miner,5,440,2,3,2.25
11,4,mining,6,441,3,3,2.5
11,4,minority,8,442,3,5,3.75
11,4,minute,6,443,3,3,8.25
11,4,mistake,7,444,2,5,3.5
11,4,mode,4,445,1,3,2.25
11,4,modest,6,446,4,2,1.75
11,4,momentum,8,447,2,6,10.75
11,4,monitor,7,448,2,5,3.5
11,4,monk,4,449,3,1,1
11,4,morality,8,450,2,6,6
11,4,morning,7,451,3,4,1.5
11,4,motorcycle,10,452,2,8,6
11,4,motorist,8,453,5,3,1.5
11,4,move,4,454,2,2,0.75
11,4,musical,7,455,1,6,1.75
11,4,myself,6,456,1,5,5.25
11,4,mysterious,10,457,3,7,2.25
11,4,mystery,7,458,6,1,1
11,4,native,6,459,0,6,5.25
11,4,nerve,5,460,1,4,1.25
11,4,nest,4,461,2,2,1
11,4,net,3,462,2,1,0.5
11,4,next,4,463,2,2,0.75
11,4,ninety,6,464,1,5,5.75
11,4,noble,5,465,1,4,1.25
11,4,nod,3,466,2,1,0.5
11,4,nonsense,8,467,2,6,6.25
11,4,noon,4,468,2,2,1
11,4,nose,4,469,2,2,1
11,4,notable,7,470,2,5,2
11,4,nowadays,8,471,2,6,6.5
11,4,number,6,472,1,5,1.5
11,4,nursery,7,473,2,5,5.5
11,4,nursing,7,474,4,3,1.5
11,4,nutrition,9,475,2,7,2.5
11,4,observe,7,476,0,7,6
11,4,observer,8,477,7,1,0.75
11,4,obtain,6,478,2,4,1.25
11,4,obvious,7,479,2,5,5.5
11,4,occasion,8,480,1,7,2.25
11,4,occasional,10,481,8,2,1
11,4,occurrence,10,482,3,7,6
11,4,offender,8,483,1,7,2
11,4,offering,8,484,4,4,5.5
11,4,on,2,485,1,1,0.5
11,4,ongoing,7,486,2,5,1.75
11,4,onion,5,487,2,3,1
11,4,onto,4,488,2,2,0.75
11,4,operate,7,489,1,6,5.5
11,4,opinion,7,490,2,5,1.75
11,4,or,2,491,1,1,0.5
11,4,orchestra,9,492,2,7,5.75
11,4,orientation,11,493,2,9,2.75
11,4,oven,4,494,1,3,4.75
11,4,pair,4,495,0,4,1.25
11,4,paper,5,496,2,3,1
11,4,parameter,9,497,2,7,6
11,4,parent,6,498,3,3,1.25
11,4,parental,8,499,6,2,1
11,4,parish,6,500,3,3,1
11,4,partly,6,501,3,3,1
11,4,party,5,502,4,1,4.75
11,4,pass,4,503,2,2,0.75
11,4,passage,7,504,4,3,1.25
11,4,passing,7,505,4,3,1.25
11,4,pension,7,506,1,6,5.75
11,4,persuade,8,507,2,6,2
11,4,petition,8,508,2,6,6
11,4,phase,5,509,1,4,1.5
11,4,pill,4,510,1,3,1
11,4,pilot,5,511,3,2,1
11,4,pink,4,512,2,2,0.75
11,4,pit,3,513,2,1,0.5
11,4,pitch,5,514,3,2,4.75
11,4,placement,9,515,1,8,2.25
11,4,plain,5,516,3,2,1
11,4,plate,5,517,3,2,1
11,4,plunge,6,518,2,4,5.25
11,4,pocket,6,519,1,5,1.5
11,4,poet,4,520,2,2,0.75
11,4,poisonous,9,521,2,7,6.25
11,4,pole,4,522,2,2,0.75
11,4,policeman,9,523,3,6,2
11,4,politics,8,524,4,4,5.5
11,4,popular,7,525,2,5,1.75
11,4,popularity,10,526,7,3,1.25
11,4,portray,7,527,2,5,5.5
11,4,pose,4,528,2,2,0.75
11,4,positive,8,529,3,5,1.75
11,4,potential,9,530,2,7,6
11,4,poverty,7,531,2,5,1.5
11,4,practice,8,532,1,7,6
11,4,preach,6,533,2,4,1.75
11,4,precede,7,534,3,4,1.5
11,4,precision,9,535,4,5,6.25
11,4,prefer,6,536,3,3,1.25
11,4,preference,10,537,6,4,1.5
11,4,premium,7,538,3,4,1.25
11,4,prepare,7,539,3,4,5.5
11,4,price,5,540,2,3,1.25
11,4,pride,5,541,3,2,0.75
11,4,priest,6,542,3,3,1
11,4,primarily,9,543,3,6,6
11,4,princess,8,544,3,5,1.75
11,4,prisoner,8,545,3,5,1.5
11,4,privilege,9,546,3,6,6.25
11,4,probably,8,547,2,6,1.75
11,4,proceed,7,548,3,4,5.5
11,4,productive,10,549,3,7,2.25
11,4,pronounce,9,550,3,6,6
11,4,prosecutor,10,551,3,7,2.5
11,4,protein,7,552,3,4,1.5
11,4,protocol,8,553,4,4,5.75
11,4,provide,7,554,3,4,1.5
11,4,provincial,10,555,5,5,1.75
11,4,psychology,10,556,1,9,6.75
11,4,punch,5,557,1,4,1.25
11,4,punishment,10,558,3,7,7.25
11,4,purely,6,559,2,4,1.75
11,4,purple,6,560,3,3,1.5
11,4,qualify,7,561,0,7,7
11,4,queen,5,562,2,3,1.25
11,4,quickly,7,563,2,5,1.75
11,4,quietly,7,564,3,4,6
11,4,quota,5,565,2,3,1.25
11,4,quote,5,566,4,1,0.5
11,4,random,6,567,0,6,5.75
11,4,rare,4,568,2,2,0.75
11,4,raw,3,569,2,1,0.5
11,4,reading,7,570,1,6,1.75
11,4,real,4,571,3,1,0.5
11,4,really,6,572,4,2,0.75
11,4,reasonable,10,573,3,7,6.25
11,4,rebellion,9,574,2,7,2.25
11,4,receive,7,575,2,5,6.25
11,4,receiver,8,576,7,1,0.75
11,4,recession,9,577,4,5,1.75
11,4,recipient,9,578,3,6,6
11,4,red,3,579,2,1,0.5
11,4,register,8,580,2,6,1.75
11,4,regularly,9,581,3,6,6.25
11,4,regulator,9,582,6,3,1.5
11,4,reinforce,9,583,2,7,2.25
11,4,release,7,584,2,5,6
11,4,remains,7,585,2,5,1.75
11,4,remarkable,10,586,4,6,6.25
11,4,remember,8,587,3,5,1.75
11,4,remote,6,588,3,3,1.25
11,4,renowned,8,589,2,6,6
11,4,repeated,8,590,2,6,2
11,4,replacement,11,591,3,8,6.75
11,4,represent,9,592,3,6,2
11,4,reputation,10,593,3,7,6.75
11,4,respect,7,594,2,5,1.75
11,4,response,8,595,4,4,1.5
11,4,restoration,11,596,3,8,6.5
11,4,resume,6,597,3,3,1.25
11,4,retreat,7,598,2,5,1.5
11,4,review,6,599,2,4,5.5
11,4,rhythm,6,600,1,5,1.5
11,4,rice,4,601,1,3,1
11,4,ridiculous,10,602,2,8,6.75
11,4,risk,4,603,2,2,0.75
11,4,rock,4,604,1,3,1
11,4,role,4,605,2,2,0.75
11,4,rule,4,606,1,3,5.25
11,4,run,3,607,2,1,0.5
11,4,sad,3,608,0,3,1
11,4,sadly,5,609,3,2,0.75
11,4,salary,6,610,2,4,1.25
11,4,sandwich,8,611,2,6,6.5
11,4,scope,5,612,1,4,1.25
11,4,scream,6,613,2,4,1.5
11,4,screening,9,614,4,5,6
11,4,script,6,615,3,3,1.25
11,4,sea,3,616,1,2,0.75
11,4,section,7,617,2,5,6
11,4,seize,5,618,2,3,1.25
11,4,self,4,619,2,2,0.75
11,4,senator,7,620,2,5,1.5
11,4,senior,6,621,3,3,5.5
11,4,serial,6,622,2,4,1.5
11,4,set,3,623,2,1,0.5
11,4,shade,5,624,1,4,1.25
11,4,shadow,6,625,4,2,0.75
11,4,shall,5,626,3,2,5
11,4,shock,5,627,2,3,1.25
11,4,shop,4,628,3,1,0.5
11,4,short,5,629,3,2,0.75
11,4,shot,4,630,3,1,0.5
11,4,shout,5,631,3,2,0.75
11,4,show,4,632,3,1,0.5
11,4,significant,11,633,1,10,7.25
11,4,silence,7,634,2,5,1.75
11,4,silly,5,635,3,2,7.25
11,4,similarity,10,636,2,8,5.5
11,4,sincere,7,637,2,5,10.25
11,4,situation,9,638,2,7,4.75
11,4,skiing,6,639,1,5,3.5
11,4,skill,5,640,3,2,9.25
11,4,slave,5,641,1,4,3
11,4,sleep,5,642,2,3,2.5
11,4,slogan,6,643,2,4,3
11,4,smart,5,644,1,4,10.25
11,4,soar,4,645,1,3,2.25
11,4,socialist,9,646,2,7,5.5
11,4,society,7,647,4,3,11.75
11,4,software,8,648,2,6,4.75
11,4,solely,6,649,2,4,3.5
11,4,sort,4,650,2,2,10.5
11,4,speculate,9,651,1,8,6.25
11,4,spending,8,652,3,5,11.5
11,4,spill,5,653,2,3,2.25
11,4,spite,5,654,3,2,2
11,4,split,5,655,2,3,2.25
11,4,sponsor,7,656,2,5,3.5
11,4,sport,5,657,3,2,8.75
11,4,spot,4,658,3,1,1.25
11,4,stadium,7,659,1,6,4
11,4,stark,5,660,3,2,1.75
11,4,station,7,661,3,4,9.75
11,4,steep,5,662,2,3,2.25
11,4,stiff,5,663,2,3,2.25
11,4,stimulate,9,664,3,6,11.25
11,4,stress,6,665,2,4,3
11,4,student,7,666,2,5,3.5
11,4,stupid,6,667,3,3,2.5
11,4,style,5,668,2,3,9
11,4,suburb,6,669,1,5,3.5
11,4,successive,10,670,2,8,12
11,4,suddenly,8,671,2,6,4.25
11,4,suffering,9,672,2,7,11.75
11,4,suggestion,10,673,2,8,5.5
11,4,suicide,7,674,2,5,3.5
11,4,sum,3,675,2,1,8
11,4,summarize,9,676,3,6,4.5
11,4,summer,6,677,4,2,2
11,4,supermarket,11,678,2,9,17.5
11,4,supervisor,10,679,5,5,4.25
11,4,surface,7,680,2,5,10.75
11,4,surprising,10,681,3,7,5.25
11,4,surrender,9,682,3,6,12.25
11,4,sustain,7,683,2,5,3.75
11,4,sweet,5,684,1,4,2.75
11,4,swimming,8,685,2,6,12
11,4,swing,5,686,3,2,2.5
11,4,sympathetic,11,687,1,10,18.75
11,4,syndrome,8,688,2,6,1805.25
11,4,t,1,689,0,1,0.75
11,4,tax,3,690,1,2,1.5
11,4,teach,5,691,1,4,3
11,4,technique,9,692,2,7,16.75
11,4,teenage,7,693,2,5,4.5
11,4,teenager,8,694,7,1,1.75
11,4,temporarily,11,695,2,9,15
11,4,tennis,6,696,2,4,3.25
11,4,tenure,6,697,3,3,2.75
11,4,terrorist,9,698,2,7,13.5
11,4,text,4,699,2,2,1.75
11,4,that,4,700,1,3,2.25
11,4,theatre,7,701,2,5,12.5
11,4,their,5,702,3,2,2
11,4,theirs,6,703,5,1,1.5
11,4,them,4,704,3,1,1.25
11,4,then,4,705,3,1,1.25
11,4,theology,8,706,3,5,3.75
11,4,therefore,9,707,3,6,14.25
11,4,they,4,708,3,1,1.25
11,4,thick,5,709,2,3,2.5
11,4,thief,5,710,3,2,2
11,4,thin,4,711,3,1,1.25
11,4,think,5,712,4,1,9.75
11,4,third,5,713,3,2,2
11,4,though,6,714,2,4,3
11,4,thought,7,715,6,1,1.25
11,4,threat,6,716,2,4,3
11,4,threshold,9,717,4,5,12.75
11,4,thrive,6,718,3,3,2.75
11,4,throughout,10,719,3,7,5.25
11,4,throw,5,720,4,1,10.5
11,4,thursday,8,721,2,6,4.25
11,4,timber,6,722,1,5,4.25
11,4,tired,5,723,2,3,11.25
11,4,toll,4,724,1,3,2.25
11,4,ton,3,725,2,1,1.25
11,4,total,5,726,2,3,2.5
11,4,touch,5,727,2,3,2.5
11,4,tourist,7,728,3,4,11.25
11,4,towel,5,729,2,3,2.5
11,4,trading,7,730,1,6,4.25
11,4,traditional,11,731,5,6,12
11,4,training,8,732,3,5,3.75
11,4,transfer,8,733,3,5,3.75
11,4,transform,9,734,6,3,10.25
11,4,transition,10,735,5,5,4.25
11,4,transparent,11,736,5,6,11.75
11,4,true,4,737,2,2,1.75
11,4,trust,5,738,3,2,2
11,4,truth,5,739,3,2,1.75
11,4,try,3,740,2,1,1
11,4,tuesday,7,741,1,6,4
11,4,tuition,7,742,2,5,10.75
11,4,tunnel,6,743,2,4,3
11,4,turnout,7,744,2,5,10.5
11,4,type,4,745,1,3,2.25
11,4,typically,9,746,3,6,4.25
11,4,ultimately,10,747,0,10,13.5
11,4,under,5,748,1,4,2.75
11,4,understand,10,749,5,5,10.75
11,4,unfold,6,750,2,4,3
11,4,unfortunate,11,751,4,7,5.25
11,4,unit,4,752,2,2,8.75
11,4,unlikely,8,753,2,6,4.25
11,4,use,3,754,1,2,1.5
11,4,utterly,7,755,1,6,11
11,4,vast,4,756,0,4,2.75
11,4,vehicle,7,757,1,6,4
11,4,village,7,758,1,6,11
11,4,violate,7,759,2,5,3.75
11,4,violation,9,760,6,3,2.75
11,4,wage,4,761,0,4,9.75
11,4,want,4,762,2,2,1.75
11,4,warm,4,763,2,2,1.75
11,4,we,2,764,1,1,0.75
11,4,weak,4,765,2,2,1.5
11,4,wear,4,766,3,1,1
11,4,weekly,6,767,2,4,10.75
11,4,when,4,768,1,3,2.75
11,4,where,5,769,3,2,2
11,4,who,3,770,2,1,1.25
11,4,whole,5,771,3,2,2
11,4,wholly,6,772,4,2,2.25
11,4,widely,6,773,1,5,10.5
11,4,widespread,10,774,4,6,4.5
11,4,wise,4,775,2,2,1.75
11,4,wooden,6,776,1,5,10.5
11,4,workout,7,777,2,5,3.75
11,4,worm,4,778,3,1,1.25
11,4,worst,5,779,3,2,1.75
11,4,wrong,5,780,1,4,9.75
11,4,yell,4,781,0,4,2.75
11,4,yesterday,9,782,2,7,4.75
11,4,you,3,783,1,2,8.75
11,4,yours,5,784,3,2,2
11,4,zero,4,785,0,4,2.75
11,4,zone,4,786,1,3,2.25
11,5,abolish,7,0,0,7,8
11,5,abortion,8,1,3,5,3.75
11,5,about,5,2,3,2,5.25
11,5,acceptance,10,3,1,9,9.5
11,5,access,6,4,4,2,2
11,5,account,7,5,3,4,10.5
11,5,accountant,10,6,7,3,3
11,5,act,3,7,2,1,1
11,5,addition,8,8,1,7,11.75
11,5,advertise,9,9,2,7,5
11,5,afraid,6,10,1,5,3.5
11,5,aged,4,11,1,3,9.5
11,5,ah,2,12,1,1,0.75
11,5,air,3,13,1,2,1.5
11,5,aircraft,8,14,3,5,3.5
11,5,alert,5,15,1,4,10
11,5,alien,5,16,2,3,2.5
11,5,all,3,17,2,1,1
11,5,allegedly,9,18,3,6,4.25
11,5,allow,5,19,3,2,8.75
11,5,along,5,20,2,3,2.5
11,5,also,4,21,2,2,1.75
11,5,although,8,22,2,6,4
11,5,ambitious,9,23,1,8,16.5
11,5,angel,5,24,1,4,2.75
11,5,answer,6,25,2,4,10.5
11,5,anything,8,26,2,6,4.25
11,5,apart,5,27,1,4,2.75
11,5,apply,5,28,2,3,2.25
11,5,appointment,11,29,3,8,11.75
11,5,arena,5,30,1,4,1.5
11,5,armed,5,31,2,3,6.5
11,5,array,5,32,2,3,1.25
11,5,arrival,7,33,3,4,1.75
11,5,assess,6,34,1,5,1.75
11,5,asset,5,35,4,1,5.75
11,5,assign,6,36,3,3,1.25
11,5,associated,10,37,3,7,2.25
11,5,association,11,38,8,3,6
11,5,athlete,7,39,1,6,1.75
11,5,attach,6,40,2,4,1.5
11,5,attack,6,41,5,1,0.75
11,5,attendance,10,42,3,7,6.75
11,5,audience,8,43,1,7,2
11,5,audit,5,44,4,1,0.75
11,5,authority,9,45,2,7,7
11,5,autumn,6,46,3,3,1.25
11,5,avoid,5,47,1,4,1.25
11,5,awkward,7,48,1,6,6.5
11,5,back,4,49,0,4,1.25
11,5,bad,3,50,2,1,0.5
11,5,bake,4,51,2,2,0.75
11,5,ballot,6,52,2,4,5.75
11,5,bare,4,53,2,2,0.75
11,5,barrier,7,54,3,4,1.5
11,5,basket,6,55,2,4,6
11,5,basketball,10,56,6,4,2
11,5,bean,4,57,1,3,1
11,5,because,7,58,2,5,1.75
11,5,become,6,59,3,3,6
11,5,bee,3,60,2,1,0.5
11,5,beef,4,61,3,1,0.5
11,5,before,6,62,2,4,1.25
11,5,beginning,9,63,2,7,7.5
11,5,being,5,64,2,3,1.25
11,5,beneath,7,65,2,5,1.75
11,5,bent,4,66,3,1,0.75
11,5,bias,4,67,1,3,6
11,5,bicycle,7,68,2,5,1.5
11,5,biological,10,69,2,8,2.5
11,5,blanket,7,70,1,6,6.5
11,5,blast,5,71,3,2,1
11,5,blood,5,72,2,3,1.25
11,5,bold,4,73,1,3,6
11,5,bonus,5,74,2,3,1.25
11,5,booking,7,75,2,5,1.75
11,5,bounce,6,76,2,4,1.25
11,5,brain,5,77,1,4,6
11,5,breath,6,78,2,4,1.5
11,5,briefly,7,79,2,5,1.5
11,5,brilliant,9,80,3,6,6.75
11,5,bring,5,81,3,2,1
11,5,broadband,9,82,2,7,2
11,5,broadcast,9,83,5,4,6.5
11,5,brother,7,84,3,4,1.5
11,5,brown,5,85,3,2,0.75
11,5,buck,4,86,1,3,1
11,5,burial,6,87,2,4,6.25
11,5,busy,4,88,2,2,0.75
11,5,but,3,89,2,1,0.5
11,5,bye,3,90,1,2,0.75
11,5,cabin,5,91,0,5,1.5
11,5,calm,4,92,2,2,5.75
11,5,camp,4,93,2,2,0.75
11,5,capitalism,10,94,2,8,2.5
11,5,capture,7,95,3,4,6.5
11,5,carriage,8,96,2,6,2
11,5,carrot,6,97,4,2,1
11,5,castle,6,98,2,4,6.25
11,5,catch,5,99,2,3,1.25
11,5,caution,7,100,2,5,1.75
11,5,cautious,8,101,6,2,1
11,5,cent,4,102,1,3,6
11,5,centre,6,103,4,2,1
11,5,chaos,5,104,1,4,1.25
11,5,chat,4,105,3,1,0.5
11,5,chef,4,106,2,2,0.75
11,5,chest,5,107,3,2,1
11,5,cigarette,9,108,1,8,7
11,5,cinema,6,109,2,4,1.5
11,5,civic,5,110,2,3,3.5
11,5,classical,9,111,1,8,5
11,5,close,5,112,2,3,1.25
11,5,cloth,5,113,3,2,1
11,5,clothes,7,114,5,2,6
11,5,clothing,8,115,5,3,1.5
11,5,clue,4,116,2,2,0.75
11,5,coalition,9,117,1,8,7.5
11,5,coast,5,118,3,2,1
11,5,coastal,7,119,5,2,1
11,5,cocktail,8,120,2,6,1.75
11,5,cognitive,9,121,2,7,7.75
11,5,coincidence,11,122,2,9,5.25
11,5,collapse,8,123,2,6,4.75
11,5,college,7,124,4,3,1.5
11,5,colour,6,125,3,3,1.5
11,5,columnist,9,126,3,6,8
11,5,combat,6,127,2,4,1.5
11,5,commander,9,128,3,6,9
11,5,commentary,10,129,4,6,3.25
11,5,commerce,8,130,5,3,2.25
11,5,commit,6,131,4,2,1.5
11,5,commitment,10,132,6,4,8.5
11,5,common,6,133,4,2,1.25
11,5,communist,9,134,4,5,2.25
11,5,compare,7,135,3,4,7.25
11,5,comparison,10,136,6,4,2
11,5,compelling,10,137,4,6,2
11,5,competitive,11,138,5,6,7.25
11,5,complain,8,139,4,4,1.5
11,5,complaint,9,140,8,1,0.75
11,5,completely,10,141,5,5,2
11,5,compliance,10,142,5,5,6.75
11,5,comprise,8,143,4,4,1.5
11,5,compromise,10,144,5,5,2
11,5,concentrate,11,145,2,9,7.75
11,5,concerned,9,146,5,4,1.75
11,5,concrete,8,147,4,4,6.75
11,5,confession,10,148,3,7,2.5
11,5,conflict,8,149,4,4,6.75
11,5,conscience,10,150,3,7,2.25
11,5,consistent,10,151,4,6,2
11,5,constitute,10,152,4,6,7.25
11,5,consumer,8,153,4,4,1.5
11,5,contact,7,154,3,4,6.5
11,5,container,9,155,5,4,1.75
11,5,contest,7,156,4,3,1.25
11,5,continuous,10,157,4,6,2
11,5,contractor,10,158,4,6,7
11,5,contributor,11,159,5,6,2.25
11,5,convict,7,160,3,4,6.5
11,5,conviction,10,161,7,3,1.5
11,5,cooperate,9,162,2,7,2
11,5,correlate,9,163,2,7,7.25
11,5,cotton,6,164,2,4,1.5
11,5,council,7,165,2,5,6.75
11,5,counsellor,10,166,4,6,2.25
11,5,countless,9,167,4,5,2
11,5,countryside,11,168,5,6,8
11,5,covered,7,169,2,5,1.75
11,5,crazy,5,170,1,4,6.25
11,5,cream,5,171,2,3,1.25
11,5,creator,7,172,4,3,1.25
11,5,criterion,9,173,2,7,2.25
11,5,critical,8,174,4,4,6.75
11,5,crop,4,175,2,2,0.75
11,5,curiosity,9,176,1,8,7.5
11,5,custody,7,177,2,5,1.75
11,5,customer,8,178,5,3,1.25
11,5,cutting,7,179,2,5,1.5
11,5,dad,3,180,0,3,5.75
11,5,dancer,6,181,2,4,1.25
11,5,dark,4,182,2,2,0.75
11,5,data,4,183,2,2,0.75
11,5,dead,4,184,1,3,6
11,5,deadline,8,185,4,4,1.75
11,5,deadly,6,186,5,1,1
11,5,debris,6,187,2,4,1.5
11,5,decision,8,188,2,6,7.25
11,5,deck,4,189,3,1,0.75
11,5,declaration,11,190,3,8,2.75
11,5,dedication,10,191,2,8,8
11,5,defeat,6,192,2,4,1.5
11,5,defend,6,193,4,2,2.25
11,5,defensive,9,194,5,4,12.25
11,5,defy,4,195,3,1,1.25
11,5,denial,6,196,2,4,3
11,5,depend,6,197,2,4,3
11,5,dependence,10,198,6,4,11.75
11,5,dependent,9,199,8,1,2.25
11,5,depict,6,200,3,3,2.5
11,5,descent,7,201,2,5,3.5
11,5,desert,6,202,3,3,10.75
11,5,desperately,11,203,3,8,6.75
11,5,detection,9,204,2,7,15.25
11,5,deteriorate,11,205,4,7,6.75
11,5,diary,5,206,1,4,3.25
11,5,dictionary,10,207,2,8,16.25
11,5,die,3,208,2,1,1.25
11,5,differ,6,209,2,4,3.5
11,5,dilemma,7,210,2,5,13.5
11,5,directly,8,211,2,6,4.75
11,5,disagree,8,212,2,6,14.5
11,5,discharge,9,213,3,6,5
11,5,disease,7,214,3,4,3.5
11,5,dispute,7,215,3,4,25.25
11,5,distance,8,216,3,5,544.25
11,5,distinction,11,217,4,7,3.5
11,5,distinctive,11,218,9,2,7.25
11,5,distract,8,219,4,4,2
11,5,district,8,220,5,3,2
11,5,divorce,7,221,2,5,2
11,5,doctrine,8,222,1,7,10
11,5,dominate,8,223,2,6,5.5
11,5,donor,5,224,2,3,8.5
11,5,door,4,225,2,2,1.75
11,5,dose,4,226,2,2,1.5
11,5,dozen,5,227,2,3,2.75
11,5,drag,4,228,1,3,2.25
11,5,draw,4,229,3,1,1.25
11,5,dress,5,230,2,3,8.25
11,5,drug,4,231,2,2,2.25
11,5,drum,4,232,3,1,1.5
11,5,drunk,5,233,3,2,2.5
11,5,dry,3,234,2,1,1.5
11,5,due,3,235,1,2,2
11,5,dynamic,7,236,1,6,11.25
11,5,each,4,237,0,4,1.5
11,5,early,5,238,2,3,1.25
11,5,east,4,239,2,2,1
11,5,eastern,7,240,4,3,13
11,5,easy,4,241,3,1,1.75
11,5,eat,3,242,2,1,1.25
11,5,echo,4,243,1,3,2
11,5,economy,7,244,2,5,2
11,5,educated,8,245,1,7,13.25
11,5,eighteen,8,246,1,7,2.75
11,5,elaborate,9,247,1,8,15.5
11,5,electric,8,248,2,6,2.75
11,5,element,7,249,3,4,6.75
11,5,else,4,250,2,2,1
11,5,embarrassed,11,251,1,10,6.75
11,5,embed,5,252,3,2,1
11,5,emotional,9,253,2,7,2.25
11,5,emotionally,11,254,9,2,1
11,5,empty,5,255,2,3,4.75
11,5,encourage,9,256,1,8,2.5
11,5,encouraging,11,257,8,3,1.25
11,5,endorsement,11,258,2,9,6.5
11,5,energy,6,259,2,4,1.25
11,5,enforce,7,260,2,5,5.5
11,5,enhance,7,261,2,5,1.75
11,5,enough,6,262,2,4,1.25
11,5,entire,6,263,2,4,5
11,5,epidemic,8,264,1,7,2.25
11,5,equal,5,265,1,4,5
11,5,equation,8,266,4,4,1.75
11,5,equip,5,267,3,2,1.25
11,5,equivalent,10,268,4,6,2.5
11,5,era,3,269,1,2,4.25
11,5,error,5,270,2,3,1.25
11,5,escape,6,271,1,5,1.5
11,5,essential,9,272,2,7,5.75
11,5,eternal,7,273,1,6,1.75
11,5,ethic,5,274,2,3,1.25
11,5,ethical,7,275,5,2,4.25
11,5,every,5,276,1,4,1.25
11,5,everyday,8,277,5,3,1
11,5,everywhere,10,278,5,5,1.5
11,5,evolution,9,279,2,7,5.75
11,5,exaggerate,10,280,1,9,6
11,5,exam,4,281,3,1,0.5
11,5,excess,6,282,2,4,1.25
11,5,exert,5,283,2,3,1
11,5,exotic,6,284,2,4,4.75
11,5,expect,6,285,2,4,1.5
11,5,experience,10,286,4,6,2
11,5,explicit,8,287,3,5,5
11,5,explosion,9,288,4,5,2
11,5,export,6,289,3,3,1
11,5,extremely,9,290,2,7,5.75
11,5,fabulous,8,291,0,8,2.25
11,5,facility,8,292,2,6,5.5
11,5,fact,4,293,3,1,0.75
11,5,factor,6,294,4,2,1
11,5,fairness,8,295,2,6,1.75
11,5,faith,5,296,3,2,4.75
11,5,fame,4,297,2,2,0.75
11,5,fan,3,298,2,1,0.5
11,5,farm,4,299,2,2,0.75
11,5,fascinating,11,300,2,9,6
11,5,favourable,10,301,2,8,2.5
11,5,favourite,9,302,6,3,1.25
11,5,feed,4,303,1,3,4.5
11,5,feedback,8,304,4,4,1.25
11,5,feel,4,305,3,1,0.5
11,5,feeling,7,306,4,3,1.75
11,5,festival,8,307,2,6,9.75
11,5,fighting,8,308,1,7,4.75
11,5,figure,6,309,3,3,2.5
11,5,fill,4,310,2,2,7.25
11,5,film,4,311,3,1,1.25
11,5,final,5,312,2,3,2.25
11,5,finger,6,313,3,3,2.25
11,5,finish,6,314,3,3,2.25
11,5,fish,4,315,2,2,7
11,5,fishing,7,316,4,3,3
11,5,flash,5,317,1,4,2.75
11,5,flaw,4,318,3,1,1.25
11,5,fleet,5,319,2,3,2.25
11,5,flour,5,320,2,3,8.25
11,5,fluid,5,321,2,3,2.25
11,5,fold,4,322,1,3,2.25
11,5,fond,4,323,2,2,1.75
11,5,fool,4,324,2,2,1.75
11,5,forecast,8,325,2,6,9.75
11,5,forest,6,326,4,2,2
11,5,forever,7,327,4,3,2.75
11,5,forge,5,328,3,2,1.75
11,5,forgive,7,329,4,3,8
11,5,format,6,330,3,3,2.5
11,5,forth,5,331,3,2,1.75
11,5,frame,5,332,1,4,2.75
11,5,framework,9,333,5,4,8.75
11,5,franchise,9,334,3,6,4.5
11,5,freely,6,335,2,4,3
11,5,frightening,11,336,2,9,12.25
11,5,fund,4,337,1,3,2.25
11,5,fundraising,11,338,4,7,11.5
11,5,funny,5,339,3,2,1.75
11,5,generation,10,340,0,10,12.25
11,5,generic,7,341,5,2,2.25
11,5,generous,8,342,5,3,3
11,5,gentle,6,343,3,3,2.5
11,5,genuine,7,344,3,4,3
11,5,ghost,5,345,1,4,9.5
11,5,glad,4,346,1,3,2.25
11,5,goal,4,347,1,3,2.25
11,5,golden,6,348,2,4,3
11,5,gradually,9,349,1,8,12
11,5,graduate,8,350,6,2,2.25
11,5,grain,5,351,3,2,2
11,5,grand,5,352,3,2,8.5
11,5,grant,5,353,4,1,1.5
11,5,grass,5,354,3,2,2
11,5,great,5,355,2,3,2.75
11,5,greatly,7,356,5,2,2
11,5,greenhouse,10,357,3,7,15
11,5,guideline,9,358,1,8,10
11,5,half,4,359,0,4,9.25
11,5,hand,4,360,2,2,1.75
11,5,harassment,10,361,2,8,6
11,5,he,2,362,1,1,1
11,5,healthcare,10,363,2,8,12.75
11,5,hear,4,364,3,1,1.5
11,5,heating,7,365,3,4,3.5
11,5,helmet,6,366,2,4,12
11,5,help,4,367,3,1,3
11,5,hence,5,368,2,3,3.25
11,5,hero,4,369,2,2,1.75
11,5,hidden,6,370,1,5,3.5
11,5,hide,4,371,3,1,7.75
11,5,highway,7,372,2,5,4
11,5,hold,4,373,1,3,2.5
11,5,homework,8,374,2,6,13.25
11,5,hook,4,375,2,2,2
11,5,hopefully,9,376,2,7,5.25
11,5,hostile,7,377,2,5,10.25
11,5,housing,7,378,2,5,4
11,5,hungry,6,379,1,5,3.5
11,5,hurry,5,380,2,3,9
11,5,ideological,11,381,0,11,7.25
11,5,imagine,7,382,1,6,9.75
11,5,immense,7,383,2,5,3.75
11,5,imminent,8,384,3,5,10
11,5,inclined,8,385,1,7,4.75
11,5,including,9,386,4,5,4
11,5,indoor,6,387,2,4,8.75
11,5,induce,6,388,3,3,2.5
11,5,industrial,10,389,4,6,4.75
11,5,inhabitant,10,390,2,8,11
11,5,initial,7,391,2,5,3.5
11,5,inmate,6,392,2,4,8.5
11,5,innovative,10,393,2,8,5.5
11,5,insider,7,394,2,5,9
11,5,insight,7,395,4,3,2.75
11,5,inspire,7,396,3,4,3
11,5,institution,11,397,3,8,11.5
11,5,insult,6,398,3,3,2.5
11,5,intention,9,399,2,7,4.75
11,5,interactive,11,400,4,7,11.5
11,5,interpret,9,401,5,4,4
11,5,invasion,8,402,2,6,9.75
11,5,invent,6,403,3,3,2.5
11,5,investigate,11,404,4,7,5.25
11,5,investor,8,405,6,2,8.25
11,5,invitation,10,406,3,7,5
11,5,ironically,10,407,1,9,11.75
11,5,irrelevant,10,408,2,8,5.25
11,5,isolation,9,409,1,8,11.25
11,5,joint,5,410,0,5,3.25
11,5,journalist,10,411,2,8,11.25
11,5,justice,7,412,1,6,4
11,5,keen,4,413,0,4,8.75
11,5,kidnap,6,414,1,5,3.5
11,5,kill,4,415,2,2,1.75
11,5,kind,4,416,2,2,1.75
11,5,kiss,4,417,2,2,1.5
11,5,knowledge,9,418,1,8,11.25
11,5,label,5,419,0,5,3.25
11,5,labour,6,420,3,3,8.5
11,5,lamp,4,421,2,2,1.5
11,5,landing,7,422,2,5,3.5
11,5,landlord,8,423,4,4,3
11,5,lane,4,424,3,1,7
11,5,late,4,425,2,2,1.75
11,5,lately,6,426,4,2,1.75
11,5,lawsuit,7,427,2,5,3.5
11,5,lead,4,428,1,3,2
11,5,learn,5,429,3,2,8
11,5,legacy,6,430,2,4,2.75
11,5,legal,5,431,4,1,1.25
11,5,legislation,11,432,3,8,11.5
11,5,less,4,433,2,2,1.5
11,5,lesson,6,434,4,2,1.75
11,5,let,3,435,2,1,1
11,5,level,5,436,2,3,2.25
11,5,liberation,10,437,1,9,12
11,5,light,5,438,2,3,2.25
11,5,likewise,8,439,2,6,4.25
11,5,linger,6,440,2,4,9
11,5,literacy,8,441,2,6,4
11,5,lively,6,442,2,4,8.75
11,5,loan,4,443,1,3,2.25
11,5,lock,4,444,2,2,1.75
11,5,logo,4,445,2,2,1.5
11,5,loom,4,446,2,2,1.5
11,5,lost,4,447,2,2,1.5
11,5,lower,5,448,2,3,8
11,5,lung,4,449,1,3,2.25
11,5,magical,7,450,0,7,4.5
11,5,magnitude,9,451,3,6,10.75
11,5,major,5,452,2,3,2.5
11,5,mall,4,453,2,2,2
11,5,man,3,454,2,1,1.25
11,5,marginal,8,455,2,6,10.25
11,5,maths,5,456,2,3,2.25
11,5,maximize,8,457,2,6,3.25
11,5,maybe,5,458,2,3,5
11,5,me,2,459,1,1,0.5
11,5,means,5,460,2,3,1
11,5,measure,7,461,3,4,1.5
11,5,meditation,10,462,2,8,6.25
11,5,menu,4,463,2,2,0.75
11,5,metaphor,8,464,2,6,2
11,5,migration,9,465,1,8,6.25
11,5,mile,4,466,2,2,0.75
11,5,militant,8,467,3,5,1.75
11,5,milk,4,468,3,1,4.5
11,5,miner,5,469,2,3,1
11,5,mistake,7,470,2,5,1.5
11,5,mode,4,471,1,3,1
11,5,modern,6,472,4,2,4.5
11,5,modest,6,473,4,2,1
11,5,monitor,7,474,2,5,1.5
11,5,morality,8,475,2,6,1.75
11,5,motor,5,476,2,3,5
11,5,motorist,8,477,5,3,1.25
11,5,musical,7,478,1,6,1.75
11,5,mysterious,10,479,1,9,6.5
11,5,mystery,7,480,6,1,0.75
11,5,national,8,481,0,8,6
11,5,native,6,482,4,2,1
11,5,naval,5,483,2,3,1
11,5,necessity,9,484,1,8,6.25
11,5,neglect,7,485,2,5,1.5
11,5,nerve,5,486,2,3,1
11,5,nest,4,487,2,2,0.75
11,5,net,3,488,2,1,0.5
11,5,network,7,489,3,4,5.25
11,5,next,4,490,2,2,0.75
11,5,ninety,6,491,1,5,1.5
11,5,noble,5,492,1,4,5
11,5,nod,3,493,2,1,0.5
11,5,noon,4,494,2,2,0.75
11,5,nose,4,495,2,2,0.75
11,5,notable,7,496,2,5,1.5
11,5,notably,7,497,6,1,0.75
11,5,nowadays,8,498,2,6,6
11,5,number,6,499,1,5,1.5
11,5,nurse,5,500,2,3,1
11,5,o,1,501,0,1,4.25
11,5,obey,4,502,1,3,1
11,5,observe,7,503,2,5,1.75
11,5,obsession,9,504,4,5,5.5
11,5,occasion,8,505,1,7,2.25
11,5,occur,5,506,3,2,1
11,5,offender,8,507,1,7,5.75
11,5,on,2,508,1,1,0.5
11,5,onion,5,509,2,3,1
11,5,onto,4,510,2,2,0.75
11,5,open,4,511,1,3,1
11,5,operator,8,512,3,5,5.75
11,5,optimism,8,513,2,6,2
11,5,oral,4,514,1,3,1
11,5,orange,6,515,3,3,5.25
11,5,originally,10,516,2,8,2.5
11,5,out,3,517,1,2,0.75
11,5,oven,4,518,1,3,5
11,5,overnight,9,519,3,6,2
11,5,overseas,8,520,4,4,1.5
11,5,oxygen,6,521,1,5,5.5
11,5,packet,6,522,0,6,1.75
11,5,palm,4,523,2,2,1
11,5,pan,3,524,2,1,0.5
11,5,party,5,525,2,3,5
11,5,pass,4,526,2,2,0.75
11,5,passion,7,527,4,3,1.25
11,5,payment,7,528,2,5,1.5
11,5,penalty,7,529,1,6,5.5
11,5,people,6,530,2,4,1.5
11,5,permanently,11,531,2,9,6.75
11,5,person,6,532,3,3,1.25
11,5,persuade,8,533,4,4,1.5
11,5,phase,5,534,1,4,5.25
11,5,photography,11,535,2,9,2.75
11,5,pill,4,536,1,3,1
11,5,pilot,5,537,3,2,5.25
11,5,pink,4,538,2,2,0.75
11,5,pitch,5,539,2,3,1
11,5,plate,5,540,1,4,1.25
11,5,plug,4,541,2,2,0.75
11,5,policeman,9,542,1,8,6.5
11,5,pool,4,543,2,2,1
11,5,pop,3,544,2,1,0.5
11,5,popular,7,545,3,4,5.5
11,5,port,4,546,2,2,0.75
11,5,portray,7,547,4,3,1.25
11,5,potential,9,548,2,7,2.25
11,5,powder,6,549,2,4,5.5
11,5,powerful,8,550,3,5,1.75
11,5,practice,8,551,1,7,7.25
11,5,precision,9,552,2,7,2.25
11,5,prefer,6,553,3,3,1.25
11,5,preference,10,554,6,4,5.75
11,5,premium,7,555,3,4,1.5
11,5,prepare,7,556,3,4,1.5
11,5,present,7,557,3,4,7.5
11,5,president,9,558,4,5,4
11,5,pretty,6,559,3,3,2.5
11,5,prevalence,10,560,3,7,11.25
11,5,priest,6,561,2,4,3
11,5,princess,8,562,3,5,3.75
11,5,prison,6,563,3,3,8.75
11,5,prisoner,8,564,6,2,2.5
11,5,privilege,9,565,3,6,4.25
11,5,probable,8,566,2,6,10.75
11,5,productive,10,567,3,7,5
11,5,promote,7,568,3,4,3
11,5,pronounce,9,569,3,6,10.75
11,5,protect,7,570,3,4,3
11,5,protein,7,571,5,2,2
11,5,provide,7,572,3,4,9.5
11,5,province,8,573,5,3,3
11,5,provincial,10,574,7,3,3
11,5,provoke,7,575,4,3,2.75
11,5,psychology,10,576,1,9,12.5
11,5,punishment,10,577,1,9,12.25
11,5,purchase,8,578,2,6,4.25
11,5,purely,6,579,3,3,2.5
11,5,question,8,580,0,8,12
11,5,quickly,7,581,2,5,3.5
11,5,quota,5,582,2,3,2.25
11,5,quote,5,583,4,1,7.75
11,5,radio,5,584,0,5,3.25
11,5,rain,4,585,2,2,1.75
11,5,rare,4,586,2,2,1.75
11,5,read,4,587,1,3,2
11,5,real,4,588,3,1,7.5
11,5,realize,7,589,4,3,3
11,5,recession,9,590,2,7,4.75
11,5,recipe,6,591,3,3,2.5
11,5,recipient,9,592,5,4,10.25
11,5,refuge,6,593,2,4,3
11,5,register,8,594,2,6,11
11,5,regret,6,595,3,3,2.5
11,5,regulator,9,596,3,6,4.5
11,5,reinforce,9,597,2,7,12.25
11,5,relatively,10,598,2,8,5.5
11,5,relaxing,8,599,4,4,11.75
11,5,release,7,600,3,4,3.75
11,5,reliability,11,601,3,8,6
11,5,reliable,8,602,6,2,9.25
11,5,rely,4,603,3,1,1.25
11,5,remarkable,10,604,2,8,5.5
11,5,remember,8,605,3,5,10.75
11,5,reminder,8,606,3,5,3.75
11,5,remote,6,607,3,3,2.5
11,5,renowned,8,608,2,6,10.75
11,5,replacement,11,609,2,9,6.25
11,5,report,6,610,3,3,9.25
11,5,reproduce,9,611,3,6,4.5
11,5,reputation,10,612,3,7,12
11,5,request,7,613,2,5,3.75
11,5,response,8,614,2,6,4.25
11,5,restraint,9,615,3,6,11
11,5,retreat,7,616,2,5,3.5
11,5,review,6,617,2,4,3
11,5,rhythm,6,618,1,5,10
11,5,rice,4,619,1,3,2.25
11,5,rid,3,620,2,1,1
11,5,riot,4,621,2,2,1.75
11,5,risk,4,622,2,2,1.5
11,5,rock,4,623,1,3,8.75
11,5,role,4,624,2,2,1.75
11,5,rugby,5,625,1,4,2.75
11,5,rule,4,626,2,2,1.75
11,5,run,3,627,2,1,1
11,5,sadly,5,628,0,5,9.75
11,5,sandwich,8,629,2,6,4.25
11,5,say,3,630,2,1,1
11,5,scope,5,631,1,4,9.5
11,5,scream,6,632,2,4,3
11,5,screening,9,633,4,5,4
11,5,script,6,634,3,3,2.5
11,5,sea,3,635,1,2,8.25
11,5,see,3,636,2,1,1
11,5,self,4,637,2,2,1.5
11,5,send,4,638,2,2,1.5
11,5,senior,6,639,3,3,2.25
11,5,sensation,9,640,3,6,11
11,5,session,7,641,2,5,3.5
11,5,set,3,642,2,1,1
11,5,shade,5,643,1,4,2.75
11,5,shadow,6,644,4,2,8.5
11,5,shall,5,645,3,2,1.75
11,5,shocking,8,646,2,6,4.25
11,5,shop,4,647,3,1,1.25
11,5,should,6,648,3,3,2.5
11,5,shout,5,649,4,1,8.75
11,5,sigh,4,650,1,3,2.25
11,5,silent,6,651,2,4,3
11,5,similarity,10,652,2,8,15
11,5,simulate,8,653,3,5,5
11,5,sixty,5,654,2,3,2.75
11,5,sky,3,655,1,2,1.5
11,5,slot,4,656,1,3,6
11,5,small,5,657,1,4,1.25
11,5,smart,5,658,3,2,1
11,5,snap,4,659,1,3,1
11,5,society,7,660,1,6,6
11,5,software,8,661,2,6,2
11,5,somewhere,9,662,2,7,7
11,5,son,3,663,2,1,0.5
11,5,soon,4,664,2,2,0.75
11,5,speculate,9,665,1,8,2.5
11,5,spending,8,666,3,5,6.25
11,5,spoil,5,667,2,3,1
11,5,spoon,5,668,3,2,1
11,5,spy,3,669,2,1,0.5
11,5,stabilize,9,670,1,8,6.75
11,5,stark,5,671,3,2,1
11,5,statement,9,672,3,6,6.5
11,5,station,7,673,4,3,1.5
11,5,statistical,11,674,5,6,2.5
11,5,status,6,675,4,2,1.25
11,5,steel,5,676,2,3,5.75
11,5,steep,5,677,4,1,0.75
11,5,struggle,8,678,2,6,2
11,5,student,7,679,2,5,1.5
11,5,stunning,8,680,3,5,6.25
11,5,style,5,681,2,3,1
11,5,suburb,6,682,1,5,1.5
11,5,successive,10,683,2,8,7
11,5,suffer,6,684,2,4,1.5
11,5,suicide,7,685,2,5,6.25
11,5,sum,3,686,2,1,0.5
11,5,summer,6,687,3,3,1
11,5,summit,6,688,4,2,0.75
11,5,superb,6,689,2,4,1.5
11,5,supervision,11,690,5,6,6.75
11,5,supplement,10,691,3,7,2.5
11,5,surface,7,692,2,5,6.25
11,5,surge,5,693,3,2,1
11,5,surprised,9,694,3,6,2
11,5,surprising,10,695,7,3,6.25
11,5,surrender,9,696,3,6,2.25
11,5,survive,7,697,3,4,1.5
11,5,symbol,6,698,1,5,6
11,5,systematic,10,699,2,8,2.5
11,5,tag,3,700,0,3,1
11,5,tax,3,701,2,1,5
11,5,teach,5,702,1,4,1.5
11,5,technical,9,703,2,7,2.25
11,5,technique,9,704,6,3,6
11,5,teenage,7,705,2,5,1.75
11,5,tennis,6,706,2,4,1.25
11,5,terminal,8,707,2,6,6.25
11,5,terrible,8,708,3,5,2
11,5,terrorist,9,709,4,5,2
11,5,testify,7,710,2,5,6.25
11,5,text,4,711,2,2,1
11,5,than,4,712,1,3,1
11,5,theology,8,713,2,6,6.5
11,5,there,5,714,3,2,1
11,5,thick,5,715,2,3,1
11,5,thinking,8,716,3,5,2
11,5,though,6,717,2,4,6
11,5,threat,6,718,2,4,1.25
11,5,threaten,8,719,6,2,1
11,5,threshold,9,720,4,5,6.25
11,5,thrive,6,721,3,3,1.5
11,5,throat,6,722,3,3,1.25
11,5,throw,5,723,4,1,0.75
11,5,timber,6,724,1,5,1.5
11,5,tiny,4,725,2,2,5.25
11,5,ton,3,726,1,2,0.75
11,5,total,5,727,2,3,1.25
11,5,toy,3,728,2,1,0.5
11,5,trace,5,729,1,4,1.25
11,5,trading,7,730,3,4,6.5
11,5,training,8,731,3,5,2
11,5,transform,9,732,3,6,2.25
11,5,transition,10,733,5,5,7.5
11,5,transparent,11,734,5,6,3
11,5,true,4,735,2,2,1.25
11,5,trust,5,736,3,2,6.25
11,5,truth,5,737,3,2,1.25
11,5,tuesday,7,738,1,6,2.25
11,5,tuition,7,739,2,5,6.5
11,5,turn,4,740,2,2,0.75
11,5,turnout,7,741,4,3,1
11,5,twist,5,742,1,4,1.5
11,5,typical,7,743,1,6,6.25
11,5,ugly,4,744,0,4,1.25
11,5,umbrella,8,745,1,7,2.25
11,5,under,5,746,1,4,6
11,5,unfold,6,747,2,4,1.5
11,5,unfortunate,11,748,4,7,6.75
11,5,unlike,6,749,2,4,1.5
11,5,upper,5,750,1,4,1.25
11,5,upset,5,751,2,3,1.25
11,5,us,2,752,1,1,0.5
11,5,user,4,753,2,2,5.5
11,5,vast,4,754,0,4,1.25
11,5,vehicle,7,755,1,6,2
11,5,versus,6,756,2,4,6.25
11,5,very,4,757,3,1,0.75
11,5,volume,6,758,1,5,1.5
11,5,vote,4,759,2,2,1
11,5,ward,4,760,0,4,5.75
11,5,we,2,761,1,1,0.5
11,5,wear,4,762,2,2,0.75
11,5,wedding,7,763,2,5,1.75
11,5,weekly,6,764,2,4,1.25
11,5,well,4,765,2,2,5.75
11,5,what,4,766,1,3,1
11,5,wheat,5,767,2,3,1.25
11,5,whilst,6,768,2,4,1.5
11,5,wholly,6,769,2,4,6.25
11,5,wide,4,770,1,3,1
11,5,widely,6,771,4,2,1
11,5,widespread,10,772,4,6,2
11,5,winner,6,773,2,4,6.25
11,5,winter,6,774,3,3,1.25
11,5,wish,4,775,2,2,0.75
11,5,worse,5,776,1,4,1.25
11,5,worst,5,777,4,1,7.75
11,5,wound,5,778,2,3,3.25
11,5,writer,6,779,1,5,2119
11,5,year,4,780,0,4,2.5
11,5,yesterday,9,781,2,7,10.25
11,5,you,3,782,1,2,1
11,5,yours,5,783,3,2,1
11,5,yourself,8,784,5,3,1.5
11,5,zero,4,785,0,4,1.5
11,5,zone,4,786,1,3,6.75
11,6,abolish,7,0,0,7,2.75
11,6,abortion,8,1,3,5,7.25
11,6,absent,6,2,2,4,1.5
11,6,accessible,10,3,1,9,8.5
11,6,according,9,4,3,6,2.5
11,6,accountable,11,5,4,7,8.25
11,6,accuracy,8,6,3,5,2
11,6,admission,9,7,1,8,8.25
11,6,advertise,9,8,2,7,3.25
11,6,advertising,11,9,8,3,1.75
11,6,affection,9,10,1,8,8.25
11,6,afford,6,11,3,3,1.5
11,6,afraid,6,12,2,4,6.75
11,6,aged,4,13,1,3,1.25
11,6,aid,3,14,1,2,0.75
11,6,air,3,15,2,1,0.75
11,6,alien,5,16,1,4,1.5
11,6,alignment,9,17,3,6,7.5
11,6,all,3,18,2,1,0.75
11,6,allege,6,19,3,3,1.25
11,6,allow,5,20,3,2,1
11,6,alone,5,21,2,3,1.25
11,6,along,5,22,4,1,0.75
11,6,although,8,23,2,6,7.75
11,6,altogether,10,24,3,7,2.75
11,6,ambitious,9,25,1,8,8
11,6,amid,4,26,2,2,1
11,6,angel,5,27,1,4,1.5
11,6,angry,5,28,3,2,6.25
11,6,anyone,6,29,2,4,1.75
11,6,anything,8,30,3,5,2.25
11,6,apart,5,31,1,4,6.5
11,6,appetite,8,32,2,6,2.25
11,6,apply,5,33,3,2,1.25
11,6,april,5,34,2,3,1.25
11,6,armed,5,35,1,4,5.75
11,6,array,5,36,2,3,1.25
11,6,arrival,7,37,3,4,1.5
11,6,article,7,38,2,5,6.5
11,6,asset,5,39,1,4,1.25
11,6,assignment,10,40,3,7,2.5
11,6,associated,10,41,3,7,7.75
11,6,athlete,7,42,1,6,2.25
11,6,attack,6,43,2,4,6.25
11,6,attempt,7,44,3,4,1.5
11,6,attend,6,45,4,2,1
11,6,attendance,10,46,6,4,1.75
11,6,attribute,9,47,3,6,6.75
11,6,audience,8,48,1,7,2
11,6,author,6,49,2,4,6.25
11,6,avoid,5,50,1,4,1.25
11,6,aware,5,51,1,4,1.25
11,6,awkward,7,52,2,5,6.5
11,6,backdrop,8,53,0,8,2.25
11,6,bake,4,54,2,2,1
11,6,banana,6,55,2,4,6.25
11,6,bare,4,56,2,2,0.75
11,6,basis,5,57,2,3,1
11,6,bean,4,58,1,3,1
11,6,bear,4,59,3,1,0.5
11,6,before,6,60,2,4,6
11,6,beginning,9,61,2,7,2.25
11,6,being,5,62,2,3,1
11,6,beneath,7,63,2,5,6.25
11,6,bet,3,64,2,1,0.5
11,6,bias,4,65,1,3,1
11,6,blanket,7,66,1,6,1.75
11,6,blend,5,67,2,3,6.25
11,6,blessing,8,68,3,5,2.25
11,6,blood,5,69,2,3,1
11,6,booking,7,70,1,6,7.75
11,6,boring,6,71,2,4,1.75
11,6,bread,5,72,1,4,1.5
11,6,breast,6,73,4,2,7
11,6,breath,6,74,4,2,1.25
11,6,brick,5,75,2,3,1
11,6,briefly,7,76,3,4,1.5
11,6,brilliant,9,77,3,6,7.25
11,6,broad,5,78,2,3,1.25
11,6,broadband,9,79,5,4,1.5
11,6,broadcast,9,80,5,4,1.25
11,6,broadly,7,81,5,2,6
11,6,brown,5,82,3,2,0.75
11,6,buck,4,83,1,3,1
11,6,bulk,4,84,2,2,0.75
11,6,burial,6,85,2,4,1.5
11,6,bus,3,86,2,1,5
11,6,but,3,87,2,1,0.5
11,6,button,6,88,3,3,1.25
11,6,bye,3,89,1,2,0.75
11,6,cabin,5,90,0,5,1.5
11,6,camp,4,91,2,2,3.25
11,6,captain,7,92,2,5,4
11,6,capture,7,93,4,3,1.25
11,6,carriage,8,94,2,6,11.25
11,6,carrot,6,95,4,2,2
11,6,cattle,6,96,2,4,3
11,6,cause,5,97,2,3,2.25
11,6,chance,6,98,1,5,11.25
11,6,chaos,5,99,3,2,1.75
11,6,chat,4,100,3,1,1.25
11,6,chef,4,101,2,2,1.5
11,6,chest,5,102,3,2,1.75
11,6,circulation,11,103,1,10,13.75
11,6,civic,5,104,2,3,2.25
11,6,classic,7,105,1,6,11.25
11,6,classify,8,106,6,2,2.5
11,6,cleaning,8,107,2,6,4.25
11,6,clinic,6,108,2,4,2.75
11,6,closure,7,109,2,5,11.25
11,6,cloth,5,110,3,2,2
11,6,clothing,8,111,5,3,2.75
11,6,coalition,9,112,1,8,12.75
11,6,coastal,7,113,3,4,3
11,6,cocktail,8,114,2,6,4.25
11,6,cognitive,9,115,2,7,12.25
11,6,coin,4,116,2,2,1.5
11,6,coincidence,11,117,4,7,12.5
11,6,comic,5,118,2,3,2.25
11,6,commentary,10,119,3,7,5
11,6,common,6,120,4,2,9.5
11,6,compare,7,121,3,4,3
11,6,compelling,10,122,4,6,4.5
11,6,competitive,11,123,5,6,12.25
11,6,completely,10,124,4,6,4.5
11,6,complex,7,125,6,1,1.5
11,6,compose,7,126,4,3,2.5
11,6,compromise,10,127,4,6,12.5
11,6,conception,10,128,2,8,13.5
11,6,confession,10,129,3,7,5.75
11,6,confirm,7,130,4,3,3.25
11,6,conflict,8,131,4,4,13.25
11,6,conscience,10,132,3,7,6
11,6,consecutive,11,133,4,7,15
11,6,conserve,8,134,5,3,3.75
11,6,consist,7,135,4,3,3.25
11,6,consistent,10,136,7,3,3.5
11,6,conspiracy,10,137,4,6,12.75
11,6,construct,9,138,4,5,4
11,6,contact,7,139,3,4,3
11,6,container,9,140,5,4,11.25
11,6,contest,7,141,4,3,2.5
11,6,contract,8,142,4,4,3
11,6,contractor,10,143,8,2,2.25
11,6,conviction,10,144,3,7,13
11,6,cook,4,145,2,2,1.75
11,6,cool,4,146,3,1,1.25
11,6,cooperate,9,147,3,6,11.75
11,6,copy,4,148,2,2,1.75
11,6,correlate,9,149,2,7,4.75
11,6,correlation,11,150,8,3,2.75
11,6,correspond,10,151,5,5,11.75
11,6,cotton,6,152,2,4,3
11,6,council,7,153,2,5,3.5
11,6,countryside,11,154,4,7,13
11,6,courage,7,155,3,4,3.25
11,6,covered,7,156,2,5,11.25
11,6,creator,7,157,1,6,4
11,6,critical,8,158,2,6,12.5
11,6,cult,4,159,1,3,2.25
11,6,cupboard,8,160,2,6,4.25
11,6,custody,7,161,2,5,11.25
11,6,cutting,7,162,2,5,3.5
11,6,date,4,163,0,4,2.75
11,6,debris,6,164,1,5,11.5
11,6,debut,5,165,3,2,2
11,6,decision,8,166,2,6,4.5
11,6,deck,4,167,3,1,1.25
11,6,declaration,11,168,3,8,14.25
11,6,decorate,8,169,3,5,3.75
11,6,defend,6,170,2,4,11
11,6,delegation,10,171,2,8,6.25
11,6,denial,6,172,2,4,3.5
11,6,depend,6,173,2,4,15
11,6,dependent,9,174,6,3,4.75
11,6,depict,6,175,3,3,3
11,6,descent,7,176,2,5,13.75
11,6,desire,6,177,3,3,3.25
11,6,desperately,11,178,3,8,6.75
11,6,deteriorate,11,179,2,9,16.5
11,6,development,11,180,2,9,16.75
11,6,devise,6,181,3,3,3.25
11,6,die,3,182,1,2,1.75
11,6,differ,6,183,2,4,2.75
11,6,dilemma,7,184,2,5,11.75
11,6,dimension,9,185,2,7,4.75
11,6,direction,9,186,2,7,12.5
11,6,directly,8,187,6,2,2.5
11,6,directory,9,188,6,3,3
11,6,disability,10,189,2,8,13
11,6,disagree,8,190,4,4,3.25
11,6,disorder,8,191,3,5,3.75
11,6,dispose,7,192,3,4,11
11,6,distance,8,193,3,5,3.75
11,6,distinct,8,194,4,4,3.25
11,6,distinction,11,195,8,3,10.5
11,6,distinctive,11,196,9,2,3
11,6,diverse,7,197,2,5,3.5
11,6,divert,6,198,5,1,1.25
11,6,doctrine,8,199,1,7,13
11,6,documentary,11,200,3,8,5.5
11,6,donate,6,201,2,4,11.25
11,6,donor,5,202,3,2,2.25
11,6,dozen,5,203,2,3,2.25
11,6,drag,4,204,1,3,2.25
11,6,drive,5,205,2,3,2.25
11,6,driver,6,206,5,1,1.25
11,6,drum,4,207,2,2,10
11,6,drunk,5,208,3,2,2
11,6,dry,3,209,2,1,1
11,6,due,3,210,1,2,1.5
11,6,dull,4,211,2,2,1.75
11,6,dynamic,7,212,1,6,12.5
11,6,each,4,213,0,4,2.75
11,6,early,5,214,2,3,2.25
11,6,eastern,7,215,2,5,3.5
11,6,economics,9,216,1,8,14.75
11,6,economy,7,217,6,1,1.75
11,6,edge,4,218,1,3,2.5
11,6,editorial,9,219,2,7,10.5
11,6,educated,8,220,2,6,2.25
11,6,education,9,221,6,3,7.5
11,6,elaborate,9,222,1,8,2.75
11,6,electoral,9,223,2,7,8.25
11,6,element,7,224,3,4,1.75
11,6,else,4,225,2,2,0.75
11,6,embed,5,226,1,4,1.25
11,6,emotional,9,227,2,7,8.25
11,6,emotionally,11,228,9,2,1.25
11,6,emphasize,9,229,2,7,8
11,6,empire,6,230,3,3,1.5
11,6,empty,5,231,3,2,1
11,6,encouraging,11,232,1,10,9
11,6,endorse,7,233,2,5,1.75
11,6,energy,6,234,2,4,1.5
11,6,enquire,7,235,2,5,7.5
11,6,entirely,8,236,2,6,2.25
11,6,entity,6,237,4,2,1.25
11,6,equivalent,10,238,1,9,8.25
11,6,error,5,239,1,4,1.25
11,6,escalate,8,240,1,7,7.75
11,6,escape,6,241,4,2,1
11,6,ethic,5,242,1,4,1.25
11,6,evolve,6,243,1,5,6.5
11,6,exaggerate,10,244,1,9,2.75
11,6,exam,4,245,3,1,0.75
11,6,example,7,246,4,3,6.5
11,6,excess,6,247,2,4,1.5
11,6,exclude,7,248,3,4,1.5
11,6,exert,5,249,2,3,1
11,6,exotic,6,250,2,4,6.75
11,6,expect,6,251,2,4,1.5
11,6,explosion,9,252,3,6,2
11,6,export,6,253,3,3,6.5
11,6,exposure,8,254,4,4,1.75
11,6,external,8,255,2,6,2
11,6,fabulous,8,256,0,8,566.5
11,6,fact,4,257,2,2,3.25
11,6,faction,7,258,4,3,4.5
11,6,fairness,8,259,2,6,18.75
11,6,faith,5,260,3,2,4.75
11,6,farm,4,261,2,2,3.25
11,6,favourable,10,262,2,8,9.5
11,6,favourite,9,263,6,3,14.25
11,6,feat,4,264,1,3,2.75
11,6,feather,7,265,4,3,2.75
11,6,feed,4,266,2,2,2.25
11,6,feel,4,267,3,1,1.5
11,6,fence,5,268,2,3,12.75
11,6,festival,8,269,2,6,5.5
11,6,fifth,5,270,1,4,3.5
11,6,figure,6,271,2,4,13.75
11,6,film,4,272,2,2,3.25
11,6,find,4,273,2,2,3
11,6,finish,6,274,3,3,4.5
11,6,firearm,7,275,2,5,6.75
11,6,first,5,276,3,2,20
11,6,fish,4,277,2,2,3.25
11,6,fishing,7,278,4,3,4.75
11,6,five,4,279,2,2,3.25
11,6,flame,5,280,1,4,5
11,6,flaw,4,281,3,1,22
11,6,flawed,6,282,4,2,2.5
11,6,fleet,5,283,2,3,3
11,6,float,5,284,2,3,3
11,6,flood,5,285,3,2,2.5
11,6,fond,4,286,1,3,22.25
11,6,fool,4,287,2,2,2.25
11,6,forest,6,288,2,4,3.75
11,6,forgive,7,289,3,4,4
11,6,fork,4,290,3,1,1.5
11,6,formal,6,291,3,3,23.25
11,6,format,6,292,5,1,2.25
11,6,formulate,9,293,4,5,6
11,6,frame,5,294,1,4,3.5
11,6,franchise,9,295,3,6,20.5
11,6,frankly,7,296,4,3,3.5
11,6,freely,6,297,2,4,4
11,6,from,4,298,2,2,2.25
11,6,fun,3,299,1,2,9
11,6,function,8,300,3,5,4.25
11,6,fundraising,11,301,3,8,11.75
11,6,funny,5,302,3,2,2
11,6,gang,4,303,0,4,2.75
11,6,garden,6,304,2,4,3
11,6,gas,3,305,2,1,1
11,6,gathering,9,306,2,7,11
11,6,generation,10,307,1,9,12
11,6,generic,7,308,5,2,2
11,6,gentle,6,309,3,3,2.5
11,6,gentleman,9,310,6,3,2.5
11,6,ghost,5,311,1,4,2.75
11,6,golden,6,312,1,5,9.25
11,6,gorgeous,8,313,2,6,4.25
11,6,governance,10,314,2,8,11.75
11,6,grain,5,315,1,4,3
11,6,great,5,316,2,3,2.5
11,6,greenhouse,10,317,3,7,11.25
11,6,guideline,9,318,1,8,5.25
11,6,half,4,319,0,4,8.75
11,6,halt,4,320,3,1,1
11,6,hardware,8,321,2,6,4.25
11,6,hearing,7,322,1,6,10.5
11,6,heating,7,323,3,4,3.25
11,6,hello,5,324,2,3,2.25
11,6,helmet,6,325,3,3,5.25
11,6,help,4,326,3,1,4.75
11,6,hence,5,327,2,3,2.5
11,6,here,4,328,2,2,1.5
11,6,hero,4,329,3,1,1
11,6,hidden,6,330,1,5,3.25
11,6,hide,4,331,3,1,1.25
11,6,hierarchy,9,332,2,7,10.75
11,6,highway,7,333,2,5,3.5
11,6,himself,7,334,2,5,10
11,6,historian,9,335,2,7,5.25
11,6,hobby,5,336,1,4,9.5
11,6,hold,4,337,2,2,1.75
11,6,holy,4,338,3,1,1.25
11,6,honour,6,339,2,4,2.75
11,6,host,4,340,2,2,1.5
11,6,hostile,7,341,4,3,2.25
11,6,house,5,342,2,3,8.25
11,6,hungry,6,343,1,5,3.5
11,6,hurry,5,344,2,3,2.25
11,6,husband,7,345,2,5,9.5
11,6,ideological,11,346,0,11,7
11,6,ideology,8,347,7,1,8
11,6,if,2,348,1,1,0.75
11,6,illness,7,349,1,6,4
11,6,immigrant,9,350,1,8,11.5
11,6,impress,7,351,2,5,3.75
11,6,in,2,352,1,1,0.75
11,6,inadequate,10,353,2,8,8.5
11,6,incentive,9,354,2,7,2.25
11,6,inclined,8,355,3,5,5.25
11,6,indeed,6,356,2,4,1.25
11,6,indication,10,357,3,7,2.25
11,6,indoor,6,358,3,3,4.5
11,6,indoors,7,359,6,1,1
11,6,infection,9,360,2,7,2
11,6,inflation,9,361,3,6,5.5
11,6,inhabitant,10,362,2,8,2.5
11,6,initial,7,363,2,5,5
11,6,injured,7,364,2,5,1.75
11,6,insect,6,365,2,4,1.25
11,6,insight,7,366,3,4,5
11,6,inspiration,11,367,3,8,2.75
11,6,instantly,9,368,3,6,5.5
11,6,intensity,9,369,2,7,2.25
11,6,intention,9,370,5,4,1.5
11,6,interested,10,371,4,6,5.75
11,6,interface,9,372,5,4,1.5
11,6,interpret,9,373,5,4,1.5
11,6,introduce,9,374,3,6,5.75
11,6,investor,8,375,2,6,1.75
11,6,invisible,9,376,3,6,5.75
11,6,invoke,6,377,3,3,1
11,6,involvement,11,378,4,7,2.25
11,6,ironically,10,379,1,9,6.25
11,6,jam,3,380,0,3,1
11,6,jeans,5,381,1,4,5
11,6,journalist,10,382,1,9,2.75
11,6,july,4,383,1,3,4.75
11,6,keen,4,384,0,4,1.25
11,6,kidnap,6,385,1,5,1.75
11,6,killing,7,386,2,5,5.5
11,6,kiss,4,387,2,2,1
11,6,knock,5,388,1,4,1.25
11,6,labour,6,389,0,6,1.75
11,6,lamp,4,390,2,2,4.5
11,6,language,8,391,2,6,2
11,6,laptop,6,392,2,4,1.25
11,6,late,4,393,2,2,4.25
11,6,lately,6,394,4,2,1
11,6,lawyer,6,395,2,4,1.25
11,6,layout,6,396,2,4,1.25
11,6,lead,4,397,1,3,4.5
11,6,leap,4,398,3,1,0.75
11,6,legacy,6,399,2,4,1.5
11,6,less,4,400,2,2,0.75
11,6,lesson,6,401,4,2,0.75
11,6,let,3,402,2,1,0.5
11,6,liberation,10,403,1,9,6.25
11,6,lifetime,8,404,2,6,2
11,6,limit,5,405,2,3,4.75
11,6,linger,6,406,2,4,1.25
11,6,literacy,8,407,2,6,1.75
11,6,lobby,5,408,1,4,5
11,6,logic,5,409,2,3,1
11,6,logo,4,410,3,1,0.5
11,6,lose,4,411,2,2,0.75
11,6,lovely,6,412,2,4,1.5
11,6,magazine,8,413,0,8,6.5
11,6,magical,7,414,3,4,1.5
11,6,major,5,415,2,3,1
11,6,man,3,416,2,1,4
11,6,management,10,417,3,7,2.25
11,6,manifest,8,418,3,5,1.5
11,6,marathon,8,419,2,6,5.75
11,6,marginal,8,420,3,5,1.75
11,6,marker,6,421,3,3,1.25
11,6,marry,5,422,3,2,5
11,6,maths,5,423,2,3,1
11,6,maximize,8,424,2,6,1.75
11,6,maybe,5,425,2,3,4.75
11,6,mayor,5,426,3,2,1
11,6,measure,7,427,1,6,1.75
11,6,metal,5,428,2,3,1
11,6,metaphor,8,429,4,4,5.25
11,6,mile,4,430,1,3,1
11,6,military,8,431,3,5,1.5
11,6,milk,4,432,3,1,0.5
11,6,mill,4,433,3,1,0.5
11,6,minimize,8,434,2,6,5.5
11,6,minute,6,435,3,3,1.25
11,6,miracle,7,436,2,5,1.5
11,6,modern,6,437,1,5,5.25
11,6,momentum,8,438,2,6,2
11,6,monk,4,439,2,2,0.75
11,6,moral,5,440,2,3,4.5
11,6,morality,8,441,5,3,1.25
11,6,morning,7,442,3,4,1.5
11,6,motorcycle,10,443,2,8,6.25
11,6,motorist,8,444,5,3,1.25
11,6,move,4,445,2,2,0.75
11,6,multiply,8,446,1,7,5.75
11,6,musical,7,447,2,5,1.75
11,6,mutual,6,448,2,4,1.25
11,6,myself,6,449,1,5,5.25
11,6,mystery,7,450,3,4,1.5
11,6,nail,4,451,0,4,1.25
11,6,national,8,452,2,6,5.75
11,6,native,6,453,4,2,1
11,6,naturally,9,454,3,6,2
11,6,nerve,5,455,1,4,5
11,6,net,3,456,2,1,0.5
11,6,news,4,457,2,2,0.75
11,6,next,4,458,2,2,0.75
11,6,nineteen,8,459,1,7,6
11,6,noble,5,460,1,4,1.25
11,6,noon,4,461,2,2,1
11,6,notably,7,462,2,5,1.5
11,6,now,3,463,2,1,0.5
11,6,nowadays,8,464,3,5,5.75
11,6,nurse,5,465,1,4,1.25
11,6,nursery,7,466,5,2,0.75
11,6,nursing,7,467,4,3,1
11,6,nutrition,9,468,2,7,6
11,6,o,1,469,0,1,0.25
11,6,object,6,470,1,5,1.5
11,6,observe,7,471,2,5,5.5
11,6,obsession,9,472,4,5,1.75
11,6,occasional,10,473,1,9,6.25
11,6,offender,8,474,1,7,2
11,6,offer,5,475,4,1,0.75
11,6,offering,8,476,5,3,5
11,6,on,2,477,1,1,0.5
11,6,ongoing,7,478,2,5,1.5
11,6,onto,4,479,2,2,0.75
11,6,open,4,480,1,3,1
11,6,operate,7,481,3,4,5.5
11,6,opinion,7,482,2,5,1.75
11,6,opposition,10,483,2,8,6.25
11,6,or,2,484,1,1,0.5
11,6,orange,6,485,2,4,1.25
11,6,orchestra,9,486,2,7,5.75
11,6,ordinary,8,487,2,6,2
11,6,orientation,11,488,2,9,6.5
11,6,originally,10,489,3,7,2.25
11,6,overly,6,490,1,5,5.25
11,6,overnight,9,491,4,5,1.75
11,6,own,3,492,1,2,0.75
11,6,oxygen,6,493,1,5,1.5
11,6,packet,6,494,0,6,5.75
11,6,pair,4,495,2,2,0.75
11,6,pan,3,496,2,1,0.5
11,6,paper,5,497,2,3,1
11,6,parameter,9,498,2,7,6
11,6,parental,8,499,3,5,1.75
11,6,parish,6,500,3,3,1.25
11,6,partly,6,501,3,3,5.25
11,6,partnership,11,502,4,7,2.25
11,6,passage,7,503,2,5,5.5
11,6,payment,7,504,2,5,1.75
11,6,peasant,7,505,1,6,1.75
11,6,people,6,506,2,4,5.25
11,6,permanently,11,507,2,9,2.75
11,6,person,6,508,3,3,5.25
11,6,persuade,8,509,4,4,1.75
11,6,phase,5,510,1,4,1.5
11,6,photograph,10,511,2,8,6.25
11,6,pill,4,512,1,3,1
11,6,pink,4,513,2,2,0.75
11,6,pitch,5,514,2,3,1
11,6,placement,9,515,1,8,6.5
11,6,plain,5,516,3,2,1
11,6,planet,6,517,3,3,1.25
11,6,plate,5,518,3,2,0.75
11,6,plug,4,519,2,2,4.75
11,6,plunge,6,520,3,3,1.25
11,6,pocket,6,521,1,5,1.5
11,6,poetry,6,522,2,4,5.25
11,6,pole,4,523,2,2,0.75
11,6,policeman,9,524,3,6,2
11,6,politics,8,525,4,4,1.75
11,6,popular,7,526,2,5,5.5
11,6,popularity,10,527,7,3,1.25
11,6,potential,9,528,2,7,6.25
11,6,poverty,7,529,2,5,1.75
11,6,practice,8,530,1,7,2
11,6,pray,4,531,3,1,4.5
11,6,preach,6,532,2,4,1.5
11,6,precede,7,533,3,4,1.25
11,6,premium,7,534,3,4,1.5
11,6,present,7,535,3,4,5.25
11,6,president,9,536,4,5,1.75
11,6,pretty,6,537,3,3,1.25
11,6,prey,4,538,3,1,0.75
11,6,price,5,539,2,3,5
11,6,pride,5,540,3,2,1
11,6,primarily,9,541,3,6,2
11,6,prince,6,542,3,3,1
11,6,prison,6,543,3,3,5
11,6,probably,8,544,2,6,3.25
11,6,problematic,11,545,4,7,11.75
11,6,proceed,7,546,3,4,3.25
11,6,profession,10,547,3,7,5
11,6,profitable,10,548,4,6,11
11,6,pronounce,9,549,3,6,4.25
11,6,pronounced,10,550,9,1,1.5
11,6,protect,7,551,3,4,9.5
11,6,protection,10,552,7,3,3
11,6,protocol,8,553,4,4,3.25
11,6,provide,7,554,3,4,3
11,6,province,8,555,5,3,9.5
11,6,provision,9,556,5,4,3.5
11,6,psychology,10,557,1,9,12.75
11,6,publication,11,558,1,10,6.5
11,6,purchase,8,559,2,6,10.75
11,6,purely,6,560,3,3,2.5
11,6,purple,6,561,3,3,2.5
11,6,pursue,6,562,3,3,8.75
11,6,qualify,7,563,0,7,4.5
11,6,quarter,7,564,3,4,3
11,6,queen,5,565,2,3,8.75
11,6,queue,5,566,3,2,2
11,6,quietly,7,567,2,5,4
11,6,quota,5,568,2,3,2.25
11,6,racist,6,569,0,6,10.5
11,6,radio,5,570,2,3,2.25
11,6,rapid,5,571,2,3,2.25
11,6,raw,3,572,2,1,1
11,6,read,4,573,1,3,2.25
11,6,reader,6,574,4,2,9
11,6,reasonable,10,575,3,7,6
11,6,rebellion,9,576,2,7,12
11,6,recipe,6,577,2,4,3
11,6,recipient,9,578,5,4,3.25
11,6,refuge,6,579,2,4,9.25
11,6,regret,6,580,2,4,3
11,6,regularly,9,581,3,6,4.25
11,6,relatively,10,582,2,8,12.5
11,6,relaxing,8,583,4,4,3.5
11,6,release,7,584,3,4,3.25
11,6,reliability,11,585,3,8,13.25
11,6,reliable,8,586,6,2,2.5
11,6,rely,4,587,3,1,1.25
11,6,remains,7,588,2,5,10.5
11,6,remember,8,589,3,5,3.75
11,6,reminder,8,590,3,5,3.75
11,6,renowned,8,591,2,6,11.25
11,6,report,6,592,2,4,3
11,6,represent,9,593,3,6,11.5
11,6,reproduce,9,594,4,5,4.5
11,6,reputation,10,595,3,7,5
11,6,request,7,596,2,5,10.75
11,6,residential,11,597,2,9,6.25
11,6,respect,7,598,3,4,11
11,6,response,8,599,4,4,3.5
11,6,restaurant,10,600,3,7,11.5
11,6,restoration,11,601,4,7,5.25
11,6,result,6,602,3,3,2.5
11,6,retreat,7,603,2,5,10.25
11,6,review,6,604,2,4,3
11,6,rhythm,6,605,1,5,3.25
11,6,ridiculous,10,606,1,9,12.5
11,6,riot,4,607,2,2,1.75
11,6,risk,4,608,2,2,1.75
11,6,rock,4,609,1,3,8.75
11,6,role,4,610,2,2,1.75
11,6,romantic,8,611,2,6,4.25
11,6,runner,6,612,1,5,9.75
11,6,sad,3,613,0,3,2
11,6,sadly,5,614,3,2,1.75
11,6,sail,4,615,2,2,1.75
11,6,salary,6,616,2,4,3
11,6,say,3,617,2,1,1
11,6,script,6,618,1,5,10.5
11,6,seldom,6,619,1,5,3.25
11,6,senator,7,620,2,5,11.5
11,6,send,4,621,3,1,1.5
11,6,sensitive,9,622,3,6,5.5
11,6,seventeen,9,623,2,7,14
11,6,several,7,624,4,3,3.25
11,6,shade,5,625,1,4,3.25
11,6,shall,5,626,3,2,2.25
11,6,shock,5,627,2,3,2.75
11,6,shocking,8,628,5,3,11
11,6,shop,4,629,3,1,1.25
11,6,shrink,6,630,2,4,3
11,6,significant,11,631,1,10,14
11,6,similarity,10,632,2,8,6.5
11,6,simulate,8,633,3,5,14
11,6,sincere,7,634,2,5,3.5
11,6,situation,9,635,2,7,12.25
11,6,sixty,5,636,2,3,2.5
11,6,size,4,637,2,2,1.75
11,6,skill,5,638,1,4,3
11,6,slave,5,639,1,4,10.25
11,6,sleep,5,640,2,3,2.5
11,6,slot,4,641,2,2,1.75
11,6,small,5,642,1,4,2.75
11,6,smash,5,643,3,2,2
11,6,snap,4,644,1,3,9.75
11,6,socialist,9,645,1,8,5.25
11,6,somebody,8,646,2,6,11.75
11,6,somewhere,9,647,4,5,4.25
11,6,soon,4,648,2,2,2
11,6,sort,4,649,2,2,1.75
11,6,source,6,650,2,4,10.75
11,6,speculate,9,651,1,8,5.25
11,6,spite,5,652,2,3,10
11,6,split,5,653,2,3,3.75
11,6,spoil,5,654,2,3,2.25
11,6,spoon,5,655,3,2,2
11,6,sport,5,656,3,2,2
11,6,spy,3,657,2,1,1
11,6,squeeze,7,658,1,6,11.5
11,6,stabilize,9,659,1,8,5.25
11,6,stadium,7,660,3,4,11.5
11,6,stage,5,661,3,2,2.25
11,6,statement,9,662,3,6,5.25
11,6,station,7,663,4,3,3.25
11,6,steel,5,664,2,3,11.25
11,6,steep,5,665,4,1,1.75
11,6,stimulate,9,666,2,7,6
11,6,stress,6,667,2,4,12.75
11,6,structure,9,668,3,6,5.25
11,6,student,7,669,2,5,4
11,6,style,5,670,2,3,10
11,6,suburb,6,671,1,5,3.5
11,6,suburban,8,672,6,2,2
11,6,successive,10,673,2,8,12.75
11,6,suffer,6,674,2,4,3
11,6,suggestion,10,675,2,8,13
11,6,sum,3,676,2,1,0.75
11,6,summarize,9,677,3,6,3
11,6,summer,6,678,4,2,1.25
11,6,superb,6,679,2,4,6.25
11,6,supervision,11,680,5,6,2.5
11,6,supervisor,10,681,8,2,1.5
11,6,supplement,10,682,3,7,7.5
11,6,supporter,9,683,4,5,2
11,6,surge,5,684,2,3,1.25
11,6,surprised,9,685,3,6,7
11,6,surprising,10,686,7,3,1.75
11,6,surrender,9,687,3,6,2.25
11,6,survive,7,688,3,4,6.5
11,6,sustain,7,689,2,5,1.75
11,6,swing,5,690,1,4,1.5
11,6,symbol,6,691,1,5,6.75
11,6,sympathetic,11,692,3,8,3
11,6,tax,3,693,0,3,5.5
11,6,teenager,8,694,1,7,2.5
11,6,tell,4,695,2,2,1
11,6,tent,4,696,2,2,1
11,6,tenure,6,697,3,3,6.25
11,6,terminal,8,698,2,6,2.25
11,6,terrain,7,699,3,4,1.75
11,6,terrible,8,700,4,4,7
11,6,terrorist,9,701,4,5,2.25
11,6,than,4,702,1,3,1
11,6,theft,5,703,2,3,1.25
11,6,theology,8,704,3,5,6.75
11,6,therefore,9,705,3,6,2.25
11,6,they,4,706,3,1,0.75
11,6,thick,5,707,2,3,5.75
11,6,thing,5,708,3,2,1
11,6,third,5,709,3,2,0.75
11,6,thought,7,710,2,5,1.75
11,6,threat,6,711,2,4,6
11,6,threaten,8,712,6,2,1.5
11,6,threshold,9,713,4,5,2.25
11,6,thrive,6,714,3,3,1.25
11,6,throat,6,715,3,3,5.75
11,6,thursday,8,716,2,6,2
11,6,tiny,4,717,1,3,1
11,6,tired,5,718,2,3,1.25
11,6,tobacco,7,719,1,6,6.25
11,6,toll,4,720,2,2,0.75
11,6,ton,3,721,2,1,0.5
11,6,tone,4,722,3,1,0.5
11,6,tongue,6,723,3,3,1
11,6,total,5,724,2,3,5.5
11,6,towel,5,725,2,3,1
11,6,toy,3,726,2,1,0.5
11,6,trace,5,727,1,4,1.25
11,6,transaction,11,728,3,8,7.25
11,6,transfer,8,729,5,3,1.5
11,6,transform,9,730,6,3,1.5
11,6,transparent,11,731,5,6,7
11,6,tremendous,10,732,2,8,2.5
11,6,trillion,8,733,2,6,7
11,6,troubled,8,734,2,6,2.25
11,6,true,4,735,2,2,1
11,6,trust,5,736,3,2,1
11,6,truth,5,737,3,2,6.25
11,6,try,3,738,2,1,0.5
11,6,tuesday,7,739,1,6,2
11,6,tuition,7,740,2,5,7.75
11,6,tunnel,6,741,2,4,1.5
11,6,turn,4,742,2,2,0.75
11,6,turnover,8,743,4,4,1.5
11,6,type,4,744,1,3,5.5
11,6,typical,7,745,3,4,1.5
11,6,ugly,4,746,0,4,1.25
11,6,ultimately,10,747,1,9,7.5
11,6,under,5,748,1,4,1.25
11,6,unfortunate,11,749,2,9,7.75
11,6,unlike,6,750,2,4,1.5
11,6,unlikely,8,751,6,2,1
11,6,up,2,752,1,1,0.5
11,6,upset,5,753,2,3,1
11,6,use,3,754,1,2,5
11,6,used,4,755,3,1,0.5
11,6,user,4,756,3,1,0.5
11,6,valid,5,757,0,5,1.5
11,6,variation,9,758,2,7,6.75
11,6,vehicle,7,759,1,6,2
11,6,versus,6,760,2,4,1.5
11,6,vicious,7,761,1,6,6.5
11,6,victim,6,762,3,3,1.25
11,6,village,7,763,2,5,1.5
11,6,violate,7,764,2,5,10.25
11,6,warfare,7,765,0,7,4.5
11,6,web,3,766,1,2,1.5
11,6,weekly,6,767,2,4,10
11,6,wet,3,768,2,1,1
11,6,what,4,769,1,3,2
11,6,where,5,770,2,3,2.25
11,6,while,5,771,2,3,9.75
11,6,whisper,7,772,3,4,3.25
11,6,whole,5,773,2,3,2.25
11,6,wide,4,774,1,3,2.25
11,6,wise,4,775,2,2,2
11,6,wish,4,776,3,1,8.25
11,6,withdraw,8,777,2,6,4.25
11,6,withdrawal,10,778,8,2,2
11,6,workout,7,779,1,6,15.75
11,6,worldwide,9,780,3,6,2096.25
11,6,wound,5,781,2,3,3.5
11,6,yell,4,782,0,4,3.5
11,6,you,3,783,1,2,2
11,6,yourself,8,784,3,5,16.5
11,6,zero,4,785,0,4,2.75
11,6,zone,4,786,1,3,2.75
11,7,ability,7,0,0,7,11.5
11,7,above,5,1,2,3,2.5
11,7,absent,6,2,2,4,13.25
11,7,abstract,8,3,3,5,4.25
11,7,account,7,4,1,6,5.25
11,7,accountable,11,5,7,4,13.5
11,7,accountant,10,6,8,2,3
11,7,accuracy,8,7,3,5,4
11,7,acquire,7,8,2,5,12.75
11,7,action,6,9,2,4,3.75
11,7,addition,8,10,1,7,5.75
11,7,adult,5,11,2,3,11.25
11,7,advertise,9,12,2,7,7
11,7,advertising,11,13,8,3,4.5
11,7,affection,9,14,1,8,16
11,7,afford,6,15,3,3,4
11,7,afraid,6,16,2,4,12.75
11,7,alert,5,17,1,4,3.75
11,7,alien,5,18,2,3,3.25
11,7,alignment,9,19,3,6,5
11,7,allege,6,20,2,4,13.5
11,7,allegedly,9,21,6,3,3
11,7,alliance,8,22,3,5,5.75
11,7,allow,5,23,3,2,11.75
11,7,along,5,24,2,3,3.25
11,7,also,4,25,2,2,2.25
11,7,altogether,10,26,2,8,20
11,7,anything,8,27,1,7,5
11,7,appetite,8,28,1,7,12.25
11,7,appoint,7,29,3,4,3.25
11,7,appointment,11,30,7,4,3.5
11,7,arena,5,31,1,4,2.75
11,7,armed,5,32,2,3,10.5
11,7,arrival,7,33,2,5,3.5
11,7,assess,6,34,1,5,3.75
11,7,asset,5,35,4,1,1.5
11,7,assignment,10,36,3,7,13.75
11,7,associated,10,37,3,7,5
11,7,athlete,7,38,1,6,12.25
11,7,attack,6,39,2,4,3
11,7,attempt,7,40,3,4,10.5
11,7,attend,6,41,4,2,2
11,7,attendance,10,42,6,4,3.5
11,7,attribute,9,43,3,6,4.25
11,7,audience,8,44,1,7,8.75
11,7,audit,5,45,4,1,0.75
11,7,author,6,46,2,4,1.5
11,7,autumn,6,47,3,3,5.75
11,7,avoid,5,48,1,4,1.25
11,7,awkward,7,49,1,6,2
11,7,bake,4,50,0,4,6.5
11,7,ballot,6,51,2,4,1.5
11,7,banana,6,52,2,4,1.25
11,7,bank,4,53,3,1,0.5
11,7,barrier,7,54,2,5,6.25
11,7,basket,6,55,2,4,1.5
11,7,basketball,10,56,6,4,1.5
11,7,being,5,57,1,4,6
11,7,bicycle,7,58,1,6,2
11,7,big,3,59,2,1,0.5
11,7,biology,7,60,2,5,1.75
11,7,blanket,7,61,1,6,6.5
11,7,blast,5,62,3,2,1
11,7,blessing,8,63,2,6,2
11,7,blood,5,64,2,3,6
11,7,bond,4,65,1,3,1
11,7,booking,7,66,2,5,1.75
11,7,boring,6,67,2,4,6
11,7,bounce,6,68,2,4,1.5
11,7,brain,5,69,1,4,1.5
11,7,bread,5,70,2,3,1.25
11,7,breast,6,71,4,2,6.25
11,7,briefly,7,72,2,5,1.75
11,7,brilliant,9,73,3,6,2.25
11,7,bring,5,74,3,2,3.25
11,7,broadband,9,75,2,7,5
11,7,buck,4,76,1,3,1
11,7,building,8,77,2,6,7.25
11,7,bury,4,78,2,2,0.75
11,7,but,3,79,2,1,0.5
11,7,bye,3,80,1,2,0.75
11,7,cabinet,7,81,0,7,7.25
11,7,calm,4,82,2,2,1
11,7,capitalism,10,83,2,8,6.75
11,7,captain,7,84,3,4,9.75
11,7,carriage,8,85,2,6,4.25
11,7,carrot,6,86,4,2,1.5
11,7,case,4,87,2,2,1.75
11,7,castle,6,88,3,3,9.25
11,7,cat,3,89,2,1,1.25
11,7,catch,5,90,3,2,2
11,7,cause,5,91,2,3,2.25
11,7,caution,7,92,3,4,2.5
11,7,cent,4,93,1,3,8.5
11,7,champion,8,94,1,7,3.5
11,7,chaos,5,95,3,2,2
11,7,charge,6,96,3,3,2.25
11,7,cheek,5,97,2,3,8.5
11,7,chest,5,98,3,2,1
11,7,cigarette,9,99,1,8,3.25
11,7,circulation,11,100,2,9,12.5
11,7,civic,5,101,2,3,1.25
11,7,claim,5,102,1,4,9
11,7,clarify,7,103,3,4,2
11,7,classic,7,104,3,4,1.5
11,7,classify,8,105,6,2,2
11,7,climate,7,106,2,5,8.75
11,7,clip,4,107,3,1,0.75
11,7,clock,5,108,2,3,1.25
11,7,closure,7,109,3,4,2.25
11,7,coast,5,110,1,4,8.75
11,7,coincidence,11,111,2,9,4.25
11,7,college,7,112,2,5,9.5
11,7,collision,9,113,4,5,2.75
11,7,coloured,8,114,3,5,2
11,7,columnist,9,115,3,6,9.75
11,7,combine,7,116,2,5,2
11,7,comic,5,117,3,2,1.25
11,7,commander,9,118,3,6,8.5
11,7,commentary,10,119,4,6,2.5
11,7,commerce,8,120,5,3,2
11,7,commit,6,121,4,2,6.5
11,7,common,6,122,4,2,1.25
11,7,communist,9,123,4,5,2.25
11,7,completely,10,124,3,7,8.5
11,7,compliance,10,125,5,5,2.5
11,7,compose,7,126,4,3,1.25
11,7,computer,8,127,4,4,7
11,7,concentrate,11,128,2,9,3
11,7,confession,10,129,3,7,7
11,7,confident,9,130,4,5,1.75
11,7,confirm,7,131,5,2,1.25
11,7,conflict,8,132,4,4,6.5
11,7,confuse,7,133,4,3,1.25
11,7,conscience,10,134,3,7,2.25
11,7,consecutive,11,135,4,7,7.75
11,7,consensus,9,136,5,4,1.75
11,7,conserve,8,137,5,3,1.25
11,7,consolidate,11,138,4,7,7.25
11,7,conspiracy,10,139,4,6,2
11,7,constitute,10,140,4,6,7.25
11,7,contact,7,141,3,4,1.5
11,7,container,9,142,5,4,1.75
11,7,contest,7,143,4,3,6.25
11,7,context,7,144,5,2,1.25
11,7,contractor,10,145,4,6,2
11,7,contrary,8,146,6,2,1.25
11,7,contributor,11,147,5,6,8.75
11,7,convict,7,148,3,4,1.5
11,7,cook,4,149,2,2,0.75
11,7,cool,4,150,3,1,0.75
11,7,cooperate,9,151,3,6,7.5
11,7,cop,3,152,2,1,0.5
11,7,copy,4,153,3,1,0.5
11,7,corporation,11,154,2,9,8
11,7,correlation,11,155,3,8,2.75
11,7,correspond,10,156,5,5,2
11,7,corrupt,7,157,4,3,7.5
11,7,cotton,6,158,2,4,1.5
11,7,counsellor,10,159,2,8,9
11,7,courage,7,160,3,4,2
11,7,covered,7,161,2,5,2
11,7,crack,5,162,1,4,7.5
11,7,cream,5,163,2,3,1.5
11,7,critique,8,164,2,6,2.5
11,7,crop,4,165,2,2,1
11,7,crystal,7,166,2,5,8
11,7,cue,3,167,1,2,0.75
11,7,curiosity,9,168,2,7,2.75
11,7,customer,8,169,2,6,8.5
11,7,dad,3,170,0,3,1
11,7,data,4,171,2,2,1
11,7,date,4,172,3,1,0.75
11,7,dead,4,173,1,3,7
11,7,deadline,8,174,4,4,2
11,7,deadly,6,175,5,1,1
11,7,debate,6,176,2,4,1.75
11,7,debut,5,177,3,2,1
11,7,decision,8,178,2,6,8.25
11,7,dedication,10,179,2,8,2.75
11,7,defend,6,180,2,4,7.25
11,7,defensive,9,181,5,4,1.75
11,7,define,6,182,3,3,1.25
11,7,delegation,10,183,2,8,8.25
11,7,depart,6,184,2,4,1.75
11,7,dependence,10,185,3,7,14
11,7,depict,6,186,3,3,2.5
11,7,descent,7,187,2,5,4
11,7,desire,6,188,3,3,2.75
11,7,detection,9,189,2,7,13.25
11,7,determined,10,190,4,6,4.5
11,7,devise,6,191,2,4,11.25
11,7,dialogue,8,192,1,7,4.75
11,7,diary,5,193,3,2,1.75
11,7,die,3,194,2,1,1
11,7,different,9,195,2,7,13
11,7,difficulty,10,196,4,6,4.5
11,7,dimension,9,197,2,7,13.25
11,7,dip,3,198,2,1,1
11,7,directly,8,199,2,6,4
11,7,directory,9,200,6,3,11.75
11,7,disability,10,201,2,8,5.5
11,7,discharge,9,202,3,6,16
11,7,discourse,9,203,4,5,5
11,7,disorder,8,204,3,5,5.5
11,7,dispose,7,205,3,4,15.75
11,7,disrupt,7,206,3,4,4
11,7,distance,8,207,3,5,4
11,7,distinct,8,208,4,4,15
11,7,distinction,11,209,8,3,5.5
11,7,distinctive,11,210,9,2,3
11,7,disturb,7,211,4,3,3.25
11,7,diverse,7,212,2,5,16
11,7,divert,6,213,5,1,3.25
11,7,dog,3,214,1,2,3.25
11,7,dominance,9,215,2,7,11.75
11,7,dominate,8,216,6,2,19
11,7,drag,4,217,1,3,5
11,7,drain,5,218,3,2,3
11,7,dress,5,219,2,3,4
11,7,driver,6,220,2,4,3.75
11,7,drum,4,221,2,2,12.25
11,7,drunk,5,222,3,2,2.25
11,7,dull,4,223,1,3,2.5
11,7,during,6,224,2,4,3.75
11,7,duty,4,225,2,2,2
11,7,dynamic,7,226,1,6,16.25
11,7,each,4,227,0,4,3.75
11,7,easily,6,228,2,4,5.5
11,7,eastern,7,229,3,4,16.25
11,7,easy,4,230,3,1,1.75
11,7,eat,3,231,2,1,1.25
11,7,ecological,10,232,1,9,18.25
11,7,economy,7,233,3,4,4.5
11,7,educated,8,234,1,7,7.5
11,7,educator,8,235,6,2,12.5
11,7,efficiency,10,236,1,9,6.75
11,7,elaborate,9,237,1,8,17.25
11,7,election,8,238,2,6,5.5
11,7,electric,8,239,5,3,4.5
11,7,element,7,240,3,4,18
11,7,elementary,10,241,7,3,3.25
11,7,emerge,6,242,1,5,3.5
11,7,employ,6,243,2,4,12.25
11,7,encourage,9,244,1,8,5.75
11,7,endorse,7,245,2,5,22
11,7,enhance,7,246,2,5,708.5
11,7,enough,6,247,2,4,2.75
11,7,enquire,7,248,2,5,4
11,7,enrol,5,249,2,3,7.75
11,7,ensue,5,250,2,3,2.25
11,7,entire,6,251,2,4,2.75
11,7,equip,5,252,1,4,2.25
11,7,error,5,253,1,4,6.5
11,7,escalate,8,254,1,7,2.75
11,7,ethic,5,255,1,4,6.25
11,7,ethical,7,256,5,2,1.5
11,7,everybody,9,257,1,8,3.25
11,7,exam,4,258,1,3,6
11,7,example,7,259,4,3,1.75
11,7,exclude,7,260,2,5,2.25
11,7,expenditure,11,261,2,9,13
11,7,explicit,8,262,3,5,2.75
11,7,explosion,9,263,4,5,13.75
11,7,exposure,8,264,3,5,4
11,7,extra,5,265,2,3,2.75
11,7,extract,7,266,5,2,2.25
11,7,fabulous,8,267,0,8,25.75
11,7,facility,8,268,2,6,5.25
11,7,fact,4,269,3,1,1.5
11,7,faction,7,270,4,3,21.5
11,7,factor,6,271,4,2,2.25
11,7,factory,7,272,6,1,1.75
11,7,fairness,8,273,2,6,4.5
11,7,fame,4,274,2,2,1.75
11,7,familiar,8,275,3,5,10.25
11,7,favourable,10,276,2,8,5.25
11,7,favourite,9,277,6,3,9
11,7,feather,7,278,1,6,4
11,7,feel,4,279,2,2,1.75
11,7,fence,5,280,2,3,2.5
11,7,festival,8,281,2,6,11.75
11,7,fifth,5,282,1,4,3.75
11,7,fighting,8,283,2,6,11.75
11,7,film,4,284,2,2,1.75
11,7,finger,6,285,2,4,3
11,7,finish,6,286,3,3,2.5
11,7,fire,4,287,2,2,1.5
11,7,fit,3,288,2,1,7.25
11,7,five,4,289,2,2,1.75
11,7,flaw,4,290,1,3,2
11,7,float,5,291,2,3,2.25
11,7,fold,4,292,1,3,2
11,7,following,9,293,3,6,10.75
11,7,forecast,8,294,2,6,4.5
11,7,forest,6,295,4,2,2.5
11,7,forever,7,296,4,3,10
11,7,forge,5,297,3,2,1.75
11,7,forgive,7,298,4,3,2.75
11,7,formulate,9,299,3,6,6.25
11,7,forth,5,300,3,2,10.5
11,7,frame,5,301,1,4,5.25
11,7,frankly,7,302,3,4,3.5
11,7,freely,6,303,2,4,4.25
11,7,freeze,6,304,4,2,15.75
11,7,from,4,305,2,2,2.75
11,7,fruit,5,306,2,3,3
11,7,fully,5,307,1,4,4.75
11,7,fund,4,308,2,2,3.5
11,7,funny,5,309,3,2,12
11,7,furthermore,11,310,2,9,9.25
11,7,gambling,8,311,0,8,11
11,7,gas,3,312,2,1,1
11,7,gentleman,9,313,1,8,11.5
11,7,get,3,314,2,1,1
11,7,ghost,5,315,1,4,4
11,7,goal,4,316,1,3,2.25
11,7,golden,6,317,2,4,3
11,7,goods,5,318,2,3,9.5
11,7,gradually,9,319,1,8,5.75
11,7,graduate,8,320,6,2,4.75
11,7,grain,5,321,3,2,11.25
11,7,grand,5,322,3,2,2
11,7,grandparent,11,323,5,6,4.5
11,7,grant,5,324,4,1,1.5
11,7,great,5,325,2,3,2.25
11,7,greenhouse,10,326,3,7,11.5
11,7,guard,5,327,1,4,2.75
11,7,guideline,9,328,2,7,11.25
11,7,halt,4,329,0,4,2.75
11,7,hand,4,330,2,2,1.75
11,7,harassment,10,331,2,8,11.5
11,7,hardware,8,332,3,5,3.75
11,7,healthcare,10,333,1,9,12
11,7,hear,4,334,3,1,1.25
11,7,hearing,7,335,4,3,2.5
11,7,heating,7,336,3,4,3.5
11,7,heavily,7,337,3,4,8.5
11,7,helmet,6,338,2,4,3
11,7,helpful,7,339,3,4,3
11,7,hidden,6,340,1,5,9.25
11,7,hide,4,341,3,1,1.25
11,7,hierarchy,9,342,2,7,4.75
11,7,hill,4,343,2,2,1.75
11,7,himself,7,344,2,5,9.5
11,7,hobby,5,345,1,4,2.75
11,7,homework,8,346,2,6,10.25
11,7,hostility,9,347,2,7,4.75
11,7,housing,7,348,2,5,3.5
11,7,hungry,6,349,1,5,9.5
11,7,husband,7,350,2,5,3.75
11,7,ideology,8,351,0,8,11.25
11,7,ignore,6,352,1,5,3.5
11,7,illness,7,353,1,6,9.5
11,7,in,2,354,1,1,0.75
11,7,incidence,9,355,2,7,4.75
11,7,inclined,8,356,3,5,9.25
11,7,increase,8,357,3,5,3.75
11,7,indeed,6,358,2,4,3
11,7,indicator,9,359,3,6,10.25
11,7,indoor,6,360,3,3,2.5
11,7,indoors,7,361,6,1,1.25
11,7,indulge,7,362,3,4,3
11,7,industrial,10,363,4,6,10.5
11,7,inequality,10,364,2,8,5.5
11,7,infect,6,365,2,4,9.25
11,7,infection,9,366,6,3,3
11,7,inflation,9,367,3,6,4.5
11,7,inhabitant,10,368,2,8,11.25
11,7,initial,7,369,2,5,3.5
11,7,injured,7,370,2,5,10
11,7,innovative,10,371,2,8,6.25
11,7,input,5,372,2,3,2.75
11,7,inspire,7,373,2,5,9.75
11,7,instantly,9,374,3,6,4.5
11,7,institution,11,375,4,7,10.75
11,7,interact,8,376,2,6,4.25
11,7,interpret,9,377,5,4,3.25
11,7,interrupt,9,378,5,4,9
11,7,interview,9,379,5,4,3.5
11,7,intriguing,10,380,3,7,11.25
11,7,investigate,11,381,2,9,6
11,7,invisible,9,382,3,6,10.75
11,7,ironically,10,383,1,9,5.75
11,7,irrelevant,10,384,2,8,11.5
11,7,jam,3,385,0,3,2
11,7,join,4,386,1,3,2.5
11,7,joint,5,387,4,1,1.25
11,7,july,4,388,1,3,8.25
11,7,keen,4,389,0,4,2.75
11,7,kidnap,6,390,1,5,3.5
11,7,kill,4,391,2,2,1.75
11,7,kiss,4,392,2,2,7.5
11,7,ladder,6,393,0,6,3.75
11,7,lady,4,394,3,1,1.25
11,7,landing,7,395,2,5,9.25
11,7,landlord,8,396,4,4,3.5
11,7,language,8,397,3,5,4
11,7,laptop,6,398,2,4,3
11,7,lately,6,399,2,4,6
11,7,layout,6,400,2,4,1.5
11,7,lead,4,401,1,3,1
11,7,leave,5,402,3,2,0.75
11,7,leisure,7,403,2,5,5.25
11,7,lend,4,404,2,2,0.75
11,7,length,6,405,3,3,1
11,7,let,3,406,2,1,0.5
11,7,level,5,407,2,3,4.5
11,7,lifetime,8,408,1,7,2.25
11,7,limit,5,409,2,3,1
11,7,linger,6,410,2,4,5
11,7,literacy,8,411,2,6,2
11,7,lock,4,412,1,3,1
11,7,logo,4,413,2,2,0.75
11,7,loom,4,414,2,2,4.25
11,7,lost,4,415,2,2,0.75
11,7,lower,5,416,2,3,1
11,7,magical,7,417,0,7,2
11,7,magnitude,9,418,3,6,5.75
11,7,mall,4,419,2,2,0.75
11,7,man,3,420,2,1,0.5
11,7,marathon,8,421,2,6,5.5
11,7,march,5,422,3,2,1
11,7,marketing,9,423,3,6,2
11,7,massive,7,424,2,5,1.5
11,7,mathematics,11,425,2,9,6.5
11,7,matter,6,426,3,3,1.25
11,7,maximize,8,427,2,6,6
11,7,maybe,5,428,2,3,1.25
11,7,me,2,429,1,1,0.5
11,7,meaning,7,430,2,5,1.75
11,7,means,5,431,4,1,4.5
11,7,mechanism,9,432,2,7,2.25
11,7,medicine,8,433,2,6,5.75
11,7,meditation,10,434,4,6,2.25
11,7,meet,4,435,2,2,0.75
11,7,membership,10,436,2,8,6.5
11,7,metaphor,8,437,2,6,2
11,7,militant,8,438,1,7,6.5
11,7,mill,4,439,3,1,0.5
11,7,mine,4,440,2,2,0.75
11,7,minimize,8,441,3,5,1.75
11,7,mistake,7,442,2,5,5.25
11,7,mobile,6,443,1,5,1.5
11,7,modern,6,444,2,4,1.5
11,7,modest,6,445,4,2,1.25
11,7,momentum,8,446,2,6,5.75
11,7,monitor,7,447,2,5,1.75
11,7,moral,5,448,2,3,1
11,7,morning,7,449,3,4,5.5
11,7,motive,6,450,2,4,1.5
11,7,motorist,8,451,3,5,1.75
11,7,mount,5,452,2,3,4.75
11,7,mountain,8,453,5,3,1.25
11,7,move,4,454,2,2,0.75
11,7,movement,8,455,4,4,1.25
11,7,multiply,8,456,1,7,6.25
11,7,musical,7,457,2,5,1.75
11,7,mystery,7,458,1,6,5.75
11,7,nail,4,459,0,4,1.25
11,7,native,6,460,2,4,1.5
11,7,naturally,9,461,3,6,6
11,7,neglect,7,462,1,6,2
11,7,nerve,5,463,2,3,1
11,7,nest,4,464,2,2,4.75
11,7,network,7,465,2,5,1.75
11,7,news,4,466,2,2,0.75
11,7,next,4,467,2,2,0.75
11,7,nineteen,8,468,1,7,6
11,7,ninety,6,469,5,1,0.75
11,7,nonsense,8,470,1,7,2
11,7,noon,4,471,2,2,1
11,7,notable,7,472,2,5,5.75
11,7,notably,7,473,6,1,0.75
11,7,nowadays,8,474,2,6,2
11,7,nutrition,9,475,1,8,6.5
11,7,observe,7,476,0,7,2.25
11,7,observer,8,477,7,1,4.75
11,7,obsession,9,478,4,5,1.75
11,7,occasion,8,479,1,7,2.25
11,7,of,2,480,1,1,4.5
11,7,offer,5,481,2,3,1.25
11,7,ongoing,7,482,1,6,1.75
11,7,onion,5,483,2,3,1.25
11,7,operate,7,484,1,6,5.75
11,7,opinion,7,485,2,5,1.75
11,7,opposition,10,486,2,8,6.25
11,7,orchestra,9,487,1,8,2.25
11,7,ordinary,8,488,2,6,6
11,7,organize,8,489,2,6,2
11,7,orientation,11,490,2,9,6.5
11,7,out,3,491,1,2,0.75
11,7,outrage,7,492,3,4,1.5
11,7,overseas,8,493,1,7,6
11,7,own,3,494,1,2,0.75
11,7,owner,5,495,3,2,0.75
11,7,pair,4,496,0,4,1.25
11,7,palm,4,497,2,2,4.75
11,7,parent,6,498,2,4,1.25
11,7,partly,6,499,3,3,1.25
11,7,passage,7,500,2,5,5.5
11,7,passing,7,501,4,3,1.5
11,7,passion,7,502,5,2,1.25
11,7,payment,7,503,2,5,1.5
11,7,peak,4,504,1,3,5
11,7,penalty,7,505,2,5,1.75
11,7,permanently,11,506,2,9,6.75
11,7,person,6,507,3,3,1.25
11,7,persuade,8,508,4,4,1.5
11,7,petition,8,509,2,6,5.75
11,7,phase,5,510,1,4,1.5
11,7,photograph,10,511,2,8,2.5
11,7,pill,4,512,1,3,5
11,7,pilot,5,513,3,2,1
11,7,pitch,5,514,2,3,1.25
11,7,plain,5,515,1,4,1.25
11,7,planet,6,516,3,3,5.25
11,7,plug,4,517,2,2,1
11,7,poet,4,518,1,3,1
11,7,policeman,9,519,2,7,2.25
11,7,politics,8,520,4,4,5.75
11,7,port,4,521,2,2,0.75
11,7,poverty,7,522,2,5,1.5
11,7,powder,6,523,2,4,6
11,7,precede,7,524,1,6,1.75
11,7,precision,9,525,4,5,2
11,7,prefer,6,526,3,3,5.25
11,7,prepare,7,527,3,4,1.5
11,7,prey,4,528,3,1,0.5
11,7,price,5,529,2,3,1
11,7,pride,5,530,3,2,1
11,7,priest,6,531,3,3,6.25
11,7,primarily,9,532,3,6,2.25
11,7,prince,6,533,3,3,1.25
11,7,prison,6,534,3,3,1
11,7,prisoner,8,535,6,2,5.25
11,7,privilege,9,536,3,6,2
11,7,probable,8,537,2,6,2
11,7,probably,8,538,7,1,5
11,7,production,10,539,3,7,2.25
11,7,profession,10,540,3,7,6.25
11,7,profitable,10,541,4,6,2.25
11,7,promote,7,542,3,4,1.5
11,7,promotion,9,543,6,3,5.75
11,7,prosecutor,10,544,3,7,2.5
11,7,province,8,545,3,5,2.75
11,7,provincial,10,546,7,3,7.5
11,7,provision,9,547,5,4,2
11,7,punishment,10,548,1,9,7.5
11,7,purchase,8,549,2,6,2
11,7,purely,6,550,3,3,1.25
11,7,purple,6,551,3,3,6
11,7,pursue,6,552,3,3,2.25
11,7,qualify,7,553,0,7,3.25
11,7,quarter,7,554,3,4,6.75
11,7,queen,5,555,2,3,1
11,7,question,8,556,3,5,1.75
11,7,queue,5,557,3,2,1
11,7,quietly,7,558,2,5,6
11,7,quota,5,559,2,3,1.25
11,7,range,5,560,0,5,1.5
11,7,rapid,5,561,2,3,1.25
11,7,raw,3,562,2,1,5.25
11,7,reader,6,563,1,5,1.75
11,7,real,4,564,3,1,0.75
11,7,realize,7,565,4,3,1.25
11,7,really,6,566,4,2,1
11,7,reasonable,10,567,3,7,7.25
11,7,rebellion,9,568,2,7,3
11,7,receive,7,569,2,5,8.75
11,7,receiver,8,570,7,1,2
11,7,recovery,8,571,3,5,11
11,7,refuge,6,572,2,4,10.25
11,7,refugee,7,573,6,1,2.25
11,7,regret,6,574,2,4,4.25
11,7,regulator,9,575,3,6,7.25
11,7,reinforce,9,576,2,7,18.25
11,7,release,7,577,2,5,5.5
11,7,rely,4,578,3,1,1.75
11,7,remains,7,579,2,5,13
11,7,remarkable,10,580,4,6,5.25
11,7,remember,8,581,3,5,14.75
11,7,reminder,8,582,3,5,6
11,7,remote,6,583,3,3,5.5
11,7,report,6,584,2,4,4.25
11,7,reporter,8,585,6,2,15.5
11,7,residential,11,586,2,9,9.5
11,7,respect,7,587,3,4,19.5
11,7,response,8,588,4,4,6
11,7,restaurant,10,589,3,7,9.75
11,7,restoration,11,590,4,7,14.75
11,7,resume,6,591,3,3,2.75
11,7,retreat,7,592,2,5,3.5
11,7,reverse,7,593,2,5,11.25
11,7,review,6,594,3,3,2.5
11,7,rhythm,6,595,1,5,3.75
11,7,rice,4,596,1,3,9.5
11,7,riot,4,597,2,2,2
11,7,risk,4,598,2,2,1.75
11,7,rock,4,599,1,3,2.25
11,7,role,4,600,2,2,2
11,7,romantic,8,601,2,6,11.75
11,7,royal,5,602,2,3,2.5
11,7,rugby,5,603,1,4,3
11,7,rumour,6,604,2,4,10.75
11,7,sad,3,605,0,3,2.25
11,7,sail,4,606,2,2,1.5
11,7,saint,5,607,3,2,2
11,7,sanction,8,608,2,6,11
11,7,sandwich,8,609,3,5,4
11,7,say,3,610,2,1,1
11,7,scope,5,611,1,4,2.75
11,7,scratch,7,612,2,5,13.5
11,7,sculpture,9,613,2,7,6.25
11,7,section,7,614,1,6,11.5
11,7,seldom,6,615,2,4,3
11,7,senator,7,616,2,5,3.5
11,7,send,4,617,3,1,1.5
11,7,senior,6,618,3,3,10.5
11,7,sensation,9,619,3,6,5.75
11,7,sentence,8,620,3,5,4
11,7,session,7,621,2,5,11.75
11,7,set,3,622,2,1,2
11,7,seventeen,9,623,2,7,6.5
11,7,seventy,7,624,6,1,2.25
11,7,several,7,625,4,3,12.25
11,7,sex,3,626,2,1,1
11,7,shadow,6,627,1,5,4
11,7,shake,5,628,3,2,2
11,7,shaped,6,629,3,3,6
11,7,shine,5,630,2,3,3.25
11,7,shocking,8,631,2,6,6.25
11,7,shop,4,632,3,1,1.75
11,7,shot,4,633,3,1,2.25
11,7,shout,5,634,3,2,3.75
11,7,shrink,6,635,2,4,16.5
11,7,significant,11,636,1,10,21.25
11,7,simulate,8,637,2,6,5.25
11,7,sincere,7,638,2,5,4
11,7,sing,4,639,3,1,1.25
11,7,sir,3,640,2,1,1
11,7,sixty,5,641,2,3,10.75
11,7,skiing,6,642,1,5,3.5
11,7,skill,5,643,3,2,2
11,7,sleep,5,644,1,4,10.25
11,7,slogan,6,645,2,4,3
11,7,slot,4,646,3,1,1.5
11,7,slow,4,647,3,1,1.25
11,7,small,5,648,1,4,3
11,7,smart,5,649,3,2,1.75
11,7,soar,4,650,1,3,10
11,7,soccer,6,651,2,4,3.25
11,7,software,8,652,2,6,4.5
11,7,solely,6,653,2,4,10.75
11,7,somebody,8,654,2,6,4.25
11,7,somewhere,9,655,4,5,11.25
11,7,son,3,656,2,1,1
11,7,soon,4,657,2,2,1.75
11,7,source,6,658,2,4,3
11,7,span,4,659,1,3,2.25
11,7,spill,5,660,2,3,2.5
11,7,spite,5,661,3,2,9
11,7,split,5,662,2,3,2.25
11,7,sponsor,7,663,2,5,3.5
11,7,sport,5,664,3,2,2
11,7,spot,4,665,3,1,1.25
11,7,spy,3,666,2,1,8.75
11,7,stabilize,9,667,1,8,6.5
11,7,stadium,7,668,3,4,3.5
11,7,stage,5,669,3,2,9.5
11,7,stark,5,670,3,2,1.75
11,7,statement,9,671,3,6,4.5
11,7,station,7,672,4,3,2.75
11,7,statistical,11,673,5,6,12
11,7,status,6,674,4,2,2.25
11,7,steel,5,675,2,3,2.5
11,7,stiff,5,676,2,3,2.5
11,7,stimulate,9,677,3,6,11.75
11,7,stream,6,678,2,4,3
11,7,struggle,8,679,3,5,11.25
11,7,student,7,680,2,5,4
11,7,suburban,8,681,1,7,5.5
11,7,suddenly,8,682,2,6,13.25
11,7,suffering,9,683,2,7,5.75
11,7,suicide,7,684,2,5,13.75
11,7,supermarket,11,685,2,9,7
11,7,supervisor,10,686,5,5,13.5
11,7,supporter,9,687,3,6,4.75
11,7,suppress,8,688,4,4,11.5
11,7,surprised,9,689,2,7,5.75
11,7,surprising,10,690,7,3,2.75
11,7,sweet,5,691,1,4,9.5
11,7,symbol,6,692,1,5,3.5
11,7,sympathetic,11,693,3,8,13.75
11,7,syndrome,8,694,2,6,4.5
11,7,systematic,10,695,2,8,14
11,7,tag,3,696,0,3,3.5
11,7,tax,3,697,2,1,1
11,7,technical,9,698,1,8,8.75
11,7,teenage,7,699,2,5,12.25
11,7,tell,4,700,2,2,1.75
11,7,terminal,8,701,2,6,4.75
11,7,theft,5,702,1,4,11
11,7,their,5,703,3,2,1.75
11,7,thief,5,704,2,3,2.5
11,7,thin,4,705,3,1,1.25
11,7,thing,5,706,4,1,1.5
11,7,thinking,8,707,4,4,10.5
11,7,third,5,708,3,2,2
11,7,threat,6,709,2,4,3
11,7,threshold,9,710,4,5,3.75
11,7,thrive,6,711,3,3,9.75
11,7,throat,6,712,3,3,2.5
11,7,throw,5,713,4,1,1.25
11,7,timber,6,714,1,5,3.5
11,7,tiny,4,715,2,2,1.75
11,7,tired,5,716,2,3,10
11,7,tobacco,7,717,1,6,4
11,7,ton,3,718,2,1,1
11,7,tone,4,719,3,1,1.25
11,7,tongue,6,720,3,3,2.25
11,7,tourist,7,721,2,5,11.5
11,7,toy,3,722,2,1,1
11,7,trace,5,723,1,4,3
11,7,transfer,8,724,3,5,13
11,7,transform,9,725,6,3,3.5
11,7,transparent,11,726,5,6,5.5
11,7,tribunal,8,727,2,6,13.25
11,7,trillion,8,728,3,5,4.25
11,7,true,4,729,2,2,1.75
11,7,trust,5,730,3,2,2
11,7,trustee,7,731,5,2,12.75
11,7,try,3,732,2,1,1.5
11,7,tuesday,7,733,1,6,6.25
11,7,tuition,7,734,2,5,4.75
11,7,turn,4,735,2,2,9.25
11,7,turnout,7,736,4,3,2.5
11,7,turnover,8,737,5,3,2.75
11,7,twenty,6,738,1,5,3.75
11,7,twist,5,739,2,3,10.25
11,7,typical,7,740,1,6,4.25
11,7,ugly,4,741,0,4,2.75
11,7,ultimately,10,742,1,9,14
11,7,umbrella,8,743,1,7,16.25
11,7,under,5,744,1,4,1.25
11,7,understand,10,745,5,5,1.75
11,7,unfortunate,11,746,2,9,7.75
11,7,unit,4,747,2,2,0.75
11,7,unlikely,8,748,2,6,2
11,7,upper,5,749,1,4,7.25
11,7,upset,5,750,2,3,1.25
11,7,upwards,7,751,2,5,2
11,7,us,2,752,1,1,0.5
11,7,use,3,753,2,1,4.75
11,7,utterly,7,754,1,6,1.75
11,7,valid,5,755,0,5,1.5
11,7,vast,4,756,2,2,0.75
11,7,versus,6,757,1,5,6.25
11,7,vicious,7,758,1,6,1.75
11,7,violate,7,759,2,5,6.25
11,7,violation,9,760,6,3,1.75
11,7,volume,6,761,1,5,3.25
11,7,vote,4,762,2,2,1.75
11,7,wage,4,763,0,4,6.5
11,7,want,4,764,2,2,0.75
11,7,ward,4,765,2,2,0.75
11,7,warfare,7,766,3,4,1.25
11,7,warm,4,767,3,1,0.5
11,7,weak,4,768,1,3,5.75
11,7,week,4,769,2,2,0.75
11,7,weekly,6,770,4,2,0.75
11,7,wet,3,771,2,1,0.5
11,7,what,4,772,1,3,1.25
11,7,wheat,5,773,2,3,1
11,7,when,4,774,3,1,5.75
11,7,while,5,775,2,3,1.25
11,7,whisper,7,776,3,4,1.5
11,7,who,3,777,2,1,0.5
11,7,winner,6,778,1,5,9.25
11,7,wise,4,779,2,2,3.5
11,7,withdraw,8,780,2,6,2466
11,7,wooden,6,781,1,5,3.25
11,7,wrong,5,782,1,4,10.25
11,7,year,4,783,0,4,2
11,7,yourself,8,784,1,7,3.25
11,7,zero,4,785,0,4,7.25
11,7,zone,4,786,1,3,1.5
11,8,ability,7,0,0,7,7.75
11,8,abolish,7,1,2,5,2
11,8,about,5,2,3,2,1
11,8,academy,7,3,1,6,7.75
11,8,accent,6,4,2,4,1.75
11,8,acceptance,10,5,4,6,2.5
11,8,according,9,6,3,6,8.25
11,8,accountable,11,7,4,7,3
11,8,action,6,8,2,4,7.75
11,8,activation,10,9,4,6,2.5
11,8,admission,9,10,1,8,8.25
11,8,adult,5,11,2,3,1.25
11,8,advance,7,12,2,5,2
11,8,advertise,9,13,3,6,8
11,8,advertising,11,14,8,3,2.25
11,8,affair,6,15,1,5,2
11,8,affection,9,16,3,6,8.25
11,8,afford,6,17,3,3,1.5
11,8,aged,4,18,1,3,1.75
11,8,agent,5,19,3,2,1.5
11,8,aid,3,20,1,2,1.25
11,8,alert,5,21,1,4,7.25
11,8,allegedly,9,22,2,7,2.75
11,8,alliance,8,23,3,5,7.5
11,8,alone,5,24,2,3,1.25
11,8,also,4,25,2,2,1
11,8,although,8,26,2,6,2.25
11,8,angry,5,27,1,4,6.75
11,8,apart,5,28,1,4,1.5
11,8,appetite,8,29,2,6,2.5
11,8,apply,5,30,3,2,6.5
11,8,appoint,7,31,3,4,2.75
11,8,appointment,11,32,7,4,2.25
11,8,appropriate,11,33,3,8,7.25
11,8,arbitrary,9,34,1,8,2.25
11,8,armed,5,35,2,3,5.75
11,8,article,7,36,2,5,1.75
11,8,artificial,10,37,4,6,2.25
11,8,asset,5,38,1,4,6
11,8,attempt,7,39,1,6,2
11,8,attend,6,40,4,2,1
11,8,attorney,8,41,3,5,6.75
11,8,audit,5,42,1,4,1.25
11,8,august,6,43,2,4,1.5
11,8,autumn,6,44,2,4,5.75
11,8,aware,5,45,1,4,1.5
11,8,awkward,7,46,2,5,1.75
11,8,ballot,6,47,0,6,6.25
11,8,bare,4,48,2,2,0.75
11,8,basket,6,49,2,4,1.5
11,8,bean,4,50,1,3,2.25
11,8,bear,4,51,3,1,1
11,8,because,7,52,2,5,10.75
11,8,beef,4,53,2,2,1.75
11,8,before,6,54,2,4,2.75
11,8,behind,6,55,2,4,10.25
11,8,beside,6,56,2,4,3
11,8,bet,3,57,2,1,1
11,8,bicycle,7,58,1,6,4.25
11,8,blanket,7,59,1,6,12.25
11,8,blast,5,60,3,2,2.25
11,8,blend,5,61,2,3,2.5
11,8,bold,4,62,1,3,2.25
11,8,bond,4,63,2,2,12.5
11,8,bonus,5,64,3,2,3
11,8,born,4,65,2,2,3
11,8,branch,6,66,1,5,5.25
11,8,bread,5,67,2,3,5.25
11,8,breast,6,68,4,2,11.75
11,8,breath,6,69,4,2,2.25
11,8,brick,5,70,2,3,2.5
11,8,bring,5,71,3,2,2
11,8,broad,5,72,2,3,2.5
11,8,broadcast,9,73,5,4,14.75
11,8,buck,4,74,1,3,3.75
11,8,bus,3,75,2,1,1
11,8,but,3,76,2,1,1.25
11,8,button,6,77,3,3,2.75
11,8,cabin,5,78,0,5,13.25
11,8,cabinet,7,79,5,2,2.5
11,8,camp,4,80,2,2,1.75
11,8,captain,7,81,2,5,4.25
11,8,cattle,6,82,2,4,11.25
11,8,cause,5,83,2,3,2.25
11,8,caution,7,84,3,4,4.5
11,8,cautious,8,85,6,2,2.5
11,8,centre,6,86,1,5,11
11,8,champion,8,87,1,7,4.5
11,8,chance,6,88,3,3,2.5
11,8,chaos,5,89,3,2,9.75
11,8,charge,6,90,3,3,2.5
11,8,chef,4,91,2,2,1.75
11,8,cigarette,9,92,1,8,12.75
11,8,cinema,6,93,2,4,3
11,8,circulation,11,94,2,9,6
11,8,civic,5,95,2,3,10.25
11,8,classic,7,96,1,6,5
11,8,cling,5,97,2,3,2.5
11,8,clinic,6,98,4,2,9.5
11,8,clip,4,99,3,1,1.25
11,8,clock,5,100,2,3,2.25
11,8,close,5,101,3,2,2
11,8,closure,7,102,4,3,2.75
11,8,clothes,7,103,3,4,10.75
11,8,clothing,8,104,5,3,3
11,8,coast,5,105,1,4,2.75
11,8,coin,4,106,2,2,1.75
11,8,collapse,8,107,2,6,12
11,8,college,7,108,4,3,3
11,8,collision,9,109,4,5,4
11,8,colour,6,110,3,3,2.75
11,8,columnist,9,111,3,6,13
11,8,combat,6,112,2,4,3
11,8,combine,7,113,4,3,2.5
11,8,comic,5,114,3,2,11.5
11,8,commander,9,115,3,6,5.25
11,8,commentary,10,116,4,6,5.5
11,8,commitment,10,117,4,6,15
11,8,comparison,10,118,3,7,6
11,8,competitive,11,119,4,7,15
11,8,completely,10,120,4,6,4.5
11,8,complex,7,121,6,1,1.5
11,8,concentrate,11,122,2,9,13.75
11,8,conception,10,123,5,5,4
11,8,concession,10,124,5,5,11.5
11,8,conclude,8,125,4,4,3.25
11,8,concrete,8,126,4,4,3.25
11,8,confident,9,127,3,6,12
11,8,conflict,8,128,4,4,3.5
11,8,consecutive,11,129,3,8,13.5
11,8,consensus,9,130,5,4,3.75
11,8,conserve,8,131,5,3,3
11,8,consist,7,132,4,3,10.75
11,8,consistent,10,133,7,3,3.5
11,8,consolidate,11,134,4,7,5.25
11,8,constitute,10,135,4,6,12.5
11,8,construct,9,136,5,4,3.75
11,8,consume,7,137,4,3,2.75
11,8,consumer,8,138,7,1,1.5
11,8,continuous,10,139,3,7,12.75
11,8,contractor,10,140,4,6,4.5
11,8,contrary,8,141,6,2,2.5
11,8,contributor,11,142,5,6,12.75
11,8,convert,7,143,3,4,3
11,8,conviction,10,144,4,6,12.25
11,8,cop,3,145,2,1,1
11,8,copy,4,146,3,1,1
11,8,corporation,11,147,2,9,6.25
11,8,cotton,6,148,2,4,11.25
11,8,council,7,149,2,5,3.5
11,8,counsellor,10,150,4,6,12.5
11,8,countless,9,151,4,5,4
11,8,crack,5,152,1,4,2.75
11,8,crash,5,153,3,2,1.75
11,8,cream,5,154,2,3,11.75
11,8,creation,8,155,4,4,4.25
11,8,creative,8,156,6,2,3.75
11,8,creator,7,157,5,2,4.25
11,8,criterion,9,158,2,7,15
11,8,critical,8,159,4,4,4
11,8,criticism,9,160,6,3,5.5
11,8,crown,5,161,2,3,3
11,8,crystal,7,162,2,5,13.5
11,8,cult,4,163,1,3,2.5
11,8,cupboard,8,164,2,6,5
11,8,customer,8,165,2,6,14
11,8,cutting,7,166,2,5,4.25
11,8,dad,3,167,0,3,2.5
11,8,dancer,6,168,2,4,13
11,8,data,4,169,2,2,2
11,8,deadline,8,170,1,7,5.25
11,8,debris,6,171,2,4,12.25
11,8,debut,5,172,3,2,2
11,8,dedication,10,173,2,8,5.75
11,8,defy,4,174,2,2,10
11,8,delegation,10,175,2,8,6.25
11,8,delivery,8,176,3,5,12.75
11,8,denial,6,177,2,4,3.5
11,8,dependence,10,178,2,8,6.25
11,8,dependent,9,179,8,1,7.25
11,8,depict,6,180,3,3,1.25
11,8,descend,7,181,2,5,1.5
11,8,desert,6,182,3,3,1.25
11,8,desire,6,183,3,3,6.5
11,8,destroy,7,184,3,4,1.5
11,8,determined,10,185,2,8,2.5
11,8,dialogue,8,186,1,7,7.5
11,8,diary,5,187,3,2,1
11,8,dictionary,10,188,2,8,7.75
11,8,difficulty,10,189,2,8,2.5
11,8,dimension,9,190,2,7,7.75
11,8,dip,3,191,2,1,0.5
11,8,directly,8,192,2,6,1.75
11,8,directory,9,193,6,3,6.75
11,8,disagree,8,194,2,6,2
11,8,discard,7,195,3,4,1.5
11,8,disease,7,196,3,4,6.75
11,8,dispute,7,197,3,4,1.75
11,8,disrupt,7,198,3,4,1.5
11,8,distinct,8,199,3,5,7.75
11,8,distinction,11,200,8,3,2
11,8,distinctive,11,201,9,2,1.75
11,8,distract,8,202,4,4,1.75
11,8,district,8,203,5,3,1.5
11,8,diverse,7,204,2,5,7.75
11,8,diversity,9,205,6,3,1.5
11,8,doctrine,8,206,1,7,8
11,8,dominance,9,207,2,7,2.5
11,8,donor,5,208,2,3,1.25
11,8,door,4,209,2,2,0.75
11,8,drag,4,210,1,3,7
11,8,draw,4,211,3,1,0.75
11,8,drive,5,212,2,3,1.25
11,8,driver,6,213,5,1,0.75
11,8,drown,5,214,2,3,1.25
11,8,drug,4,215,2,2,1
11,8,drunk,5,216,3,2,7
11,8,dull,4,217,1,3,1
11,8,dump,4,218,2,2,1
11,8,early,5,219,0,5,1.5
11,8,easily,6,220,2,4,7.5
11,8,east,4,221,3,1,0.75
11,8,eastern,7,222,4,3,1.25
11,8,echo,4,223,1,3,1
11,8,ecological,10,224,2,8,8.25
11,8,economics,9,225,3,6,2.25
11,8,economy,7,226,6,1,1
11,8,editorial,9,227,1,8,8
11,8,educated,8,228,2,6,2
11,8,education,9,229,6,3,6.75
11,8,efficiency,10,230,1,9,2.75
11,8,election,8,231,1,7,7.5
11,8,electoral,9,232,5,4,1.75
11,8,elevate,7,233,3,4,1.5
11,8,else,4,234,2,2,0.75
11,8,embarrassed,11,235,1,10,8.5
11,8,embed,5,236,3,2,1
11,8,empire,6,237,2,4,6.75
11,8,empty,5,238,3,2,1
11,8,encouraging,11,239,1,10,8.25
11,8,endorse,7,240,2,5,1.75
11,8,enhance,7,241,2,5,1.75
11,8,enquire,7,242,2,5,7
11,8,ensue,5,243,2,3,1.25
11,8,entire,6,244,2,4,1.5
11,8,equip,5,245,1,4,1.25
11,8,era,3,246,1,2,6
11,8,erupt,5,247,2,3,1.25
11,8,escape,6,248,1,5,1.5
11,8,eternal,7,249,1,6,7.25
11,8,ethical,7,250,2,5,1.75
11,8,every,5,251,1,4,1.25
11,8,everybody,9,252,5,4,12
11,8,everyday,8,253,5,3,649.5
11,8,everywhere,10,254,5,5,5
11,8,evil,4,255,2,2,2.25
11,8,evolution,9,256,2,7,17.5
11,8,exaggerate,10,257,1,9,14
11,8,except,6,258,2,4,14.75
11,8,excitement,10,259,3,7,10
11,8,expected,8,260,2,6,15.25
11,8,experience,10,261,4,6,6.25
11,8,explosion,9,262,3,6,10.5
11,8,export,6,263,3,3,14.75
11,8,extremely,9,264,2,7,8.5
11,8,fabulous,8,265,0,8,24.75
11,8,facility,8,266,2,6,5
11,8,fairness,8,267,2,6,29.75
11,8,fame,4,268,2,2,4
11,8,fan,3,269,2,1,2.5
11,8,farm,4,270,2,2,2.5
11,8,favourite,9,271,2,7,27
11,8,feature,7,272,1,6,8.25
11,8,feed,4,273,2,2,3.5
11,8,feeling,7,274,3,4,6
11,8,fence,5,275,2,3,25.25
11,8,fighting,8,276,1,7,5.75
11,8,fill,4,277,2,2,1.75
11,8,film,4,278,3,1,1.25
11,8,final,5,279,2,3,12
11,8,finish,6,280,3,3,4.5
11,8,firework,8,281,2,6,6.25
11,8,first,5,282,3,2,3
11,8,fishing,7,283,2,5,12.5
11,8,fit,3,284,2,1,1.25
11,8,flame,5,285,1,4,3.5
11,8,fleet,5,286,2,3,2.5
11,8,float,5,287,2,3,9
11,8,flour,5,288,3,2,2
11,8,fluid,5,289,2,3,2.25
11,8,following,9,290,1,8,13.25
11,8,fond,4,291,2,2,1.75
11,8,fool,4,292,2,2,1.75
11,8,forecast,8,293,2,6,4.5
11,8,forgive,7,294,3,4,10
11,8,fork,4,295,3,1,1.5
11,8,formal,6,296,3,3,2
11,8,format,6,297,5,1,1
11,8,forth,5,298,3,2,1.25
11,8,fossil,6,299,2,4,5.25
11,8,frame,5,300,1,4,1.5
11,8,framework,9,301,5,4,1.5
11,8,franchise,9,302,3,6,6.25
11,8,freely,6,303,2,4,1.5
11,8,frequently,10,304,3,7,2.5
11,8,frightening,11,305,2,9,6.5
11,8,fruit,5,306,2,3,1.5
11,8,function,8,307,1,7,6.5
11,8,funny,5,308,3,2,1.25
11,8,furious,7,309,2,5,1.75
11,8,furthermore,11,310,3,8,7
11,8,gang,4,311,0,4,1.25
11,8,garden,6,312,2,4,1.5
11,8,gathering,9,313,2,7,6.5
11,8,generation,10,314,1,9,7.25
11,8,generic,7,315,5,2,1.25
11,8,generous,8,316,5,3,1.5
11,8,get,3,317,2,1,0.5
11,8,goal,4,318,1,3,1.25
11,8,goods,5,319,2,3,5.25
11,8,gorgeous,8,320,2,6,2.25
11,8,governance,10,321,2,8,6.5
11,8,government,10,322,6,4,2.25
11,8,graduate,8,323,1,7,2.25
11,8,grain,5,324,3,2,5
11,8,grandmother,11,325,3,8,2.75
11,8,grandparent,11,326,5,6,5.75
11,8,greatly,7,327,2,5,1.75
11,8,greenhouse,10,328,3,7,2.5
11,8,guard,5,329,1,4,6.5
11,8,guideline,9,330,2,7,5.25
11,8,halt,4,331,0,4,7.25
11,8,hand,4,332,2,2,1.75
11,8,harassment,10,333,2,8,4.25
11,8,hardly,6,334,3,3,6
11,8,hardware,8,335,4,4,2
11,8,harmful,7,336,3,4,1.75
11,8,harmony,7,337,4,3,1.25
11,8,he,2,338,1,1,0.5
11,8,healthcare,10,339,2,8,5.75
11,8,hear,4,340,3,1,0.75
11,8,hearing,7,341,4,3,1.25
11,8,heavily,7,342,3,4,4.75
11,8,hello,5,343,2,3,1.25
11,8,helpful,7,344,3,4,1.75
11,8,hence,5,345,2,3,1
11,8,hero,4,346,2,2,4.25
11,8,hidden,6,347,1,5,1.75
11,8,highway,7,348,2,5,1.75
11,8,historian,9,349,2,7,5.75
11,8,hobby,5,350,1,4,1.25
11,8,honour,6,351,2,4,1.5
11,8,house,5,352,2,3,4.5
11,8,ideological,11,353,0,11,3
11,8,imagine,7,354,1,6,5.5
11,8,immense,7,355,2,5,1.75
11,8,imminent,8,356,3,5,5.25
11,8,impact,6,357,2,4,1.25
11,8,impress,7,358,3,4,1.5
11,8,in,2,359,1,1,0.5
11,8,incentive,9,360,2,7,5.75
11,8,including,9,361,3,6,2
11,8,increase,8,362,3,5,5.25
11,8,indicator,9,363,2,7,2
11,8,indigenous,10,364,4,6,6.75
11,8,indoors,7,365,3,4,2.25
11,8,induce,6,366,3,3,1.25
11,8,industrial,10,367,4,6,2.25
11,8,inequality,10,368,2,8,6.75
11,8,initial,7,369,2,5,3.25
11,8,innocent,8,370,2,6,11.75
11,8,insider,7,371,2,5,2.5
11,8,inspiration,11,372,3,8,10.75
11,8,inspire,7,373,6,1,1.75
11,8,institution,11,374,3,8,5.75
11,8,insult,6,375,3,3,8.5
11,8,intensity,9,376,2,7,4.75
11,8,intention,9,377,5,4,11
11,8,interactive,11,378,4,7,10
11,8,interested,10,379,5,5,7.5
11,8,interpret,9,380,5,4,12.5
11,8,interview,9,381,5,4,5.25
11,8,intriguing,10,382,3,7,11.75
11,8,introduce,9,383,4,5,4
11,8,invent,6,384,2,4,2.75
11,8,investor,8,385,4,4,3
11,8,irrelevant,10,386,1,9,11.5
11,8,jeans,5,387,0,5,9
11,8,join,4,388,1,3,2.25
11,8,joint,5,389,4,1,1
11,8,journalist,10,390,2,8,5.25
11,8,july,4,391,1,3,7.75
11,8,justice,7,392,2,5,3.75
11,8,kill,4,393,0,4,2.5
11,8,kind,4,394,2,2,1.75
11,8,label,5,395,0,5,9.25
11,8,labour,6,396,3,3,2.5
11,8,ladder,6,397,2,4,3
11,8,landing,7,398,2,5,9.5
11,8,landlord,8,399,4,4,3.25
11,8,language,8,400,3,5,3.75
11,8,lately,6,401,2,4,8.75
11,8,lawsuit,7,402,2,5,3.5
11,8,lawyer,6,403,3,3,2.5
11,8,layout,6,404,2,4,9
11,8,leap,4,405,1,3,2.25
11,8,learn,5,406,3,2,1.75
11,8,legislation,11,407,2,9,12
11,8,length,6,408,2,4,3.25
11,8,level,5,409,2,3,2.25
11,8,liberation,10,410,1,9,11.75
11,8,lifetime,8,411,2,6,4.25
11,8,light,5,412,2,3,2.25
11,8,limit,5,413,2,3,8.25
11,8,linger,6,414,2,4,2.75
11,8,lobby,5,415,1,4,2.75
11,8,lock,4,416,2,2,1.75
11,8,logo,4,417,2,2,7.5
11,8,loom,4,418,2,2,1.5
11,8,lord,4,419,2,2,1.5
11,8,lose,4,420,2,2,1.5
11,8,lost,4,421,3,1,1
11,8,lower,5,422,2,3,2.25
11,8,luck,4,423,1,3,8
11,8,march,5,424,0,5,3.5
11,8,marker,6,425,3,3,3
11,8,marketing,9,426,5,4,3.75
11,8,matching,8,427,2,6,11.25
11,8,mate,4,428,3,1,1.25
11,8,mathematics,11,429,3,8,11.5
11,8,maths,5,430,4,1,1.25
11,8,matter,6,431,3,3,2.5
11,8,maximize,8,432,2,6,4.25
11,8,mayor,5,433,2,3,8.5
11,8,me,2,434,1,1,0.75
11,8,means,5,435,2,3,2.25
11,8,mechanism,9,436,2,7,4.5
11,8,medical,7,437,2,5,9.5
11,8,medicine,8,438,5,3,2.75
11,8,meet,4,439,2,2,1.5
11,8,metal,5,440,2,3,2.25
11,8,metaphor,8,441,4,4,9.25
11,8,militant,8,442,1,7,5
11,8,military,8,443,6,2,2
11,8,miner,5,444,2,3,8.5
11,8,mining,6,445,3,3,2.5
11,8,minor,5,446,3,2,2
11,8,miracle,7,447,2,5,3.5
11,8,modern,6,448,1,5,9.25
11,8,modest,6,449,4,2,2
11,8,morality,8,450,2,6,4.25
11,8,morning,7,451,3,4,9.75
11,8,motivation,10,452,2,8,5.5
11,8,motive,6,453,5,1,1.5
11,8,motor,5,454,3,2,2
11,8,motorcycle,10,455,5,5,11
11,8,motorist,8,456,5,3,3
11,8,mountain,8,457,2,6,4.25
11,8,myself,6,458,1,5,9.75
11,8,native,6,459,0,6,4
11,8,nest,4,460,1,3,2.25
11,8,net,3,461,2,1,7.25
11,8,network,7,462,3,4,3.25
11,8,next,4,463,2,2,1.75
11,8,noon,4,464,1,3,2.25
11,8,nose,4,465,2,2,1.75
11,8,notable,7,466,2,5,10
11,8,now,3,467,2,1,1
11,8,nowadays,8,468,3,5,3.5
11,8,number,6,469,1,5,9.5
11,8,nurse,5,470,2,3,2.25
11,8,nutrition,9,471,2,7,4.75
11,8,observe,7,472,0,7,11
11,8,obsession,9,473,4,5,3.75
11,8,obtain,6,474,2,4,3
11,8,obvious,7,475,2,5,9.75
11,8,occasion,8,476,1,7,4.75
11,8,occurrence,10,477,3,7,13.5
11,8,offering,8,478,1,7,4.75
11,8,on,2,479,1,1,0.75
11,8,ongoing,7,480,2,5,9.75
11,8,onion,5,481,2,3,2.25
11,8,operate,7,482,1,6,4
11,8,operator,8,483,6,2,8.25
11,8,opposition,10,484,2,8,5.25
11,8,optimism,8,485,2,6,10.25
11,8,orange,6,486,1,5,3.5
11,8,ordinary,8,487,2,6,4
11,8,organize,8,488,2,6,10.5
11,8,out,3,489,1,2,1.5
11,8,outrage,7,490,3,4,2.75
11,8,over,4,491,1,3,8.25
11,8,owner,5,492,1,4,3
11,8,oxygen,6,493,1,5,3.25
11,8,packet,6,494,0,6,10
11,8,palm,4,495,2,2,1.75
11,8,parameter,9,496,2,7,4.75
11,8,parent,6,497,3,3,8.5
11,8,pass,4,498,2,2,1.5
11,8,pathway,7,499,2,5,3.5
11,8,peak,4,500,1,3,2
11,8,peasant,7,501,3,4,9.25
11,8,penalty,7,502,2,5,3.75
11,8,period,6,503,2,4,2.75
11,8,permanent,9,504,3,6,10.5
11,8,person,6,505,3,3,2.5
11,8,persuade,8,506,4,4,3.25
11,8,petition,8,507,2,6,15.25
11,8,photograph,10,508,1,9,5.75
11,8,physics,7,509,2,5,9.75
11,8,pilot,5,510,1,4,2.75
11,8,pink,4,511,2,2,1.75
11,8,pit,3,512,2,1,1
11,8,plain,5,513,1,4,8.75
11,8,planet,6,514,3,3,2.5
11,8,pleasure,8,515,2,6,4.25
11,8,plug,4,516,2,2,1.75
11,8,plunge,6,517,3,3,8.75
11,8,pocket,6,518,1,5,3.5
11,8,poet,4,519,2,2,1.75
11,8,poetry,6,520,4,2,1.75
11,8,pole,4,521,2,2,1.25
11,8,pool,4,522,2,2,4.75
11,8,popular,7,523,2,5,1.5
11,8,positive,8,524,2,6,1.75
11,8,potential,9,525,2,7,6.5
11,8,poverty,7,526,2,5,1.5
11,8,powerful,8,527,2,6,6.5
11,8,preach,6,528,1,5,1.75
11,8,precede,7,529,3,4,1.75
11,8,preference,10,530,3,7,7.25
11,8,premium,7,531,3,4,1.25
11,8,prepare,7,532,3,4,1.25
11,8,pretty,6,533,3,3,5.25
11,8,previous,8,534,3,5,1.75
11,8,prey,4,535,3,1,0.5
11,8,price,5,536,2,3,1
11,8,pride,5,537,3,2,4.75
11,8,priest,6,538,3,3,1.25
11,8,prince,6,539,3,3,1
11,8,princess,8,540,6,2,0.75
11,8,problematic,11,541,2,9,6.5
11,8,production,10,542,3,7,2.25
11,8,productive,10,543,8,2,1.25
11,8,profession,10,544,3,7,6.25
11,8,promote,7,545,3,4,1.5
11,8,pronounced,10,546,3,7,6.25
11,8,prosecutor,10,547,3,7,2.25
11,8,protocol,8,548,3,5,5.5
11,8,province,8,549,3,5,1.75
11,8,provincial,10,550,7,3,1.25
11,8,provision,9,551,5,4,5.75
11,8,provoke,7,552,4,3,1.25
11,8,psychology,10,553,1,9,2.5
11,8,pub,3,554,1,2,4.75
11,8,publication,11,555,3,8,2.5
11,8,punch,5,556,2,3,1
11,8,purple,6,557,2,4,5
11,8,qualify,7,558,0,7,2
11,8,quarter,7,559,3,4,5.5
11,8,queen,5,560,2,3,1
11,8,queue,5,561,3,2,1
11,8,quickly,7,562,2,5,1.75
11,8,quota,5,563,2,3,1
11,8,quote,5,564,4,1,5
11,8,racist,6,565,0,6,1.75
11,8,radio,5,566,2,3,1.25
11,8,range,5,567,2,3,1.25
11,8,rare,4,568,2,2,4.75
11,8,read,4,569,1,3,1
11,8,readily,7,570,4,3,1
11,8,reading,7,571,5,2,0.75
11,8,realize,7,572,3,4,5.5
11,8,rebellion,9,573,2,7,2.25
11,8,receive,7,574,2,5,1.5
11,8,recipe,6,575,3,3,5.25
11,8,recipient,9,576,5,4,1.75
11,8,recovery,8,577,3,5,1.75
11,8,refugee,7,578,2,5,5.75
11,8,regret,6,579,2,4,1.25
11,8,relatively,10,580,2,8,6.5
11,8,relaxing,8,581,4,4,1.75
11,8,reliability,11,582,3,8,2.5
11,8,rely,4,583,3,1,4.75
11,8,remarkable,10,584,2,8,2.5
11,8,remote,6,585,3,3,1.25
11,8,renowned,8,586,2,6,6
11,8,rental,6,587,3,3,1.25
11,8,report,6,588,2,4,1.25
11,8,residential,11,589,2,9,6.75
11,8,restaurant,10,590,3,7,2.5
11,8,restoration,11,591,4,7,6.5
11,8,retreat,7,592,2,5,1.75
11,8,review,6,593,2,4,5.5
11,8,rhetoric,8,594,1,7,2.25
11,8,role,4,595,1,3,1
11,8,route,5,596,2,3,5.25
11,8,rugby,5,597,1,4,1.25
11,8,rumour,6,598,2,4,1.5
11,8,run,3,599,2,1,0.5
11,8,runner,6,600,3,3,5.25
11,8,saint,5,601,0,5,1.5
11,8,sanction,8,602,2,6,2
11,8,scope,5,603,1,4,5.25
11,8,scratch,7,604,2,5,1.75
11,8,scream,6,605,3,3,1.25
11,8,screening,9,606,4,5,6.25
11,8,script,6,607,3,3,1.25
11,8,sculpture,9,608,2,7,2.25
11,8,sea,3,609,1,2,0.75
11,8,section,7,610,2,5,5.75
11,8,see,3,611,2,1,0.5
11,8,seize,5,612,2,3,1
11,8,send,4,613,2,2,0.75
11,8,senior,6,614,3,3,5.25
11,8,sensitive,9,615,3,6,2.25
11,8,serial,6,616,2,4,1.25
11,8,session,7,617,2,5,6.5
11,8,seventeen,9,618,2,7,2.75
11,8,shadow,6,619,1,5,7
11,8,shake,5,620,3,2,1
11,8,shall,5,621,3,2,1
11,8,shaped,6,622,3,3,1.25
11,8,sheet,5,623,2,3,1.25
11,8,shine,5,624,2,3,5.75
11,8,shock,5,625,2,3,1.25
11,8,shocking,8,626,5,3,1.25
11,8,shop,4,627,3,1,0.5
11,8,short,5,628,3,2,0.75
11,8,shot,4,629,3,1,0.5
11,8,should,6,630,3,3,1
11,8,show,4,631,3,1,4.75
11,8,significant,11,632,1,10,2.75
11,8,silence,7,633,2,5,6
11,8,similarity,10,634,2,8,2.5
11,8,sincere,7,635,2,5,5.75
11,8,sing,4,636,3,1,0.5
11,8,sir,3,637,2,1,0.5
11,8,situation,9,638,2,7,2
11,8,sixty,5,639,2,3,5
11,8,size,4,640,2,2,0.75
11,8,skiing,6,641,1,5,1.5
11,8,skill,5,642,3,2,0.75
11,8,sky,3,643,2,1,0.5
11,8,slave,5,644,1,4,5.25
11,8,sleep,5,645,2,3,1
11,8,slow,4,646,2,2,0.75
11,8,small,5,647,1,4,1.25
11,8,smart,5,648,3,2,0.75
11,8,snap,4,649,1,3,5.25
11,8,soak,4,650,1,3,1
11,8,soar,4,651,3,1,0.5
11,8,society,7,652,2,5,1.5
11,8,soft,4,653,2,2,0.75
11,8,solely,6,654,2,4,5.75
11,8,somebody,8,655,2,6,2
11,8,somewhere,9,656,4,5,6
11,8,son,3,657,2,1,0.5
11,8,sort,4,658,2,2,0.75
11,8,span,4,659,1,3,1
11,8,spending,8,660,2,6,2
11,8,split,5,661,2,3,5.5
11,8,sponsor,7,662,2,5,1.5
11,8,stadium,7,663,1,6,6
11,8,stage,5,664,3,2,1
11,8,statement,9,665,3,6,2
11,8,status,6,666,4,2,1
11,8,steep,5,667,2,3,1
11,8,stiff,5,668,2,3,5.25
11,8,stimulate,9,669,3,6,2
11,8,stress,6,670,2,4,1.25
11,8,strive,6,671,3,3,5.5
11,8,stunning,8,672,2,6,2
11,8,success,7,673,1,6,6
11,8,suffer,6,674,2,4,1.5
11,8,suggestion,10,675,2,8,2.5
11,8,suicide,7,676,2,5,6.25
11,8,sum,3,677,2,1,0.5
11,8,summarize,9,678,3,6,1.75
11,8,summit,6,679,4,2,0.75
11,8,superb,6,680,2,4,5.75
11,8,superior,8,681,5,3,1.5
11,8,supermarket,11,682,5,6,2
11,8,supervision,11,683,5,6,6.25
11,8,supplement,10,684,3,7,2.25
11,8,suppress,8,685,4,4,6
11,8,surface,7,686,2,5,1.5
11,8,surprised,9,687,3,6,10.25
11,8,survive,7,688,3,4,2.75
11,8,swimming,8,689,1,7,3.25
11,8,sympathetic,11,690,1,10,7.5
11,8,systematic,10,691,2,8,7
11,8,t,1,692,0,1,0.5
11,8,tag,3,693,1,2,0.75
11,8,tax,3,694,2,1,0.5
11,8,teach,5,695,1,4,1.25
11,8,technique,9,696,2,7,6.5
11,8,teenage,7,697,2,5,1.75
11,8,teenager,8,698,7,1,0.75
11,8,tennis,6,699,2,4,5.5
11,8,tenure,6,700,3,3,1.5
11,8,terminal,8,701,2,6,2
11,8,terrible,8,702,3,5,8.75
11,8,testify,7,703,2,5,3.75
11,8,testing,7,704,5,2,2
11,8,than,4,705,1,3,2
11,8,theft,5,706,2,3,9.75
11,8,theirs,6,707,3,3,2.5
11,8,them,4,708,3,1,1.25
11,8,theology,8,709,3,5,4.25
11,8,there,5,710,3,2,2.5
11,8,therefore,9,711,5,4,12.75
11,8,thick,5,712,2,3,2.75
11,8,thief,5,713,3,2,2
11,8,thin,4,714,3,1,1.5
11,8,thing,5,715,4,1,1.5
11,8,thinking,8,716,4,4,12.5
11,8,threat,6,717,2,4,3.5
11,8,threaten,8,718,6,2,2.25
11,8,threshold,9,719,4,5,4.5
11,8,throat,6,720,3,3,11.25
11,8,throughout,10,721,4,6,5.25
11,8,throw,5,722,4,1,1.5
11,8,thursday,8,723,2,6,13
11,8,timber,6,724,1,5,3.75
11,8,tobacco,7,725,1,6,4.5
11,8,tomato,6,726,2,4,12
11,8,total,5,727,2,3,2.5
11,8,towel,5,728,2,3,2.25
11,8,toy,3,729,2,1,1
11,8,tradition,9,730,1,8,19
11,8,traditional,11,731,9,2,2.5
11,8,training,8,732,3,5,3.75
11,8,transform,9,733,3,6,12
11,8,true,4,734,2,2,1.75
11,8,truly,5,735,3,2,1.75
11,8,truth,5,736,3,2,1.75
11,8,try,3,737,2,1,1
11,8,tuesday,7,738,1,6,10.75
11,8,turnout,7,739,2,5,3.5
11,8,twenty,6,740,1,5,3.5
11,8,typical,7,741,1,6,11.25
11,8,typically,9,742,7,2,2
11,8,ultimately,10,743,0,10,13.25
11,8,umbrella,8,744,1,7,4.75
11,8,under,5,745,1,4,10.25
11,8,unfold,6,746,2,4,3
11,8,unfortunate,11,747,4,7,5
11,8,unit,4,748,2,2,9
11,8,unlike,6,749,2,4,3
11,8,up,2,750,1,1,0.75
11,8,upper,5,751,2,3,2.25
11,8,upset,5,752,2,3,2.25
11,8,upwards,7,753,2,5,13
11,8,used,4,754,1,3,2.25
11,8,variation,9,755,0,9,15
11,8,vast,4,756,2,2,2
11,8,vehicle,7,757,1,6,4.75
11,8,very,4,758,2,2,3.5
11,8,vicious,7,759,1,6,13.5
11,8,victim,6,760,3,3,2.75
11,8,village,7,761,2,5,4
11,8,violate,7,762,2,5,12.5
11,8,volume,6,763,1,5,3.75
11,8,voluntary,9,764,4,5,4
11,8,want,4,765,0,4,12.25
11,8,ward,4,766,2,2,2
11,8,wash,4,767,2,2,2.5
11,8,we,2,768,1,1,1.75
11,8,wear,4,769,2,2,3.25
11,8,web,3,770,2,1,1.75
11,8,week,4,771,2,2,14
11,8,weekly,6,772,4,2,3
11,8,well,4,773,2,2,2
11,8,wet,3,774,2,1,4.75
11,8,when,4,775,1,3,6
11,8,who,3,776,2,1,2.75
11,8,winter,6,777,1,5,2121
11,8,wish,4,778,2,2,3
11,8,withdraw,8,779,2,6,7.25
11,8,withdrawal,10,780,8,2,3.5
11,8,worldwide,9,781,1,8,16.75
11,8,wound,5,782,2,3,2.5
11,8,wrong,5,783,1,4,3
11,8,yell,4,784,0,4,12
11,8,yesterday,9,785,2,7,5.25
11,8,yourself,8,786,1,7,14
11,9,abortion,8,0,0,8,9
11,9,abstract,8,1,2,6,8.5
11,9,academy,7,2,1,6,4
11,9,acceptance,10,3,2,8,14.25
11,9,accessible,10,4,4,6,4.5
11,9,account,7,5,3,4,11.75
11,9,accountable,11,6,7,4,3.5
11,9,accountant,10,7,8,2,2.5
11,9,accuracy,8,8,3,5,12.5
11,9,acquire,7,9,2,5,3.5
11,9,activation,10,10,2,8,13.5
11,9,adhere,6,11,1,5,3.5
11,9,admission,9,12,2,7,5
11,9,advertise,9,13,2,7,13.5
11,9,advertising,11,14,8,3,3
11,9,affair,6,15,1,5,7.75
11,9,afraid,6,16,2,4,7.5
11,9,aged,4,17,1,3,3.5
11,9,ah,2,18,1,1,1.25
11,9,air,3,19,1,2,2.25
11,9,aircraft,8,20,3,5,13.75
11,9,alike,5,21,1,4,2.75
11,9,allegedly,9,22,2,7,5
11,9,also,4,23,2,2,9.5
11,9,although,8,24,2,6,4.25
11,9,altogether,10,25,3,7,13.75
11,9,amid,4,26,1,3,2.25
11,9,angel,5,27,1,4,2.75
11,9,anything,8,28,2,6,8
11,9,appearance,10,29,1,9,3.5
11,9,appetite,8,30,4,4,2
11,9,apple,5,31,3,2,5.5
11,9,apply,5,32,4,1,0.75
11,9,archive,7,33,1,6,1.75
11,9,arena,5,34,2,3,1
11,9,armed,5,35,2,3,5.75
11,9,array,5,36,2,3,1
11,9,article,7,37,2,5,1.5
11,9,artificial,10,38,4,6,6.75
11,9,asset,5,39,1,4,1.25
11,9,assignment,10,40,3,7,2.5
11,9,associated,10,41,3,7,7.25
11,9,association,11,42,8,3,1.75
11,9,athlete,7,43,1,6,6.75
11,9,attach,6,44,2,4,1.5
11,9,attack,6,45,5,1,0.75
11,9,attempt,7,46,3,4,1.5
11,9,attendance,10,47,4,6,9.25
11,9,attribute,9,48,3,6,2.75
11,9,audit,5,49,1,4,1.75
11,9,august,6,50,2,4,6.75
11,9,aware,5,51,1,4,1.25
11,9,away,4,52,3,1,0.75
11,9,backdrop,8,53,0,8,7.75
11,9,bad,3,54,2,1,0.5
11,9,ballot,6,55,2,4,1.5
11,9,basketball,10,56,2,8,7.5
11,9,because,7,57,1,6,1.75
11,9,become,6,58,3,3,1.25
11,9,before,6,59,2,4,6.75
11,9,beginning,9,60,2,7,2.25
11,9,behind,6,61,2,4,1.75
11,9,being,5,62,2,3,6.5
11,9,bend,4,63,2,2,0.75
11,9,beneath,7,64,3,4,1.5
11,9,beside,6,65,2,4,1.25
11,9,bet,3,66,2,1,5.25
11,9,blast,5,67,1,4,1.25
11,9,bond,4,68,1,3,1
11,9,bonus,5,69,3,2,1
11,9,boring,6,70,2,4,6
11,9,born,4,71,3,1,0.75
11,9,brain,5,72,1,4,1.25
11,9,breast,6,73,2,4,1.25
11,9,brilliant,9,74,2,7,7
11,9,bring,5,75,3,2,1
11,9,brown,5,76,2,3,1
11,9,buck,4,77,1,3,1
11,9,bulk,4,78,2,2,0.75
11,9,bureaucracy,11,79,2,9,7.5
11,9,burial,6,80,3,3,1.25
11,9,burst,5,81,3,2,1
11,9,bury,4,82,3,1,5.25
11,9,bus,3,83,2,1,0.5
11,9,busy,4,84,3,1,0.5
11,9,camp,4,85,0,4,1.25
11,9,capitalism,10,86,2,8,7.25
11,9,carriage,8,87,2,6,2
11,9,case,4,88,2,2,0.75
11,9,castle,6,89,3,3,1.25
11,9,cat,3,90,2,1,5.25
11,9,catch,5,91,3,2,1
11,9,cause,5,92,2,3,1
11,9,cautious,8,93,3,5,1.75
11,9,cent,4,94,1,3,5.75
11,9,centre,6,95,4,2,1
11,9,chance,6,96,1,5,1.5
11,9,chat,4,97,3,1,0.5
11,9,cheek,5,98,2,3,1
11,9,class,5,99,1,4,5.75
11,9,cling,5,100,2,3,1.25
11,9,clinic,6,101,4,2,1
11,9,clip,4,102,3,1,0.5
11,9,clock,5,103,2,3,1.25
11,9,close,5,104,3,2,0.75
11,9,closure,7,105,4,3,6
11,9,clothes,7,106,3,4,1.5
11,9,clothing,8,107,5,3,1.25
11,9,clue,4,108,2,2,0.75
11,9,coastal,7,109,1,6,6.5
11,9,coin,4,110,2,2,0.75
11,9,collapse,8,111,2,6,1.75
11,9,collision,9,112,4,5,12.75
11,9,coloured,8,113,3,5,2
11,9,columnist,9,114,3,6,8.5
11,9,combination,11,115,2,9,3.25
11,9,combine,7,116,6,1,1
11,9,comic,5,117,3,2,1
11,9,commerce,8,118,3,5,12.5
11,9,commit,6,119,4,2,1
11,9,commitment,10,120,6,4,1.75
11,9,communist,9,121,4,5,7
11,9,complaint,9,122,3,6,2
11,9,completely,10,123,5,5,1.75
11,9,complex,7,124,6,1,5.75
11,9,compliance,10,125,5,5,2
11,9,comprise,8,126,4,4,1.5
11,9,computer,8,127,4,4,6.25
11,9,concentrate,11,128,2,9,3
11,9,concession,10,129,5,5,6.75
11,9,conclude,8,130,4,4,1.5
11,9,concrete,8,131,4,4,1.5
11,9,confession,10,132,3,7,7.25
11,9,confident,9,133,4,5,2
11,9,conflict,8,134,4,4,1.75
11,9,confuse,7,135,4,3,6.25
11,9,confusion,9,136,6,3,1.75
11,9,conscience,10,137,3,7,2.5
11,9,conserve,8,138,4,4,6.75
11,9,consist,7,139,4,3,1.5
11,9,consistent,10,140,7,3,1.5
11,9,consolidate,11,141,4,7,7.25
11,9,construct,9,142,4,5,2
11,9,consume,7,143,4,3,1.25
11,9,container,9,144,3,6,7
11,9,continue,8,145,4,4,1.5
11,9,contract,8,146,4,4,1.5
11,9,contractor,10,147,8,2,1
11,9,convert,7,148,3,4,6.25
11,9,conviction,10,149,4,6,2.25
11,9,cooking,7,150,2,5,1.75
11,9,cooperate,9,151,3,6,7
11,9,copy,4,152,2,2,0.75
11,9,cotton,6,153,2,4,1.25
11,9,council,7,154,2,5,6.75
11,9,counsellor,10,155,4,6,2.25
11,9,countless,9,156,4,5,6.75
11,9,countryside,11,157,5,6,2.5
11,9,covered,7,158,2,5,1.75
11,9,cow,3,159,2,1,0.5
11,9,crash,5,160,1,4,6.25
11,9,cream,5,161,2,3,1.25
11,9,creative,8,162,4,4,1.5
11,9,creator,7,163,5,2,1.25
11,9,criticism,9,164,2,7,7.25
11,9,critique,8,165,5,3,1.5
11,9,crop,4,166,2,2,0.75
11,9,crystal,7,167,2,5,6.75
11,9,cult,4,168,1,3,1
11,9,cupboard,8,169,2,6,2
11,9,custody,7,170,2,5,6.75
11,9,dancer,6,171,0,6,1.75
11,9,database,8,172,2,6,7.25
11,9,daughter,8,173,2,6,2
11,9,deadline,8,174,1,7,7
11,9,dear,4,175,3,1,0.75
11,9,debate,6,176,2,4,1.5
11,9,debris,6,177,3,3,1.25
11,9,decorate,8,178,2,6,7.25
11,9,dedicated,9,179,2,7,2.5
11,9,dedication,10,180,7,3,1.5
11,9,defend,6,181,2,4,6.5
11,9,define,6,182,3,3,1.5
11,9,depart,6,183,2,4,1.5
11,9,depend,6,184,3,3,1.5
11,9,depict,6,185,3,3,6.25
11,9,derive,6,186,2,4,1.25
11,9,descent,7,187,2,5,1.5
11,9,desert,6,188,3,3,1.25
11,9,desperately,11,189,3,8,9.25
11,9,destroy,7,190,3,4,3.25
11,9,detection,9,191,2,7,13.5
11,9,deteriorate,11,192,4,7,5.25
11,9,development,11,193,2,9,14.5
11,9,dialogue,8,194,1,7,15
11,9,dictionary,10,195,2,8,6.75
11,9,die,3,196,2,1,1.25
11,9,dilemma,7,197,2,5,14.5
11,9,direction,9,198,2,7,5.75
11,9,directory,9,199,6,3,3.25
11,9,discard,7,200,2,5,17.25
11,9,discharge,9,201,4,5,4.75
11,9,discourse,9,202,4,5,4.75
11,9,disease,7,203,3,4,14
11,9,disorder,8,204,3,5,4.5
11,9,dispute,7,205,3,4,3.75
11,9,distinctive,11,206,3,8,16.75
11,9,distract,8,207,4,4,3.75
11,9,diverse,7,208,2,5,13.25
11,9,divorce,7,209,3,4,3.5
11,9,documentary,11,210,1,10,16.25
11,9,dominance,9,211,2,7,5.5
11,9,dominate,8,212,6,2,2.5
11,9,donor,5,213,2,3,12.25
11,9,door,4,214,2,2,2
11,9,dose,4,215,2,2,1.75
11,9,drag,4,216,1,3,2.25
11,9,dress,5,217,2,3,2.5
11,9,drive,5,218,2,3,11.25
11,9,driver,6,219,5,1,1.75
11,9,dry,3,220,2,1,1.5
11,9,dull,4,221,1,3,3.25
11,9,dynamic,7,222,1,6,7.5
11,9,east,4,223,0,4,14.5
11,9,eastern,7,224,4,3,4.75
11,9,economy,7,225,1,6,5.75
11,9,educated,8,226,1,7,16
11,9,education,9,227,6,3,3
11,9,efficiency,10,228,1,9,25.25
11,9,elaborate,9,229,1,8,8
11,9,election,8,230,2,6,18.5
11,9,electric,8,231,5,3,5.5
11,9,elementary,10,232,3,7,19.25
11,9,elevate,7,233,3,4,3.5
11,9,embarrassed,11,234,1,10,16.5
11,9,embed,5,235,3,2,2.25
11,9,emotional,9,236,2,7,5.5
11,9,emotionally,11,237,9,2,2.25
11,9,empire,6,238,2,4,13
11,9,employ,6,239,3,3,2.75
11,9,encourage,9,240,1,8,5.75
11,9,endorse,7,241,2,5,612.25
11,9,enforce,7,242,2,5,4.5
11,9,enough,6,243,2,4,3.25
11,9,enquire,7,244,2,5,10.25
11,9,enrol,5,245,2,3,2.25
11,9,ensue,5,246,2,3,2.25
11,9,entire,6,247,2,4,2.75
11,9,epidemic,8,248,1,7,9.75
11,9,equation,8,249,1,7,4.5
11,9,equivalent,10,250,3,7,10.25
11,9,era,3,251,1,2,1.5
11,9,error,5,252,2,3,2.25
11,9,escalate,8,253,1,7,9.75
11,9,escape,6,254,4,2,2
11,9,ethical,7,255,1,6,4
11,9,ethnic,6,256,3,3,11.75
11,9,everyday,8,257,1,7,5
11,9,everywhere,10,258,5,5,4.75
11,9,evil,4,259,2,2,11.75
11,9,evolution,9,260,2,7,2.75
11,9,exaggerate,10,261,1,9,15.25
11,9,exam,4,262,3,1,1.25
11,9,example,7,263,4,3,1.5
11,9,excess,6,264,2,4,1.75
11,9,excitement,10,265,3,7,11.75
11,9,exert,5,266,2,3,1.25
11,9,exotic,6,267,2,4,1.5
11,9,expected,8,268,2,6,7.25
11,9,experience,10,269,4,6,2.25
11,9,explicit,8,270,3,5,5.25
11,9,export,6,271,3,3,1.25
11,9,exposure,8,272,4,4,1.5
11,9,external,8,273,2,6,5
11,9,extra,5,274,3,2,0.75
11,9,extract,7,275,5,2,0.75
11,9,facility,8,276,0,8,5.25
11,9,fact,4,277,3,1,0.5
11,9,faction,7,278,4,3,1.25
11,9,factory,7,279,4,3,1
11,9,fairness,8,280,2,6,1.75
11,9,faith,5,281,3,2,4.25
11,9,farm,4,282,2,2,0.75
11,9,favourite,9,283,2,7,2
11,9,feature,7,284,1,6,5
11,9,feeling,7,285,2,5,1.75
11,9,figure,6,286,1,5,1.5
11,9,film,4,287,2,2,4.25
11,9,filter,6,288,3,3,1.25
11,9,final,5,289,2,3,1
11,9,finger,6,290,3,3,1
11,9,finish,6,291,3,3,4.5
11,9,first,5,292,2,3,1
11,9,flash,5,293,1,4,1.25
11,9,fleet,5,294,2,3,1
11,9,float,5,295,2,3,4.5
11,9,follow,6,296,1,5,1.75
11,9,fond,4,297,2,2,0.75
11,9,fool,4,298,2,2,0.75
11,9,forecast,8,299,2,6,5.75
11,9,forever,7,300,4,3,1.5
11,9,format,6,301,3,3,1.25
11,9,formulate,9,302,4,5,1.75
11,9,fossil,6,303,2,4,5.5
11,9,frankly,7,304,1,6,1.75
11,9,freely,6,305,2,4,1.25
11,9,from,4,306,2,2,5
11,9,fully,5,307,1,4,1.25
11,9,funny,5,308,2,3,1
11,9,furious,7,309,2,5,9
11,9,gang,4,310,0,4,2.75
11,9,gas,3,311,2,1,1
11,9,gathering,9,312,2,7,4.75
11,9,generation,10,313,1,9,12
11,9,generic,7,314,5,2,2
11,9,generous,8,315,5,3,2.5
11,9,genuine,7,316,3,4,9
11,9,goal,4,317,1,3,2.25
11,9,gradually,9,318,1,8,11.25
11,9,grain,5,319,3,2,2
11,9,grant,5,320,3,2,2
11,9,half,4,321,0,4,2.5
11,9,halt,4,322,3,1,1
11,9,hand,4,323,2,2,1.75
11,9,hardly,6,324,2,4,9
11,9,hardware,8,325,4,4,3.25
11,9,healthcare,10,326,1,9,12
11,9,hearing,7,327,3,4,3
11,9,heavily,7,328,3,4,3
11,9,hello,5,329,2,3,2.25
11,9,helmet,6,330,3,3,8.75
11,9,help,4,331,3,1,1.25
11,9,here,4,332,2,2,1.75
11,9,hide,4,333,1,3,2
11,9,hierarchy,9,334,2,7,11
11,9,highway,7,335,2,5,3.5
11,9,hill,4,336,2,2,1.5
11,9,himself,7,337,2,5,9.25
11,9,historian,9,338,2,7,4.75
11,9,history,7,339,6,1,1.5
11,9,hobby,5,340,1,4,2.75
11,9,hold,4,341,2,2,8
11,9,homeless,8,342,2,6,4
11,9,homework,8,343,4,4,3.25
11,9,hook,4,344,2,2,7.5
11,9,hope,4,345,2,2,1.5
11,9,horizon,7,346,2,5,3.5
11,9,hostile,7,347,2,5,3.5
11,9,hungry,6,348,1,5,9.5
11,9,husband,7,349,2,5,3.5
11,9,ideological,11,350,0,11,12.75
11,9,if,2,351,1,1,1
11,9,ignore,6,352,1,5,3.75
11,9,illness,7,353,1,6,11
11,9,immigrant,9,354,1,8,7.25
11,9,imminent,8,355,4,4,9.5
11,9,impact,6,356,2,4,3
11,9,in,2,357,1,1,0.75
11,9,inclined,8,358,2,6,9.75
11,9,including,9,359,4,5,4
11,9,increase,8,360,3,5,3.5
11,9,indoors,7,361,2,5,9.25
11,9,induce,6,362,3,3,2.75
11,9,indulge,7,363,4,3,2.75
11,9,industrial,10,364,4,6,9.75
11,9,infect,6,365,2,4,3.25
11,9,infection,9,366,6,3,2.75
11,9,inflation,9,367,3,6,4.25
11,9,inhabitant,10,368,2,8,11.5
11,9,initial,7,369,2,5,3.5
11,9,injured,7,370,2,5,9
11,9,inmate,6,371,2,4,3
11,9,innocent,8,372,2,6,10
11,9,innovative,10,373,4,6,4.75
11,9,input,5,374,2,3,2.25
11,9,insect,6,375,2,4,8.75
11,9,insight,7,376,3,4,3.25
11,9,insult,6,377,3,3,2.75
11,9,intensity,9,378,2,7,10.5
11,9,intention,9,379,5,4,3.5
11,9,interact,8,380,4,4,3
11,9,interested,10,381,5,5,9.5
11,9,invasion,8,382,2,6,4
11,9,invent,6,383,3,3,2.5
11,9,invisible,9,384,3,6,10
11,9,invoke,6,385,3,3,2.5
11,9,ironically,10,386,1,9,11.75
11,9,irrelevant,10,387,2,8,5.25
11,9,jeans,5,388,0,5,3.25
11,9,join,4,389,1,3,8
11,9,journalist,10,390,2,8,5.5
11,9,keen,4,391,0,4,8.5
11,9,kidnap,6,392,1,5,3.25
11,9,kill,4,393,2,2,1.75
11,9,killing,7,394,4,3,2.5
11,9,knock,5,395,1,4,8.75
11,9,lady,4,396,0,4,2.75
11,9,lane,4,397,2,2,1.75
11,9,language,8,398,3,5,3.5
11,9,late,4,399,2,2,7.75
11,9,lately,6,400,4,2,2
11,9,lawsuit,7,401,2,5,3.5
11,9,lawyer,6,402,3,3,3
11,9,lead,4,403,1,3,8
11,9,learn,5,404,3,2,1.75
11,9,legislation,11,405,2,9,6
11,9,leisure,7,406,2,5,9.5
11,9,lend,4,407,2,2,1.5
11,9,let,3,408,2,1,1
11,9,level,5,409,2,3,2
11,9,liberation,10,410,1,9,6.75
11,9,lifetime,8,411,2,6,2
11,9,light,5,412,2,3,4.5
11,9,linger,6,413,2,4,1.25
11,9,literacy,8,414,2,6,1.75
11,9,lively,6,415,2,4,5
11,9,lobby,5,416,1,4,1.25
11,9,lock,4,417,2,2,0.75
11,9,logic,5,418,2,3,1
11,9,loop,4,419,2,2,0.75
11,9,loss,4,420,2,2,4.25
11,9,lost,4,421,3,1,0.75
11,9,lovely,6,422,2,4,1.25
11,9,magnitude,9,423,0,9,6.25
11,9,mall,4,424,2,2,0.75
11,9,man,3,425,2,1,0.5
11,9,marathon,8,426,2,6,1.75
11,9,marginal,8,427,3,5,5.25
11,9,marker,6,428,3,3,1.25
11,9,mate,4,429,2,2,0.75
11,9,mathematics,11,430,3,8,6
11,9,matter,6,431,3,3,1
11,9,mayor,5,432,2,3,1
11,9,means,5,433,1,4,1.25
11,9,measure,7,434,3,4,5
11,9,medicine,8,435,2,6,1.75
11,9,meditation,10,436,4,6,5.5
11,9,meet,4,437,2,2,0.75
11,9,membership,10,438,2,8,2.5
11,9,metaphor,8,439,2,6,5.5
11,9,mile,4,440,1,3,1
11,9,military,8,441,3,5,1.75
11,9,milk,4,442,3,1,0.5
11,9,mill,4,443,3,1,0.5
11,9,mine,4,444,2,2,4.25
11,9,miner,5,445,4,1,0.5
11,9,minimize,8,446,3,5,1.5
11,9,mining,6,447,4,2,0.75
11,9,minor,5,448,3,2,0.75
11,9,missile,7,449,2,5,5.25
11,9,mistake,7,450,3,4,1.5
11,9,mobile,6,451,1,5,1.5
11,9,mode,4,452,2,2,4.25
11,9,modern,6,453,4,2,1
11,9,momentum,8,454,2,6,1.75
11,9,motor,5,455,2,3,1
11,9,mount,5,456,2,3,4.75
11,9,move,4,457,2,2,0.75
11,9,movement,8,458,4,4,1.25
11,9,multiply,8,459,1,7,5.75
11,9,mysterious,10,460,1,9,2.5
11,9,national,8,461,0,8,6
11,9,native,6,462,4,2,1
11,9,naval,5,463,2,3,1
11,9,nerve,5,464,1,4,4.75
11,9,nest,4,465,2,2,0.75
11,9,net,3,466,2,1,0.5
11,9,news,4,467,2,2,0.75
11,9,next,4,468,2,2,0.75
11,9,nineteen,8,469,1,7,5.75
11,9,nod,3,470,1,2,0.75
11,9,nonsense,8,471,2,6,1.75
11,9,noon,4,472,2,2,0.75
11,9,nose,4,473,2,2,0.75
11,9,now,3,474,2,1,4
11,9,nowadays,8,475,3,5,1.75
11,9,nurse,5,476,1,4,1.25
11,9,nutrition,9,477,2,7,6
11,9,o,1,478,0,1,0.25
11,9,object,6,479,1,5,1.5
11,9,obsession,9,480,2,7,5.75
11,9,occasion,8,481,1,7,2
11,9,occasional,10,482,8,2,1
11,9,offender,8,483,1,7,5.75
11,9,offering,8,484,4,4,1.5
11,9,ongoing,7,485,1,6,5.5
11,9,onto,4,486,2,2,0.75
11,9,open,4,487,1,3,1
11,9,operate,7,488,3,4,1.25
11,9,opinion,7,489,2,5,5.25
11,9,opposition,10,490,2,8,2.5
11,9,or,2,491,1,1,0.5
11,9,oral,4,492,2,2,0.75
11,9,order,5,493,2,3,4.75
11,9,orientation,11,494,2,9,2.5
11,9,originally,10,495,3,7,6
11,9,outrage,7,496,1,6,1.75
11,9,overly,6,497,1,5,5.25
11,9,overnight,9,498,4,5,1.75
11,9,own,3,499,1,2,0.75
11,9,owner,5,500,3,2,0.75
11,9,pair,4,501,0,4,5.5
11,9,parish,6,502,2,4,1.5
11,9,partnership,11,503,3,8,6.5
11,9,passage,7,504,2,5,1.75
11,9,pathway,7,505,2,5,1.5
11,9,payment,7,506,2,5,5.5
11,9,peak,4,507,1,3,1
11,9,people,6,508,2,4,1.25
11,9,period,6,509,2,4,1.25
11,9,permanent,9,510,3,6,5.75
11,9,permanently,11,511,9,2,1
11,9,person,6,512,3,3,1.75
11,9,persuade,8,513,4,4,9.75
11,9,petition,8,514,2,6,4.25
11,9,phase,5,515,1,4,2.75
11,9,pilot,5,516,1,4,9
11,9,pit,3,517,2,1,1
11,9,plate,5,518,1,4,2.75
11,9,player,6,519,3,3,2.5
11,9,pocket,6,520,1,5,9.5
11,9,poisonous,9,521,2,7,4.75
11,9,pole,4,522,2,2,1.75
11,9,policeman,9,523,3,6,10.5
11,9,pop,3,524,2,1,1
11,9,port,4,525,2,2,1.75
11,9,positive,8,526,2,6,4
11,9,potential,9,527,2,7,11
11,9,powerful,8,528,2,6,4.25
11,9,practice,8,529,1,7,10.75
11,9,prefer,6,530,2,4,3
11,9,preference,10,531,6,4,3.25
11,9,premium,7,532,3,4,9.25
11,9,present,7,533,3,4,3
11,9,prevent,7,534,3,4,3
11,9,previous,8,535,4,4,9.75
11,9,price,5,536,2,3,2.25
11,9,primarily,9,537,3,6,4.5
11,9,prince,6,538,3,3,8.75
11,9,prisoner,8,539,3,5,3.5
11,9,privilege,9,540,3,6,4.25
11,9,probable,8,541,2,6,10.25
11,9,problematic,11,542,4,7,5
11,9,proceed,7,543,3,4,9.25
11,9,profession,10,544,3,7,5.25
11,9,pronounce,9,545,3,6,11
11,9,prosecutor,10,546,3,7,5
11,9,protect,7,547,3,4,3
11,9,provide,7,548,3,4,9.5
11,9,provincial,10,549,5,5,4.25
11,9,provision,9,550,5,4,3.5
11,9,provoke,7,551,4,3,9.5
11,9,pub,3,552,1,2,1.5
11,9,publication,11,553,3,8,6.25
11,9,punishment,10,554,2,8,14.75
11,9,purchase,8,555,2,6,4.25
11,9,purple,6,556,3,3,9
11,9,pursue,6,557,3,3,2.5
11,9,qualify,7,558,0,7,4.5
11,9,question,8,559,2,6,10.75
11,9,quietly,7,560,2,5,3.5
11,9,quota,5,561,2,3,2.25
11,9,random,6,562,0,6,10.25
11,9,range,5,563,3,2,1.75
11,9,rapid,5,564,2,3,2.25
11,9,raw,3,565,2,1,1
11,9,reader,6,566,1,5,9.75
11,9,reading,7,567,4,3,2.75
11,9,really,6,568,3,3,2.5
11,9,rebellion,9,569,2,7,11.25
11,9,receive,7,570,2,5,3.75
11,9,recipient,9,571,3,6,4.25
11,9,recovery,8,572,3,5,10.25
11,9,red,3,573,2,1,1
11,9,refuge,6,574,2,4,2.75
11,9,refugee,7,575,6,1,1.25
11,9,register,8,576,2,6,10.25
11,9,relaxing,8,577,2,6,4.25
11,9,release,7,578,3,4,3
11,9,reliable,8,579,3,5,10.25
11,9,rely,4,580,3,1,1.25
11,9,remains,7,581,2,5,3.5
11,9,remote,6,582,3,3,2.25
11,9,renowned,8,583,2,6,10.75
11,9,replacement,11,584,2,9,12.25
11,9,reporter,8,585,3,5,4
11,9,represent,9,586,3,6,4.25
11,9,reproduce,9,587,4,5,10.25
11,9,respect,7,588,2,5,3.5
11,9,response,8,589,4,4,3.25
11,9,restaurant,10,590,3,7,11.5
11,9,restoration,11,591,4,7,5
11,9,restraint,9,592,4,5,10.5
11,9,result,6,593,3,3,2.5
11,9,resume,6,594,4,2,2
11,9,retreat,7,595,2,5,10.5
11,9,reverse,7,596,2,5,3.5
11,9,review,6,597,3,3,2.5
11,9,rhythm,6,598,1,5,4
11,9,rid,3,599,1,2,9.75
11,9,ridiculous,10,600,3,7,6
11,9,risk,4,601,2,2,2
11,9,rock,4,602,1,3,15.5
11,9,route,5,603,2,3,2.5
11,9,royal,5,604,2,3,2.25
11,9,rule,4,605,1,3,2.25
11,9,rumour,6,606,2,4,3
11,9,run,3,607,2,1,7.75
11,9,saint,5,608,0,5,3.25
11,9,scale,5,609,1,4,2.75
11,9,scratch,7,610,2,5,10.5
11,9,screening,9,611,3,6,4.5
11,9,script,6,612,3,3,2.5
11,9,sculpture,9,613,2,7,11.25
11,9,section,7,614,1,6,4
11,9,seize,5,615,2,3,2.25
11,9,self,4,616,2,2,8.25
11,9,senator,7,617,2,5,3.5
11,9,send,4,618,3,1,1.25
11,9,sensation,9,619,3,6,4.5
11,9,sensitive,9,620,4,5,10.5
11,9,sentence,8,621,3,5,3.75
11,9,serial,6,622,2,4,6.75
11,9,seventeen,9,623,2,7,2.25
11,9,several,7,624,4,3,1.25
11,9,sex,3,625,2,1,0.5
11,9,shadow,6,626,1,5,5.5
11,9,shake,5,627,3,2,0.75
11,9,shall,5,628,3,2,0.75
11,9,shine,5,629,2,3,1
11,9,shocking,8,630,2,6,6
11,9,shot,4,631,3,1,0.75
11,9,shout,5,632,3,2,0.75
11,9,shrink,6,633,2,4,1.25
11,9,shrug,5,634,3,2,0.75
11,9,significant,11,635,1,10,7
11,9,silence,7,636,2,5,1.75
11,9,silent,6,637,5,1,4.75
11,9,silly,5,638,3,2,1
11,9,sincere,7,639,2,5,1.5
11,9,sing,4,640,3,1,0.5
11,9,situation,9,641,2,7,6.25
11,9,skiing,6,642,1,5,1.5
11,9,sleep,5,643,1,4,1.25
11,9,slot,4,644,2,2,0.75
11,9,small,5,645,1,4,5.25
11,9,snap,4,646,1,3,1
11,9,son,3,647,1,2,0.5
11,9,soon,4,648,2,2,0.75
11,9,sort,4,649,2,2,0.75
11,9,span,4,650,1,3,5
11,9,speculate,9,651,2,7,2.25
11,9,spending,8,652,3,5,5.75
11,9,spicy,5,653,2,3,1
11,9,spill,5,654,3,2,0.75
11,9,split,5,655,2,3,1
11,9,spoil,5,656,2,3,1
11,9,sponsor,7,657,3,4,11
11,9,spoon,5,658,3,2,0.75
11,9,sport,5,659,3,2,0.75
11,9,spy,3,660,2,1,0.5
11,9,squeeze,7,661,1,6,12.75
11,9,stadium,7,662,1,6,2.25
11,9,stage,5,663,3,2,1.25
11,9,stark,5,664,3,2,1
11,9,statistical,11,665,3,8,7
11,9,steel,5,666,2,3,1
11,9,steep,5,667,4,1,0.75
11,9,stiff,5,668,2,3,1
11,9,strive,6,669,2,4,5.5
11,9,student,7,670,2,5,1.5
11,9,stupid,6,671,3,3,1.5
11,9,style,5,672,2,3,6
11,9,suffering,9,673,1,8,2.75
11,9,summarize,9,674,2,7,7.5
11,9,summit,6,675,4,2,1.25
11,9,superb,6,676,2,4,1.5
11,9,superior,8,677,5,3,1.5
11,9,supervision,11,678,5,6,7.25
11,9,supplement,10,679,3,7,2.5
11,9,surface,7,680,2,5,6.25
11,9,surge,5,681,3,2,0.75
11,9,surprised,9,682,3,6,1.75
11,9,surprising,10,683,7,3,1.25
11,9,surrender,9,684,3,6,6.25
11,9,suspicious,10,685,2,8,2.25
11,9,sustain,7,686,3,4,5.75
11,9,sweet,5,687,1,4,1.25
11,9,swimming,8,688,2,6,6.25
11,9,swing,5,689,3,2,1
11,9,sympathetic,11,690,1,10,2.75
11,9,systematic,10,691,2,8,6.75
11,9,tag,3,692,0,3,1
11,9,tax,3,693,2,1,0.5
11,9,technique,9,694,1,8,6.25
11,9,teenage,7,695,2,5,1.75
11,9,teenager,8,696,7,1,0.75
11,9,temporarily,11,697,2,9,6.75
11,9,tenure,6,698,2,4,1.25
11,9,terminal,8,699,2,6,6.25
11,9,terrain,7,700,3,4,1.5
11,9,terrorist,9,701,4,5,1.75
11,9,testify,7,702,2,5,5.75
11,9,testing,7,703,5,2,1
11,9,text,4,704,2,2,0.75
11,9,than,4,705,1,3,1
11,9,that,4,706,3,1,0.5
11,9,theft,5,707,2,3,5.25
11,9,theirs,6,708,3,3,1.25
11,9,therefore,9,709,3,6,2
11,9,think,5,710,2,3,1
11,9,though,6,711,2,4,5.75
11,9,threat,6,712,2,4,1.25
11,9,thrive,6,713,3,3,1
11,9,thursday,8,714,2,6,6.25
11,9,toll,4,715,1,3,1
11,9,tomato,6,716,2,4,1.25
11,9,ton,3,717,2,1,0.5
11,9,tone,4,718,3,1,0.5
11,9,total,5,719,2,3,5.75
11,9,touch,5,720,2,3,1
11,9,tourist,7,721,3,4,1.5
11,9,towards,7,722,2,5,6
11,9,trading,7,723,1,6,1.75
11,9,tradition,9,724,5,4,1.5
11,9,traditional,11,725,9,2,1
11,9,training,8,726,3,5,6
11,9,transaction,11,727,3,8,2.75
11,9,transition,10,728,5,5,6.5
11,9,tremendous,10,729,2,8,2.5
11,9,tribunal,8,730,2,6,6.25
11,9,true,4,731,2,2,0.75
11,9,trustee,7,732,3,4,1.5
11,9,truth,5,733,3,2,0.75
11,9,try,3,734,2,1,0.5
11,9,tuesday,7,735,1,6,6
11,9,turn,4,736,2,2,0.75
11,9,twist,5,737,1,4,1.25
11,9,typically,9,738,1,8,6.75
11,9,ultimately,10,739,0,10,7
11,9,under,5,740,1,4,1.25
11,9,unfold,6,741,2,4,1.25
11,9,unit,4,742,2,2,0.75
11,9,unlike,6,743,2,4,5.75
11,9,unlikely,8,744,6,2,1
11,9,upper,5,745,1,4,1.25
11,9,upwards,7,746,2,5,6
11,9,us,2,747,1,1,0.5
11,9,use,3,748,2,1,0.5
11,9,used,4,749,3,1,0.5
11,9,user,4,750,3,1,0.5
11,9,valid,5,751,0,5,1.5
11,9,victim,6,752,1,5,6
11,9,village,7,753,2,5,1.75
11,9,violate,7,754,2,5,1.5
11,9,vitamin,7,755,2,5,6.25
11,9,wage,4,756,0,4,1.25
11,9,wall,4,757,2,2,0.75
11,9,ward,4,758,2,2,0.75
11,9,warfare,7,759,3,4,6
11,9,wash,4,760,2,2,0.75
11,9,weak,4,761,1,3,1
11,9,wear,4,762,3,1,0.5
11,9,web,3,763,2,1,0.5
11,9,wedding,7,764,2,5,6.75
11,9,weekly,6,765,2,4,1.5
11,9,wet,3,766,2,1,0.5
11,9,while,5,767,1,4,1.25
11,9,whisper,7,768,3,4,9.25
11,9,who,3,769,2,1,2.5
11,9,whole,5,770,3,2,2071.5
11,9,widely,6,771,1,5,2
11,9,wish,4,772,2,2,1
11,9,withdrawal,10,773,2,8,9.5
11,9,worldwide,9,774,1,8,2.75
11,9,worm,4,775,3,1,0.75
11,9,worse,5,776,3,2,6.5
11,9,worst,5,777,4,1,1
11,9,wound,5,778,2,3,1.25
11,9,writing,7,779,1,6,2.25
11,9,wrong,5,780,2,3,1.25
11,9,yell,4,781,0,4,6.75
11,9,yesterday,9,782,2,7,2.5
11,9,you,3,783,1,2,1
11,9,yours,5,784,3,2,6.25
11,9,yourself,8,785,5,3,1.5
11,9,zone,4,786,0,4,1.25
3,0,ah,2,0,0,2,2.5
3,0,aid,3,1,1,2,2.5
3,0,all,3,2,1,2,1
3,0,bad,3,3,0,3,2.25
3,0,bee,3,4,1,2,2.25
3,0,bet,3,5,2,1,0.5
3,0,bus,3,6,1,2,0.75
3,0,but,3,7,2,1,0.75
3,0,cop,3,8,0,3,1
3,0,cow,3,9,2,1,0.5
3,0,cue,3,10,1,2,2
3,0,dip,3,11,0,3,2.5
3,0,dog,3,12,1,2,0.75
3,0,era,3,13,0,3,1
3,0,fan,3,14,0,3,0.75
3,0,get,3,15,0,3,4
3,0,he,2,16,0,2,14.5
3,0,if,2,17,0,2,0.75
3,0,man,3,18,0,3,1
3,0,nod,3,19,0,3,1
3,0,now,3,20,2,1,0.5
3,0,of,2,21,0,2,0.75
3,0,on,2,22,1,1,0.5
3,0,or,2,23,1,1,0.5
3,0,pan,3,24,0,3,3.75
3,0,pop,3,25,1,2,0.75
3,0,rid,3,26,0,3,1
3,0,sea,3,27,0,3,0.75
3,0,set,3,28,2,1,0.5
3,0,sky,3,29,1,2,0.75
3,0,sum,3,30,1,2,3.25
3,0,t,1,31,0,1,0.25
3,0,tag,3,32,1,2,0.75
3,0,tax,3,33,2,1,0.5
3,0,toy,3,34,1,2,0.5
3,0,try,3,35,1,2,0.5
3,0,us,2,36,0,2,0.5
3,0,web,3,37,0,3,3.5
3,0,who,3,38,1,2,0.75
3,1,act,3,0,0,3,1
3,1,aid,3,1,1,2,0.75
3,1,all,3,2,1,2,0.75
3,1,bee,3,3,0,3,3.75
3,1,bus,3,4,1,2,0.75
3,1,bye,3,5,1,2,0.75
3,1,cow,3,6,0,3,1
3,1,cue,3,7,1,2,0.75
3,1,dad,3,8,0,3,1
3,1,die,3,9,1,2,4
3,1,dip,3,10,2,1,0.75
3,1,dry,3,11,1,2,0.75
3,1,due,3,12,1,2,0.75
3,1,eat,3,13,0,3,0.75
3,1,era,3,14,1,2,0.75
3,1,fan,3,15,0,3,3.75
3,1,fit,3,16,1,2,0.75
3,1,fun,3,17,1,2,0.75
3,1,get,3,18,0,3,1
3,1,he,2,19,0,2,0.5
3,1,if,2,20,0,2,0.5
3,1,jam,3,21,0,3,3.75
3,1,man,3,22,0,3,1
3,1,net,3,23,0,3,0.75
3,1,or,2,24,0,2,0.5
3,1,out,3,25,1,2,0.75
3,1,own,3,26,1,2,0.75
3,1,red,3,27,0,3,3.75
3,1,rid,3,28,1,2,0.75
3,1,run,3,29,1,2,1
3,1,see,3,30,0,3,1
3,1,set,3,31,2,1,0.5
3,1,sir,3,32,1,2,0.75
3,1,spy,3,33,1,2,3.75
3,1,try,3,34,0,3,1
3,1,up,2,35,0,2,0.5
3,1,use,3,36,1,2,0.75
3,1,we,2,37,0,2,0.5
3,1,web,3,38,2,1,0.25
3,2,act,3,0,0,3,3.75
3,2,ah,2,1,1,1,0.5
3,2,aid,3,2,1,2,0.75
3,2,air,3,3,2,1,0.5
3,2,bet,3,4,0,3,1
3,2,but,3,5,1,2,0.75
3,2,cue,3,6,0,3,1
3,2,dad,3,7,0,3,3.75
3,2,due,3,8,1,2,0.75
3,2,era,3,9,0,3,1
3,2,fit,3,10,0,3,1
3,2,fun,3,11,1,2,0.75
3,2,gas,3,12,0,3,4
3,2,get,3,13,1,2,0.75
3,2,he,2,14,0,2,0.5
3,2,jam,3,15,0,3,0.75
3,2,let,3,16,0,3,0.75
3,2,man,3,17,0,3,4
3,2,me,2,18,1,1,0.5
3,2,nod,3,19,0,3,0.75
3,2,now,3,20,2,1,0.5
3,2,o,1,21,0,1,0.25
3,2,of,2,22,1,1,0.25
3,2,our,3,23,1,2,0.5
3,2,own,3,24,1,2,0.5
3,2,pit,3,25,0,3,3.75
3,2,pub,3,26,1,2,0.75
3,2,red,3,27,0,3,0.75
3,2,rid,3,28,1,2,0.75
3,2,run,3,29,1,2,0.75
3,2,say,3,30,0,3,0.75
3,2,sex,3,31,1,2,3.75
3,2,sir,3,32,1,2,0.75
3,2,sky,3,33,1,2,0.75
3,2,son,3,34,1,2,0.75
3,2,spy,3,35,1,2,0.75
3,2,ton,3,36,0,3,0.75
3,2,we,2,37,0,2,3.75
3,2,who,3,38,1,2,0.75
3,3,ah,2,0,0,2,0.75
3,3,aid,3,1,1,2,0.75
3,3,air,3,2,2,1,0.5
3,3,all,3,3,1,2,0.75
3,3,bee,3,4,0,3,3.75
3,3,bet,3,5,2,1,0.5
3,3,but,3,6,1,2,0.75
3,3,cat,3,7,0,3,1.25
3,3,cop,3,8,1,2,1.75
3,3,cow,3,9,2,1,1.25
3,3,cue,3,10,1,2,1.75
3,3,fun,3,11,0,3,7
3,3,gas,3,12,0,3,2
3,3,he,2,13,0,2,1.25
3,3,if,2,14,0,2,1.25
3,3,in,2,15,1,1,1
3,3,let,3,16,0,3,2
3,3,man,3,17,0,3,12.5
3,3,me,2,18,1,1,25
3,3,net,3,19,0,3,5.25
3,3,of,2,20,0,2,3.5
3,3,on,2,21,1,1,2.25
3,3,out,3,22,1,2,3.75
3,3,raw,3,23,0,3,2
3,3,red,3,24,1,2,1.5
3,3,rid,3,25,1,2,6.25
3,3,sad,3,26,0,3,2
3,3,see,3,27,1,2,1.5
3,3,set,3,28,2,1,1
3,3,sex,3,29,2,1,1
3,3,sir,3,30,1,2,1.5
3,3,son,3,31,1,2,1.5
3,3,tax,3,32,0,3,6.5
3,3,ton,3,33,1,2,1.5
3,3,toy,3,34,2,1,1
3,3,we,2,35,0,2,1.25
3,3,web,3,36,2,1,0.75
3,3,wet,3,37,2,1,0.75
3,3,you,3,38,0,3,2
3,4,act,3,0,0,3,2
3,4,air,3,1,1,2,1.75
3,4,bad,3,2,0,3,2
3,4,bet,3,3,1,2,1.5
3,4,big,3,4,1,2,3.75
3,4,bus,3,5,1,2,4.25
3,4,but,3,6,2,1,1.25
3,4,cat,3,7,0,3,2
3,4,cow,3,8,1,2,1.75
3,4,cue,3,9,1,2,1.75
3,4,dry,3,10,0,3,2
3,4,due,3,11,1,2,6.75
3,4,eat,3,12,0,3,2
3,4,fit,3,13,0,3,2
3,4,fun,3,14,1,2,1.75
3,4,gas,3,15,0,3,2
3,4,get,3,16,1,2,6
3,4,if,2,17,0,2,1.25
3,4,in,2,18,1,1,1
3,4,let,3,19,0,3,2
3,4,net,3,20,0,3,2
3,4,now,3,21,1,2,1.5
3,4,o,1,22,0,1,5.25
3,4,own,3,23,1,2,1.5
3,4,pub,3,24,0,3,2
3,4,run,3,25,0,3,2
3,4,say,3,26,0,3,2
3,4,sea,3,27,1,2,6.5
3,4,set,3,28,2,1,1.25
3,4,sir,3,29,1,2,1.75
3,4,sky,3,30,1,2,1.5
3,4,tag,3,31,0,3,2
3,4,tax,3,32,2,1,1
3,4,ton,3,33,1,2,1.5
3,4,us,2,34,0,2,6.25
3,4,we,2,35,0,2,1.5
3,4,web,3,36,2,1,1
3,4,who,3,37,1,2,1.5
3,4,you,3,38,0,3,2
3,5,air,3,0,0,3,2
3,5,bee,3,1,0,3,6.5
3,5,big,3,2,1,2,1.75
3,5,bus,3,3,1,2,1.75
3,5,bye,3,4,1,2,1.75
3,5,cat,3,5,0,3,2
3,5,cow,3,6,1,2,6.25
3,5,cue,3,7,1,2,1.5
3,5,eat,3,8,0,3,2
3,5,era,3,9,1,2,1.75
3,5,gas,3,10,0,3,2
3,5,he,2,11,0,2,1.25
3,5,if,2,12,0,2,6.5
3,5,in,2,13,1,1,1
3,5,jam,3,14,0,3,2
3,5,let,3,15,0,3,2
3,5,net,3,16,0,3,2
3,5,now,3,17,1,2,6.5
3,5,of,2,18,0,2,1.5
3,5,out,3,19,1,2,1.75
3,5,own,3,20,1,2,1.5
3,5,pan,3,21,0,3,2
3,5,pub,3,22,1,2,1.5
3,5,raw,3,23,0,3,6.5
3,5,red,3,24,1,2,1.5
3,5,run,3,25,1,2,1.5
3,5,say,3,26,0,3,2
3,5,see,3,27,1,2,1.5
3,5,set,3,28,2,1,1
3,5,sky,3,29,1,2,6.5
3,5,spy,3,30,1,2,1.5
3,5,t,1,31,0,1,0.75
3,5,tag,3,32,1,2,1.5
3,5,try,3,33,1,2,1.5
3,5,up,2,34,0,2,1.25
3,5,us,2,35,1,1,1
3,5,use,3,36,2,1,1
3,5,we,2,37,0,2,6
3,5,you,3,38,0,3,2
3,6,act,3,0,0,3,2
3,6,ah,2,1,1,1,1
3,6,aid,3,2,1,2,1.75
3,6,air,3,3,2,1,1.25
3,6,bee,3,4,0,3,7
3,6,big,3,5,1,2,1.5
3,6,bus,3,6,1,2,1.5
3,6,bye,3,7,1,2,1.5
3,6,dad,3,8,0,3,2
3,6,die,3,9,1,2,1.5
3,6,dog,3,10,1,2,6.5
3,6,dry,3,11,1,2,1.5
3,6,eat,3,12,0,3,2
3,6,era,3,13,1,2,1.5
3,6,fan,3,14,0,3,2
3,6,gas,3,15,0,3,6.75
3,6,he,2,16,0,2,1.25
3,6,in,2,17,0,2,1.25
3,6,let,3,18,0,3,2
3,6,man,3,19,0,3,2
3,6,net,3,20,0,3,8.75
3,6,nod,3,21,1,2,4.5
3,6,now,3,22,2,1,31.25
3,6,of,2,23,0,2,1.75
3,6,pit,3,24,0,3,2.75
3,6,pub,3,25,1,2,3.5
3,6,red,3,26,0,3,2.5
3,6,run,3,27,1,2,2
3,6,sad,3,28,0,3,6.25
3,6,say,3,29,2,1,1
3,6,sea,3,30,1,2,1.5
3,6,see,3,31,2,1,1
3,6,sex,3,32,2,1,1
3,6,sum,3,33,1,2,1.5
3,6,tax,3,34,0,3,2
3,6,us,2,35,0,2,5.25
3,6,wet,3,36,0,3,2
3,6,who,3,37,1,2,1.5
3,6,you,3,38,0,3,2
3,7,air,3,0,0,3,6.25
3,7,all,3,1,1,2,1.5
3,7,bad,3,2,0,3,2
3,7,but,3,3,1,2,1.5
3,7,bye,3,4,1,2,1.5
3,7,cop,3,5,0,3,2
3,7,dad,3,6,0,3,6.75
3,7,dog,3,7,1,2,1.75
3,7,dry,3,8,1,2,1.5
3,7,due,3,9,1,2,1.5
3,7,fit,3,10,0,3,2
3,7,fun,3,11,1,2,6.5
3,7,gas,3,12,0,3,2.25
3,7,if,2,13,0,2,1.5
3,7,jam,3,14,0,3,2
3,7,net,3,15,0,3,2
3,7,nod,3,16,1,2,3
3,7,o,1,17,0,1,1.75
3,7,on,2,18,1,1,0.5
3,7,or,2,19,1,1,0.25
3,7,out,3,20,1,2,0.75
3,7,pop,3,21,0,3,1
3,7,pub,3,22,1,2,0.75
3,7,raw,3,23,0,3,3.5
3,7,red,3,24,1,2,0.75
3,7,run,3,25,1,2,0.75
3,7,sad,3,26,0,3,0.75
3,7,say,3,27,2,1,0.5
3,7,sea,3,28,1,2,0.75
3,7,sex,3,29,2,1,0.5
3,7,sir,3,30,1,2,3.5
3,7,sky,3,31,1,2,0.75
3,7,son,3,32,1,2,0.75
3,7,t,1,33,0,1,0.25
3,7,tag,3,34,1,2,0.75
3,7,toy,3,35,1,2,0.75
3,7,up,2,36,0,2,0.5
3,7,us,2,37,1,1,0.5
3,7,we,2,38,0,2,3.5
3,8,act,3,0,0,3,0.75
3,8,air,3,1,1,2,0.75
3,8,bad,3,2,0,3,0.75
3,8,bus,3,3,1,2,0.75
3,8,cop,3,4,0,3,3.75
3,8,cow,3,5,2,1,0.5
3,8,cue,3,6,1,2,0.75
3,8,die,3,7,0,3,0.75
3,8,dog,3,8,1,2,0.75
3,8,dry,3,9,1,2,0.75
3,8,due,3,10,1,2,3.5
3,8,eat,3,11,0,3,0.75
3,8,fan,3,12,0,3,1
3,8,fit,3,13,1,2,0.75
3,8,fun,3,14,1,2,0.75
3,8,gas,3,15,0,3,3.75
3,8,get,3,16,1,2,0.75
3,8,he,2,17,0,2,0.5
3,8,jam,3,18,0,3,1
3,8,man,3,19,0,3,0.75
3,8,now,3,20,0,3,3.75
3,8,our,3,21,0,3,0.75
3,8,out,3,22,2,1,0.5
3,8,own,3,23,1,2,0.75
3,8,pan,3,24,0,3,0.75
3,8,pub,3,25,1,2,0.75
3,8,red,3,26,0,3,3.75
3,8,run,3,27,1,2,0.75
3,8,sea,3,28,0,3,0.75
3,8,sky,3,29,1,2,0.75
3,8,son,3,30,1,2,0.75
3,8,spy,3,31,1,2,0.75
3,8,t,1,32,0,1,3.25
3,8,tag,3,33,1,2,0.75
3,8,up,2,34,0,2,0.5
3,8,use,3,35,1,2,0.75
3,8,we,2,36,0,2,0.5
3,8,wet,3,37,2,1,0.5
3,8,who,3,38,1,2,0.75
3,9,act,3,0,0,3,1
3,9,ah,2,1,1,1,0.5
3,9,bee,3,2,0,3,1
3,9,cop,3,3,0,3,1.25
3,9,dog,3,4,0,3,6.5
3,9,dry,3,5,1,2,1
3,9,due,3,6,1,2,0.75
3,9,eat,3,7,0,3,1
3,9,era,3,8,1,2,0.75
3,9,fan,3,9,0,3,1
3,9,get,3,10,0,3,4
3,9,he,2,11,0,2,0.75
3,9,jam,3,12,0,3,1
3,9,let,3,13,0,3,0.75
3,9,man,3,14,0,3,4
3,9,me,2,15,1,1,0.5
3,9,nod,3,16,0,3,1
3,9,o,1,17,0,1,0.25
3,9,of,2,18,1,1,0.5
3,9,on,2,19,1,1,0.25
3,9,red,3,20,0,3,0.75
3,9,run,3,21,1,2,0.75
3,9,sad,3,22,0,3,4.25
3,9,sea,3,23,1,2,0.75
3,9,see,3,24,2,1,0.5
3,9,set,3,25,2,1,0.5
3,9,sex,3,26,2,1,0.5
3,9,sir,3,27,1,2,0.75
3,9,sky,3,28,1,2,0.75
3,9,son,3,29,1,2,3.5
3,9,spy,3,30,1,2,0.75
3,9,tag,3,31,0,3,0.75
3,9,ton,3,32,1,2,0.75
3,9,up,2,33,0,2,0.5
3,9,us,2,34,1,1,0.5
3,9,web,3,35,0,3,3.75
3,9,wet,3,36,2,1,0.75
3,9,who,3,37,1,2,0.75
3,9,you,3,38,0,3,1
4,0,able,4,0,0,4,3
4,0,ah,2,1,1,1,4.5
4,0,air,3,2,1,2,1.5
4,0,all,3,3,1,2,2.75
4,0,away,4,4,1,3,1.5
4,0,back,4,5,0,4,1.75
4,0,bad,3,6,2,1,0.75
4,0,bank,4,7,2,2,1
4,0,bare,4,8,2,2,1
4,0,bear,4,9,1,3,5.25
4,0,bee,3,10,2,1,0.5
4,0,bent,4,11,2,2,0.75
4,0,bet,3,12,2,1,0.5
4,0,big,3,13,1,2,0.75
4,0,body,4,14,1,3,1
4,0,bond,4,15,2,2,3.25
4,0,born,4,16,2,2,1
4,0,buck,4,17,1,3,1
4,0,bury,4,18,2,2,0.75
4,0,busy,4,19,2,2,0.75
4,0,camp,4,20,0,4,3.5
4,0,case,4,21,2,2,1
4,0,chat,4,22,1,3,1
4,0,chef,4,23,2,2,0.75
4,0,clip,4,24,1,3,1
4,0,coin,4,25,1,3,3.75
4,0,cook,4,26,2,2,1
4,0,cool,4,27,3,1,0.75
4,0,cow,3,28,2,1,0.5
4,0,cult,4,29,1,3,1
4,0,dad,3,30,0,3,0.75
4,0,dark,4,31,2,2,0.75
4,0,data,4,32,2,2,3.75
4,0,defy,4,33,1,3,1
4,0,dose,4,34,1,3,1
4,0,draw,4,35,1,3,1
4,0,drug,4,36,2,2,0.75
4,0,drum,4,37,3,1,3.25
4,0,dump,4,38,1,3,1
4,0,duty,4,39,2,2,0.75
4,0,each,4,40,0,4,1
4,0,east,4,41,2,2,0.75
4,0,easy,4,42,3,1,0.5
4,0,else,4,43,1,3,3.75
4,0,evil,4,44,1,3,1
4,0,exam,4,45,1,3,1
4,0,fact,4,46,0,4,1
4,0,fame,4,47,2,2,3.5
4,0,fan,3,48,2,1,0.5
4,0,feed,4,49,1,3,1
4,0,fill,4,50,1,3,1
4,0,find,4,51,2,2,0.75
4,0,fish,4,52,2,2,0.75
4,0,flaw,4,53,1,3,4.25
4,0,fold,4,54,1,3,1
4,0,fond,4,55,2,2,0.75
4,0,fool,4,56,2,2,0.75
4,0,fork,4,57,2,2,0.75
4,0,from,4,58,1,3,5
4,0,gang,4,59,0,4,1.25
4,0,gas,3,60,2,1,0.5
4,0,hand,4,61,0,4,1.25
4,0,hear,4,62,1,3,1
4,0,hero,4,63,2,2,3.5
4,0,hill,4,64,1,3,1
4,0,holy,4,65,1,3,1
4,0,hook,4,66,2,2,0.75
4,0,host,4,67,2,2,0.75
4,0,if,2,68,0,2,0.5
4,0,keen,4,69,0,4,99
4,0,kill,4,70,1,3,3.75
4,0,lady,4,71,0,4,4.25
4,0,lamp,4,72,2,2,2.25
4,0,leap,4,73,1,3,2.25
4,0,less,4,74,2,2,9
4,0,lock,4,75,1,3,2.25
4,0,logo,4,76,2,2,2
4,0,loom,4,77,2,2,2
4,0,loop,4,78,3,1,1.5
4,0,lord,4,79,2,2,1.75
4,0,lose,4,80,2,2,1.75
4,0,luck,4,81,1,3,6.75
4,0,lung,4,82,2,2,1.75
4,0,mall,4,83,0,4,2.5
4,0,man,3,84,2,1,1
4,0,mate,4,85,2,2,1.75
4,0,me,2,86,1,1,0.75
4,0,meet,4,87,2,2,6.5
4,0,monk,4,88,1,3,2
4,0,move,4,89,2,2,1.75
4,0,nail,4,90,0,4,2.5
4,0,nest,4,91,1,3,7.25
4,0,news,4,92,2,2,1.75
4,0,nod,3,93,1,2,1.5
4,0,nose,4,94,2,2,1.75
4,0,o,1,95,0,1,0.75
4,0,on,2,96,1,1,0.75
4,0,open,4,97,1,3,2
4,0,or,2,98,1,1,0.75
4,0,oven,4,99,1,3,6.75
4,0,over,4,100,3,1,1
4,0,own,3,101,1,2,1.5
4,0,peak,4,102,0,4,2.5
4,0,pit,3,103,1,2,1.5
4,0,poet,4,104,1,3,6.75
4,0,pole,4,105,2,2,1.75
4,0,port,4,106,2,2,1.75
4,0,pose,4,107,2,2,1.5
4,0,pray,4,108,1,3,2
4,0,prey,4,109,2,2,1.5
4,0,raw,3,110,0,3,6.75
4,0,read,4,111,1,3,2.25
4,0,riot,4,112,1,3,2.25
4,0,rule,4,113,1,3,2.25
4,0,sad,3,114,0,3,6.75
4,0,say,3,115,2,1,1.25
4,0,sea,3,116,1,2,1.5
4,0,see,3,117,2,1,1
4,0,set,3,118,2,1,1
4,0,sex,3,119,2,1,1
4,0,sir,3,120,1,2,1.5
4,0,size,4,121,2,2,1.75
4,0,sky,3,122,1,2,6
4,0,slow,4,123,1,3,2.25
4,0,soar,4,124,1,3,2.25
4,0,soft,4,125,2,2,1.75
4,0,son,3,126,2,1,1
4,0,sort,4,127,2,2,1.75
4,0,span,4,128,1,3,7.25
4,0,spot,4,129,2,2,1.75
4,0,spy,3,130,2,1,1
4,0,tag,3,131,0,3,2
4,0,tent,4,132,1,3,2.25
4,0,text,4,133,2,2,1.75
4,0,them,4,134,1,3,7.25
4,0,toll,4,135,1,3,2
4,0,true,4,136,1,3,2
4,0,try,3,137,2,1,1
4,0,turn,4,138,1,3,2
4,0,type,4,139,1,3,7
4,0,ugly,4,140,0,4,2.5
4,0,used,4,141,1,3,2.25
4,0,user,4,142,3,1,1.25
4,0,vast,4,143,0,4,7.5
4,0,very,4,144,1,3,2.25
4,0,want,4,145,0,4,2.5
4,0,wash,4,146,2,2,1.75
4,0,we,2,147,1,1,1
4,0,web,3,148,2,1,1
4,0,well,4,149,2,2,6.25
4,0,wish,4,150,1,3,2.25
4,0,worm,4,151,1,3,2
4,0,year,4,152,0,4,2.5
4,0,yell,4,153,2,2,1.75
4,0,zero,4,154,0,4,7.25
4,1,act,3,0,0,3,2
4,1,aged,4,1,1,3,2.25
4,1,air,3,2,1,2,1.5
4,1,all,3,3,1,2,6.75
4,1,away,4,4,1,3,2
4,1,back,4,5,0,4,2.5
4,1,bad,3,6,2,1,1
4,1,bean,4,7,1,3,2.25
4,1,bee,3,8,2,1,6
4,1,bend,4,9,2,2,1.75
4,1,bet,3,10,2,1,1
4,1,bias,4,11,1,3,2
4,1,body,4,12,1,3,2
4,1,bond,4,13,2,2,1.75
4,1,born,4,14,2,2,6.5
4,1,bulk,4,15,1,3,2
4,1,bury,4,16,2,2,1.75
4,1,case,4,17,0,4,2.5
4,1,chat,4,18,1,3,2.25
4,1,clip,4,19,1,3,7.25
4,1,cook,4,20,1,3,2
4,1,cow,3,21,2,1,1
4,1,cure,4,22,1,3,2
4,1,dad,3,23,0,3,2
4,1,data,4,24,2,2,6.5
4,1,dear,4,25,1,3,2.25
4,1,defy,4,26,2,2,1.75
4,1,die,3,27,1,2,1.5
4,1,dog,3,28,1,2,1.5
4,1,drag,4,29,1,3,2
4,1,draw,4,30,3,1,6
4,1,drum,4,31,2,2,1.75
4,1,dry,3,32,2,1,1
4,1,due,3,33,1,2,1.5
4,1,dull,4,34,2,2,1.75
4,1,each,4,35,0,4,2.5
4,1,easy,4,36,2,2,6.5
4,1,echo,4,37,1,3,2.25
4,1,else,4,38,1,3,2
4,1,evil,4,39,1,3,2.25
4,1,fan,3,40,0,3,2.5
4,1,feat,4,41,1,3,8.5
4,1,feel,4,42,2,2,2.5
4,1,film,4,43,1,3,2.25
4,1,find,4,44,2,2,1.75
4,1,flaw,4,45,1,3,2
4,1,fold,4,46,1,3,7.5
4,1,fond,4,47,2,2,1.75
4,1,fool,4,48,2,2,1.75
4,1,fund,4,49,1,3,2
4,1,get,3,50,0,3,2
4,1,glad,4,51,1,3,7.5
4,1,goal,4,52,1,3,2
4,1,half,4,53,0,4,2.5
4,1,halt,4,54,3,1,1
4,1,he,2,55,1,1,1
4,1,here,4,56,2,2,1.75
4,1,hero,4,57,3,1,7.5
4,1,hide,4,58,1,3,2.25
4,1,hook,4,59,1,3,2.25
4,1,hope,4,60,2,2,2
4,1,in,2,61,0,2,1.5
4,1,jam,3,62,0,3,8
4,1,kiss,4,63,0,4,2.75
4,1,lady,4,64,0,4,2.5
4,1,lane,4,65,2,2,1.5
4,1,lead,4,66,1,3,4.75
4,1,leap,4,67,3,1,0.75
4,1,less,4,68,2,2,1
4,1,loan,4,69,1,3,1.25
4,1,loop,4,70,2,2,1
4,1,lose,4,71,2,2,0.75
4,1,loss,4,72,3,1,0.75
4,1,luck,4,73,1,3,4.5
4,1,lung,4,74,2,2,1
4,1,me,2,75,0,2,0.75
4,1,meet,4,76,2,2,0.75
4,1,menu,4,77,2,2,0.75
4,1,mile,4,78,1,3,1.25
4,1,mill,4,79,3,1,5.25
4,1,mine,4,80,2,2,1.5
4,1,move,4,81,1,3,2.75
4,1,net,3,82,0,3,2.25
4,1,news,4,83,2,2,1
4,1,next,4,84,2,2,1
4,1,noon,4,85,1,3,6
4,1,now,3,86,2,1,1.25
4,1,o,1,87,0,1,0.75
4,1,onto,4,88,1,3,1.5
4,1,open,4,89,1,3,1.5
4,1,or,2,90,1,1,0.75
4,1,out,3,91,1,2,1.25
4,1,own,3,92,1,2,4.75
4,1,pair,4,93,0,4,2.75
4,1,palm,4,94,2,2,1.5
4,1,pass,4,95,2,2,2
4,1,pink,4,96,1,3,1.5
4,1,pit,3,97,2,1,6
4,1,port,4,98,1,3,2.75
4,1,pose,4,99,2,2,1.25
4,1,pray,4,100,1,3,1.75
4,1,rare,4,101,0,4,1.5
4,1,raw,3,102,2,1,4.25
4,1,read,4,103,1,3,1.25
4,1,rice,4,104,1,3,1
4,1,rid,3,105,2,1,0.5
4,1,rock,4,106,1,3,1
4,1,role,4,107,2,2,0.75
4,1,sad,3,108,0,3,4.5
4,1,sail,4,109,2,2,1
4,1,sea,3,110,1,2,0.75
4,1,self,4,111,2,2,0.75
4,1,send,4,112,2,2,0.75
4,1,shot,4,113,1,3,4.5
4,1,size,4,114,1,3,1.25
4,1,sky,3,115,1,2,0.75
4,1,slot,4,116,1,3,1
4,1,snap,4,117,1,3,1
4,1,soft,4,118,1,3,4.75
4,1,son,3,119,2,1,0.75
4,1,spy,3,120,1,2,0.75
4,1,t,1,121,0,1,0.25
4,1,tag,3,122,1,2,0.75
4,1,tax,3,123,2,1,0.5
4,1,tell,4,124,1,3,1
4,1,text,4,125,2,2,4.5
4,1,them,4,126,1,3,1
4,1,they,4,127,3,1,0.5
4,1,thin,4,128,2,2,0.75
4,1,tiny,4,129,1,3,1
4,1,toy,3,130,1,2,0.75
4,1,true,4,131,1,3,4.5
4,1,turn,4,132,1,3,1.25
4,1,ugly,4,133,0,4,1.25
4,1,up,2,134,1,1,0.5
4,1,us,2,135,1,1,0.5
4,1,used,4,136,2,2,1
4,1,vast,4,137,0,4,5
4,1,very,4,138,1,3,1
4,1,vote,4,139,1,3,1
4,1,wall,4,140,0,4,1.5
4,1,want,4,141,2,2,4.5
4,1,warm,4,142,2,2,1
4,1,wash,4,143,2,2,0.75
4,1,we,2,144,1,1,0.5
4,1,wear,4,145,2,2,0.75
4,1,web,3,146,2,1,0.5
4,1,well,4,147,2,2,0.75
4,1,wet,3,148,2,1,0.5
4,1,what,4,149,1,3,4
4,1,when,4,150,2,2,0.75
4,1,who,3,151,2,1,0.5
4,1,wish,4,152,1,3,1
4,1,worm,4,153,1,3,1
4,1,you,3,154,0,3,4
4,2,act,3,0,0,3,1
4,2,ah,2,1,1,1,0.5
4,2,all,3,2,1,2,0.75
4,2,also,4,3,2,2,1
4,2,amid,4,4,1,3,4.25
4,2,back,4,5,0,4,1.25
4,2,bank,4,6,2,2,0.75
4,2,bare,4,7,2,2,0.75
4,2,bee,3,8,1,2,0.75
4,2,beef,4,9,3,1,0.5
4,2,bend,4,10,2,2,4
4,2,bent,4,11,3,1,0.75
4,2,bet,3,12,2,1,0.5
4,2,born,4,13,1,3,1
4,2,bulk,4,14,1,3,1
4,2,but,3,15,2,1,0.5
4,2,camp,4,16,0,4,4.75
4,2,case,4,17,2,2,0.75
4,2,cat,3,18,2,1,0.5
4,2,clip,4,19,1,3,1
4,2,cook,4,20,1,3,1
4,2,cool,4,21,3,1,0.75
4,2,cue,3,22,1,2,1
4,2,cult,4,23,2,2,6
4,2,cure,4,24,2,2,1.5
4,2,dark,4,25,0,4,1.5
4,2,date,4,26,2,2,1.25
4,2,dead,4,27,1,3,2
4,2,die,3,28,1,2,5.25
4,2,dog,3,29,1,2,0.75
4,2,draw,4,30,1,3,1
4,2,drum,4,31,2,2,1
4,2,dry,3,32,2,1,0.75
4,2,due,3,33,1,2,0.75
4,2,dull,4,34,2,2,5.25
4,2,duty,4,35,2,2,2.5
4,2,east,4,36,0,4,25.75
4,2,eat,3,37,2,1,0.75
4,2,echo,4,38,1,3,1.5
4,2,else,4,39,1,3,1.75
4,2,farm,4,40,0,4,7.5
4,2,feat,4,41,1,3,1.25
4,2,feed,4,42,2,2,1
4,2,feel,4,43,3,1,1
4,2,film,4,44,1,3,1.25
4,2,fit,3,45,2,1,0.75
4,2,flaw,4,46,1,3,5.5
4,2,fond,4,47,1,3,1.25
4,2,fool,4,48,2,2,1
4,2,fork,4,49,2,2,0.75
4,2,from,4,50,1,3,1
4,2,gas,3,51,0,3,3.25
4,2,glad,4,52,1,3,1
4,2,half,4,53,0,4,1.25
4,2,halt,4,54,3,1,0.5
4,2,hand,4,55,2,2,0.75
4,2,here,4,56,1,3,3.75
4,2,hero,4,57,3,1,0.75
4,2,hold,4,58,1,3,1
4,2,hook,4,59,2,2,1
4,2,in,2,60,0,2,0.5
4,2,join,4,61,0,4,1.25
4,2,july,4,62,1,3,4
4,2,keen,4,63,0,4,1.25
4,2,kill,4,64,1,3,1
4,2,kind,4,65,2,2,1
4,2,lamp,4,66,0,4,4
4,2,late,4,67,2,2,0.75
4,2,lead,4,68,1,3,1
4,2,lend,4,69,2,2,0.75
4,2,lose,4,70,1,3,1
4,2,loss,4,71,3,1,0.5
4,2,luck,4,72,1,3,3.75
4,2,man,3,73,0,3,1
4,2,mate,4,74,2,2,0.75
4,2,me,2,75,1,1,0.5
4,2,mile,4,76,1,3,1
4,2,milk,4,77,3,1,0.5
4,2,mill,4,78,3,1,3.5
4,2,monk,4,79,1,3,1
4,2,nod,3,80,0,3,1
4,2,noon,4,81,2,2,0.75
4,2,nose,4,82,2,2,0.75
4,2,now,3,83,2,1,0.5
4,2,o,1,84,0,1,0.25
4,2,obey,4,85,1,3,4
4,2,of,2,86,1,1,0.5
4,2,onto,4,87,1,3,1
4,2,open,4,88,1,3,1
4,2,oral,4,89,1,3,1
4,2,over,4,90,1,3,4.25
4,2,pair,4,91,0,4,1.25
4,2,pan,3,92,2,1,0.5
4,2,peak,4,93,1,3,1
4,2,pit,3,94,1,2,0.75
4,2,pop,3,95,1,2,4.25
4,2,port,4,96,2,2,1
4,2,pose,4,97,2,2,1
4,2,pray,4,98,1,3,1
4,2,prey,4,99,2,2,0.75
4,2,pub,3,100,1,2,0.75
4,2,rain,4,101,0,4,4.75
4,2,rare,4,102,2,2,1
4,2,real,4,103,1,3,1
4,2,red,3,104,2,1,0.5
4,2,rice,4,105,1,3,1
4,2,rule,4,106,1,3,4.5
4,2,run,3,107,2,1,0.5
4,2,sad,3,108,0,3,1
4,2,say,3,109,2,1,0.5
4,2,sea,3,110,1,2,0.75
4,2,see,3,111,2,1,0.5
4,2,sex,3,112,2,1,0.5
4,2,shop,4,113,1,3,4.5
4,2,shot,4,114,3,1,0.75
4,2,show,4,115,3,1,0.75
4,2,sigh,4,116,1,3,1
4,2,sing,4,117,2,2,0.75
4,2,sir,3,118,2,1,0.5
4,2,size,4,119,2,2,0.75
4,2,slot,4,120,1,3,4
4,2,spot,4,121,1,3,1.25
4,2,spy,3,122,2,1,0.75
4,2,sum,3,123,1,2,0.75
4,2,tag,3,124,0,3,1
4,2,tent,4,125,1,3,2.5
4,2,text,4,126,2,2,2.5
4,2,than,4,127,1,3,1
4,2,that,4,128,3,1,0.5
4,2,them,4,129,2,2,0.75
4,2,then,4,130,3,1,0.5
4,2,thin,4,131,2,2,0.75
4,2,tiny,4,132,1,3,3.75
4,2,ton,3,133,1,2,0.75
4,2,toy,3,134,2,1,0.5
4,2,true,4,135,1,3,1
4,2,turn,4,136,1,3,1
4,2,up,2,137,0,2,0.75
4,2,us,2,138,1,1,0.5
4,2,use,3,139,2,1,3.5
4,2,vast,4,140,0,4,1.25
4,2,very,4,141,1,3,1
4,2,vote,4,142,1,3,1
4,2,wage,4,143,0,4,4.25
4,2,wall,4,144,2,2,1
4,2,ward,4,145,2,2,1
4,2,we,2,146,1,1,0.5
4,2,weak,4,147,2,2,0.75
4,2,wear,4,148,3,1,0.5
4,2,well,4,149,2,2,0.75
4,2,when,4,150,1,3,3.75
4,2,year,4,151,0,4,1.25
4,2,you,3,152,1,2,0.75
4,2,zero,4,153,0,4,1.25
4,2,zone,4,154,1,3,4
4,3,act,3,0,0,3,1
4,3,aged,4,1,1,3,1
4,3,ah,2,2,1,1,0.5
4,3,aid,3,3,1,2,0.75
4,3,air,3,4,2,1,0.5
4,3,all,3,5,1,2,3.25
4,3,bare,4,6,0,4,1.25
4,3,bean,4,7,1,3,1
4,3,bear,4,8,3,1,0.5
4,3,beef,4,9,2,2,0.75
4,3,bend,4,10,2,2,3.75
4,3,bias,4,11,1,3,1
4,3,big,3,12,2,1,0.5
4,3,body,4,13,1,3,1
4,3,bold,4,14,2,2,0.75
4,3,bond,4,15,2,2,0.75
4,3,bury,4,16,1,3,3.75
4,3,bus,3,17,2,1,0.5
4,3,busy,4,18,3,1,0.5
4,3,but,3,19,2,1,0.5
4,3,camp,4,20,0,4,1
4,3,case,4,21,2,2,0.75
4,3,cent,4,22,1,3,4
4,3,chef,4,23,1,3,1
4,3,clue,4,24,1,3,1
4,3,cook,4,25,1,3,1
4,3,cool,4,26,3,1,0.5
4,3,copy,4,27,2,2,0.75
4,3,cow,3,28,2,1,3.5
4,3,crop,4,29,1,3,1
4,3,cue,3,30,1,2,0.75
4,3,cult,4,31,2,2,0.75
4,3,date,4,32,0,4,1
4,3,deck,4,33,1,3,4
4,3,dip,3,34,1,2,0.75
4,3,dog,3,35,1,2,0.75
4,3,door,4,36,2,2,0.75
4,3,drag,4,37,1,3,0.75
4,3,draw,4,38,3,1,0.5
4,3,drum,4,39,2,2,4
4,3,dry,3,40,2,1,1.25
4,3,due,3,41,1,2,2.25
4,3,dull,4,42,2,2,27.25
4,3,dump,4,43,2,2,1.25
4,3,each,4,44,0,4,1.5
4,3,echo,4,45,1,3,2
4,3,edge,4,46,1,3,8.25
4,3,fact,4,47,0,4,2.5
4,3,fame,4,48,2,2,1.75
4,3,fan,3,49,2,1,1
4,3,feat,4,50,1,3,2
4,3,feed,4,51,2,2,1.75
4,3,feel,4,52,3,1,5.5
4,3,fill,4,53,1,3,2.25
4,3,film,4,54,3,1,1
4,3,find,4,55,2,2,1.75
4,3,fire,4,56,2,2,1.5
4,3,fish,4,57,2,2,1.5
4,3,fit,3,58,2,1,1
4,3,flaw,4,59,1,3,5.75
4,3,fun,3,60,1,2,1.5
4,3,gang,4,61,0,4,2.75
4,3,half,4,62,0,4,2.5
4,3,hand,4,63,2,2,6.25
4,3,help,4,64,1,3,2.25
4,3,hero,4,65,2,2,2
4,3,hook,4,66,1,3,2.25
4,3,hope,4,67,2,2,1.75
4,3,jam,3,68,0,3,2
4,3,kind,4,69,0,4,7.25
4,3,kiss,4,70,2,2,1.75
4,3,less,4,71,0,4,2.5
4,3,let,3,72,2,1,1
4,3,lock,4,73,1,3,7.25
4,3,loom,4,74,2,2,1.75
4,3,lord,4,75,2,2,1.75
4,3,lost,4,76,2,2,1.75
4,3,luck,4,77,1,3,2.25
4,3,mall,4,78,0,4,7.75
4,3,man,3,79,2,1,1
4,3,menu,4,80,1,3,2
4,3,milk,4,81,1,3,2.25
4,3,mill,4,82,3,1,1
4,3,news,4,83,0,4,2.5
4,3,next,4,84,2,2,6.25
4,3,nod,3,85,1,2,1.5
4,3,noon,4,86,2,2,1.75
4,3,nose,4,87,2,2,1.75
4,3,o,1,88,0,1,0.75
4,3,on,2,89,1,1,0.75
4,3,oral,4,90,1,3,2.25
4,3,our,3,91,1,2,6.25
4,3,out,3,92,2,1,1
4,3,oven,4,93,1,3,2
4,3,over,4,94,3,1,1
4,3,own,3,95,1,2,1.5
4,3,pan,3,96,0,3,2
4,3,pit,3,97,1,2,6.25
4,3,plug,4,98,1,3,2
4,3,poet,4,99,1,3,2
4,3,pole,4,100,2,2,1.75
4,3,port,4,101,2,2,1.75
4,3,pose,4,102,2,2,1.75
4,3,read,4,103,0,4,7.5
4,3,red,3,104,2,1,1
4,3,riot,4,105,1,3,2.25
4,3,risk,4,106,2,2,1.75
4,3,sad,3,107,0,3,2
4,3,sail,4,108,2,2,7.25
4,3,sea,3,109,1,2,1.75
4,3,see,3,110,2,1,1
4,3,self,4,111,2,2,1.75
4,3,send,4,112,2,2,1.75
4,3,set,3,113,2,1,1
4,3,sex,3,114,2,1,1
4,3,shot,4,115,1,3,7.5
4,3,show,4,116,3,1,1.5
4,3,sigh,4,117,1,3,2.25
4,3,sir,3,118,2,1,1
4,3,snap,4,119,1,3,2.25
4,3,soft,4,120,1,3,2
4,3,soon,4,121,2,2,3.75
4,3,sort,4,122,2,2,4.5
4,3,span,4,123,1,3,2.25
4,3,spot,4,124,2,2,1.75
4,3,spy,3,125,2,1,1
4,3,tax,3,126,0,3,2
4,3,text,4,127,1,3,7
4,3,than,4,128,1,3,2.25
4,3,them,4,129,2,2,1.75
4,3,then,4,130,3,1,1.25
4,3,they,4,131,3,1,1
4,3,thin,4,132,2,2,1.75
4,3,ton,3,133,1,2,1.5
4,3,tone,4,134,3,1,3.25
4,3,toy,3,135,2,1,1.25
4,3,true,4,136,1,3,2.25
4,3,ugly,4,137,0,4,2.5
4,3,unit,4,138,1,3,2.25
4,3,us,2,139,1,1,1
4,3,use,3,140,2,1,1
4,3,used,4,141,3,1,6.25
4,3,user,4,142,3,1,1.25
4,3,ward,4,143,0,4,2.5
4,3,wash,4,144,2,2,1.75
4,3,we,2,145,1,1,1
4,3,wear,4,146,2,2,1.5
4,3,web,3,147,2,1,1
4,3,what,4,148,1,3,6.75
4,3,wish,4,149,1,3,2
4,3,worm,4,150,1,3,2
4,3,yell,4,151,0,4,2.5
4,3,you,3,152,1,2,6.5
4,3,zero,4,153,0,4,2.75
4,3,zone,4,154,1,3,2.25
4,4,able,4,0,0,4,2.5
4,4,act,3,1,1,2,7
4,4,ah,2,2,1,1,1
4,4,aid,3,3,1,2,1.5
4,4,away,4,4,1,3,2
4,4,bare,4,5,0,4,2.5
4,4,bean,4,6,1,3,7.5
4,4,bear,4,7,3,1,1.25
4,4,bee,3,8,2,1,1.5
4,4,bend,4,9,2,2,1.75
4,4,bent,4,10,3,1,1.25
4,4,big,3,11,1,2,1.5
4,4,born,4,12,1,3,2
4,4,bulk,4,13,1,3,7.25
4,4,bury,4,14,2,2,1.75
4,4,bus,3,15,2,1,1
4,4,busy,4,16,3,1,1
4,4,bye,3,17,1,2,1.5
4,4,case,4,18,0,4,2.5
4,4,cat,3,19,2,1,1
4,4,cent,4,20,1,3,7.25
4,4,chat,4,21,1,3,2.25
4,4,chef,4,22,2,2,1.75
4,4,clue,4,23,1,3,2.25
4,4,coin,4,24,1,3,7.5
4,4,copy,4,25,2,2,1.75
4,4,crop,4,26,1,3,2
4,4,cue,3,27,1,2,1.5
4,4,cult,4,28,2,2,1.75
4,4,cure,4,29,2,2,1.75
4,4,dad,3,30,0,3,7
4,4,date,4,31,2,2,1.75
4,4,dead,4,32,1,3,2.25
4,4,dear,4,33,3,1,1.25
4,4,defy,4,34,2,2,1.75
4,4,dip,3,35,1,2,1.5
4,4,door,4,36,1,3,7.25
4,4,drag,4,37,1,3,2
4,4,draw,4,38,3,1,1.25
4,4,drum,4,39,2,2,1.75
4,4,due,3,40,1,2,1.5
4,4,duty,4,41,2,2,1.75
4,4,each,4,42,0,4,7.5
4,4,era,3,43,1,2,1.5
4,4,evil,4,44,1,3,2.25
4,4,fact,4,45,0,4,2.5
4,4,fan,3,46,2,1,1
4,4,feed,4,47,1,3,7
4,4,feel,4,48,3,1,1.25
4,4,fill,4,49,1,3,2.25
4,4,fire,4,50,2,2,1.75
4,4,fish,4,51,2,2,1.75
4,4,fit,3,52,2,1,1
4,4,five,4,53,2,2,1.5
4,4,fold,4,54,1,3,7.25
4,4,fond,4,55,2,2,1.75
4,4,fool,4,56,2,2,1.75
4,4,from,4,57,1,3,2
4,4,fun,3,58,1,2,1.5
4,4,fund,4,59,3,1,1
4,4,gas,3,60,0,3,6.75
4,4,goal,4,61,1,3,2.25
4,4,half,4,62,0,4,2.5
4,4,he,2,63,1,1,1
4,4,hear,4,64,2,2,1.75
4,4,help,4,65,2,2,10.75
4,4,hide,4,66,1,3,92.75
4,4,hill,4,67,2,2,2.25
4,4,holy,4,68,1,3,3
4,4,hook,4,69,2,2,3.5
4,4,july,4,70,0,4,7.25
4,4,keen,4,71,0,4,9.5
4,4,kill,4,72,1,3,2.25
4,4,kiss,4,73,2,2,1.75
4,4,lady,4,74,0,4,2.75
4,4,lane,4,75,2,2,6
4,4,lead,4,76,1,3,2.25
4,4,leap,4,77,3,1,1.25
4,4,lend,4,78,2,2,1.75
4,4,lock,4,79,1,3,2.25
4,4,logo,4,80,2,2,1.75
4,4,lose,4,81,2,2,5.75
4,4,mate,4,82,0,4,2.5
4,4,menu,4,83,1,3,2.25
4,4,mile,4,84,1,3,2.25
4,4,milk,4,85,3,1,1
4,4,mill,4,86,3,1,1
4,4,move,4,87,1,3,6.75
4,4,nail,4,88,0,4,2.5
4,4,nest,4,89,1,3,2.25
4,4,net,3,90,2,1,1.25
4,4,nod,3,91,1,2,1.5
4,4,of,2,92,0,2,6
4,4,oral,4,93,1,3,2.25
4,4,our,3,94,1,2,1.5
4,4,pan,3,95,0,3,2
4,4,pass,4,96,2,2,1.5
4,4,peak,4,97,1,3,7
4,4,pill,4,98,1,3,2.25
4,4,pink,4,99,2,2,1.75
4,4,pool,4,100,1,3,2.25
4,4,port,4,101,2,2,1.75
4,4,pose,4,102,2,2,6.5
4,4,pray,4,103,1,3,2.25
4,4,prey,4,104,2,2,1.75
4,4,raw,3,105,0,3,2
4,4,red,3,106,1,2,1.5
4,4,rid,3,107,1,2,1.5
4,4,risk,4,108,2,2,6.5
4,4,rule,4,109,1,3,2
4,4,run,3,110,2,1,1
4,4,sail,4,111,0,4,2.75
4,4,self,4,112,1,3,2.25
4,4,set,3,113,2,1,3.25
4,4,shop,4,114,1,3,4.75
4,4,sing,4,115,1,3,2
4,4,size,4,116,2,2,1.75
4,4,sky,3,117,1,2,1.5
4,4,slow,4,118,1,3,2
4,4,snap,4,119,1,3,7
4,4,soak,4,120,1,3,2.5
4,4,soft,4,121,2,2,1.75
4,4,son,3,122,2,1,1
4,4,soon,4,123,2,2,1.5
4,4,sort,4,124,2,2,1.75
4,4,span,4,125,1,3,7
4,4,spot,4,126,2,2,1.75
4,4,spy,3,127,2,1,1
4,4,tax,3,128,0,3,2
4,4,tell,4,129,1,3,2
4,4,that,4,130,1,3,6.75
4,4,then,4,131,2,2,1.75
4,4,thin,4,132,2,2,1.75
4,4,toll,4,133,1,3,2
4,4,tone,4,134,2,2,1.75
4,4,turn,4,135,1,3,6.75
4,4,type,4,136,1,3,2.25
4,4,ugly,4,137,0,4,2
4,4,up,2,138,1,1,0.75
4,4,use,3,139,1,2,1
4,4,used,4,140,3,1,0.5
4,4,user,4,141,3,1,0.5
4,4,vast,4,142,0,4,4
4,4,want,4,143,0,4,1.25
4,4,warm,4,144,2,2,0.75
4,4,we,2,145,1,1,0.5
4,4,weak,4,146,2,2,0.75
4,4,wear,4,147,3,1,3.5
4,4,week,4,148,2,2,1
4,4,when,4,149,1,3,1
4,4,wise,4,150,1,3,1
4,4,worm,4,151,1,3,1
4,4,year,4,152,0,4,4
4,4,yell,4,153,2,2,0.75
4,4,zone,4,154,0,4,1.25
4,5,able,4,0,0,4,4
4,5,act,3,1,1,2,0.75
4,5,aid,3,2,1,2,0.75
4,5,air,3,3,2,1,0.5
4,5,also,4,4,1,3,1
4,5,away,4,5,1,3,1
4,5,bad,3,6,0,3,4.25
4,5,bake,4,7,2,2,0.75
4,5,bear,4,8,1,3,1
4,5,bee,3,9,2,1,0.5
4,5,bend,4,10,2,2,0.75
4,5,bias,4,11,1,3,1
4,5,bond,4,12,1,3,3.75
4,5,born,4,13,2,2,1.25
4,5,bury,4,14,1,3,1
4,5,busy,4,15,2,2,1
4,5,but,3,16,2,1,0.5
4,5,calm,4,17,0,4,4
4,5,cat,3,18,2,1,0.5
4,5,chef,4,19,1,3,1
4,5,cook,4,20,1,3,1
4,5,cow,3,21,2,1,0.5
4,5,crop,4,22,1,3,1
4,5,cure,4,23,1,3,4
4,5,date,4,24,0,4,1.25
4,5,dead,4,25,1,3,1
4,5,dear,4,26,3,1,0.75
4,5,dip,3,27,1,2,0.75
4,5,dog,3,28,1,2,3.5
4,5,dose,4,29,2,2,1
4,5,drag,4,30,1,3,1
4,5,drug,4,31,2,2,0.75
4,5,dry,3,32,2,1,0.5
4,5,due,3,33,1,2,0.75
4,5,dump,4,34,2,2,0.75
4,5,each,4,35,0,4,4
4,5,east,4,36,2,2,0.75
4,5,eat,3,37,2,1,0.5
4,5,echo,4,38,1,3,1
4,5,edge,4,39,1,3,1
4,5,evil,4,40,1,3,3.75
4,5,fan,3,41,0,3,0.75
4,5,feed,4,42,1,3,1
4,5,film,4,43,1,3,1
4,5,fire,4,44,2,2,0.75
4,5,fit,3,45,2,1,3.5
4,5,flaw,4,46,1,3,1
4,5,fool,4,47,1,3,1
4,5,fork,4,48,2,2,1
4,5,fun,3,49,1,2,0.5
4,5,get,3,50,0,3,4
4,5,glad,4,51,1,3,1
4,5,half,4,52,0,4,1
4,5,halt,4,53,3,1,0.5
4,5,hand,4,54,2,2,0.75
4,5,hear,4,55,1,3,3.75
4,5,help,4,56,2,2,1
4,5,here,4,57,2,2,0.75
4,5,hide,4,58,1,3,1
4,5,hold,4,59,1,3,1
4,5,holy,4,60,3,1,0.5
4,5,hook,4,61,2,2,3.75
4,5,host,4,62,2,2,0.75
4,5,if,2,63,0,2,0.5
4,5,in,2,64,1,1,0.5
4,5,jam,3,65,0,3,0.75
4,5,keen,4,66,0,4,1
4,5,kiss,4,67,1,3,4
4,5,lady,4,68,0,4,1.25
4,5,lane,4,69,2,2,0.75
4,5,late,4,70,2,2,0.75
4,5,lead,4,71,1,3,2.25
4,5,lock,4,72,1,3,2.5
4,5,loom,4,73,2,2,0.75
4,5,loss,4,74,2,2,0.75
4,5,luck,4,75,1,3,1
4,5,lung,4,76,2,2,0.75
4,5,man,3,77,0,3,4
4,5,mate,4,78,2,2,0.75
4,5,mill,4,79,1,3,1
4,5,move,4,80,1,3,1
4,5,net,3,81,0,3,0.75
4,5,news,4,82,2,2,4
4,5,next,4,83,2,2,1
4,5,noon,4,84,1,3,1
4,5,nose,4,85,2,2,0.75
4,5,now,3,86,2,1,0.5
4,5,obey,4,87,0,4,4.25
4,5,of,2,88,1,1,0.5
4,5,on,2,89,1,1,0.5
4,5,onto,4,90,2,2,0.75
4,5,or,2,91,1,1,0.25
4,5,oral,4,92,2,2,0.75
4,5,out,3,93,1,2,0.5
4,5,over,4,94,1,3,0.75
4,5,palm,4,95,0,4,4.25
4,5,pan,3,96,2,1,0.5
4,5,pass,4,97,2,2,1
4,5,pink,4,98,1,3,1.25
4,5,pit,3,99,2,1,0.5
4,5,poet,4,100,1,3,4
4,5,pool,4,101,2,2,1
4,5,pop,3,102,2,1,0.5
4,5,port,4,103,2,2,0.75
4,5,pub,3,104,1,2,0.75
4,5,raw,3,105,0,3,0.75
4,5,read,4,106,1,3,4
4,5,real,4,107,3,1,0.75
4,5,red,3,108,2,1,0.5
4,5,rely,4,109,2,2,0.75
4,5,riot,4,110,1,3,1
4,5,rule,4,111,1,3,1
4,5,run,3,112,2,1,0.5
4,5,sad,3,113,0,3,4
4,5,sail,4,114,2,2,0.75
4,5,sea,3,115,1,2,0.75
4,5,set,3,116,2,1,0.5
4,5,sex,3,117,2,1,0.5
4,5,shop,4,118,1,3,1
4,5,show,4,119,3,1,0.5
4,5,sir,3,120,1,2,3.5
4,5,slot,4,121,1,3,1
4,5,soft,4,122,1,3,1
4,5,son,3,123,2,1,0.5
4,5,span,4,124,1,3,1
4,5,spy,3,125,2,1,0.5
4,5,sum,3,126,1,2,3.5
4,5,t,1,127,0,1,0.25
4,5,tag,3,128,1,2,0.75
4,5,tell,4,129,1,3,1
4,5,text,4,130,2,2,0.75
4,5,then,4,131,1,3,0.75
4,5,thin,4,132,2,2,3.75
4,5,tone,4,133,1,3,1
4,5,true,4,134,1,3,1
4,5,turn,4,135,1,3,1
4,5,unit,4,136,0,4,1.25
4,5,up,2,137,1,1,3.5
4,5,use,3,138,1,2,0.75
4,5,used,4,139,3,1,0.5
4,5,user,4,140,3,1,0.5
4,5,very,4,141,0,4,1.25
4,5,vote,4,142,1,3,1
4,5,want,4,143,0,4,4.25
4,5,warm,4,144,2,2,0.75
4,5,we,2,145,1,1,0.5
4,5,weak,4,146,2,2,0.75
4,5,web,3,147,2,1,0.5
4,5,week,4,148,2,2,0.75
4,5,wet,3,149,2,1,0.5
4,5,who,3,150,1,2,3.75
4,5,wise,4,151,1,3,1
4,5,wish,4,152,3,1,0.5
4,5,yell,4,153,0,4,1
4,5,you,3,154,1,2,0.75
4,6,aged,4,0,0,4,2.75
4,6,ah,2,1,1,1,0.5
4,6,air,3,2,1,2,0.75
4,6,bad,3,3,0,3,0.75
4,6,bank,4,4,2,2,2.25
4,6,bare,4,5,2,2,4.25
4,6,bee,3,6,1,2,7.25
4,6,bend,4,7,2,2,3.25
4,6,big,3,8,1,2,3.25
4,6,bold,4,9,1,3,2.75
4,6,bond,4,10,2,2,2.25
4,6,born,4,11,2,2,2.25
4,6,bury,4,12,1,3,12.25
4,6,bus,3,13,2,1,2.25
4,6,but,3,14,2,1,3.25
4,6,calm,4,15,0,4,4.5
4,6,case,4,16,2,2,2.25
4,6,cat,3,17,2,1,1.5
4,6,chef,4,18,1,3,7.5
4,6,clip,4,19,1,3,2.25
4,6,cool,4,20,1,3,2.25
4,6,cop,3,21,2,1,1
4,6,cow,3,22,2,1,1
4,6,crop,4,23,1,3,2
4,6,cult,4,24,1,3,6.25
4,6,cure,4,25,2,2,1.75
4,6,deck,4,26,0,4,2.5
4,6,defy,4,27,2,2,1.75
4,6,die,3,28,1,2,1.5
4,6,dip,3,29,2,1,1
4,6,dog,3,30,1,2,6.25
4,6,door,4,31,2,2,1.75
4,6,draw,4,32,1,3,2.25
4,6,drug,4,33,2,2,1.75
4,6,drum,4,34,3,1,1.25
4,6,dry,3,35,2,1,1
4,6,due,3,36,1,2,1.5
4,6,each,4,37,0,4,7.5
4,6,fact,4,38,0,4,2.5
4,6,fame,4,39,2,2,1.75
4,6,fan,3,40,2,1,1
4,6,farm,4,41,2,2,1.5
4,6,feat,4,42,1,3,7.25
4,6,feed,4,43,2,2,1.75
4,6,feel,4,44,3,1,1.25
4,6,film,4,45,1,3,2.25
4,6,fit,3,46,2,1,1
4,6,flaw,4,47,1,3,2.25
4,6,fold,4,48,1,3,6.75
4,6,fool,4,49,2,2,1.75
4,6,from,4,50,1,3,2.25
4,6,gas,3,51,0,3,2
4,6,get,3,52,1,2,1.5
4,6,goal,4,53,1,3,6.75
4,6,help,4,54,0,4,2.75
4,6,here,4,55,2,2,1.75
4,6,hero,4,56,3,1,1.25
4,6,hill,4,57,1,3,2.25
4,6,hold,4,58,1,3,6.75
4,6,jam,3,59,0,3,2
4,6,july,4,60,1,3,2.25
4,6,keen,4,61,0,4,2.5
4,6,kill,4,62,1,3,7
4,6,lane,4,63,0,4,2.5
4,6,less,4,64,1,3,2.25
4,6,loan,4,65,1,3,2.25
4,6,logo,4,66,2,2,6.5
4,6,loop,4,67,2,2,1.75
4,6,lost,4,68,2,2,1.75
4,6,luck,4,69,1,3,2
4,6,lung,4,70,2,2,1.75
4,6,mall,4,71,0,4,2.5
4,6,man,3,72,2,1,6
4,6,mate,4,73,2,2,1.75
4,6,me,2,74,1,1,0.75
4,6,move,4,75,1,3,2
4,6,net,3,76,0,3,2
4,6,news,4,77,2,2,1.5
4,6,next,4,78,2,2,6.25
4,6,nod,3,79,1,2,1.75
4,6,nose,4,80,2,2,1.75
4,6,now,3,81,2,1,1
4,6,o,1,82,0,1,0.75
4,6,obey,4,83,1,3,2
4,6,on,2,84,1,1,0.75
4,6,onto,4,85,2,2,3.5
4,6,or,2,86,1,1,6.75
4,6,our,3,87,1,2,125
4,6,oven,4,88,1,3,3.5
4,6,pan,3,89,0,3,3.25
4,6,pit,3,90,1,2,1.75
4,6,plug,4,91,1,3,2.25
4,6,poet,4,92,1,3,7.75
4,6,pop,3,93,2,1,1.25
4,6,port,4,94,2,2,1.75
4,6,pose,4,95,2,2,1.75
4,6,pray,4,96,1,3,2.25
4,6,prey,4,97,2,2,1.75
4,6,rain,4,98,0,4,7.25
4,6,rare,4,99,2,2,1.75
4,6,raw,3,100,2,1,1
4,6,real,4,101,1,3,2
4,6,rid,3,102,1,2,1.5
4,6,rock,4,103,1,3,6.75
4,6,rule,4,104,1,3,2.25
4,6,run,3,105,2,1,1
4,6,sail,4,106,0,4,2.75
4,6,say,3,107,2,1,1
4,6,sea,3,108,1,2,1.5
4,6,see,3,109,2,1,1
4,6,send,4,110,2,2,6.75
4,6,set,3,111,2,1,1
4,6,sex,3,112,2,1,1
4,6,shop,4,113,1,3,2.25
4,6,show,4,114,3,1,1
4,6,sigh,4,115,1,3,2
4,6,sing,4,116,2,2,1.75
4,6,sir,3,117,2,1,5.75
4,6,size,4,118,2,2,1.75
4,6,snap,4,119,1,3,2
4,6,soar,4,120,1,3,2
4,6,son,3,121,2,1,1
4,6,sort,4,122,2,2,1.5
4,6,span,4,123,1,3,6.75
4,6,spy,3,124,2,1,1
4,6,sum,3,125,1,2,1.5
4,6,t,1,126,0,1,0.75
4,6,tag,3,127,1,2,1.5
4,6,tell,4,128,1,3,2
4,6,tent,4,129,2,2,1.5
4,6,then,4,130,1,3,7
4,6,they,4,131,3,1,1.25
4,6,tiny,4,132,1,3,2.25
4,6,ton,3,133,1,2,1.5
4,6,tone,4,134,3,1,1
4,6,true,4,135,1,3,2
4,6,turn,4,136,1,3,7
4,6,ugly,4,137,0,4,2.5
4,6,unit,4,138,1,3,2.25
4,6,us,2,139,1,1,1
4,6,user,4,140,2,2,1.75
4,6,vast,4,141,0,4,7.75
4,6,wage,4,142,0,4,2.75
4,6,wall,4,143,2,2,1.75
4,6,want,4,144,2,2,1.75
4,6,ward,4,145,2,2,1.75
4,6,warm,4,146,3,1,6.25
4,6,weak,4,147,1,3,2
4,6,web,3,148,2,1,0.75
4,6,week,4,149,2,2,1
4,6,well,4,150,2,2,1
4,6,what,4,151,1,3,1
4,6,who,3,152,2,1,3.5
4,6,worm,4,153,1,3,1
4,6,year,4,154,0,4,1.25
4,7,ah,2,0,0,2,0.5
4,7,aid,3,1,1,2,0.75
4,7,air,3,2,2,1,3.5
4,7,all,3,3,1,2,0.75
4,7,amid,4,4,1,3,1
4,7,back,4,5,0,4,1.25
4,7,bad,3,6,2,1,0.5
4,7,bake,4,7,2,2,0.75
4,7,bank,4,8,2,2,3.75
4,7,bare,4,9,2,2,1
4,7,bee,3,10,1,2,0.75
4,7,bend,4,11,2,2,0.75
4,7,bent,4,12,3,1,0.75
4,7,big,3,13,1,2,0.75
4,7,bond,4,14,1,3,3.75
4,7,buck,4,15,1,3,1
4,7,bury,4,16,2,2,0.75
4,7,busy,4,17,2,2,0.75
4,7,but,3,18,2,1,0.5
4,7,bye,3,19,1,2,0.75
4,7,calm,4,20,0,4,4.25
4,7,case,4,21,2,2,0.75
4,7,cat,3,22,2,1,0.5
4,7,chat,4,23,1,3,1
4,7,chef,4,24,2,2,0.75
4,7,clue,4,25,1,3,1
4,7,cook,4,26,1,3,4
4,7,crop,4,27,1,3,1
4,7,cult,4,28,1,3,1
4,7,cure,4,29,2,2,0.75
4,7,dad,3,30,0,3,1
4,7,dark,4,31,2,2,4
4,7,date,4,32,2,2,0.75
4,7,deck,4,33,1,3,1
4,7,die,3,34,1,2,0.75
4,7,door,4,35,1,3,1
4,7,dose,4,36,2,2,3.75
4,7,drag,4,37,1,3,1
4,7,drug,4,38,2,2,0.75
4,7,drum,4,39,3,1,0.5
4,7,dry,3,40,2,1,0.5
4,7,dull,4,41,1,3,0.75
4,7,dump,4,42,2,2,0.75
4,7,east,4,43,0,4,4
4,7,eat,3,44,2,1,0.5
4,7,else,4,45,1,3,1
4,7,fame,4,46,0,4,1
4,7,feat,4,47,1,3,4
4,7,fill,4,48,1,3,1
4,7,find,4,49,2,2,0.75
4,7,fire,4,50,2,2,0.75
4,7,fit,3,51,2,1,0.5
4,7,five,4,52,2,2,0.75
4,7,fold,4,53,1,3,4
4,7,fork,4,54,2,2,1
4,7,gang,4,55,0,4,1
4,7,gas,3,56,2,1,0.5
4,7,get,3,57,1,2,0.75
4,7,glad,4,58,1,3,1
4,7,goal,4,59,1,3,4
4,7,he,2,60,0,2,0.75
4,7,hero,4,61,2,2,0.75
4,7,hill,4,62,1,3,1
4,7,hook,4,63,1,3,1
4,7,host,4,64,2,2,4
4,7,in,2,65,0,2,0.75
4,7,lamp,4,66,0,4,1.25
4,7,late,4,67,2,2,0.75
4,7,lead,4,68,1,3,1
4,7,leap,4,69,3,1,3.75
4,7,lend,4,70,2,2,1
4,7,less,4,71,2,2,0.75
4,7,loan,4,72,1,3,1
4,7,logo,4,73,2,2,0.75
4,7,lose,4,74,2,2,0.75
4,7,loss,4,75,3,1,0.75
4,7,lost,4,76,3,1,3.75
4,7,luck,4,77,1,3,1
4,7,mall,4,78,0,4,1
4,7,mile,4,79,1,3,1
4,7,mill,4,80,3,1,0.5
4,7,mode,4,81,1,3,4
4,7,monk,4,82,2,2,1
4,7,nail,4,83,0,4,1.25
4,7,net,3,84,1,2,0.75
4,7,news,4,85,2,2,0.75
4,7,nose,4,86,1,3,4
4,7,now,3,87,2,1,0.5
4,7,o,1,88,0,1,0.25
4,7,obey,4,89,1,3,1
4,7,on,2,90,1,1,0.25
4,7,onto,4,91,2,2,0.75
4,7,out,3,92,1,2,0.75
4,7,oven,4,93,1,3,4
4,7,own,3,94,1,2,0.75
4,7,pan,3,95,0,3,1
4,7,pass,4,96,2,2,0.75
4,7,peak,4,97,1,3,1
4,7,pit,3,98,1,2,3.75
4,7,poet,4,99,1,3,1
4,7,pole,4,100,2,2,0.75
4,7,pool,4,101,2,2,0.75
4,7,pop,3,102,2,1,0.5
4,7,port,4,103,2,2,0.75
4,7,pose,4,104,2,2,0.75
4,7,prey,4,105,1,3,4
4,7,pub,3,106,1,2,0.75
4,7,read,4,107,0,4,1.25
4,7,real,4,108,3,1,0.5
4,7,rid,3,109,1,2,0.75
4,7,risk,4,110,2,2,0.75
4,7,rock,4,111,1,3,4
4,7,role,4,112,2,2,0.75
4,7,rule,4,113,1,3,1
4,7,run,3,114,2,1,0.5
4,7,say,3,115,0,3,0.75
4,7,sex,3,116,1,2,3.75
4,7,shop,4,117,1,3,1
4,7,shot,4,118,3,1,0.5
4,7,show,4,119,3,1,0.5
4,7,sigh,4,120,1,3,1
4,7,sing,4,121,2,2,0.75
4,7,sir,3,122,2,1,0.5
4,7,snap,4,123,1,3,4
4,7,soak,4,124,1,3,1
4,7,soar,4,125,3,1,0.75
4,7,soft,4,126,2,2,0.75
4,7,spy,3,127,1,2,0.75
4,7,sum,3,128,1,2,0.5
4,7,tax,3,129,0,3,4
4,7,tell,4,130,1,3,1
4,7,text,4,131,2,2,0.75
4,7,than,4,132,1,3,1
4,7,they,4,133,2,2,0.75
4,7,thin,4,134,2,2,4
4,7,tiny,4,135,1,3,1
4,7,tone,4,136,1,3,1
4,7,toy,3,137,2,1,0.5
4,7,turn,4,138,1,3,1
4,7,use,3,139,0,3,4
4,7,used,4,140,3,1,0.5
4,7,user,4,141,3,1,0.5
4,7,vote,4,142,0,4,1.25
4,7,want,4,143,0,4,1.25
4,7,warm,4,144,2,2,0.75
4,7,wash,4,145,2,2,4.5
4,7,weak,4,146,1,3,1.25
4,7,wear,4,147,3,1,0.75
4,7,web,3,148,2,1,0.5
4,7,wet,3,149,2,1,0.5
4,7,what,4,150,1,3,1
4,7,wide,4,151,1,3,2.5
4,7,worm,4,152,1,3,2.75
4,7,yell,4,153,0,4,1.25
4,7,you,3,154,1,2,0.75
4,8,act,3,0,0,3,3.75
4,8,ah,2,1,1,1,0.5
4,8,air,3,2,1,2,0.75
4,8,amid,4,3,1,3,1
4,8,back,4,4,0,4,1
4,8,bad,3,5,2,1,0.5
4,8,bake,4,6,2,2,3.75
4,8,bare,4,7,2,2,0.75
4,8,bean,4,8,1,3,1
4,8,bee,3,9,2,1,0.5
4,8,bend,4,10,2,2,0.75
4,8,bet,3,11,2,1,0.5
4,8,bias,4,12,1,3,1
4,8,big,3,13,2,1,3.5
4,8,born,4,14,1,3,1
4,8,bulk,4,15,1,3,1
4,8,bury,4,16,2,2,0.75
4,8,camp,4,17,0,4,1.25
4,8,case,4,18,2,2,4
4,8,cat,3,19,2,1,0.5
4,8,chat,4,20,1,3,1
4,8,clue,4,21,1,3,1
4,8,coin,4,22,1,3,1.5
4,8,cook,4,23,2,2,1.75
4,8,cool,4,24,3,1,6.25
4,8,cop,3,25,2,1,1
4,8,crop,4,26,1,3,3.25
4,8,dad,3,27,0,3,2
4,8,data,4,28,2,2,1.75
4,8,date,4,29,3,1,1.5
4,8,dear,4,30,1,3,8
4,8,dip,3,31,1,2,1.75
4,8,dog,3,32,1,2,1.5
4,8,draw,4,33,1,3,2.25
4,8,drug,4,34,2,2,1.75
4,8,dull,4,35,1,3,2.25
4,8,duty,4,36,2,2,7.75
4,8,east,4,37,0,4,2.5
4,8,easy,4,38,3,1,1
4,8,edge,4,39,1,3,2.25
4,8,else,4,40,1,3,2.25
4,8,era,3,41,1,2,7
4,8,evil,4,42,1,3,2.25
4,8,fact,4,43,0,4,2.75
4,8,fame,4,44,2,2,1.75
4,8,farm,4,45,2,2,1.75
4,8,feat,4,46,1,3,8.25
4,8,feel,4,47,2,2,1.75
4,8,fire,4,48,1,3,2
4,8,five,4,49,2,2,1.75
4,8,flaw,4,50,1,3,2.25
4,8,fold,4,51,1,3,7.25
4,8,fond,4,52,2,2,1.75
4,8,fool,4,53,2,2,1.75
4,8,fork,4,54,2,2,1.75
4,8,from,4,55,1,3,2
4,8,fund,4,56,1,3,7.25
4,8,get,3,57,0,3,2
4,8,goal,4,58,1,3,2.25
4,8,hand,4,59,0,4,2.5
4,8,here,4,60,1,3,7.75
4,8,hide,4,61,1,3,2.25
4,8,in,2,62,0,2,1.5
4,8,jam,3,63,0,3,2
4,8,july,4,64,1,3,2.25
4,8,kind,4,65,0,4,7.75
4,8,kiss,4,66,2,2,1.75
4,8,lady,4,67,0,4,2.5
4,8,lamp,4,68,2,2,1.75
4,8,lead,4,69,1,3,2.25
4,8,leap,4,70,3,1,6.75
4,8,lend,4,71,2,2,1.75
4,8,less,4,72,2,2,1.75
4,8,let,3,73,2,1,1
4,8,loan,4,74,1,3,2
4,8,logo,4,75,2,2,1.75
4,8,loop,4,76,2,2,1.75
4,8,lord,4,77,2,2,7
4,8,lose,4,78,2,2,1.75
4,8,loss,4,79,3,1,1.25
4,8,lung,4,80,1,3,2.25
4,8,mall,4,81,0,4,2.5
4,8,meet,4,82,1,3,7.5
4,8,menu,4,83,2,2,1.75
4,8,mill,4,84,1,3,2
4,8,mine,4,85,2,2,1.75
4,8,monk,4,86,1,3,2.25
4,8,nest,4,87,0,4,7.75
4,8,net,3,88,2,1,1.25
4,8,news,4,89,2,2,1.75
4,8,nose,4,90,1,3,2
4,8,o,1,91,0,1,0.75
4,8,obey,4,92,1,3,2
4,8,on,2,93,1,1,8
4,8,onto,4,94,2,2,4.5
4,8,open,4,95,1,3,143.75
4,8,or,2,96,1,1,1.75
4,8,oral,4,97,2,2,3.25
4,8,our,3,98,1,2,3.25
4,8,over,4,99,1,3,5.25
4,8,own,3,100,1,2,3.75
4,8,pass,4,101,0,4,11.75
4,8,pill,4,102,1,3,4.25
4,8,pit,3,103,2,1,2.5
4,8,poet,4,104,1,3,2.5
4,8,pole,4,105,2,2,1.75
4,8,port,4,106,2,2,5.75
4,8,pose,4,107,2,2,1.75
4,8,prey,4,108,1,3,2
4,8,real,4,109,0,4,2.5
4,8,rely,4,110,2,2,1.75
4,8,rid,3,111,1,2,6
4,8,riot,4,112,2,2,1.75
4,8,risk,4,113,2,2,1.75
4,8,rock,4,114,1,3,2
4,8,role,4,115,2,2,1.75
4,8,rule,4,116,1,3,2
4,8,sad,3,117,0,3,6.5
4,8,sea,3,118,1,2,1.5
4,8,send,4,119,2,2,1.75
4,8,sigh,4,120,1,3,2
4,8,sing,4,121,2,2,1.75
4,8,sir,3,122,2,1,1
4,8,size,4,123,2,2,6.5
4,8,sky,3,124,1,2,1.5
4,8,slot,4,125,1,3,2
4,8,slow,4,126,3,1,1
4,8,son,3,127,1,2,1.5
4,8,sum,3,128,1,2,1.5
4,8,t,1,129,0,1,0.75
4,8,than,4,130,1,3,6.75
4,8,they,4,131,2,2,1.75
4,8,toll,4,132,1,3,2
4,8,ton,3,133,2,1,1
4,8,try,3,134,1,2,1.5
4,8,turn,4,135,1,3,7
4,8,type,4,136,1,3,2.25
4,8,unit,4,137,0,4,2.5
4,8,use,3,138,1,2,1.5
4,8,used,4,139,3,1,1
4,8,user,4,140,3,1,1
4,8,wage,4,141,0,4,7.25
4,8,want,4,142,2,2,1.75
4,8,ward,4,143,2,2,1.75
4,8,warm,4,144,3,1,1.25
4,8,wash,4,145,2,2,1.75
4,8,wear,4,146,1,3,2
4,8,web,3,147,2,1,4.5
4,8,what,4,148,1,3,1
4,8,when,4,149,2,2,0.75
4,8,who,3,150,2,1,0.5
4,8,wide,4,151,1,3,1
4,8,wise,4,152,2,2,0.75
4,8,wish,4,153,3,1,0.5
4,8,you,3,154,0,3,3.75
4,9,able,4,0,0,4,1
4,9,aid,3,1,1,2,0.75
4,9,air,3,2,2,1,0.5
4,9,also,4,3,1,3,3.75
4,9,amid,4,4,1,3,1
4,9,back,4,5,0,4,1.25
4,9,bad,3,6,2,1,0.5
4,9,bake,4,7,2,2,0.75
4,9,bank,4,8,2,2,0.75
4,9,bear,4,9,1,3,4
4,9,bent,4,10,2,2,1
4,9,bet,3,11,2,1,0.5
4,9,bold,4,12,1,3,1
4,9,bond,4,13,2,2,0.75
4,9,bulk,4,14,1,3,4
4,9,bury,4,15,2,2,1
4,9,bus,3,16,2,1,0.5
4,9,calm,4,17,0,4,1.25
4,9,cat,3,18,2,1,0.5
4,9,chat,4,19,1,3,1
4,9,clip,4,20,1,3,4
4,9,clue,4,21,2,2,1
4,9,coin,4,22,1,3,1
4,9,cook,4,23,2,2,0.75
4,9,cool,4,24,3,1,0.75
4,9,crop,4,25,1,3,1
4,9,cure,4,26,1,3,4.5
4,9,dad,3,27,0,3,1
4,9,dark,4,28,2,2,0.75
4,9,date,4,29,2,2,0.75
4,9,dear,4,30,1,3,1
4,9,deck,4,31,2,2,4.25
4,9,defy,4,32,2,2,1
4,9,die,3,33,1,2,0.75
4,9,dip,3,34,2,1,0.5
4,9,dog,3,35,1,2,0.75
4,9,dose,4,36,2,2,0.75
4,9,drag,4,37,1,3,1
4,9,drug,4,38,2,2,4.5
4,9,drum,4,39,3,1,0.75
4,9,due,3,40,1,2,0.75
4,9,dull,4,41,2,2,0.75
4,9,each,4,42,0,4,1.25
4,9,eat,3,43,2,1,0.5
4,9,echo,4,44,1,3,4.5
4,9,edge,4,45,1,3,1
4,9,era,3,46,1,2,0.75
4,9,evil,4,47,1,3,1
4,9,exam,4,48,1,3,1
4,9,fame,4,49,0,4,4.25
4,9,fan,3,50,2,1,0.5
4,9,feel,4,51,1,3,1
4,9,fill,4,52,1,3,1
4,9,film,4,53,3,1,0.5
4,9,fire,4,54,2,2,3.75
4,9,fish,4,55,2,2,1
4,9,flaw,4,56,1,3,1
4,9,fond,4,57,1,3,1
4,9,glad,4,58,0,4,1.25
4,9,halt,4,59,0,4,4.25
4,9,here,4,60,1,3,1
4,9,hero,4,61,3,1,0.5
4,9,hill,4,62,1,3,1
4,9,hold,4,63,1,3,1
4,9,host,4,64,2,2,4
4,9,if,2,65,0,2,0.75
4,9,jam,3,66,0,3,0.75
4,9,join,4,67,1,3,1
4,9,july,4,68,1,3,1
4,9,kill,4,69,0,4,4.25
4,9,lady,4,70,0,4,1
4,9,late,4,71,2,2,0.75
4,9,leap,4,72,1,3,1
4,9,loan,4,73,1,3,4
4,9,lock,4,74,2,2,1
4,9,logo,4,75,2,2,0.75
4,9,loop,4,76,2,2,0.75
4,9,lord,4,77,2,2,0.75
4,9,mate,4,78,0,4,4.25
4,9,mile,4,79,1,3,1
4,9,mill,4,80,3,1,0.5
4,9,mode,4,81,1,3,1
4,9,monk,4,82,2,2,0.75
4,9,net,3,83,0,3,0.75
4,9,nose,4,84,1,3,4
4,9,now,3,85,2,1,0.5
4,9,obey,4,86,0,4,1
4,9,of,2,87,1,1,0.5
4,9,on,2,88,1,1,0.5
4,9,onto,4,89,2,2,0.75
4,9,our,3,90,1,2,4
4,9,out,3,91,2,1,0.75
4,9,own,3,92,1,2,0.75
4,9,pair,4,93,0,4,1.25
4,9,pan,3,94,2,1,0.5
4,9,pink,4,95,1,3,1
4,9,poet,4,96,1,3,4
4,9,pole,4,97,2,2,1
4,9,pop,3,98,2,1,0.5
4,9,pose,4,99,2,2,0.75
4,9,prey,4,100,1,3,1
4,9,rain,4,101,0,4,4.25
4,9,rare,4,102,2,2,0.75
4,9,raw,3,103,2,1,0.5
4,9,real,4,104,1,3,1
4,9,red,3,105,2,1,0.5
4,9,rely,4,106,2,2,0.75
4,9,risk,4,107,1,3,1
4,9,rock,4,108,1,3,4
4,9,role,4,109,2,2,1
4,9,rule,4,110,1,3,1
4,9,sad,3,111,0,3,1
4,9,say,3,112,2,1,0.5
4,9,sea,3,113,1,2,3.75
4,9,set,3,114,2,1,0.5
4,9,sex,3,115,2,1,0.5
4,9,sigh,4,116,1,3,1
4,9,sing,4,117,2,2,1
4,9,sir,3,118,2,1,0.5
4,9,slot,4,119,1,3,1
4,9,soak,4,120,1,3,4
4,9,soft,4,121,2,2,0.75
4,9,son,3,122,2,1,0.5
4,9,soon,4,123,2,2,0.75
4,9,sort,4,124,2,2,0.75
4,9,span,4,125,1,3,0.75
4,9,spy,3,126,2,1,0.5
4,9,sum,3,127,1,2,3.75
4,9,tell,4,128,0,4,1.25
4,9,text,4,129,2,2,0.75
4,9,than,4,130,1,3,1
4,9,they,4,131,2,2,0.75
4,9,thin,4,132,2,2,4.25
4,9,tiny,4,133,1,3,1
4,9,tone,4,134,1,3,1
4,9,try,3,135,1,2,0.75
4,9,type,4,136,1,3,1
4,9,unit,4,137,0,4,4.5
4,9,up,2,138,1,1,0.5
4,9,us,2,139,1,1,0.5
4,9,use,3,140,2,1,0.5
4,9,vast,4,141,0,4,1.25
4,9,very,4,142,1,3,1
4,9,wage,4,143,0,4,4.25
4,9,wall,4,144,2,2,0.75
4,9,wash,4,145,2,2,0.75
4,9,weak,4,146,1,3,1
4,9,wear,4,147,3,1,0.5
4,9,well,4,148,2,2,3.75
4,9,what,4,149,1,3,1
4,9,when,4,150,2,2,0.75
4,9,worm,4,151,1,3,1
4,9,year,4,152,0,4,1.25
4,9,yell,4,153,2,2,4
4,9,zone,4,154,0,4,1.25
5,0,able,4,0,0,4,1.25
5,0,about,5,1,2,3,4.25
5,0,aged,4,2,1,3,1
5,0,aid,3,3,1,2,0.75
5,0,alert,5,4,1,4,1.25
5,0,alien,5,5,2,3,1
5,0,alike,5,6,3,2,4.25
5,0,allow,5,7,2,3,1.25
5,0,alone,5,8,2,3,1
5,0,also,4,9,2,2,0.75
5,0,amid,4,10,1,3,1
5,0,angel,5,11,1,4,4.5
5,0,apart,5,12,1,4,1.5
5,0,apple,5,13,2,3,1.25
5,0,apply,5,14,4,1,0.75
5,0,arena,5,15,1,4,5
5,0,armed,5,16,2,3,1.25
5,0,asset,5,17,1,4,1.25
5,0,audit,5,18,1,4,1.25
5,0,avoid,5,19,1,4,5.25
5,0,away,4,20,1,3,1
5,0,back,4,21,0,4,1.25
5,0,bad,3,22,2,1,0.5
5,0,bank,4,23,2,2,4
5,0,basis,5,24,2,3,1
5,0,beef,4,25,1,3,1
5,0,being,5,26,2,3,1
5,0,bend,4,27,2,2,0.75
5,0,bent,4,28,3,1,0.75
5,0,bias,4,29,1,3,4.25
5,0,big,3,30,2,1,0.5
5,0,bleed,5,31,1,4,1.25
5,0,blood,5,32,2,3,1.25
5,0,body,4,33,1,3,4
5,0,bold,4,34,2,2,1
5,0,bonus,5,35,2,3,1
5,0,born,4,36,2,2,0.75
5,0,brain,5,37,1,4,1.25
5,0,brick,5,38,2,3,4.5
5,0,broad,5,39,2,3,1.25
5,0,buck,4,40,1,3,1
5,0,bulk,4,41,2,2,0.75
5,0,bury,4,42,2,2,0.75
5,0,busy,4,43,2,2,0.75
5,0,but,3,44,2,1,3.75
5,0,camp,4,45,0,4,1
5,0,case,4,46,2,2,0.75
5,0,cat,3,47,2,1,0.5
5,0,catch,5,48,3,2,0.75
5,0,cause,5,49,2,3,1
5,0,cent,4,50,1,3,4
5,0,chaos,5,51,1,4,1.25
5,0,chest,5,52,2,3,1
5,0,civic,5,53,1,4,4.5
5,0,cling,5,54,1,4,1.25
5,0,close,5,55,2,3,1
5,0,cloth,5,56,3,2,1
5,0,clue,4,57,2,2,0.75
5,0,coast,5,58,1,4,4.5
5,0,comic,5,59,2,3,1.25
5,0,cop,3,60,2,1,0.5
5,0,cow,3,61,2,1,0.5
5,0,crack,5,62,1,4,1.25
5,0,cream,5,63,2,3,4.25
5,0,crown,5,64,2,3,1.25
5,0,data,4,65,0,4,1.25
5,0,dear,4,66,1,3,1
5,0,debut,5,67,2,3,4.5
5,0,donor,5,68,1,4,1.25
5,0,door,4,69,2,2,0.75
5,0,dozen,5,70,2,3,1
5,0,drag,4,71,1,3,1
5,0,drain,5,72,3,2,4
5,0,draw,4,73,3,1,0.75
5,0,dress,5,74,2,3,1
5,0,drug,4,75,2,2,0.75
5,0,drum,4,76,3,1,0.5
5,0,east,4,77,0,4,1.25
5,0,easy,4,78,3,1,4
5,0,eat,3,79,2,1,0.5
5,0,embed,5,80,1,4,1.25
5,0,enrol,5,81,1,4,1.25
5,0,error,5,82,1,4,1.5
5,0,every,5,83,1,4,4.75
5,0,fan,3,84,0,3,0.75
5,0,feat,4,85,1,3,1
5,0,feed,4,86,2,2,0.75
5,0,fifth,5,87,1,4,4.5
5,0,film,4,88,2,2,1
5,0,final,5,89,2,3,1
5,0,first,5,90,2,3,1.25
5,0,fish,4,91,2,2,0.75
5,0,fit,3,92,2,1,3.75
5,0,flame,5,93,1,4,1.25
5,0,flash,5,94,3,2,1
5,0,flaw,4,95,3,1,0.5
5,0,float,5,96,2,3,1
5,0,flood,5,97,3,2,1
5,0,flour,5,98,3,2,4.75
5,0,fond,4,99,1,3,1.25
5,0,fool,4,100,2,2,1
5,0,forge,5,101,2,3,1.25
5,0,fork,4,102,3,1,0.75
5,0,from,4,103,1,3,5.5
5,0,fruit,5,104,2,3,1.25
5,0,fully,5,105,1,4,1.25
5,0,fun,3,106,2,1,0.75
5,0,fund,4,107,3,1,0.5
5,0,funny,5,108,3,2,0.75
5,0,gas,3,109,0,3,4.5
5,0,glad,4,110,1,3,1
5,0,grain,5,111,1,4,1.25
5,0,grand,5,112,3,2,1
5,0,grant,5,113,4,1,1
5,0,guard,5,114,1,4,5.5
5,0,half,4,115,0,4,1.25
5,0,hear,4,116,1,3,1.25
5,0,hello,5,117,2,3,1.25
5,0,help,4,118,3,1,0.75
5,0,hero,4,119,2,2,7.25
5,0,hide,4,120,1,3,143.5
5,0,hobby,5,121,1,4,3.25
5,0,hold,4,122,2,2,3.25
5,0,holy,4,123,3,1,2.5
5,0,hurry,5,124,1,4,5.5
5,0,if,2,125,0,2,11.5
5,0,in,2,126,1,1,1.75
5,0,input,5,127,2,3,4.5
5,0,jeans,5,128,0,5,6.5
5,0,join,4,129,1,3,7
5,0,july,4,130,1,3,2.25
5,0,keen,4,131,0,4,2.5
5,0,kill,4,132,1,3,2.25
5,0,lane,4,133,0,4,6.5
5,0,learn,5,134,1,4,2.75
5,0,lend,4,135,2,2,1.75
5,0,less,4,136,2,2,1.75
5,0,level,5,137,2,3,2.25
5,0,light,5,138,1,4,7.5
5,0,limit,5,139,2,3,2.5
5,0,loan,4,140,1,3,2.25
5,0,lobby,5,141,2,3,2.25
5,0,lock,4,142,2,2,7
5,0,logic,5,143,2,3,2.5
5,0,loom,4,144,2,2,1.75
5,0,lose,4,145,2,2,1.75
5,0,loss,4,146,3,1,1.25
5,0,lost,4,147,3,1,1
5,0,lower,5,148,2,3,2.25
5,0,luck,4,149,1,3,7.25
5,0,major,5,150,0,5,3.25
5,0,man,3,151,2,1,1.25
5,0,mate,4,152,2,2,1.75
5,0,maybe,5,153,2,3,2.25
5,0,meet,4,154,1,3,7
5,0,menu,4,155,2,2,1.75
5,0,metal,5,156,2,3,2.25
5,0,mile,4,157,1,3,2
5,0,milk,4,158,3,1,1
5,0,mine,4,159,2,2,6.75
5,0,miner,5,160,4,1,1.5
5,0,minor,5,161,3,2,2
5,0,moral,5,162,1,4,2.75
5,0,mount,5,163,2,3,2.25
5,0,move,4,164,2,2,1.75
5,0,nail,4,165,0,4,7.5
5,0,naval,5,166,2,3,2.25
5,0,nest,4,167,1,3,2.25
5,0,net,3,168,2,1,1
5,0,next,4,169,2,2,1.75
5,0,noble,5,170,1,4,7.5
5,0,noon,4,171,2,2,1.75
5,0,nurse,5,172,1,4,2.75
5,0,obey,4,173,0,4,7.75
5,0,offer,5,174,1,4,2.75
5,0,onto,4,175,1,3,2
5,0,oral,4,176,1,3,2
5,0,oven,4,177,1,3,2
5,0,over,4,178,3,1,6.5
5,0,own,3,179,1,2,1.5
5,0,owner,5,180,3,2,1.5
5,0,pair,4,181,0,4,2.75
5,0,palm,4,182,2,2,1.75
5,0,phase,5,183,1,4,8.25
5,0,pilot,5,184,1,4,2.75
5,0,poet,4,185,1,3,2
5,0,port,4,186,2,2,1.75
5,0,price,5,187,1,4,8.25
5,0,queen,5,188,0,5,3.25
5,0,quota,5,189,2,3,2.25
5,0,quote,5,190,4,1,1.25
5,0,radio,5,191,0,5,8.5
5,0,range,5,192,2,3,2.5
5,0,rapid,5,193,2,3,2.5
5,0,raw,3,194,2,1,1.25
5,0,read,4,195,1,3,2.25
5,0,rely,4,196,2,2,7.5
5,0,rice,4,197,1,3,2.25
5,0,rid,3,198,2,1,1
5,0,riot,4,199,2,2,1.75
5,0,risk,4,200,2,2,1.75
5,0,rock,4,201,1,3,2.25
5,0,role,4,202,2,2,6.5
5,0,royal,5,203,2,3,2.5
5,0,rule,4,204,1,3,2.25
5,0,run,3,205,2,1,1
5,0,sadly,5,206,0,5,3.25
5,0,say,3,207,2,1,6.25
5,0,see,3,208,1,2,1.5
5,0,set,3,209,2,1,1
5,0,shade,5,210,1,4,2.75
5,0,shake,5,211,3,2,1.75
5,0,shall,5,212,3,2,1.75
5,0,sheet,5,213,2,3,7
5,0,shine,5,214,2,3,2.25
5,0,shock,5,215,2,3,2.25
5,0,short,5,216,3,2,2
5,0,shout,5,217,3,2,1.75
5,0,show,4,218,3,1,1.25
5,0,shrug,5,219,2,3,7.5
5,0,sing,4,220,1,3,2.25
5,0,sixty,5,221,2,3,2.25
5,0,sky,3,222,1,2,1.5
5,0,sleep,5,223,1,4,7.75
5,0,slot,4,224,2,2,1.75
5,0,slow,4,225,3,1,1.25
5,0,smart,5,226,1,4,2.75
5,0,snap,4,227,1,3,2
5,0,soak,4,228,1,3,7.25
5,0,soon,4,229,2,2,1.75
5,0,span,4,230,1,3,2
5,0,spicy,5,231,2,3,2.25
5,0,spill,5,232,3,2,2
5,0,spite,5,233,3,2,2.25
5,0,split,5,234,2,3,7.5
5,0,spoil,5,235,2,3,2.25
5,0,spoon,5,236,3,2,1.75
5,0,spy,3,237,2,1,1
5,0,sweet,5,238,1,4,2.75
5,0,swing,5,239,2,3,7.5
5,0,teach,5,240,0,5,3.25
5,0,tell,4,241,2,2,1.75
5,0,theft,5,242,1,4,2.75
5,0,their,5,243,3,2,7
5,0,them,4,244,3,1,1.25
5,0,then,4,245,3,1,1.25
5,0,thief,5,246,2,3,2.25
5,0,think,5,247,3,2,1.75
5,0,throw,5,248,2,3,2.25
5,0,tiny,4,249,1,3,7.25
5,0,tired,5,250,2,3,2.25
5,0,tone,4,251,1,3,2
5,0,trace,5,252,1,4,2.75
5,0,true,4,253,2,2,4.75
5,0,truly,5,254,3,2,1
5,0,type,4,255,1,3,1
5,0,up,2,256,0,2,0.5
5,0,upper,5,257,2,3,1
5,0,upset,5,258,2,3,4
5,0,use,3,259,1,2,0.75
5,0,vast,4,260,0,4,1.25
5,0,very,4,261,1,3,1
5,0,want,4,262,0,4,1
5,0,warm,4,263,2,2,4.25
5,0,we,2,264,1,1,0.5
5,0,weak,4,265,2,2,0.75
5,0,week,4,266,2,2,0.75
5,0,well,4,267,2,2,0.75
5,0,wet,3,268,2,1,0.5
5,0,wheat,5,269,1,4,4.25
5,0,when,4,270,3,1,0.75
5,0,worst,5,271,1,4,1.25
5,0,yell,4,272,0,4,1.25
5,0,you,3,273,1,2,0.75
5,0,yours,5,274,3,2,4
5,1,able,4,0,0,4,1.5
5,1,about,5,1,2,3,1.25
5,1,act,3,2,1,2,0.75
5,1,adult,5,3,1,4,4.5
5,1,ah,2,4,1,1,0.5
5,1,aid,3,5,1,2,0.75
5,1,air,3,6,2,1,0.5
5,1,alert,5,7,1,4,1.25
5,1,alien,5,8,2,3,1
5,1,alike,5,9,3,2,4.25
5,1,all,3,10,2,1,0.75
5,1,allow,5,11,3,2,1
5,1,along,5,12,2,3,1
5,1,also,4,13,2,2,0.75
5,1,amid,4,14,1,3,1
5,1,angel,5,15,1,4,4.5
5,1,april,5,16,1,4,1.25
5,1,arena,5,17,1,4,1.25
5,1,armed,5,18,2,3,4.5
5,1,aware,5,19,1,4,1.25
5,1,back,4,20,0,4,1.25
5,1,bad,3,21,2,1,0.5
5,1,bake,4,22,2,2,0.75
5,1,bank,4,23,2,2,3.75
5,1,basis,5,24,2,3,1
5,1,bean,4,25,1,3,1
5,1,bear,4,26,3,1,0.5
5,1,being,5,27,2,3,1
5,1,bent,4,28,2,2,3.75
5,1,big,3,29,1,2,0.75
5,1,blend,5,30,1,4,1.25
5,1,bond,4,31,1,3,1
5,1,born,4,32,2,2,0.75
5,1,brain,5,33,1,4,4.5
5,1,brick,5,34,2,3,1.25
5,1,bring,5,35,3,2,1
5,1,bulk,4,36,1,3,1
5,1,bury,4,37,2,2,0.75
5,1,busy,4,38,2,2,4
5,1,camp,4,39,0,4,1.25
5,1,case,4,40,2,2,0.75
5,1,cat,3,41,2,1,0.5
5,1,cause,5,42,2,3,1
5,1,chat,4,43,1,3,4
5,1,cheek,5,44,2,3,1
5,1,chest,5,45,3,2,1
5,1,climb,5,46,1,4,1.25
5,1,clip,4,47,3,1,0.5
5,1,clock,5,48,2,3,4.25
5,1,cloth,5,49,3,2,1
5,1,copy,4,50,1,3,1
5,1,cow,3,51,2,1,0.5
5,1,crack,5,52,1,4,1.25
5,1,crash,5,53,3,2,1
5,1,crazy,5,54,3,2,4.25
5,1,crown,5,55,2,3,1.25
5,1,cue,3,56,1,2,0.75
5,1,cult,4,57,2,2,0.75
5,1,cure,4,58,2,2,0.75
5,1,data,4,59,0,4,4.5
5,1,dead,4,60,1,3,1
5,1,deck,4,61,2,2,0.75
5,1,diary,5,62,1,4,1.25
5,1,dip,3,63,2,1,0.5
5,1,door,4,64,1,3,4.25
5,1,dozen,5,65,2,3,1.25
5,1,drag,4,66,1,3,1
5,1,draw,4,67,3,1,0.5
5,1,dress,5,68,2,3,1
5,1,drug,4,69,2,2,0.75
5,1,drum,4,70,3,1,3.75
5,1,due,3,71,1,2,0.75
5,1,dull,4,72,2,2,0.75
5,1,early,5,73,0,5,1.5
5,1,east,4,74,2,2,0.75
5,1,else,4,75,1,3,4.25
5,1,empty,5,76,1,4,1.25
5,1,enrol,5,77,1,4,1.25
5,1,equip,5,78,1,4,1.25
5,1,every,5,79,1,4,4.5
5,1,exert,5,80,1,4,1.25
5,1,fame,4,81,0,4,1.5
5,1,feed,4,82,1,3,4.25
5,1,fifth,5,83,1,4,1.25
5,1,fire,4,84,2,2,1
5,1,fish,4,85,2,2,0.75
5,1,flame,5,86,1,4,4.25
5,1,flash,5,87,3,2,1
5,1,flaw,4,88,3,1,0.75
5,1,fleet,5,89,2,3,1
5,1,flood,5,90,2,3,1
5,1,forge,5,91,1,4,1.25
5,1,fork,4,92,3,1,4.25
5,1,forth,5,93,3,2,0.75
5,1,get,3,94,0,3,1
5,1,grain,5,95,1,4,1.5
5,1,grant,5,96,3,2,1
5,1,grass,5,97,3,2,4.25
5,1,great,5,98,2,3,1.25
5,1,guard,5,99,1,4,1.25
5,1,halt,4,100,0,4,1.25
5,1,hand,4,101,2,2,4
5,1,he,2,102,1,1,0.5
5,1,hello,5,103,2,3,1
5,1,help,4,104,3,1,0.5
5,1,here,4,105,2,2,0.75
5,1,hero,4,106,3,1,0.5
5,1,hide,4,107,1,3,1
5,1,hill,4,108,2,2,4
5,1,hold,4,109,1,3,1
5,1,hope,4,110,2,2,0.75
5,1,host,4,111,2,2,0.75
5,1,if,2,112,0,2,0.5
5,1,in,2,113,1,1,0.5
5,1,input,5,114,2,3,4.25
5,1,jam,3,115,0,3,1
5,1,jeans,5,116,1,4,1.25
5,1,join,4,117,1,3,1
5,1,july,4,118,1,3,4.25
5,1,keen,4,119,0,4,1.25
5,1,knock,5,120,1,4,1.25
5,1,label,5,121,0,5,1.25
5,1,lamp,4,122,2,2,5
5,1,lane,4,123,2,2,1
5,1,late,4,124,2,2,1
5,1,lead,4,125,1,3,1
5,1,leap,4,126,3,1,0.5
5,1,legal,5,127,2,3,1
5,1,less,4,128,2,2,4.5
5,1,let,3,129,2,1,0.5
5,1,level,5,130,2,3,1
5,1,lock,4,131,1,3,1
5,1,logic,5,132,2,3,1.25
5,1,loom,4,133,2,2,6.75
5,1,lord,4,134,2,2,1.75
5,1,lower,5,135,2,3,2.25
5,1,luck,4,136,1,3,2.25
5,1,lung,4,137,2,2,1.75
5,1,man,3,138,0,3,7.5
5,1,metal,5,139,1,4,2.75
5,1,mine,4,140,1,3,2.25
5,1,miner,5,141,4,1,1
5,1,minor,5,142,3,2,1.75
5,1,monk,4,143,1,3,8.5
5,1,moral,5,144,2,3,2.5
5,1,motor,5,145,2,3,2.25
5,1,nail,4,146,0,4,2.5
5,1,nest,4,147,1,3,2.25
5,1,net,3,148,2,1,7
5,1,news,4,149,2,2,1.75
5,1,next,4,150,2,2,1.75
5,1,nod,3,151,1,2,1.5
5,1,nose,4,152,2,2,1.75
5,1,o,1,153,0,1,0.75
5,1,occur,5,154,1,4,8
5,1,offer,5,155,1,4,2.75
5,1,onto,4,156,1,3,2
5,1,open,4,157,1,3,2
5,1,oral,4,158,1,3,7.5
5,1,order,5,159,2,3,2.5
5,1,our,3,160,1,2,1.5
5,1,oven,4,161,1,3,2
5,1,over,4,162,3,1,1
5,1,owner,5,163,1,4,8
5,1,paper,5,164,0,5,3.25
5,1,party,5,165,2,3,2.25
5,1,pass,4,166,2,2,1.75
5,1,peak,4,167,1,3,2.25
5,1,phase,5,168,1,4,8.25
5,1,pilot,5,169,1,4,2.75
5,1,pink,4,170,2,2,1.75
5,1,pitch,5,171,2,3,2.25
5,1,poet,4,172,1,3,7.75
5,1,pole,4,173,2,2,1.75
5,1,pool,4,174,2,2,1.75
5,1,pop,3,175,2,1,1
5,1,port,4,176,2,2,1.5
5,1,pose,4,177,2,2,1.5
5,1,pray,4,178,1,3,7.5
5,1,price,5,179,2,3,2.5
5,1,pub,3,180,1,2,1.5
5,1,punch,5,181,2,3,2.25
5,1,queen,5,182,0,5,8.5
5,1,quote,5,183,2,3,2.25
5,1,rain,4,184,0,4,2.5
5,1,rapid,5,185,2,3,2.25
5,1,red,3,186,1,2,1.5
5,1,rid,3,187,1,2,7
5,1,riot,4,188,2,2,1.75
5,1,risk,4,189,2,2,1.75
5,1,route,5,190,1,4,2.75
5,1,run,3,191,1,2,1.5
5,1,sad,3,192,0,3,7.75
5,1,sadly,5,193,3,2,1.75
5,1,sail,4,194,2,2,1.5
5,1,say,3,195,2,1,1
5,1,scale,5,196,1,4,2.75
5,1,scope,5,197,2,3,7.5
5,1,sea,3,198,1,2,1.5
5,1,see,3,199,2,1,1
5,1,self,4,200,2,2,1.5
5,1,set,3,201,2,1,1
5,1,sex,3,202,2,1,1
5,1,shade,5,203,1,4,2.75
5,1,shake,5,204,3,2,7
5,1,shine,5,205,2,3,2.5
5,1,shock,5,206,2,3,2.5
5,1,shop,4,207,3,1,1.25
5,1,short,5,208,3,2,1.75
5,1,shout,5,209,3,2,1.75
5,1,shrug,5,210,2,3,8
5,1,sigh,4,211,1,3,2
5,1,silly,5,212,2,3,2.25
5,1,sixty,5,213,2,3,2.25
5,1,size,4,214,2,2,1.5
5,1,skill,5,215,1,4,8.25
5,1,sky,3,216,2,1,1
5,1,slave,5,217,1,4,2.75
5,1,sleep,5,218,2,3,2.5
5,1,slot,4,219,2,2,1.75
5,1,slow,4,220,3,1,7
5,1,smart,5,221,1,4,2.75
5,1,soak,4,222,1,3,2
5,1,sorry,5,223,2,3,2.25
5,1,span,4,224,1,3,8.25
5,1,spicy,5,225,2,3,2.5
5,1,spill,5,226,3,2,2
5,1,spite,5,227,3,2,2
5,1,stage,5,228,1,4,2.75
5,1,steep,5,229,2,3,8
5,1,stiff,5,230,2,3,2.25
5,1,t,1,231,0,1,0.75
5,1,tax,3,232,1,2,1.5
5,1,teach,5,233,1,4,2.5
5,1,tell,4,234,2,2,1.75
5,1,that,4,235,1,3,8
5,1,theft,5,236,2,3,2.5
5,1,them,4,237,3,1,1.25
5,1,then,4,238,3,1,1.25
5,1,there,5,239,3,2,2
5,1,thief,5,240,2,3,2.25
5,1,thin,4,241,3,1,7
5,1,throw,5,242,2,3,2.25
5,1,tired,5,243,1,4,2.75
5,1,toll,4,244,1,3,2
5,1,toy,3,245,2,1,1
5,1,trace,5,246,1,4,8.5
5,1,truly,5,247,2,3,2.25
5,1,truth,5,248,3,2,2
5,1,try,3,249,2,1,1
5,1,ugly,4,250,0,4,2.5
5,1,under,5,251,1,4,8.5
5,1,unit,4,252,2,2,1.75
5,1,upper,5,253,1,4,2.75
5,1,upset,5,254,2,3,2.25
5,1,us,2,255,1,1,6.75
5,1,vast,4,256,0,4,2.5
5,1,very,4,257,1,3,2.25
5,1,vote,4,258,1,3,2.25
5,1,wage,4,259,0,4,8.5
5,1,wall,4,260,2,2,2
5,1,want,4,261,2,2,1.75
5,1,wash,4,262,2,2,1.75
5,1,web,3,263,1,2,1.5
5,1,week,4,264,2,2,1.75
5,1,well,4,265,2,2,1.75
5,1,wet,3,266,2,1,11
5,1,wheat,5,267,1,4,268.5
5,1,where,5,268,3,2,1.5
5,1,while,5,269,2,3,1.5
5,1,whole,5,270,2,3,1.75
5,1,wise,4,271,1,3,8.5
5,1,wrong,5,272,1,4,2
5,1,you,3,273,0,3,1.25
5,1,zone,4,274,0,4,1.75
5,2,able,4,0,0,4,1.5
5,2,act,3,1,1,2,1
5,2,agent,5,2,1,4,1.5
5,2,ah,2,3,1,1,0.5
5,2,air,3,4,1,2,3.75
5,2,alert,5,5,1,4,1.5
5,2,alien,5,6,2,3,2
5,2,alike,5,7,3,2,1.25
5,2,all,3,8,2,1,0.75
5,2,allow,5,9,3,2,1
5,2,also,4,10,2,2,3.75
5,2,apart,5,11,1,4,1.25
5,2,arena,5,12,1,4,1.25
5,2,armed,5,13,2,3,1.25
5,2,array,5,14,2,3,4.25
5,2,asset,5,15,1,4,1.25
5,2,back,4,16,0,4,1.25
5,2,bad,3,17,2,1,0.5
5,2,being,5,18,1,4,4.5
5,2,bend,4,19,2,2,0.75
5,2,blast,5,20,1,4,1.25
5,2,bleed,5,21,2,3,1
5,2,bold,4,22,1,3,4
5,2,bonus,5,23,2,3,1.25
5,2,born,4,24,2,2,0.75
5,2,bring,5,25,1,4,1.25
5,2,broad,5,26,2,3,1
5,2,buck,4,27,1,3,4.25
5,2,bulk,4,28,2,2,0.75
5,2,bury,4,29,2,2,0.75
5,2,bus,3,30,2,1,0.5
5,2,busy,4,31,3,1,0.5
5,2,but,3,32,2,1,0.5
5,2,bye,3,33,1,2,0.75
5,2,cabin,5,34,0,5,4.5
5,2,camp,4,35,2,2,0.75
5,2,cat,3,36,2,1,0.5
5,2,cheek,5,37,1,4,1.25
5,2,chest,5,38,3,2,0.75
5,2,civic,5,39,1,4,4.25
5,2,climb,5,40,1,4,1.5
5,2,clip,4,41,3,1,0.75
5,2,clock,5,42,2,3,1.25
5,2,cloth,5,43,3,2,4.5
5,2,clue,4,44,2,2,1
5,2,coast,5,45,1,4,1.25
5,2,comic,5,46,2,3,1.25
5,2,cook,4,47,2,2,0.75
5,2,cool,4,48,3,1,0.75
5,2,cop,3,49,2,1,4
5,2,crack,5,50,1,4,1.5
5,2,crazy,5,51,3,2,1
5,2,cream,5,52,2,3,1
5,2,crop,4,53,2,2,0.75
5,2,crown,5,54,3,2,1
5,2,cue,3,55,1,2,4.25
5,2,cult,4,56,2,2,0.75
5,2,cure,4,57,2,2,0.75
5,2,date,4,58,0,4,1.25
5,2,dear,4,59,1,3,1
5,2,deck,4,60,2,2,4.75
5,2,die,3,61,1,2,0.75
5,2,door,4,62,1,3,1
5,2,dozen,5,63,2,3,1
5,2,dress,5,64,1,4,4.5
5,2,drive,5,65,2,3,1.25
5,2,dull,4,66,1,3,1
5,2,duty,4,67,2,2,0.75
5,2,early,5,68,0,5,3
5,2,eat,3,69,2,1,2.25
5,2,edge,4,70,1,3,1
5,2,else,4,71,1,3,0.75
5,2,embed,5,72,1,4,1.25
5,2,empty,5,73,2,3,4.25
5,2,era,3,74,1,2,0.75
5,2,error,5,75,2,3,1
5,2,erupt,5,76,2,3,1
5,2,exam,4,77,1,3,1
5,2,fact,4,78,0,4,4.5
5,2,faith,5,79,2,3,1.25
5,2,farm,4,80,2,2,0.75
5,2,feat,4,81,1,3,1
5,2,feel,4,82,2,2,0.75
5,2,fence,5,83,2,3,4.25
5,2,film,4,84,1,3,1
5,2,find,4,85,2,2,0.75
5,2,fire,4,86,2,2,0.75
5,2,first,5,87,3,2,0.75
5,2,fit,3,88,2,1,0.5
5,2,five,4,89,2,2,4
5,2,flame,5,90,1,4,1.25
5,2,flash,5,91,3,2,0.75
5,2,float,5,92,2,3,1
5,2,flood,5,93,3,2,0.75
5,2,fond,4,94,1,3,4.25
5,2,fool,4,95,2,2,0.75
5,2,forth,5,96,2,3,1
5,2,forum,5,97,3,2,0.75
5,2,from,4,98,1,3,1
5,2,fun,3,99,1,2,4
5,2,fund,4,100,3,1,0.75
5,2,get,3,101,0,3,0.75
5,2,grand,5,102,1,4,1.25
5,2,grant,5,103,4,1,0.5
5,2,grass,5,104,3,2,0.75
5,2,guard,5,105,1,4,4.5
5,2,half,4,106,0,4,1.25
5,2,halt,4,107,3,1,0.5
5,2,hand,4,108,2,2,0.75
5,2,happy,5,109,2,3,1
5,2,he,2,110,1,1,3.5
5,2,hello,5,111,2,3,1
5,2,help,4,112,3,1,0.5
5,2,hence,5,113,2,3,1
5,2,hobby,5,114,1,4,1.25
5,2,holy,4,115,2,2,4
5,2,hook,4,116,2,2,1
5,2,host,4,117,2,2,0.75
5,2,house,5,118,2,3,1
5,2,jeans,5,119,0,5,1.25
5,2,july,4,120,1,3,4.25
5,2,keen,4,121,0,4,1.25
5,2,kind,4,122,1,3,1
5,2,knock,5,123,1,4,1.25
5,2,lady,4,124,0,4,4.5
5,2,lane,4,125,2,2,0.75
5,2,learn,5,126,1,4,1.25
5,2,leave,5,127,3,2,1
5,2,legal,5,128,2,3,4.25
5,2,let,3,129,2,1,0.5
5,2,light,5,130,1,4,1.25
5,2,limit,5,131,2,3,1
5,2,logic,5,132,1,4,1.25
5,2,logo,4,133,3,1,4
5,2,loom,4,134,2,2,0.75
5,2,loss,4,135,2,2,0.75
5,2,lost,4,136,3,1,0.5
5,2,lower,5,137,2,3,1
5,2,luck,4,138,1,3,1
5,2,major,5,139,0,5,4.75
5,2,mate,4,140,2,2,0.75
5,2,maths,5,141,3,2,1
5,2,maybe,5,142,2,3,1
5,2,mayor,5,143,3,2,1
5,2,me,2,144,1,1,3.75
5,2,meet,4,145,2,2,0.75
5,2,menu,4,146,2,2,0.75
5,2,mile,4,147,1,3,1
5,2,mine,4,148,2,2,0.75
5,2,miner,5,149,4,1,0.5
5,2,monk,4,150,1,3,4.5
5,2,moral,5,151,2,3,1.25
5,2,mount,5,152,2,3,1
5,2,move,4,153,2,2,0.75
5,2,noble,5,154,0,5,4.75
5,2,nod,3,155,2,1,0.5
5,2,noon,4,156,2,2,0.75
5,2,nose,4,157,2,2,0.75
5,2,nurse,5,158,1,4,1.5
5,2,o,1,159,0,1,0.25
5,2,of,2,160,1,1,0.25
5,2,onto,4,161,1,3,4.25
5,2,open,4,162,1,3,1
5,2,our,3,163,1,2,0.75
5,2,over,4,164,1,3,1
5,2,owner,5,165,1,4,2.75
5,2,palm,4,166,0,4,3.25
5,2,pan,3,167,2,1,0.5
5,2,party,5,168,2,3,1.25
5,2,pass,4,169,2,2,0.75
5,2,peak,4,170,1,3,1
5,2,pill,4,171,1,3,4.5
5,2,pilot,5,172,3,2,0.75
5,2,plain,5,173,1,4,1.25
5,2,plate,5,174,3,2,0.75
5,2,pool,4,175,1,3,4.25
5,2,port,4,176,2,2,0.75
5,2,pray,4,177,1,3,1
5,2,prey,4,178,2,2,0.75
5,2,price,5,179,2,3,1
5,2,punch,5,180,1,4,4.75
5,2,queen,5,181,0,5,1.5
5,2,radio,5,182,0,5,1.25
5,2,rain,4,183,2,2,0.75
5,2,range,5,184,2,3,6.25
5,2,rapid,5,185,2,3,2.5
5,2,rare,4,186,2,2,1.75
5,2,real,4,187,1,3,2
5,2,role,4,188,1,3,7.5
5,2,rugby,5,189,1,4,3
5,2,rule,4,190,2,2,1.75
5,2,run,3,191,2,1,1.25
5,2,sadly,5,192,0,5,3.25
5,2,sail,4,193,2,2,7
5,2,scope,5,194,1,4,2.75
5,2,sea,3,195,1,2,1.5
5,2,see,3,196,2,1,1
5,2,seize,5,197,2,3,2.25
5,2,self,4,198,2,2,7
5,2,send,4,199,2,2,1.75
5,2,sex,3,200,2,1,1
5,2,shake,5,201,1,4,2.75
5,2,sheet,5,202,2,3,2.25
5,2,shock,5,203,2,3,2.25
5,2,show,4,204,3,1,7
5,2,shrug,5,205,2,3,2.25
5,2,sigh,4,206,1,3,2
5,2,sir,3,207,2,1,1
5,2,sixty,5,208,2,3,2.25
5,2,skill,5,209,1,4,8.25
5,2,sky,3,210,2,1,1
5,2,sleep,5,211,1,4,2.75
5,2,small,5,212,1,4,2.75
5,2,smart,5,213,3,2,1.75
5,2,snap,4,214,1,3,7.75
5,2,soak,4,215,1,3,2.25
5,2,sorry,5,216,2,3,2.25
5,2,span,4,217,1,3,2
5,2,spicy,5,218,2,3,7.75
5,2,spite,5,219,3,2,2
5,2,split,5,220,2,3,2.25
5,2,spoon,5,221,2,3,2.25
5,2,sport,5,222,3,2,1.75
5,2,spy,3,223,2,1,1
5,2,stark,5,224,1,4,8.25
5,2,steel,5,225,2,3,2.25
5,2,steep,5,226,4,1,1.25
5,2,stiff,5,227,2,3,2.25
5,2,tag,3,228,0,3,2
5,2,teach,5,229,1,4,8.5
5,2,text,4,230,2,2,1.75
5,2,their,5,231,1,4,2.75
5,2,them,4,232,3,1,1
5,2,then,4,233,3,1,1.25
5,2,there,5,234,3,2,7.25
5,2,they,4,235,3,1,1.25
5,2,thief,5,236,2,3,2.25
5,2,thin,4,237,3,1,1.25
5,2,thing,5,238,4,1,1.25
5,2,think,5,239,4,1,1
5,2,throw,5,240,2,3,2.25
5,2,toll,4,241,1,3,8
5,2,ton,3,242,2,1,1
5,2,tone,4,243,3,1,1
5,2,total,5,244,2,3,2.25
5,2,towel,5,245,2,3,2.25
5,2,toy,3,246,2,1,1
5,2,trace,5,247,1,4,8.25
5,2,truly,5,248,2,3,2.25
5,2,trust,5,249,3,2,2.25
5,2,twist,5,250,1,4,2.75
5,2,type,4,251,1,3,2
5,2,ugly,4,252,0,4,8.25
5,2,under,5,253,1,4,2.75
5,2,unit,4,254,2,2,1.75
5,2,us,2,255,1,1,0.75
5,2,use,3,256,2,1,1
5,2,wage,4,257,0,4,8.25
5,2,ward,4,258,2,2,1.75
5,2,wash,4,259,2,2,1.75
5,2,we,2,260,1,1,0.75
5,2,web,3,261,2,1,1
5,2,week,4,262,2,2,1.5
5,2,well,4,263,2,2,1.5
5,2,wet,3,264,2,1,6.5
5,2,what,4,265,1,3,2.25
5,2,wheat,5,266,2,3,2.25
5,2,when,4,267,3,1,1.25
5,2,who,3,268,2,1,1
5,2,wide,4,269,1,3,2.25
5,2,wish,4,270,2,2,7.5
5,2,worse,5,271,1,4,2.75
5,2,wound,5,272,2,3,2.25
5,2,you,3,273,0,3,2
5,2,zone,4,274,0,4,8.25
5,3,above,5,0,0,5,3.25
5,3,adult,5,1,1,4,2.75
5,3,alert,5,2,1,4,8.25
5,3,all,3,3,2,1,1
5,3,allow,5,4,3,2,1.75
5,3,alone,5,5,2,3,2.25
5,3,along,5,6,4,1,1.25
5,3,also,4,7,2,2,1.75
5,3,amid,4,8,1,3,7.75
5,3,apart,5,9,1,4,2.75
5,3,apple,5,10,2,3,2.25
5,3,april,5,11,2,3,2.25
5,3,arena,5,12,1,4,8.25
5,3,armed,5,13,2,3,2.25
5,3,asset,5,14,1,4,2.75
5,3,avoid,5,15,1,4,2.75
5,3,aware,5,16,1,4,8.75
5,3,away,4,17,3,1,1.25
5,3,back,4,18,0,4,2.5
5,3,bad,3,19,2,1,1
5,3,bank,4,20,2,2,1.75
5,3,basis,5,21,2,3,8
5,3,bean,4,22,1,3,2
5,3,bee,3,23,2,1,1
5,3,beef,4,24,3,1,1
5,3,being,5,25,2,3,2.25
5,3,bent,4,26,2,2,1.5
5,3,bet,3,27,2,1,1
5,3,bias,4,28,1,3,7.5
5,3,big,3,29,2,1,1
5,3,blast,5,30,1,4,2.75
5,3,bleed,5,31,2,3,2.25
5,3,blend,5,32,3,2,1.75
5,3,bond,4,33,1,3,8
5,3,born,4,34,2,2,1.75
5,3,bread,5,35,1,4,2.75
5,3,bring,5,36,2,3,2.25
5,3,broad,5,37,2,3,8
5,3,buck,4,38,1,3,2.25
5,3,bulk,4,39,2,2,1.75
5,3,burst,5,40,2,3,2.25
5,3,bury,4,41,3,1,1.25
5,3,but,3,42,2,1,1
5,3,calm,4,43,0,4,8.5
5,3,camp,4,44,2,2,1.75
5,3,case,4,45,2,2,1.5
5,3,cat,3,46,2,1,1
5,3,catch,5,47,3,2,1.5
5,3,cause,5,48,2,3,2.25
5,3,cent,4,49,1,3,8
5,3,chaos,5,50,1,4,2.75
5,3,civic,5,51,1,4,2.75
5,3,claim,5,52,1,4,2.75
5,3,class,5,53,3,2,7.75
5,3,climb,5,54,2,3,2.5
5,3,cling,5,55,3,2,2
5,3,clock,5,56,2,3,2.25
5,3,clue,4,57,2,2,1.75
5,3,coast,5,58,1,4,8.5
5,3,coin,4,59,2,2,1.75
5,3,comic,5,60,2,3,2.25
5,3,cook,4,61,2,2,1.5
5,3,cop,3,62,2,1,1
5,3,crazy,5,63,1,4,8.5
5,3,cream,5,64,2,3,2.25
5,3,crop,4,65,2,2,1.75
5,3,cult,4,66,1,3,2
5,3,dad,3,67,0,3,2
5,3,data,4,68,2,2,7.5
5,3,date,4,69,3,1,1.25
5,3,dead,4,70,1,3,2
5,3,deck,4,71,2,2,1.5
5,3,defy,4,72,2,2,1.5
5,3,die,3,73,1,2,1.5
5,3,dog,3,74,1,2,7
5,3,door,4,75,2,2,1.75
5,3,dose,4,76,2,2,1.75
5,3,dozen,5,77,2,3,2.25
5,3,drag,4,78,1,3,2
5,3,drain,5,79,3,2,1.75
5,3,draw,4,80,3,1,3.75
5,3,drive,5,81,2,3,6.25
5,3,drown,5,82,2,3,2.25
5,3,drug,4,83,2,2,1.75
5,3,drum,4,84,3,1,1.25
5,3,dry,3,85,2,1,1
5,3,due,3,86,1,2,1.5
5,3,duty,4,87,2,2,7.25
5,3,each,4,88,0,4,2.5
5,3,early,5,89,2,3,2.25
5,3,east,4,90,2,2,1.75
5,3,eat,3,91,2,1,1
5,3,edge,4,92,1,3,8
5,3,else,4,93,1,3,2
5,3,empty,5,94,1,4,2.75
5,3,ensue,5,95,1,4,2.75
5,3,equal,5,96,1,4,8.5
5,3,equip,5,97,3,2,2
5,3,erupt,5,98,1,4,2.75
5,3,exam,4,99,1,3,2
5,3,extra,5,100,2,3,8.25
5,3,fact,4,101,0,4,2.5
5,3,faith,5,102,2,3,2.25
5,3,fan,3,103,2,1,1
5,3,feat,4,104,1,3,2
5,3,fill,4,105,1,3,7.75
5,3,film,4,106,3,1,1.25
5,3,first,5,107,2,3,2.25
5,3,fish,4,108,2,2,1.75
5,3,fit,3,109,2,1,1
5,3,flame,5,110,1,4,2.75
5,3,flaw,4,111,3,1,7.25
5,3,fleet,5,112,2,3,2.5
5,3,flood,5,113,2,3,2.25
5,3,flour,5,114,3,2,2
5,3,fold,4,115,1,3,2
5,3,fork,4,116,2,2,7.5
5,3,frame,5,117,1,4,2.75
5,3,from,4,118,2,2,1.75
5,3,fruit,5,119,2,3,2.5
5,3,funny,5,120,1,4,8.75
5,3,gas,3,121,0,3,2
5,3,get,3,122,1,2,1.5
5,3,glad,4,123,1,3,2.25
5,3,grain,5,124,1,4,2.75
5,3,grass,5,125,3,2,9.75
5,3,he,2,126,0,2,1.75
5,3,hello,5,127,2,3,2.25
5,3,hence,5,128,2,3,2.25
5,3,here,4,129,2,2,1.75
5,3,hero,4,130,3,1,1
5,3,hobby,5,131,1,4,9.25
5,3,holy,4,132,2,2,1.75
5,3,hook,4,133,2,2,1.75
5,3,hope,4,134,2,2,1.75
5,3,house,5,135,2,3,2.25
5,3,hurry,5,136,1,4,9
5,3,if,2,137,0,2,1.5
5,3,jam,3,138,0,3,2
5,3,joint,5,139,1,4,2.75
5,3,label,5,140,0,5,9.25
5,3,lamp,4,141,2,2,1.75
5,3,lane,4,142,2,2,1.75
5,3,late,4,143,2,2,1.75
5,3,lead,4,144,1,3,2.25
5,3,legal,5,145,2,3,8.25
5,3,lend,4,146,2,2,1.75
5,3,less,4,147,2,2,1.75
5,3,let,3,148,2,1,1
5,3,level,5,149,2,3,2.25
5,3,limit,5,150,1,4,9
5,3,loan,4,151,1,3,2.25
5,3,logo,4,152,2,2,1.75
5,3,loop,4,153,2,2,2.25
5,3,lose,4,154,2,2,2.25
5,3,lost,4,155,3,1,1.25
5,3,major,5,156,0,5,5.5
5,3,meet,4,157,1,3,1
5,3,menu,4,158,2,2,0.75
5,3,milk,4,159,1,3,1
5,3,mill,4,160,3,1,0.5
5,3,moral,5,161,1,4,5
5,3,mount,5,162,2,3,1.25
5,3,move,4,163,2,2,0.75
5,3,nail,4,164,0,4,1.25
5,3,naval,5,165,2,3,5
5,3,nerve,5,166,1,4,1.25
5,3,noon,4,167,1,3,1
5,3,nurse,5,168,1,4,1.25
5,3,o,1,169,0,1,0.25
5,3,obey,4,170,1,3,4.75
5,3,of,2,171,1,1,0.25
5,3,on,2,172,1,1,0.25
5,3,onto,4,173,2,2,0.75
5,3,or,2,174,1,1,0.25
5,3,over,4,175,1,3,1
5,3,own,3,176,1,2,0.5
5,3,owner,5,177,3,2,4.75
5,3,palm,4,178,0,4,1
5,3,pan,3,179,2,1,0.5
5,3,paper,5,180,2,3,1
5,3,peak,4,181,1,3,1
5,3,phase,5,182,1,4,5
5,3,pill,4,183,1,3,1
5,3,pit,3,184,2,1,0.5
5,3,pitch,5,185,3,2,0.75
5,3,plain,5,186,1,4,4.75
5,3,plug,4,187,2,2,1
5,3,poet,4,188,1,3,1
5,3,pop,3,189,2,1,0.5
5,3,port,4,190,2,2,0.75
5,3,pose,4,191,2,2,0.75
5,3,pray,4,192,1,3,4.75
5,3,price,5,193,2,3,1.25
5,3,punch,5,194,1,4,1.25
5,3,radio,5,195,0,5,1.5
5,3,rain,4,196,2,2,4.75
5,3,range,5,197,2,3,1
5,3,rapid,5,198,2,3,1
5,3,rare,4,199,2,2,0.75
5,3,raw,3,200,2,1,0.25
5,3,real,4,201,1,3,1
5,3,red,3,202,2,1,4.5
5,3,rice,4,203,1,3,1
5,3,riot,4,204,2,2,0.75
5,3,role,4,205,1,3,1
5,3,rule,4,206,1,3,1
5,3,sadly,5,207,0,5,5.5
5,3,sail,4,208,2,2,0.75
5,3,scope,5,209,1,4,1.25
5,3,see,3,210,1,2,0.75
5,3,seize,5,211,2,3,5.25
5,3,shade,5,212,1,4,1.25
5,3,shall,5,213,3,2,1
5,3,shine,5,214,2,3,1.25
5,3,shop,4,215,2,2,0.75
5,3,shot,4,216,3,1,5
5,3,shout,5,217,3,2,1.25
5,3,silly,5,218,1,4,1.5
5,3,sky,3,219,1,2,0.75
5,3,slave,5,220,1,4,1.25
5,3,sleep,5,221,2,3,5.5
5,3,smart,5,222,1,4,1.25
5,3,smash,5,223,3,2,1
5,3,snap,4,224,1,3,1
5,3,soar,4,225,1,3,5.25
5,3,sort,4,226,2,2,1
5,3,spill,5,227,1,4,1.25
5,3,split,5,228,2,3,1.25
5,3,sport,5,229,2,3,1.25
5,3,stage,5,230,1,4,5.25
5,3,stark,5,231,3,2,1
5,3,style,5,232,2,3,1.25
5,3,swing,5,233,1,4,1.25
5,3,tax,3,234,0,3,4.75
5,3,teach,5,235,1,4,1.25
5,3,tent,4,236,2,2,0.75
5,3,text,4,237,2,2,0.75
5,3,than,4,238,1,3,1
5,3,that,4,239,3,1,4.5
5,3,their,5,240,2,3,1.25
5,3,them,4,241,3,1,0.75
5,3,then,4,242,3,1,0.5
5,3,there,5,243,3,2,0.75
5,3,thick,5,244,2,3,1
5,3,thief,5,245,3,2,1
5,3,thing,5,246,3,2,5
5,3,third,5,247,3,2,1
5,3,throw,5,248,2,3,1.5
5,3,tiny,4,249,1,3,1
5,3,tone,4,250,1,3,1
5,3,touch,5,251,2,3,5.25
5,3,towel,5,252,2,3,1
5,3,trace,5,253,1,4,1.25
5,3,truly,5,254,2,3,1
5,3,truth,5,255,3,2,4.75
5,3,type,4,256,1,3,1
5,3,under,5,257,0,5,1.25
5,3,user,4,258,1,3,1
5,3,very,4,259,0,4,5
5,3,vote,4,260,1,3,1
5,3,wage,4,261,0,4,1.25
5,3,wall,4,262,2,2,0.75
5,3,want,4,263,2,2,4.75
5,3,warm,4,264,2,2,1
5,3,weak,4,265,1,3,1
5,3,what,4,266,1,3,1
5,3,where,5,267,2,3,1
5,3,whole,5,268,2,3,5
5,3,wish,4,269,1,3,1
5,3,worm,4,270,1,3,1
5,3,worst,5,271,3,2,0.75
5,3,wound,5,272,2,3,1
5,3,yell,4,273,0,4,5
5,3,zone,4,274,0,4,1.25
5,4,able,4,0,0,4,1.25
5,4,about,5,1,2,3,5
5,4,above,5,2,3,2,0.75
5,4,adult,5,3,1,4,1.25
5,4,agent,5,4,1,4,1.25
5,4,ah,2,5,1,1,0.25
5,4,air,3,6,1,2,4.75
5,4,alike,5,7,1,4,1.25
5,4,all,3,8,2,1,0.5
5,4,allow,5,9,3,2,0.75
5,4,also,4,10,2,2,0.75
5,4,amid,4,11,1,3,4.75
5,4,angry,5,12,1,4,1.25
5,4,apart,5,13,1,4,1.25
5,4,apple,5,14,2,3,1
5,4,apply,5,15,4,1,0.75
5,4,april,5,16,2,3,5
5,4,armed,5,17,1,4,1.25
5,4,array,5,18,2,3,1
5,4,asset,5,19,1,4,7.5
5,4,audit,5,20,1,4,2.75
5,4,aware,5,21,1,4,3
5,4,back,4,22,0,4,2.75
5,4,bake,4,23,2,2,9
5,4,bank,4,24,2,2,2
5,4,bare,4,25,2,2,1.75
5,4,bean,4,26,1,3,2.25
5,4,bear,4,27,3,1,1.25
5,4,beef,4,28,2,2,1.75
5,4,bend,4,29,2,2,1.75
5,4,bet,3,30,2,1,8.5
5,4,bias,4,31,1,3,2.25
5,4,blend,5,32,1,4,3.75
5,4,body,4,33,1,3,3.25
5,4,bold,4,34,2,2,1.75
5,4,bonus,5,35,2,3,9.5
5,4,brain,5,36,1,4,2.75
5,4,bread,5,37,2,3,2.25
5,4,brick,5,38,2,3,2.5
5,4,brown,5,39,2,3,9.25
5,4,bulk,4,40,1,3,2.25
5,4,burst,5,41,2,3,2.25
5,4,bus,3,42,2,1,1
5,4,busy,4,43,3,1,1.25
5,4,camp,4,44,0,4,9.75
5,4,case,4,45,2,2,1.75
5,4,catch,5,46,2,3,2.25
5,4,cause,5,47,2,3,2.25
5,4,cent,4,48,1,3,2.25
5,4,chat,4,49,1,3,9.25
5,4,civic,5,50,1,4,2.75
5,4,cling,5,51,1,4,2.75
5,4,clock,5,52,2,3,2.25
5,4,coast,5,53,1,4,10
5,4,coin,4,54,2,2,1.75
5,4,comic,5,55,2,3,2.5
5,4,cop,3,56,2,1,1
5,4,cow,3,57,2,1,1
5,4,crack,5,58,1,4,9.75
5,4,crazy,5,59,3,2,2
5,4,crop,4,60,2,2,1.75
5,4,crown,5,61,3,2,2
5,4,cue,3,62,1,2,1.5
5,4,cure,4,63,2,2,1.75
5,4,dad,3,64,0,3,9
5,4,dark,4,65,2,2,1.75
5,4,data,4,66,2,2,1.5
5,4,date,4,67,3,1,1.25
5,4,dear,4,68,1,3,2.25
5,4,deck,4,69,2,2,1.75
5,4,defy,4,70,2,2,1.75
5,4,diary,5,71,1,4,6.25
5,4,die,3,72,2,1,1
5,4,door,4,73,1,3,2
5,4,drag,4,74,1,3,2
5,4,drain,5,75,3,2,1.75
5,4,draw,4,76,3,1,7.75
5,4,dress,5,77,2,3,2.5
5,4,drive,5,78,2,3,2.5
5,4,drown,5,79,2,3,2.5
5,4,early,5,80,0,5,10.25
5,4,east,4,81,2,2,1.75
5,4,echo,4,82,1,3,2.25
5,4,else,4,83,1,3,3.25
5,4,ensue,5,84,1,4,10
5,4,era,3,85,1,2,1.5
5,4,error,5,86,2,3,2.25
5,4,exam,4,87,1,3,2.25
5,4,faith,5,88,0,5,3.25
5,4,fan,3,89,2,1,8.25
5,4,farm,4,90,2,2,1.75
5,4,feed,4,91,1,3,2.25
5,4,fifth,5,92,1,4,2.75
5,4,fill,4,93,2,2,1.75
5,4,five,4,94,2,2,9
5,4,flame,5,95,1,4,2.75
5,4,flash,5,96,3,2,2
5,4,fleet,5,97,2,3,2.25
5,4,flour,5,98,2,3,2.5
5,4,fluid,5,99,2,3,9.25
5,4,fool,4,100,1,3,2
5,4,forth,5,101,2,3,2.5
5,4,fun,3,102,1,2,1.5
5,4,funny,5,103,3,2,1.75
5,4,gas,3,104,0,3,9
5,4,get,3,105,1,2,1.5
5,4,goods,5,106,1,4,2.75
5,4,grand,5,107,1,4,2.75
5,4,grant,5,108,4,1,1.25
5,4,guard,5,109,1,4,9.5
5,4,hand,4,110,0,4,2.5
5,4,happy,5,111,2,3,2.25
5,4,he,2,112,1,1,1
5,4,hero,4,113,2,2,8.75
5,4,hill,4,114,1,3,2
5,4,hold,4,115,1,3,2
5,4,holy,4,116,3,1,1
5,4,hook,4,117,2,2,1.75
5,4,hope,4,118,2,2,1.75
5,4,host,4,119,2,2,9.5
5,4,house,5,120,2,3,2.5
5,4,hurry,5,121,1,4,2.75
5,4,jam,3,122,0,3,2.25
5,4,join,4,123,1,3,9.75
5,4,joint,5,124,4,1,1.5
5,4,july,4,125,1,3,2.25
5,4,keen,4,126,0,4,2.75
5,4,kiss,4,127,1,3,2.25
5,4,label,5,128,0,5,10.5
5,4,lamp,4,129,2,2,1.75
5,4,lane,4,130,2,2,1.75
5,4,level,5,131,1,4,2.75
5,4,light,5,132,1,4,10
5,4,logic,5,133,1,4,2.75
5,4,loom,4,134,2,2,1.75
5,4,luck,4,135,1,3,3.75
5,4,lung,4,136,2,2,2
5,4,man,3,137,0,3,9.75
5,4,marry,5,138,2,3,2.5
5,4,mate,4,139,2,2,1.75
5,4,me,2,140,1,1,1
5,4,means,5,141,2,3,2.25
5,4,meet,4,142,2,2,8.5
5,4,metal,5,143,2,3,2.5
5,4,mill,4,144,1,3,2.25
5,4,mine,4,145,2,2,1.75
5,4,minor,5,146,3,2,2
5,4,moral,5,147,1,4,9.5
5,4,motor,5,148,2,3,2.5
5,4,mount,5,149,2,3,2.25
5,4,nail,4,150,0,4,2.75
5,4,nest,4,151,1,3,9
5,4,net,3,152,2,1,1.25
5,4,news,4,153,2,2,1.75
5,4,next,4,154,2,2,1.75
5,4,noble,5,155,1,4,2.75
5,4,nod,3,156,2,1,1
5,4,noon,4,157,2,2,1.75
5,4,o,1,158,0,1,7.5
5,4,obey,4,159,1,3,2.25
5,4,on,2,160,1,1,0.75
5,4,onto,4,161,2,2,1.5
5,4,open,4,162,1,3,2
5,4,order,5,163,1,4,7
5,4,our,3,164,1,2,0.75
5,4,out,3,165,2,1,0.5
5,4,over,4,166,1,3,1
5,4,palm,4,167,0,4,1.25
5,4,pan,3,168,2,1,0.5
5,4,pill,4,169,1,3,5
5,4,pilot,5,170,3,2,1
5,4,pink,4,171,2,2,0.75
5,4,pit,3,172,2,1,0.5
5,4,pitch,5,173,3,2,0.75
5,4,plug,4,174,1,3,1
5,4,pole,4,175,1,3,5.25
5,4,pool,4,176,2,2,1
5,4,port,4,177,2,2,0.75
5,4,prey,4,178,1,3,1
5,4,pride,5,179,2,3,1
5,4,punch,5,180,1,4,5.5
5,4,queen,5,181,0,5,1.5
5,4,radio,5,182,0,5,1.5
5,4,rain,4,183,2,2,5.25
5,4,raw,3,184,2,1,0.75
5,4,read,4,185,1,3,1
5,4,red,3,186,2,1,0.75
5,4,rice,4,187,1,3,1
5,4,rid,3,188,2,1,0.5
5,4,risk,4,189,2,2,0.75
5,4,rock,4,190,1,3,5.25
5,4,role,4,191,2,2,1
5,4,run,3,192,1,2,0.75
5,4,sadly,5,193,0,5,1.5
5,4,sail,4,194,2,2,0.75
5,4,saint,5,195,3,2,5.5
5,4,say,3,196,2,1,0.5
5,4,scale,5,197,1,4,1.25
5,4,seize,5,198,1,4,1.25
5,4,send,4,199,2,2,1
5,4,set,3,200,2,1,5
5,4,sex,3,201,2,1,0.75
5,4,shake,5,202,1,4,1.25
5,4,shine,5,203,2,3,1.25
5,4,shout,5,204,2,3,1.25
5,4,silly,5,205,1,4,5.75
5,4,sixty,5,206,2,3,1.25
5,4,skill,5,207,1,4,1.25
5,4,sky,3,208,2,1,0.5
5,4,slave,5,209,1,4,5.75
5,4,sleep,5,210,2,3,1.25
5,4,slot,4,211,2,2,1
5,4,slow,4,212,3,1,0.75
5,4,small,5,213,1,4,1.25
5,4,soak,4,214,1,3,5.25
5,4,soar,4,215,3,1,0.75
5,4,soon,4,216,2,2,1
5,4,sorry,5,217,2,3,1.25
5,4,sort,4,218,3,1,0.75
5,4,span,4,219,1,3,1
5,4,spite,5,220,2,3,5.5
5,4,spot,4,221,2,2,0.75
5,4,spy,3,222,2,1,0.5
5,4,steel,5,223,1,4,1.25
5,4,steep,5,224,4,1,0.5
5,4,stiff,5,225,2,3,1
5,4,sweet,5,226,1,4,5.5
5,4,swing,5,227,2,3,1.25
5,4,t,1,228,0,1,0.5
5,4,tag,3,229,1,2,0.75
5,4,teach,5,230,1,4,1.25
5,4,tell,4,231,2,2,5
5,4,tent,4,232,2,2,1
5,4,text,4,233,2,2,0.75
5,4,than,4,234,1,3,1
5,4,that,4,235,3,1,0.5
5,4,theft,5,236,2,3,1
5,4,them,4,237,3,1,0.5
5,4,there,5,238,3,2,5.25
5,4,thing,5,239,2,3,1.25
5,4,tiny,4,240,1,3,1
5,4,tired,5,241,2,3,1
5,4,toll,4,242,1,3,5.25
5,4,ton,3,243,2,1,0.5
5,4,total,5,244,2,3,1.25
5,4,touch,5,245,2,3,1
5,4,true,4,246,1,3,1
5,4,truly,5,247,3,2,0.75
5,4,trust,5,248,3,2,5.25
5,4,try,3,249,2,1,0.5
5,4,twist,5,250,1,4,1.25
5,4,ugly,4,251,0,4,1.75
5,4,upper,5,252,1,4,5.75
5,4,upset,5,253,2,3,1.25
5,4,us,2,254,1,1,0.5
5,4,use,3,255,2,1,0.5
5,4,used,4,256,3,1,0.5
5,4,user,4,257,3,1,0.5
5,4,valid,5,258,0,5,1.5
5,4,wage,4,259,0,4,5.5
5,4,warm,4,260,2,2,1
5,4,weak,4,261,1,3,1
5,4,web,3,262,2,1,0.5
5,4,week,4,263,2,2,0.75
5,4,what,4,264,1,3,5.25
5,4,where,5,265,2,3,1.25
5,4,while,5,266,2,3,1
5,4,whole,5,267,2,3,1.25
5,4,wide,4,268,1,3,5.25
5,4,wise,4,269,2,2,0.75
5,4,worm,4,270,1,3,1
5,4,wrong,5,271,1,4,1.25
5,4,year,4,272,0,4,5.5
5,4,yours,5,273,1,4,1.25
5,4,zone,4,274,0,4,1.25
5,5,adult,5,0,0,5,5.75
5,5,agent,5,1,1,4,1.25
5,5,ah,2,2,1,1,0.5
5,5,alert,5,3,1,4,1.25
5,5,alien,5,4,2,3,5.25
5,5,alike,5,5,3,2,1
5,5,alone,5,6,2,3,1.25
5,5,angry,5,7,1,4,1.25
5,5,apart,5,8,1,4,1.25
5,5,apple,5,9,2,3,11
5,5,apply,5,10,4,1,13.75
5,5,arena,5,11,1,4,2.5
5,5,armed,5,12,2,3,1.5
5,5,array,5,13,2,3,1.25
5,5,asset,5,14,1,4,7
5,5,audit,5,15,1,4,1.75
5,5,aware,5,16,1,4,1.75
5,5,bean,4,17,0,4,6.5
5,5,bear,4,18,3,1,0.75
5,5,bee,3,19,2,1,0.75
5,5,being,5,20,2,3,1.5
5,5,bend,4,21,2,2,2
5,5,bet,3,22,2,1,1.5
5,5,bias,4,23,1,3,2.25
5,5,blood,5,24,1,4,7.75
5,5,bold,4,25,1,3,1.75
5,5,bond,4,26,2,2,1.5
5,5,bonus,5,27,3,2,2
5,5,brick,5,28,1,4,2.5
5,5,broad,5,29,2,3,10.75
5,5,buck,4,30,1,3,3.25
5,5,bulk,4,31,2,2,2.5
5,5,burst,5,32,2,3,2.75
5,5,bus,3,33,2,1,0.75
5,5,but,3,34,2,1,0.75
5,5,cabin,5,35,0,5,13.75
5,5,camp,4,36,2,2,2
5,5,cat,3,37,2,1,1
5,5,cent,4,38,1,3,2.25
5,5,chat,4,39,1,3,13.25
5,5,cheek,5,40,2,3,3.25
5,5,chest,5,41,3,2,1.5
5,5,claim,5,42,1,4,1.75
5,5,class,5,43,3,2,1.25
5,5,climb,5,44,2,3,8.75
5,5,close,5,45,2,3,1
5,5,coast,5,46,1,4,1.25
5,5,coin,4,47,2,2,0.75
5,5,comic,5,48,2,3,1.25
5,5,cook,4,49,2,2,4.25
5,5,copy,4,50,2,2,0.75
5,5,cow,3,51,2,1,0.5
5,5,crazy,5,52,1,4,1.25
5,5,cream,5,53,2,3,1
5,5,crown,5,54,2,3,4.25
5,5,cue,3,55,1,2,0.75
5,5,cult,4,56,2,2,0.75
5,5,cure,4,57,2,2,0.75
5,5,date,4,58,0,4,1.25
5,5,dear,4,59,1,3,4.25
5,5,defy,4,60,2,2,1.25
5,5,diary,5,61,1,4,1.5
5,5,die,3,62,2,1,0.5
5,5,dip,3,63,2,1,0.5
5,5,dog,3,64,1,2,0.75
5,5,donor,5,65,2,3,4.5
5,5,dose,4,66,2,2,1
5,5,drag,4,67,1,3,1
5,5,drown,5,68,2,3,1.25
5,5,drunk,5,69,2,3,1.25
5,5,dry,3,70,2,1,3.75
5,5,dull,4,71,1,3,1
5,5,dump,4,72,2,2,1
5,5,duty,4,73,2,2,0.75
5,5,each,4,74,0,4,1.25
5,5,east,4,75,2,2,4.5
5,5,echo,4,76,1,3,1.25
5,5,edge,4,77,1,3,1
5,5,else,4,78,1,3,1
5,5,embed,5,79,1,4,1.25
5,5,empty,5,80,2,3,4.5
5,5,ensue,5,81,1,4,1.25
5,5,equal,5,82,1,4,1.25
5,5,equip,5,83,3,2,1
5,5,era,3,84,1,2,3.5
5,5,error,5,85,2,3,1.25
5,5,erupt,5,86,2,3,1
5,5,ethic,5,87,1,4,1.25
5,5,exam,4,88,1,3,3.75
5,5,extra,5,89,2,3,1.25
5,5,fact,4,90,0,4,1
5,5,fame,4,91,2,2,0.75
5,5,feat,4,92,1,3,1
5,5,feel,4,93,2,2,3.75
5,5,fifth,5,94,1,4,1.25
5,5,film,4,95,2,2,0.75
5,5,final,5,96,2,3,1
5,5,find,4,97,3,1,0.5
5,5,fire,4,98,2,2,4.5
5,5,fish,4,99,2,2,2.5
5,5,fit,3,100,2,1,117.5
5,5,flame,5,101,1,4,2.75
5,5,flaw,4,102,3,1,1.25
5,5,fleet,5,103,2,3,2.5
5,5,float,5,104,2,3,2.25
5,5,flour,5,105,3,2,8.5
5,5,fold,4,106,1,3,2.25
5,5,fond,4,107,2,2,1.75
5,5,fork,4,108,2,2,1.75
5,5,frame,5,109,1,4,2.75
5,5,from,4,110,2,2,6.5
5,5,fruit,5,111,2,3,2.5
5,5,fun,3,112,1,2,1.5
5,5,fund,4,113,3,1,1
5,5,funny,5,114,3,2,1.5
5,5,gas,3,115,0,3,2
5,5,ghost,5,116,1,4,7.5
5,5,goods,5,117,1,4,2.75
5,5,grand,5,118,1,4,2.75
5,5,guard,5,119,1,4,7.5
5,5,half,4,120,0,4,2.5
5,5,happy,5,121,2,3,2.25
5,5,hear,4,122,1,3,2.25
5,5,hello,5,123,2,3,7
5,5,help,4,124,3,1,1.5
5,5,here,4,125,2,2,1.75
5,5,hero,4,126,3,1,1.25
5,5,hobby,5,127,1,4,2.75
5,5,host,4,128,2,2,1.75
5,5,hurry,5,129,1,4,8.25
5,5,if,2,130,0,2,1.5
5,5,jam,3,131,0,3,2
5,5,join,4,132,1,3,2.25
5,5,joint,5,133,4,1,1
5,5,july,4,134,1,3,2
5,5,kill,4,135,0,4,7.25
5,5,knock,5,136,1,4,2.75
5,5,lane,4,137,0,4,2.5
5,5,leap,4,138,1,3,7
5,5,let,3,139,2,1,1
5,5,light,5,140,1,4,2.75
5,5,limit,5,141,2,3,2.25
5,5,loan,4,142,1,3,2
5,5,lobby,5,143,2,3,7.25
5,5,lock,4,144,2,2,1.75
5,5,logic,5,145,2,3,2.25
5,5,logo,4,146,3,1,1.25
5,5,loop,4,147,2,2,1.5
5,5,lord,4,148,2,2,1.5
5,5,lose,4,149,2,2,6.5
5,5,lower,5,150,2,3,2.5
5,5,lung,4,151,1,3,2.25
5,5,major,5,152,0,5,3.25
5,5,man,3,153,2,1,1
5,5,maybe,5,154,2,3,7.75
5,5,meet,4,155,1,3,2
5,5,menu,4,156,2,2,1.75
5,5,metal,5,157,2,3,2.25
5,5,mill,4,158,1,3,6.75
5,5,mine,4,159,2,2,1.75
5,5,miner,5,160,4,1,1.25
5,5,mode,4,161,1,3,2
5,5,monk,4,162,2,2,1.75
5,5,mount,5,163,2,3,2.25
5,5,nail,4,164,0,4,7.25
5,5,nerve,5,165,1,4,2.75
5,5,nest,4,166,2,2,1.75
5,5,net,3,167,2,1,1
5,5,noon,4,168,1,3,2
5,5,o,1,169,0,1,5.5
5,5,offer,5,170,1,4,2.75
5,5,on,2,171,1,1,0.75
5,5,onto,4,172,2,2,1.5
5,5,open,4,173,1,3,2
5,5,oral,4,174,1,3,6.75
5,5,order,5,175,2,3,2.5
5,5,our,3,176,1,2,1.5
5,5,oven,4,177,1,3,2
5,5,pair,4,178,0,4,2.5
5,5,pan,3,179,2,1,1
5,5,party,5,180,2,3,7
5,5,phase,5,181,1,4,2.75
5,5,pitch,5,182,1,4,2.75
5,5,plain,5,183,1,4,7.5
5,5,plate,5,184,3,2,2
5,5,poet,4,185,1,3,2
5,5,pub,3,186,1,2,1.5
5,5,queue,5,187,0,5,8
5,5,quote,5,188,2,3,2.25
5,5,radio,5,189,0,5,3.25
5,5,range,5,190,2,3,2.25
5,5,rare,4,191,2,2,1.75
5,5,real,4,192,1,3,7.75
5,5,rid,3,193,1,2,1.5
5,5,risk,4,194,2,2,1.75
5,5,rock,4,195,1,3,2
5,5,route,5,196,2,3,2.25
5,5,royal,5,197,2,3,7.25
5,5,rugby,5,198,1,4,2.75
5,5,sadly,5,199,0,5,3.25
5,5,scale,5,200,1,4,7.5
5,5,seize,5,201,1,4,3
5,5,self,4,202,2,2,1.75
5,5,shade,5,203,1,4,2.75
5,5,shall,5,204,3,2,7
5,5,sheet,5,205,2,3,2.5
5,5,shock,5,206,2,3,2.5
5,5,shop,4,207,3,1,1.25
5,5,shout,5,208,3,2,1.75
5,5,shrug,5,209,2,3,2.25
5,5,silly,5,210,1,4,8.25
5,5,sing,4,211,2,2,1.75
5,5,sixty,5,212,2,3,2.25
5,5,size,4,213,2,2,1.5
5,5,sky,3,214,1,2,1.5
5,5,slot,4,215,1,3,7
5,5,slow,4,216,3,1,1.25
5,5,smart,5,217,1,4,2.75
5,5,snap,4,218,1,3,2
5,5,soar,4,219,1,3,4.5
5,5,soft,4,220,2,2,4.5
5,5,sorry,5,221,2,3,2.5
5,5,sort,4,222,3,1,1.25
5,5,span,4,223,1,3,2
5,5,spite,5,224,2,3,2.25
5,5,sport,5,225,2,3,7.25
5,5,spot,4,226,3,1,1.25
5,5,stage,5,227,1,4,3
5,5,stark,5,228,3,2,1.75
5,5,steel,5,229,2,3,2.25
5,5,sweet,5,230,1,4,7.75
5,5,tag,3,231,0,3,2
5,5,tax,3,232,2,1,1
5,5,tell,4,233,1,3,2
5,5,that,4,234,1,3,2
5,5,theft,5,235,2,3,7.5
5,5,their,5,236,3,2,2
5,5,them,4,237,3,1,1.25
5,5,then,4,238,3,1,1
5,5,there,5,239,3,2,1.75
5,5,thick,5,240,2,3,2.25
5,5,think,5,241,3,2,7
5,5,third,5,242,3,2,2
5,5,throw,5,243,2,3,2.5
5,5,tiny,4,244,1,3,2
5,5,toy,3,245,1,2,1.5
5,5,truly,5,246,1,4,7.75
5,5,trust,5,247,3,2,2
5,5,unit,4,248,0,4,2.5
5,5,upper,5,249,1,4,2.75
5,5,use,3,250,1,2,1.5
5,5,user,4,251,3,1,6.5
5,5,valid,5,252,0,5,3.25
5,5,very,4,253,1,3,2.25
5,5,vote,4,254,1,3,2.25
5,5,wall,4,255,0,4,8.25
5,5,want,4,256,2,2,1.75
5,5,ward,4,257,2,2,1.75
5,5,warm,4,258,3,1,1.5
5,5,wash,4,259,2,2,1.75
5,5,weak,4,260,1,3,2.25
5,5,web,3,261,2,1,6.75
5,5,week,4,262,2,2,1.75
5,5,well,4,263,2,2,2
5,5,wet,3,264,2,1,1
5,5,what,4,265,1,3,2.25
5,5,while,5,266,2,3,2.25
5,5,wish,4,267,1,3,8
5,5,worm,4,268,1,3,2.25
5,5,worse,5,269,3,2,1.75
5,5,wound,5,270,2,3,2.25
5,5,wrong,5,271,1,4,8.25
5,5,you,3,272,0,3,2
5,5,yours,5,273,3,2,1.5
5,5,zone,4,274,0,4,2.75
5,6,about,5,0,0,5,10.25
5,6,above,5,1,3,2,3.25
5,6,act,3,2,1,2,2
5,6,aged,4,3,1,3,2.25
5,6,air,3,4,1,2,2
5,6,alert,5,5,1,4,9.5
5,6,alien,5,6,2,3,2.75
5,6,alike,5,7,3,2,3
5,6,allow,5,8,2,3,2.75
5,6,alone,5,9,2,3,2.5
5,6,angel,5,10,1,4,10.75
5,6,apart,5,11,1,4,2.75
5,6,apple,5,12,2,3,2.25
5,6,april,5,13,2,3,10.75
5,6,armed,5,14,1,4,3.25
5,6,audit,5,15,1,4,3.75
5,6,avoid,5,16,1,4,3.5
5,6,aware,5,17,1,4,9.5
5,6,away,4,18,3,1,2
5,6,back,4,19,0,4,3.25
5,6,bad,3,20,2,1,1
5,6,bake,4,21,2,2,1.75
5,6,bank,4,22,2,2,1.75
5,6,bare,4,23,2,2,7
5,6,bean,4,24,1,3,2
5,6,bear,4,25,3,1,1
5,6,bee,3,26,2,1,1
5,6,being,5,27,2,3,2.25
5,6,bend,4,28,2,2,1.75
5,6,bent,4,29,3,1,7.25
5,6,bet,3,30,2,1,1
5,6,big,3,31,1,2,1.75
5,6,blast,5,32,1,4,3
5,6,blood,5,33,2,3,2.5
5,6,body,4,34,1,3,2.25
5,6,bold,4,35,2,2,8
5,6,bonus,5,36,2,3,2.75
5,6,brain,5,37,1,4,3
5,6,bread,5,38,2,3,2.25
5,6,brown,5,39,2,3,8.5
5,6,buck,4,40,1,3,2.25
5,6,burst,5,41,2,3,1.75
5,6,bury,4,42,3,1,1
5,6,bye,3,43,1,2,1.25
5,6,cabin,5,44,0,5,5.25
5,6,calm,4,45,2,2,0.75
5,6,case,4,46,2,2,0.75
5,6,cat,3,47,2,1,0.5
5,6,cause,5,48,2,3,1
5,6,chef,4,49,1,3,4
5,6,chest,5,50,3,2,1
5,6,class,5,51,1,4,1.25
5,6,clip,4,52,2,2,0.75
5,6,clock,5,53,2,3,1
5,6,close,5,54,3,2,1
5,6,cloth,5,55,3,2,4.25
5,6,clue,4,56,2,2,0.75
5,6,cook,4,57,1,3,1
5,6,cool,4,58,3,1,0.5
5,6,cop,3,59,2,1,0.5
5,6,copy,4,60,3,1,0.5
5,6,crash,5,61,1,4,4.5
5,6,cue,3,62,1,2,0.75
5,6,cult,4,63,2,2,1
5,6,dad,3,64,0,3,1
5,6,data,4,65,2,2,0.75
5,6,date,4,66,3,1,0.5
5,6,dear,4,67,1,3,4.5
5,6,deck,4,68,2,2,1
5,6,defy,4,69,2,2,0.75
5,6,diary,5,70,1,4,1.25
5,6,dip,3,71,2,1,0.5
5,6,dozen,5,72,1,4,4.75
5,6,dress,5,73,1,4,1.25
5,6,drive,5,74,2,3,1.25
5,6,drug,4,75,2,2,0.75
5,6,drum,4,76,3,1,0.75
5,6,dry,3,77,2,1,0.5
5,6,due,3,78,1,2,3.75
5,6,easy,4,79,0,4,1.25
5,6,eat,3,80,2,1,0.5
5,6,echo,4,81,1,3,1
5,6,edge,4,82,1,3,1
5,6,enrol,5,83,1,4,4.5
5,6,era,3,84,1,2,0.75
5,6,error,5,85,2,3,1
5,6,erupt,5,86,2,3,1
5,6,ethic,5,87,1,4,4.5
5,6,every,5,88,1,4,1.25
5,6,exert,5,89,1,4,1.25
5,6,fact,4,90,0,4,1
5,6,faith,5,91,2,3,4.25
5,6,feat,4,92,1,3,1
5,6,feel,4,93,2,2,0.75
5,6,fence,5,94,2,3,1
5,6,film,4,95,1,3,4.25
5,6,fire,4,96,2,2,1
5,6,flame,5,97,1,4,1.25
5,6,flour,5,98,2,3,1
5,6,fool,4,99,1,3,1
5,6,forth,5,100,2,3,4.75
5,6,frame,5,101,1,4,1.5
5,6,fully,5,102,1,4,1.25
5,6,fun,3,103,2,1,0.5
5,6,get,3,104,0,3,4.25
5,6,glad,4,105,1,3,1
5,6,goal,4,106,1,3,1
5,6,goods,5,107,2,3,1
5,6,grain,5,108,1,4,5
5,6,grass,5,109,3,2,1
5,6,guard,5,110,1,4,1.25
5,6,half,4,111,0,4,1.25
5,6,hear,4,112,1,3,1
5,6,hello,5,113,2,3,4.75
5,6,help,4,114,3,1,0.75
5,6,here,4,115,2,2,0.75
5,6,hobby,5,116,1,4,1.25
5,6,holy,4,117,2,2,0.75
5,6,hook,4,118,2,2,4.25
5,6,host,4,119,2,2,0.75
5,6,house,5,120,2,3,1
5,6,jam,3,121,0,3,0.75
5,6,kiss,4,122,0,4,1
5,6,label,5,123,0,5,4.75
5,6,lady,4,124,2,2,1
5,6,lamp,4,125,2,2,0.75
5,6,lane,4,126,2,2,0.75
5,6,lead,4,127,1,3,4.25
5,6,level,5,128,2,3,1.25
5,6,light,5,129,1,4,1.25
5,6,limit,5,130,2,3,1
5,6,loan,4,131,1,3,1
5,6,lobby,5,132,2,3,4.5
5,6,lock,4,133,2,2,0.75
5,6,loom,4,134,2,2,0.75
5,6,loss,4,135,2,2,0.75
5,6,lost,4,136,3,1,0.5
5,6,mall,4,137,0,4,4.5
5,6,man,3,138,2,1,0.5
5,6,maths,5,139,2,3,1
5,6,mayor,5,140,2,3,1
5,6,me,2,141,1,1,0.25
5,6,means,5,142,2,3,1
5,6,meet,4,143,2,2,4
5,6,milk,4,144,1,3,1
5,6,mill,4,145,3,1,0.5
5,6,mine,4,146,2,2,0.75
5,6,minor,5,147,3,2,0.75
5,6,monk,4,148,1,3,1
5,6,moral,5,149,2,3,4.25
5,6,naval,5,150,0,5,1.25
5,6,nest,4,151,1,3,1
5,6,next,4,152,2,2,0.75
5,6,noble,5,153,1,4,4.75
5,6,noon,4,154,2,2,1
5,6,nose,4,155,2,2,0.75
5,6,now,3,156,2,1,1
5,6,o,1,157,0,1,0.75
5,6,obey,4,158,1,3,1.75
5,6,of,2,159,1,1,0.75
5,6,on,2,160,1,1,4.75
5,6,onto,4,161,2,2,1
5,6,order,5,162,1,4,1.75
5,6,oven,4,163,1,3,1.25
5,6,over,4,164,3,1,0.75
5,6,own,3,165,1,2,1
5,6,owner,5,166,3,2,6.5
5,6,pan,3,167,0,3,1
5,6,paper,5,168,2,3,1.5
5,6,party,5,169,2,3,1.5
5,6,phase,5,170,1,4,5.5
5,6,pill,4,171,1,3,1.25
5,6,pilot,5,172,3,2,0.75
5,6,pink,4,173,2,2,1
5,6,plate,5,174,1,4,1.25
5,6,poet,4,175,1,3,5
5,6,pole,4,176,2,2,1
5,6,pool,4,177,2,2,1
5,6,pop,3,178,2,1,0.5
5,6,pose,4,179,2,2,1
5,6,pray,4,180,1,3,1
5,6,prey,4,181,2,2,5
5,6,queen,5,182,0,5,1.5
5,6,queue,5,183,3,2,1
5,6,radio,5,184,0,5,1.75
5,6,range,5,185,2,3,165.75
5,6,rapid,5,186,2,3,1.75
5,6,raw,3,187,2,1,0.75
5,6,read,4,188,1,3,1.5
5,6,rice,4,189,1,3,1.5
5,6,rid,3,190,2,1,0.75
5,6,riot,4,191,2,2,7
5,6,risk,4,192,2,2,1.5
5,6,sad,3,193,0,3,1.75
5,6,saint,5,194,2,3,2
5,6,sea,3,195,1,2,1.5
5,6,see,3,196,2,1,1.5
5,6,send,4,197,2,2,6
5,6,sex,3,198,2,1,0.75
5,6,shade,5,199,1,4,1.5
5,6,shake,5,200,3,2,1
5,6,shall,5,201,3,2,1
5,6,sheet,5,202,2,3,1
5,6,shout,5,203,2,3,3.75
5,6,shrug,5,204,2,3,1
5,6,sigh,4,205,1,3,1
5,6,silly,5,206,2,3,1
5,6,sing,4,207,2,2,0.75
5,6,sir,3,208,2,1,3
5,6,slave,5,209,1,4,1.25
5,6,slot,4,210,2,2,0.75
5,6,smart,5,211,1,4,1.25
5,6,smash,5,212,3,2,0.75
5,6,snap,4,213,1,3,4
5,6,soak,4,214,1,3,1
5,6,son,3,215,2,1,0.5
5,6,soon,4,216,2,2,0.75
5,6,sorry,5,217,2,3,1
5,6,span,4,218,1,3,4
5,6,spite,5,219,2,3,1.25
5,6,split,5,220,2,3,1
5,6,spoil,5,221,2,3,1
5,6,sport,5,222,3,2,1
5,6,stark,5,223,1,4,4.5
5,6,steel,5,224,2,3,1.25
5,6,steep,5,225,4,1,0.5
5,6,stiff,5,226,2,3,1
5,6,style,5,227,2,3,3.75
5,6,sum,3,228,1,2,0.75
5,6,surge,5,229,2,3,1
5,6,swing,5,230,1,4,1.25
5,6,tag,3,231,0,3,0.75
5,6,tax,3,232,2,1,0.5
5,6,teach,5,233,1,4,4.5
5,6,tell,4,234,2,2,0.75
5,6,than,4,235,1,3,1
5,6,their,5,236,2,3,1.25
5,6,third,5,237,2,3,4.5
5,6,tired,5,238,1,4,1.25
5,6,toll,4,239,1,3,1
5,6,ton,3,240,2,1,0.5
5,6,total,5,241,2,3,1
5,6,touch,5,242,2,3,5.5
5,6,towel,5,243,2,3,2.5
5,6,trace,5,244,1,4,2.75
5,6,true,4,245,2,2,1.75
5,6,truly,5,246,3,2,4.25
5,6,trust,5,247,3,2,5
5,6,try,3,248,2,1,1
5,6,turn,4,249,1,3,2
5,6,twist,5,250,1,4,2.75
5,6,type,4,251,1,3,2
5,6,ugly,4,252,0,4,8
5,6,up,2,253,1,1,1
5,6,used,4,254,1,3,2
5,6,user,4,255,3,1,1
5,6,valid,5,256,0,5,8
5,6,vast,4,257,2,2,1.75
5,6,vote,4,258,1,3,2.25
5,6,wall,4,259,0,4,2.5
5,6,week,4,260,1,3,2.25
5,6,well,4,261,2,2,7
5,6,wet,3,262,2,1,1
5,6,what,4,263,1,3,2
5,6,where,5,264,2,3,2.25
5,6,while,5,265,2,3,2.25
5,6,who,3,266,2,1,1
5,6,wise,4,267,1,3,7.75
5,6,wish,4,268,3,1,1.25
5,6,worm,4,269,1,3,2
5,6,wound,5,270,2,3,2.5
5,6,wrong,5,271,1,4,2.75
5,6,you,3,272,0,3,7.5
5,6,yours,5,273,3,2,1.5
5,6,zone,4,274,0,4,2.5
5,7,above,5,0,0,5,8.5
5,7,act,3,1,1,2,1.5
5,7,adult,5,2,1,4,3.25
5,7,aged,4,3,1,3,2.25
5,7,aid,3,4,1,2,7
5,7,alert,5,5,1,4,2.75
5,7,alike,5,6,2,3,2.25
5,7,allow,5,7,2,3,2.25
5,7,along,5,8,2,3,2.5
5,7,also,4,9,2,2,7.25
5,7,angel,5,10,1,4,2.75
5,7,apple,5,11,1,4,2.75
5,7,april,5,12,2,3,2.25
5,7,audit,5,13,1,4,8
5,7,avoid,5,14,1,4,2.75
5,7,aware,5,15,1,4,2.75
5,7,away,4,16,3,1,1.25
5,7,bad,3,17,0,3,7
5,7,bake,4,18,2,2,1.75
5,7,bank,4,19,2,2,1.75
5,7,bare,4,20,2,2,1.5
5,7,basis,5,21,2,3,2.25
5,7,bee,3,22,1,2,1.5
5,7,bend,4,23,2,2,7
5,7,bent,4,24,3,1,1.25
5,7,bet,3,25,2,1,1
5,7,blend,5,26,1,4,2.75
5,7,blood,5,27,2,3,2.25
5,7,body,4,28,1,3,7.5
5,7,bond,4,29,2,2,1.75
5,7,bonus,5,30,3,2,2
5,7,brain,5,31,1,4,2.75
5,7,bread,5,32,2,3,2.25
5,7,brick,5,33,2,3,8.25
5,7,bring,5,34,3,2,2
5,7,bulk,4,35,1,3,2.25
5,7,but,3,36,2,1,1
5,7,bye,3,37,1,2,1.5
5,7,cabin,5,38,0,5,12
5,7,camp,4,39,2,2,1.75
5,7,case,4,40,2,2,1.75
5,7,cat,3,41,2,1,1
5,7,chaos,5,42,1,4,2.75
5,7,chat,4,43,3,1,1.25
5,7,cheek,5,44,2,3,7.75
5,7,chef,4,45,3,1,2
5,7,civic,5,46,1,4,2.75
5,7,claim,5,47,1,4,2.75
5,7,class,5,48,3,2,1.75
5,7,clip,4,49,2,2,7.5
5,7,close,5,50,2,3,2.25
5,7,coast,5,51,1,4,2.75
5,7,comic,5,52,2,3,2.5
5,7,cool,4,53,2,2,1.75
5,7,crack,5,54,1,4,8.5
5,7,crazy,5,55,3,2,2
5,7,cream,5,56,2,3,2.25
5,7,crop,4,57,2,2,1.75
5,7,cue,3,58,1,2,1.5
5,7,cult,4,59,2,2,7
5,7,cure,4,60,2,2,1.75
5,7,dark,4,61,0,4,2.5
5,7,date,4,62,2,2,1.75
5,7,dead,4,63,1,3,2
5,7,dear,4,64,3,1,6.25
5,7,debut,5,65,2,3,2.5
5,7,deck,4,66,2,2,1.75
5,7,defy,4,67,2,2,1.5
5,7,diary,5,68,1,4,2.75
5,7,die,3,69,2,1,1
5,7,dip,3,70,2,1,6
5,7,dog,3,71,1,2,1.5
5,7,donor,5,72,2,3,2.25
5,7,door,4,73,2,2,1.5
5,7,dozen,5,74,2,3,2.25
5,7,drain,5,75,1,4,7.75
5,7,drive,5,76,2,3,2.25
5,7,drug,4,77,2,2,1.75
5,7,due,3,78,1,2,1.5
5,7,dull,4,79,2,2,1.75
5,7,easy,4,80,0,4,8.25
5,7,eat,3,81,2,1,1
5,7,else,4,82,1,3,2.25
5,7,enrol,5,83,1,4,2.75
5,7,ensue,5,84,2,3,2.5
5,7,era,3,85,1,2,7
5,7,every,5,86,1,4,2.75
5,7,extra,5,87,1,4,2.75
5,7,fact,4,88,0,4,2.5
5,7,faith,5,89,2,3,8.25
5,7,fame,4,90,2,2,1.75
5,7,fan,3,91,2,1,1
5,7,farm,4,92,2,2,2
5,7,fifth,5,93,1,4,2.75
5,7,film,4,94,2,2,1.75
5,7,final,5,95,2,3,8.25
5,7,fire,4,96,2,2,1.75
5,7,flame,5,97,1,4,2.75
5,7,fleet,5,98,2,3,2.25
5,7,flour,5,99,2,3,8
5,7,fluid,5,100,2,3,2.25
5,7,fold,4,101,1,3,2
5,7,forth,5,102,2,3,2.25
5,7,fruit,5,103,1,4,8.25
5,7,fun,3,104,1,2,1.5
5,7,funny,5,105,3,2,1.5
5,7,gas,3,106,0,3,2
5,7,get,3,107,1,2,1.5
5,7,ghost,5,108,1,4,8
5,7,glad,4,109,1,3,2.25
5,7,goal,4,110,1,3,2.25
5,7,grain,5,111,1,4,2.75
5,7,hand,4,112,0,4,8
5,7,happy,5,113,2,3,2.25
5,7,he,2,114,1,1,0.75
5,7,hear,4,115,2,2,1.5
5,7,hello,5,116,2,3,2
5,7,hence,5,117,2,3,7.25
5,7,hill,4,118,1,3,2.25
5,7,holy,4,119,1,3,2
5,7,hook,4,120,2,2,1.75
5,7,hope,4,121,2,2,1.75
5,7,in,2,122,0,2,1.25
5,7,input,5,123,2,3,7.5
5,7,join,4,124,0,4,2.5
5,7,july,4,125,1,3,2.25
5,7,keen,4,126,0,4,2.5
5,7,kill,4,127,1,3,7.75
5,7,kiss,4,128,2,2,1.75
5,7,lady,4,129,0,4,2.5
5,7,lead,4,130,1,3,2.25
5,7,leap,4,131,3,1,1.25
5,7,learn,5,132,3,2,7.25
5,7,leave,5,133,3,2,2
5,7,legal,5,134,2,3,2.25
5,7,less,4,135,2,2,1.75
5,7,let,3,136,2,1,1
5,7,light,5,137,1,4,8.25
5,7,limit,5,138,2,3,2.5
5,7,lobby,5,139,1,4,2.75
5,7,loom,4,140,2,2,1.75
5,7,loss,4,141,2,2,1.75
5,7,lower,5,142,2,3,8.25
5,7,luck,4,143,1,3,2.25
5,7,lung,4,144,2,2,1.75
5,7,mall,4,145,0,4,2.5
5,7,man,3,146,2,1,1
5,7,march,5,147,2,3,8
5,7,mayor,5,148,2,3,2.25
5,7,meet,4,149,1,3,2.25
5,7,metal,5,150,2,3,2.25
5,7,mile,4,151,1,3,2
5,7,milk,4,152,3,1,7.25
5,7,mill,4,153,3,1,1.25
5,7,mode,4,154,1,3,2
5,7,monk,4,155,2,2,1.75
5,7,motor,5,156,2,3,2.75
5,7,mount,5,157,2,3,2.5
5,7,nest,4,158,0,4,9.25
5,7,net,3,159,2,1,1.25
5,7,news,4,160,2,2,2
5,7,nod,3,161,1,2,1.5
5,7,now,3,162,2,1,1.25
5,7,offer,5,163,0,5,9.25
5,7,on,2,164,1,1,1
5,7,onion,5,165,2,3,2.25
5,7,onto,4,166,2,2,1.75
5,7,oral,4,167,1,3,2.25
5,7,order,5,168,2,3,9.25
5,7,our,3,169,1,2,2.25
5,7,out,3,170,2,1,1
5,7,oven,4,171,1,3,2.25
5,7,over,4,172,3,1,1
5,7,owner,5,173,1,4,2.75
5,7,paper,5,174,0,5,9.25
5,7,pass,4,175,2,2,1.75
5,7,pink,4,176,1,3,2.25
5,7,pit,3,177,2,1,1.25
5,7,pitch,5,178,3,2,1.75
5,7,plate,5,179,1,4,8.5
5,7,pole,4,180,1,3,2.25
5,7,price,5,181,1,4,2.75
5,7,pride,5,182,3,2,2
5,7,pub,3,183,1,2,1.5
5,7,queen,5,184,0,5,9
5,7,quota,5,185,2,3,2.5
5,7,range,5,186,0,5,3.25
5,7,rapid,5,187,2,3,8.25
5,7,read,4,188,1,3,2.25
5,7,red,3,189,2,1,1
5,7,rice,4,190,1,3,2.25
5,7,rid,3,191,2,1,1
5,7,risk,4,192,2,2,1.75
5,7,route,5,193,1,4,8.75
5,7,rugby,5,194,1,4,3.25
5,7,sad,3,195,0,3,2.25
5,7,sadly,5,196,3,2,1.75
5,7,scale,5,197,1,4,8.75
5,7,scope,5,198,2,3,2.5
5,7,see,3,199,1,2,1.5
5,7,seize,5,200,2,3,2.5
5,7,self,4,201,2,2,1.75
5,7,send,4,202,2,2,7.5
5,7,set,3,203,2,1,0.75
5,7,shade,5,204,1,4,1.5
5,7,shock,5,205,2,3,1.25
5,7,short,5,206,3,2,1
5,7,shot,4,207,3,1,0.75
5,7,shrug,5,208,2,3,4.75
5,7,silly,5,209,1,4,1.25
5,7,sir,3,210,2,1,0.5
5,7,skill,5,211,1,4,1.25
5,7,slave,5,212,1,4,4.75
5,7,slot,4,213,2,2,1
5,7,slow,4,214,3,1,0.75
5,7,small,5,215,1,4,1.25
5,7,smart,5,216,3,2,1
5,7,smash,5,217,3,2,1
5,7,snap,4,218,1,3,4.5
5,7,soar,4,219,1,3,1
5,7,son,3,220,2,1,0.5
5,7,soon,4,221,2,2,0.75
5,7,sorry,5,222,2,3,1
5,7,sort,4,223,3,1,0.75
5,7,span,4,224,1,3,4.25
5,7,spill,5,225,2,3,1
5,7,spite,5,226,3,2,1
5,7,split,5,227,2,3,1
5,7,spoil,5,228,2,3,4.75
5,7,style,5,229,1,4,1.25
5,7,sum,3,230,1,2,0.75
5,7,sweet,5,231,1,4,1.25
5,7,swing,5,232,2,3,4.75
5,7,tax,3,233,0,3,1
5,7,teach,5,234,1,4,1.5
5,7,tent,4,235,2,2,1
5,7,theft,5,236,1,4,1.5
5,7,them,4,237,3,1,4.5
5,7,then,4,238,3,1,0.75
5,7,there,5,239,3,2,1
5,7,they,4,240,3,1,0.75
5,7,thief,5,241,2,3,1.25
5,7,think,5,242,3,2,1
5,7,third,5,243,3,2,1
5,7,toll,4,244,1,3,4.75
5,7,tone,4,245,2,2,1
5,7,touch,5,246,2,3,1
5,7,towel,5,247,2,3,1
5,7,trace,5,248,1,4,5
5,7,true,4,249,2,2,1
5,7,truly,5,250,3,2,1
5,7,truth,5,251,3,2,1
5,7,unit,4,252,0,4,1.25
5,7,up,2,253,1,1,0.5
5,7,upper,5,254,2,3,4.75
5,7,us,2,255,1,1,0.5
5,7,vast,4,256,0,4,1.25
5,7,vote,4,257,1,3,1
5,7,wage,4,258,0,4,5.25
5,7,ward,4,259,2,2,1
5,7,wash,4,260,2,2,1
5,7,we,2,261,1,1,0.5
5,7,weak,4,262,2,2,0.75
5,7,well,4,263,2,2,0.75
5,7,wet,3,264,2,1,0.5
5,7,what,4,265,1,3,5
5,7,when,4,266,2,2,1
5,7,whole,5,267,2,3,1.25
5,7,wide,4,268,1,3,1
5,7,worm,4,269,1,3,1
5,7,wound,5,270,2,3,4.75
5,7,wrong,5,271,1,4,1.5
5,7,yours,5,272,0,5,1.5
5,7,zero,4,273,0,4,4.75
5,7,zone,4,274,1,3,1.25
5,8,aged,4,0,0,4,1.25
5,8,agent,5,1,3,2,1
5,8,air,3,2,1,2,4.25
5,8,alert,5,3,1,4,1.25
5,8,allow,5,4,2,3,1
5,8,along,5,5,2,3,1.25
5,8,also,4,6,2,2,1
5,8,apple,5,7,1,4,5
5,8,april,5,8,2,3,1.25
5,8,arena,5,9,1,4,1.25
5,8,array,5,10,2,3,1.25
5,8,asset,5,11,1,4,4.75
5,8,aware,5,12,1,4,1.5
5,8,away,4,13,3,1,0.75
5,8,basis,5,14,0,5,5.5
5,8,beef,4,15,1,3,1
5,8,bend,4,16,2,2,0.75
5,8,bent,4,17,3,1,0.75
5,8,bet,3,18,2,1,0.5
5,8,big,3,19,1,2,0.75
5,8,blood,5,20,1,4,1.25
5,8,body,4,21,1,3,4.5
5,8,bread,5,22,1,4,1.25
5,8,brick,5,23,2,3,1.25
5,8,bring,5,24,3,2,1
5,8,broad,5,25,2,3,4.75
5,8,buck,4,26,1,3,1
5,8,bulk,4,27,2,2,0.75
5,8,burst,5,28,2,3,1.25
5,8,bury,4,29,3,1,0.75
5,8,bus,3,30,2,1,0.5
5,8,bye,3,31,1,2,4.5
5,8,calm,4,32,0,4,1.25
5,8,camp,4,33,2,2,1
5,8,case,4,34,2,2,1
5,8,catch,5,35,2,3,1
5,8,cent,4,36,1,3,4.5
5,8,chat,4,37,1,3,1
5,8,cheek,5,38,2,3,1.25
5,8,chest,5,39,3,2,1
5,8,civic,5,40,1,4,5.25
5,8,claim,5,41,1,4,1.5
5,8,class,5,42,3,2,1
5,8,climb,5,43,2,3,1.25
5,8,clip,4,44,3,1,0.75
5,8,clock,5,45,2,3,1.25
5,8,coast,5,46,1,4,5
5,8,coin,4,47,2,2,0.75
5,8,cook,4,48,2,2,0.75
5,8,cool,4,49,3,1,0.75
5,8,cop,3,50,2,1,0.5
5,8,cow,3,51,2,1,0.5
5,8,crazy,5,52,1,4,5
5,8,cream,5,53,2,3,1.25
5,8,crop,4,54,2,2,1
5,8,crown,5,55,3,2,1
5,8,cue,3,56,1,2,0.75
5,8,cure,4,57,2,2,1
5,8,dark,4,58,0,4,5.25
5,8,date,4,59,2,2,0.75
5,8,dear,4,60,1,3,1
5,8,dip,3,61,1,2,0.75
5,8,donor,5,62,1,4,5
5,8,door,4,63,2,2,1
5,8,dose,4,64,2,2,1
5,8,drag,4,65,1,3,1
5,8,drive,5,66,2,3,1.25
5,8,drown,5,67,2,3,4.75
5,8,drum,4,68,2,2,0.75
5,8,due,3,69,1,2,0.75
5,8,dull,4,70,2,2,1
5,8,dump,4,71,2,2,0.75
5,8,each,4,72,0,4,1
5,8,eat,3,73,2,1,4.25
5,8,echo,4,74,1,3,1
5,8,edge,4,75,1,3,1
5,8,embed,5,76,1,4,1.5
5,8,equip,5,77,1,4,5.25
5,8,era,3,78,1,2,0.75
5,8,exam,4,79,1,3,1
5,8,extra,5,80,2,3,1
5,8,fact,4,81,0,4,5
5,8,fame,4,82,2,2,1
5,8,fan,3,83,2,1,0.75
5,8,fence,5,84,1,4,1.25
5,8,film,4,85,1,3,1
5,8,final,5,86,2,3,5
5,8,fish,4,87,2,2,1
5,8,fit,3,88,2,1,0.5
5,8,flame,5,89,1,4,1.25
5,8,flaw,4,90,3,1,0.75
5,8,fleet,5,91,2,3,1
5,8,fold,4,92,1,3,4.5
5,8,forth,5,93,2,3,1
5,8,forum,5,94,3,2,1
5,8,fully,5,95,1,4,1.25
5,8,fun,3,96,2,1,0.5
5,8,funny,5,97,3,2,1
5,8,ghost,5,98,0,5,5
5,8,goal,4,99,1,3,1.25
5,8,grain,5,100,1,4,1.5
5,8,grass,5,101,3,2,5
5,8,great,5,102,2,3,1.25
5,8,halt,4,103,0,4,1.25
5,8,happy,5,104,2,3,1
5,8,he,2,105,1,1,0.5
5,8,hear,4,106,2,2,4.75
5,8,help,4,107,2,2,1
5,8,hero,4,108,2,2,1
5,8,hide,4,109,1,3,1
5,8,hobby,5,110,1,4,1.25
5,8,hold,4,111,2,2,4.5
5,8,holy,4,112,3,1,0.75
5,8,hope,4,113,2,2,0.75
5,8,house,5,114,2,3,1.25
5,8,hurry,5,115,1,4,1.25
5,8,in,2,116,0,2,0.75
5,8,jam,3,117,0,3,5.25
5,8,jeans,5,118,1,4,1.5
5,8,join,4,119,1,3,1.25
5,8,july,4,120,1,3,1.25
5,8,keen,4,121,0,4,5.5
5,8,kill,4,122,1,3,1
5,8,kiss,4,123,2,2,0.75
5,8,label,5,124,0,5,1.75
5,8,lamp,4,125,2,2,5
5,8,lane,4,126,2,2,1
5,8,lead,4,127,1,3,1
5,8,leap,4,128,3,1,0.75
5,8,learn,5,129,3,2,0.75
5,8,legal,5,130,2,3,1
5,8,less,4,131,2,2,5.25
5,8,light,5,132,1,4,1.5
5,8,limit,5,133,2,3,1.25
5,8,lobby,5,134,1,4,1.25
5,8,logic,5,135,2,3,5.5
5,8,lord,4,136,2,2,1
5,8,lose,4,137,2,2,1
5,8,loss,4,138,3,1,0.75
5,8,lower,5,139,2,3,1.5
5,8,luck,4,140,1,3,1.25
5,8,lung,4,141,2,2,5.25
5,8,major,5,142,0,5,1.5
5,8,mall,4,143,2,2,1
5,8,marry,5,144,2,3,1.25
5,8,mate,4,145,2,2,5.25
5,8,maths,5,146,3,2,1.25
5,8,mayor,5,147,2,3,1.25
5,8,means,5,148,1,4,1.25
5,8,meet,4,149,2,2,1
5,8,menu,4,150,2,2,5
5,8,metal,5,151,2,3,1
5,8,mile,4,152,1,3,1
5,8,milk,4,153,3,1,0.5
5,8,mill,4,154,3,1,0.5
5,8,minor,5,155,2,3,1.25
5,8,monk,4,156,1,3,4.75
5,8,moral,5,157,2,3,1.25
5,8,net,3,158,0,3,0.75
5,8,noble,5,159,1,4,1.5
5,8,noon,4,160,2,2,1
5,8,now,3,161,2,1,4.5
5,8,o,1,162,0,1,0.25
5,8,occur,5,163,1,4,1.25
5,8,offer,5,164,1,4,1.25
5,8,onion,5,165,1,4,5
5,8,open,4,166,1,3,1
5,8,out,3,167,1,2,0.75
5,8,oven,4,168,1,3,1
5,8,own,3,169,1,2,0.75
5,8,owner,5,170,3,2,0.75
5,8,pair,4,171,0,4,5.25
5,8,pan,3,172,2,1,0.5
5,8,paper,5,173,2,3,1
5,8,phase,5,174,1,4,1.25
5,8,pill,4,175,1,3,4.75
5,8,pit,3,176,2,1,0.5
5,8,plain,5,177,1,4,1.25
5,8,plug,4,178,2,2,1
5,8,pole,4,179,1,3,1
5,8,pool,4,180,2,2,1
5,8,pop,3,181,2,1,4.5
5,8,pose,4,182,2,2,0.75
5,8,price,5,183,1,4,1.25
5,8,pride,5,184,3,2,0.75
5,8,pub,3,185,1,2,0.75
5,8,punch,5,186,2,3,5.5
5,8,queen,5,187,0,5,1.5
5,8,quote,5,188,2,3,1
5,8,rain,4,189,0,4,1.25
5,8,rapid,5,190,2,3,5.25
5,8,rare,4,191,2,2,1
5,8,raw,3,192,2,1,0.5
5,8,red,3,193,1,2,0.75
5,8,rice,4,194,1,3,1
5,8,rid,3,195,2,1,0.75
5,8,riot,4,196,2,2,4.75
5,8,rule,4,197,1,3,1.25
5,8,run,3,198,2,1,0.5
5,8,sail,4,199,0,4,1.25
5,8,scale,5,200,1,4,1.25
5,8,sea,3,201,1,2,4.75
5,8,seize,5,202,2,3,1.25
5,8,shade,5,203,1,4,1.25
5,8,shake,5,204,3,2,1
5,8,shall,5,205,3,2,1
5,8,sheet,5,206,2,3,5.25
5,8,shine,5,207,2,3,1.25
5,8,shop,4,208,2,2,0.75
5,8,shot,4,209,3,1,0.75
5,8,show,4,210,3,1,1
5,8,sing,4,211,1,3,2
5,8,slave,5,212,1,4,9.75
5,8,slot,4,213,2,2,1.75
5,8,smash,5,214,1,4,2.75
5,8,snap,4,215,1,3,2.25
5,8,soak,4,216,1,3,8.5
5,8,soft,4,217,2,2,1.75
5,8,son,3,218,2,1,1
5,8,soon,4,219,2,2,1.75
5,8,sorry,5,220,2,3,2.25
5,8,span,4,221,1,3,2.25
5,8,spicy,5,222,2,3,8.5
5,8,spite,5,223,3,2,2
5,8,spoon,5,224,2,3,2.25
5,8,spot,4,225,3,1,1.25
5,8,stage,5,226,1,4,2.75
5,8,steel,5,227,2,3,8.5
5,8,surge,5,228,1,4,3
5,8,sweet,5,229,1,4,3
5,8,swing,5,230,2,3,2.5
5,8,t,1,231,0,1,7.5
5,8,tag,3,232,1,2,1.5
5,8,tax,3,233,2,1,1.25
5,8,tent,4,234,1,3,2
5,8,that,4,235,1,3,2
5,8,theft,5,236,2,3,2.25
5,8,their,5,237,3,2,8.5
5,8,them,4,238,3,1,1.25
5,8,thick,5,239,2,3,2.5
5,8,thin,4,240,3,1,1.25
5,8,thing,5,241,4,1,1.25
5,8,tired,5,242,1,4,2.75
5,8,trace,5,243,1,4,15.25
5,8,true,4,244,2,2,428.75
5,8,trust,5,245,3,2,2.5
5,8,truth,5,246,3,2,2.5
5,8,try,3,247,2,1,1.5
5,8,turn,4,248,1,3,2.75
5,8,twist,5,249,1,4,3.75
5,8,under,5,250,0,5,16.75
5,8,unit,4,251,2,2,4.25
5,8,up,2,252,1,1,2.25
5,8,us,2,253,1,1,2.25
5,8,use,3,254,2,1,2.5
5,8,used,4,255,3,1,3
5,8,very,4,256,0,4,14.75
5,8,wage,4,257,0,4,4
5,8,ward,4,258,2,2,2.75
5,8,warm,4,259,3,1,3
5,8,wear,4,260,1,3,3.5
5,8,web,3,261,2,1,1.5
5,8,well,4,262,2,2,10.25
5,8,where,5,263,1,4,3.5
5,8,who,3,264,2,1,1.25
5,8,wide,4,265,1,3,2.25
5,8,wise,4,266,2,2,1.75
5,8,worm,4,267,1,3,7
5,8,worse,5,268,3,2,2
5,8,worst,5,269,4,1,1.5
5,8,wound,5,270,2,3,2.5
5,8,wrong,5,271,1,4,2.75
5,8,year,4,272,0,4,7.75
5,8,yell,4,273,2,2,1.75
5,8,zone,4,274,0,4,2.75
5,9,able,4,0,0,4,7.5
5,9,act,3,1,1,2,1.5
5,9,agent,5,2,1,4,2.75
5,9,alien,5,3,1,4,2.75
5,9,allow,5,4,2,3,7.5
5,9,along,5,5,2,3,2.5
5,9,also,4,6,2,2,1.75
5,9,angry,5,7,1,4,2.75
5,9,apart,5,8,1,4,2.75
5,9,apply,5,9,2,3,7.5
5,9,arena,5,10,1,4,2.75
5,9,armed,5,11,2,3,2.5
5,9,array,5,12,2,3,2.25
5,9,avoid,5,13,1,4,8
5,9,away,4,14,1,3,2
5,9,bare,4,15,0,4,2.5
5,9,basis,5,16,2,3,8
5,9,bean,4,17,1,3,2.25
5,9,bee,3,18,2,1,1
5,9,bend,4,19,2,2,1.75
5,9,bent,4,20,3,1,1.25
5,9,bias,4,21,1,3,2
5,9,big,3,22,2,1,1
5,9,bleed,5,23,1,4,8.75
5,9,blood,5,24,2,3,2.25
5,9,brain,5,25,1,4,1.75
5,9,bring,5,26,2,3,1.25
5,9,brown,5,27,2,3,4.75
5,9,bulk,4,28,1,3,1
5,9,burst,5,29,2,3,1.25
5,9,bury,4,30,3,1,0.75
5,9,bye,3,31,1,2,0.75
5,9,cabin,5,32,0,5,5.25
5,9,case,4,33,2,2,0.75
5,9,cat,3,34,2,1,0.5
5,9,catch,5,35,3,2,0.75
5,9,cent,4,36,1,3,1
5,9,chaos,5,37,1,4,5
5,9,cheek,5,38,2,3,1.25
5,9,chef,4,39,3,1,0.75
5,9,civic,5,40,1,4,1.25
5,9,class,5,41,1,4,5
5,9,climb,5,42,2,3,1.25
5,9,clock,5,43,2,3,1.25
5,9,clue,4,44,2,2,1
5,9,coast,5,45,1,4,1.25
5,9,coin,4,46,2,2,4.5
5,9,comic,5,47,2,3,1.25
5,9,cook,4,48,2,2,0.75
5,9,cool,4,49,3,1,0.75
5,9,cop,3,50,2,1,0.5
5,9,cow,3,51,2,1,0.5
5,9,cream,5,52,1,4,1.25
5,9,crop,4,53,2,2,4.5
5,9,cue,3,54,1,2,0.75
5,9,cult,4,55,2,2,0.75
5,9,cure,4,56,2,2,0.75
5,9,dad,3,57,0,3,0.75
5,9,date,4,58,2,2,0.75
5,9,dear,4,59,1,3,4.25
5,9,defy,4,60,2,2,0.75
5,9,die,3,61,1,2,0.75
5,9,dog,3,62,1,2,0.5
5,9,dose,4,63,2,2,0.75
5,9,drain,5,64,1,4,4.5
5,9,draw,4,65,3,1,0.75
5,9,drive,5,66,2,3,1
5,9,drown,5,67,2,3,1
5,9,drug,4,68,2,2,0.75
5,9,drunk,5,69,3,2,1
5,9,dry,3,70,2,1,4
5,9,due,3,71,1,2,1
5,9,dump,4,72,2,2,0.75
5,9,duty,4,73,2,2,0.75
5,9,easy,4,74,0,4,1.25
5,9,eat,3,75,2,1,0.5
5,9,embed,5,76,1,4,4.5
5,9,empty,5,77,2,3,1.25
5,9,ensue,5,78,1,4,1.25
5,9,era,3,79,1,2,0.75
5,9,ethic,5,80,1,4,4.75
5,9,every,5,81,1,4,1.25
5,9,evil,4,82,2,2,0.75
5,9,exert,5,83,1,4,1.25
5,9,extra,5,84,2,3,4.5
5,9,fact,4,85,0,4,1.25
5,9,faith,5,86,2,3,1
5,9,feat,4,87,1,3,1
5,9,feed,4,88,2,2,4.25
5,9,feel,4,89,3,1,0.75
5,9,fence,5,90,2,3,1
5,9,fill,4,91,1,3,1
5,9,final,5,92,2,3,1
5,9,first,5,93,2,3,4.25
5,9,fish,4,94,2,2,0.75
5,9,fit,3,95,2,1,0.5
5,9,flaw,4,96,1,3,1
5,9,fleet,5,97,2,3,1
5,9,flood,5,98,2,3,1
5,9,fool,4,99,1,3,4.25
5,9,forge,5,100,2,3,1
5,9,forth,5,101,3,2,1
5,9,frame,5,102,1,4,1.25
5,9,fruit,5,103,2,3,4.5
5,9,fun,3,104,1,2,0.75
5,9,fund,4,105,3,1,0.5
5,9,funny,5,106,3,2,0.75
5,9,gang,4,107,0,4,1.25
5,9,gas,3,108,2,1,0.5
5,9,ghost,5,109,1,4,4.5
5,9,grain,5,110,1,4,1.25
5,9,grand,5,111,3,2,1
5,9,grant,5,112,4,1,0.75
5,9,great,5,113,2,3,1
5,9,guard,5,114,1,4,4.5
5,9,halt,4,115,0,4,1.25
5,9,hear,4,116,1,3,1
5,9,help,4,117,2,2,0.75
5,9,here,4,118,2,2,0.75
5,9,hero,4,119,3,1,4
5,9,hide,4,120,1,3,1
5,9,host,4,121,1,3,1
5,9,house,5,122,2,3,1.25
5,9,hurry,5,123,1,4,5.5
5,9,input,5,124,0,5,1.5
5,9,jam,3,125,0,3,1
5,9,jeans,5,126,1,4,1.25
5,9,joint,5,127,1,4,5.5
5,9,july,4,128,1,3,1.25
5,9,keen,4,129,0,4,1.25
5,9,kill,4,130,1,3,1
5,9,knock,5,131,1,4,4.75
5,9,label,5,132,0,5,1.5
5,9,lane,4,133,2,2,0.75
5,9,late,4,134,2,2,0.75
5,9,leap,4,135,1,3,4.25
5,9,learn,5,136,3,2,0.75
5,9,legal,5,137,2,3,1
5,9,less,4,138,2,2,0.75
5,9,limit,5,139,1,4,4.75
5,9,logic,5,140,1,4,1.25
5,9,loom,4,141,2,2,1
5,9,loop,4,142,3,1,0.75
5,9,loss,4,143,2,2,0.75
5,9,lung,4,144,1,3,1
5,9,major,5,145,0,5,4.75
5,9,man,3,146,2,1,0.75
5,9,marry,5,147,2,3,1
5,9,maths,5,148,2,3,1.25
5,9,maybe,5,149,2,3,4.25
5,9,me,2,150,1,1,0.5
5,9,meet,4,151,2,2,0.75
5,9,metal,5,152,2,3,1
5,9,mile,4,153,1,3,1
5,9,milk,4,154,3,1,0.5
5,9,mine,4,155,2,2,0.75
5,9,moral,5,156,1,4,4.5
5,9,mount,5,157,2,3,1.25
5,9,nail,4,158,0,4,1.25
5,9,naval,5,159,2,3,4.25
5,9,net,3,160,1,2,0.75
5,9,next,4,161,2,2,0.75
5,9,nod,3,162,1,2,0.75
5,9,noon,4,163,2,2,1
5,9,nose,4,164,2,2,1
5,9,nurse,5,165,1,4,4.75
5,9,obey,4,166,0,4,1.25
5,9,on,2,167,1,1,0.5
5,9,onion,5,168,2,3,1
5,9,onto,4,169,2,2,0.75
5,9,out,3,170,1,2,4
5,9,oven,4,171,1,3,1
5,9,over,4,172,3,1,0.5
5,9,owner,5,173,1,4,1.25
5,9,pair,4,174,0,4,1.25
5,9,party,5,175,2,3,7.75
5,9,phase,5,176,1,4,2.75
5,9,pill,4,177,1,3,2
5,9,pilot,5,178,3,2,1.75
5,9,pink,4,179,2,2,1.75
5,9,pitch,5,180,2,3,7.75
5,9,plate,5,181,1,4,2.75
5,9,poet,4,182,1,3,2.25
5,9,pole,4,183,2,2,1.75
5,9,pose,4,184,2,2,7.25
5,9,pray,4,185,1,3,2.25
5,9,prey,4,186,2,2,1.75
5,9,pride,5,187,2,3,2.25
5,9,punch,5,188,1,4,2.75
5,9,quota,5,189,0,5,8.5
5,9,quote,5,190,4,1,1
5,9,rare,4,191,0,4,2.5
5,9,red,3,192,1,2,1.5
5,9,rice,4,193,1,3,7.75
5,9,risk,4,194,2,2,2
5,9,role,4,195,1,3,2.25
5,9,route,5,196,2,3,2.25
5,9,royal,5,197,2,3,2.25
5,9,run,3,198,1,2,7.5
5,9,saint,5,199,0,5,3.25
5,9,scale,5,200,1,4,2.75
5,9,scope,5,201,2,3,2.5
5,9,sea,3,202,1,2,7
5,9,see,3,203,2,1,1
5,9,seize,5,204,2,3,2.25
5,9,shall,5,205,1,4,2.75
5,9,short,5,206,2,3,2.25
5,9,shout,5,207,3,2,7.5
5,9,shrug,5,208,2,3,2.25
5,9,sigh,4,209,1,3,2
5,9,sing,4,210,2,2,1.75
5,9,sixty,5,211,2,3,2.25
5,9,size,4,212,2,2,7.5
5,9,sky,3,213,1,2,1.5
5,9,sleep,5,214,1,4,2.75
5,9,slow,4,215,2,2,1.75
5,9,smart,5,216,1,4,2.75
5,9,snap,4,217,1,3,7.75
5,9,son,3,218,1,2,1.5
5,9,sort,4,219,2,2,1.75
5,9,span,4,220,1,3,2
5,9,spill,5,221,2,3,2.25
5,9,split,5,222,2,3,7.75
5,9,spoon,5,223,2,3,2.5
5,9,sport,5,224,3,2,1.75
5,9,spy,3,225,2,1,1
5,9,stark,5,226,1,4,2.75
5,9,steel,5,227,2,3,8
5,9,sum,3,228,1,2,1.5
5,9,surge,5,229,2,3,2.25
5,9,sweet,5,230,1,4,2.75
5,9,swing,5,231,2,3,8.25
5,9,tag,3,232,0,3,2
5,9,tell,4,233,1,3,2.25
5,9,text,4,234,2,2,1.75
5,9,than,4,235,1,3,2.25
5,9,that,4,236,3,1,1.25
5,9,them,4,237,2,2,7.5
5,9,thing,5,238,2,3,2.5
5,9,third,5,239,3,2,2
5,9,tiny,4,240,1,3,2
5,9,tired,5,241,2,3,2.25
5,9,tone,4,242,1,3,8
5,9,touch,5,243,2,3,2.5
5,9,toy,3,244,2,1,1
5,9,true,4,245,1,3,2.25
5,9,truly,5,246,3,2,1.75
5,9,twist,5,247,1,4,8.75
5,9,type,4,248,1,3,2.25
5,9,up,2,249,0,2,1.25
5,9,upper,5,250,2,3,2
5,9,upset,5,251,2,3,2
5,9,us,2,252,1,1,6.5
5,9,use,3,253,2,1,1
5,9,used,4,254,3,1,1
5,9,user,4,255,3,1,1
5,9,valid,5,256,0,5,3.25
5,9,vast,4,257,2,2,1.75
5,9,very,4,258,1,3,8.25
5,9,wage,4,259,0,4,3.5
5,9,wall,4,260,2,2,1.75
5,9,want,4,261,2,2,1.75
5,9,ward,4,262,2,2,1.75
5,9,warm,4,263,3,1,1.5
5,9,weak,4,264,1,3,7.75
5,9,wear,4,265,3,1,1.25
5,9,web,3,266,2,1,1
5,9,wet,3,267,2,1,1
5,9,wheat,5,268,1,4,2.75
5,9,while,5,269,2,3,2.25
5,9,wise,4,270,1,3,7.75
5,9,worm,4,271,1,3,2.25
5,9,year,4,272,0,4,2.5
5,9,yell,4,273,2,2,1.75
5,9,yours,5,274,1,4,12.5
6,0,able,4,0,0,4,3
6,0,about,5,1,2,3,2.5
6,0,abroad,6,2,2,4,8.75
6,0,accent,6,3,1,5,4
6,0,action,6,4,2,4,3.25
6,0,affair,6,5,1,5,10
6,0,afraid,6,6,2,4,3.5
6,0,aged,4,7,1,3,2.25
6,0,aid,3,8,1,2,1.5
6,0,alike,5,9,1,4,8.75
6,0,allege,6,10,2,4,3
6,0,allow,5,11,3,2,2
6,0,alone,5,12,2,3,2.25
6,0,amid,4,13,1,3,5
6,0,answer,6,14,1,5,6.25
6,0,anyone,6,15,2,4,3
6,0,apart,5,16,1,4,3
6,0,apple,5,17,2,3,9
6,0,apply,5,18,4,1,1.25
6,0,april,5,19,2,3,2.25
6,0,arena,5,20,1,4,2.75
6,0,armed,5,21,2,3,8.75
6,0,asset,5,22,1,4,2.75
6,0,author,6,23,1,5,3.25
6,0,autumn,6,24,3,3,2.5
6,0,back,4,25,0,4,9
6,0,bad,3,26,2,1,1.25
6,0,bake,4,27,2,2,1.75
6,0,ballot,6,28,2,4,3
6,0,banana,6,29,2,4,8.75
6,0,basis,5,30,2,3,2.25
6,0,bean,4,31,1,3,2.25
6,0,become,6,32,2,4,2.75
6,0,beef,4,33,2,2,1.5
6,0,behind,6,34,2,4,8.5
6,0,being,5,35,2,3,2.25
6,0,bend,4,36,2,2,1.5
6,0,bent,4,37,3,1,1
6,0,beside,6,38,2,4,2.75
6,0,bet,3,39,2,1,7
6,0,big,3,40,1,2,1.5
6,0,blend,5,41,1,4,2.75
6,0,blood,5,42,2,3,1.75
6,0,bold,4,43,1,3,1.25
6,0,brain,5,44,1,4,5
6,0,branch,6,45,3,3,1.25
6,0,bread,5,46,2,3,1
6,0,breast,6,47,4,2,1
6,0,bring,5,48,2,3,4.5
6,0,broad,5,49,2,3,1
6,0,brown,5,50,3,2,1
6,0,burial,6,51,1,5,1.5
6,0,bus,3,52,2,1,0.5
6,0,but,3,53,2,1,4
6,0,button,6,54,3,3,1.25
6,0,camp,4,55,0,4,1
6,0,carrot,6,56,2,4,1.25
6,0,case,4,57,2,2,0.75
6,0,castle,6,58,3,3,4.75
6,0,cent,4,59,1,3,1
6,0,centre,6,60,4,2,0.75
6,0,chaos,5,61,1,4,1.25
6,0,charge,6,62,3,3,4.75
6,0,chat,4,63,3,1,0.75
6,0,chef,4,64,2,2,0.75
6,0,chest,5,65,3,2,0.75
6,0,cinema,6,66,1,5,1.5
6,0,claim,5,67,1,4,5
6,0,climb,5,68,2,3,1
6,0,close,5,69,2,3,1
6,0,clue,4,70,2,2,0.75
6,0,coast,5,71,1,4,4.75
6,0,coin,4,72,2,2,0.75
6,0,colour,6,73,2,4,1.25
6,0,combat,6,74,2,4,1.25
6,0,commit,6,75,3,3,4.75
6,0,common,6,76,4,2,1.25
6,0,cop,3,77,2,1,0.5
6,0,cotton,6,78,2,4,1.25
6,0,cow,3,79,2,1,0.5
6,0,crash,5,80,1,4,1.25
6,0,cream,5,81,2,3,5
6,0,crop,4,82,2,2,0.75
6,0,custom,6,83,1,5,1.5
6,0,dad,3,84,0,3,1
6,0,dark,4,85,2,2,5
6,0,date,4,86,2,2,0.75
6,0,dead,4,87,1,3,1.5
6,0,dear,4,88,3,1,0.75
6,0,debris,6,89,2,4,1.75
6,0,debut,5,90,3,2,5.75
6,0,deck,4,91,2,2,1
6,0,defeat,6,92,2,4,2
6,0,defend,6,93,4,2,1
6,0,denial,6,94,2,4,1.5
6,0,depart,6,95,2,4,5.5
6,0,depend,6,96,3,3,1.25
6,0,depict,6,97,3,3,1.25
6,0,derive,6,98,2,4,1.5
6,0,detail,6,99,2,4,5.75
6,0,devise,6,100,2,4,2.25
6,0,diary,5,101,1,4,2.75
6,0,die,3,102,2,1,1
6,0,dose,4,103,1,3,5.75
6,0,dozen,5,104,2,3,1.25
6,0,drug,4,105,1,3,1.75
6,0,drum,4,106,3,1,1
6,0,drunk,5,107,3,2,1
6,0,dry,3,108,2,1,0.5
6,0,due,3,109,1,2,5
6,0,dull,4,110,2,2,1
6,0,during,6,111,2,4,1.75
6,0,early,5,112,0,5,1.5
6,0,east,4,113,2,2,4.75
6,0,eat,3,114,2,1,0.5
6,0,empire,6,115,1,5,1.5
6,0,employ,6,116,3,3,1.25
6,0,energy,6,117,1,5,5.25
6,0,enough,6,118,2,4,1.5
6,0,entire,6,119,2,4,1.5
6,0,equip,5,120,1,4,1.25
6,0,era,3,121,1,2,4.5
6,0,erupt,5,122,2,3,1.25
6,0,ethic,5,123,1,4,1.25
6,0,ethnic,6,124,3,3,1.25
6,0,every,5,125,1,4,5
6,0,evil,4,126,2,2,0.75
6,0,exam,4,127,1,3,1
6,0,exotic,6,128,2,4,1.25
6,0,expect,6,129,2,4,5
6,0,export,6,130,3,3,1.25
6,0,faith,5,131,0,5,1.5
6,0,fan,3,132,2,1,0.5
6,0,farm,4,133,2,2,0.75
6,0,favour,6,134,2,4,5.5
6,0,feat,4,135,1,3,1
6,0,feel,4,136,2,2,1
6,0,fill,4,137,1,3,1
6,0,final,5,138,2,3,5.25
6,0,find,4,139,3,1,0.75
6,0,finger,6,140,3,3,1.25
6,0,first,5,141,2,3,1
6,0,flaw,4,142,1,3,1
6,0,flawed,6,143,4,2,4.75
6,0,float,5,144,2,3,1
6,0,flour,5,145,3,2,1
6,0,fluid,5,146,2,3,1
6,0,fold,4,147,1,3,1
6,0,follow,6,148,3,3,5
6,0,forge,5,149,2,3,1
6,0,format,6,150,3,3,1
6,0,forum,5,151,3,2,1
6,0,frame,5,152,1,4,1.25
6,0,freeze,6,153,2,4,5.5
6,0,from,4,154,2,2,0.75
6,0,fruit,5,155,2,3,1
6,0,fun,3,156,1,2,0.75
6,0,gentle,6,157,0,6,5.75
6,0,golden,6,158,1,5,1.5
6,0,goods,5,159,2,3,1.25
6,0,grass,5,160,1,4,5.75
6,0,guard,5,161,1,4,1.25
6,0,hand,4,162,0,4,1.25
6,0,hardly,6,163,2,4,5.25
6,0,hatred,6,164,2,4,1.5
6,0,he,2,165,1,1,0.5
6,0,hear,4,166,2,2,0.75
6,0,hence,5,167,2,3,1
6,0,hero,4,168,2,2,0.75
6,0,hockey,6,169,1,5,5.25
6,0,hungry,6,170,1,5,1.75
6,0,impact,6,171,0,6,5.75
6,0,in,2,172,1,1,0.5
6,0,indoor,6,173,2,4,1.25
6,0,infect,6,174,2,4,1.25
6,0,insect,6,175,2,4,5.25
6,0,insult,6,176,3,3,1.25
6,0,jam,3,177,0,3,0.75
6,0,join,4,178,1,3,1
6,0,keen,4,179,0,4,5.25
6,0,kidnap,6,180,1,5,1.75
6,0,kind,4,181,2,2,0.75
6,0,kiss,4,182,2,2,0.75
6,0,label,5,183,0,5,5.25
6,0,labour,6,184,3,3,1
6,0,lady,4,185,2,2,0.75
6,0,lamp,4,186,2,2,0.75
6,0,lane,4,187,2,2,0.75
6,0,late,4,188,2,2,0.75
6,0,lately,6,189,4,2,4.75
6,0,lawyer,6,190,2,4,1.25
6,0,layout,6,191,2,4,1.25
6,0,lead,4,192,1,3,1
6,0,learn,5,193,3,2,5
6,0,legal,5,194,2,3,1
6,0,lend,4,195,2,2,0.75
6,0,less,4,196,2,2,0.75
6,0,lesson,6,197,4,2,0.75
6,0,limit,5,198,1,4,5.25
6,0,linger,6,199,2,4,1.5
6,0,loan,4,200,1,3,1
6,0,lobby,5,201,2,3,1.25
6,0,lock,4,202,2,2,0.75
6,0,logic,5,203,2,3,5
6,0,loom,4,204,2,2,0.75
6,0,loop,4,205,3,1,0.5
6,0,lord,4,206,2,2,0.75
6,0,loss,4,207,2,2,0.75
6,0,lower,5,208,2,3,1
6,0,mall,4,209,0,4,5
6,0,man,3,210,2,1,0.75
6,0,manner,6,211,3,3,1.5
6,0,march,5,212,2,3,1
6,0,marker,6,213,3,3,5.25
6,0,maths,5,214,2,3,1.25
6,0,maybe,5,215,2,3,1.25
6,0,mayor,5,216,3,2,0.75
6,0,me,2,217,1,1,0.5
6,0,metal,5,218,2,3,1
6,0,minute,6,219,1,5,5.25
6,0,mobile,6,220,1,5,1.5
6,0,mode,4,221,2,2,0.75
6,0,modern,6,222,4,2,0.75
6,0,monk,4,223,2,2,4.75
6,0,motor,5,224,2,3,1
6,0,mount,5,225,2,3,1
6,0,move,4,226,2,2,0.75
6,0,mutual,6,227,1,5,5.25
6,0,naval,5,228,0,5,1.5
6,0,nest,4,229,1,3,1
6,0,net,3,230,2,1,0.5
6,0,news,4,231,2,2,0.75
6,0,noble,5,232,1,4,5.5
6,0,number,6,233,1,5,1.5
6,0,nurse,5,234,2,3,1.25
6,0,object,6,235,0,6,6.25
6,0,obtain,6,236,2,4,1.5
6,0,of,2,237,1,1,0.5
6,0,on,2,238,1,1,0.5
6,0,onto,4,239,2,2,1
6,0,open,4,240,1,3,5.75
6,0,or,2,241,1,1,0.5
6,0,out,3,242,1,2,0.75
6,0,over,4,243,1,3,1
6,0,overly,6,244,4,2,1
6,0,own,3,245,1,2,0.75
6,0,owner,5,246,3,2,5.75
6,0,oxygen,6,247,1,5,1.75
6,0,packet,6,248,0,6,1.75
6,0,pair,4,249,2,2,5.25
6,0,palm,4,250,2,2,1
6,0,parent,6,251,2,4,1.25
6,0,parish,6,252,3,3,1.25
6,0,people,6,253,1,5,5.5
6,0,person,6,254,2,4,1.25
6,0,phase,5,255,1,4,1.25
6,0,pill,4,256,1,3,1
6,0,pink,4,257,2,2,5
6,0,pitch,5,258,2,3,1.25
6,0,plain,5,259,1,4,1.25
6,0,planet,6,260,3,3,1.25
6,0,plate,5,261,3,2,1
6,0,plug,4,262,2,2,4.75
6,0,plunge,6,263,3,3,1.25
6,0,pocket,6,264,1,5,1.5
6,0,pole,4,265,2,2,0.75
6,0,pool,4,266,2,2,1
6,0,pop,3,267,2,1,4.75
6,0,port,4,268,2,2,0.75
6,0,pose,4,269,2,2,0.75
6,0,preach,6,270,1,5,1.5
6,0,price,5,271,2,3,1
6,0,priest,6,272,3,3,5.25
6,0,prince,6,273,3,3,1.25
6,0,pub,3,274,1,2,0.75
6,0,punch,5,275,2,3,1
6,0,pursue,6,276,2,4,5.25
6,0,queue,5,277,0,5,1.5
6,0,racist,6,278,0,6,1.75
6,0,rain,4,279,2,2,5
6,0,range,5,280,2,3,1.25
6,0,rapid,5,281,2,3,1.25
6,0,raw,3,282,2,1,0.5
6,0,reader,6,283,1,5,1.5
6,0,really,6,284,3,3,5.5
6,0,recipe,6,285,2,4,1.25
6,0,rely,4,286,2,2,0.75
6,0,report,6,287,2,4,1.25
6,0,review,6,288,2,4,5.5
6,0,rice,4,289,1,3,1
6,0,rid,3,290,2,1,0.5
6,0,riot,4,291,2,2,1
6,0,risk,4,292,2,2,1
6,0,role,4,293,1,3,5
6,0,rule,4,294,1,3,1
6,0,runner,6,295,2,4,2.5
6,0,sadly,5,296,0,5,3.25
6,0,sail,4,297,2,2,8.5
6,0,salary,6,298,2,4,3
6,0,scale,5,299,1,4,2.75
6,0,scream,6,300,2,4,9.25
6,0,script,6,301,3,3,2.75
6,0,see,3,302,1,2,1.5
6,0,seize,5,303,2,3,2.25
6,0,self,4,304,2,2,1.5
6,0,serial,6,305,2,4,9.25
6,0,set,3,306,2,1,1
6,0,sex,3,307,2,1,1
6,0,shadow,6,308,1,5,3.25
6,0,sheet,5,309,2,3,2.25
6,0,shock,5,310,2,3,8.75
6,0,shop,4,311,3,1,1.25
6,0,shot,4,312,3,1,1.25
6,0,should,6,313,3,3,2.25
6,0,show,4,314,3,1,1
6,0,sing,4,315,1,3,2
6,0,sixty,5,316,2,3,2.25
6,0,size,4,317,2,2,8.25
6,0,slave,5,318,1,4,2.75
6,0,sleep,5,319,2,3,2.25
6,0,slot,4,320,2,2,1.75
6,0,smart,5,321,1,4,9.5
6,0,smash,5,322,3,2,2
6,0,snap,4,323,1,3,2.25
6,0,soccer,6,324,1,5,3.25
6,0,son,3,325,2,1,1
6,0,soon,4,326,2,2,8.75
6,0,sorry,5,327,2,3,2.5
6,0,span,4,328,1,3,2.25
6,0,spicy,5,329,2,3,2.5
6,0,spill,5,330,3,2,2
6,0,spoil,5,331,2,3,9.75
6,0,stage,5,332,1,4,2.75
6,0,status,6,333,3,3,2.5
6,0,steel,5,334,2,3,2.25
6,0,stress,6,335,2,4,9.75
6,0,stupid,6,336,2,4,3
6,0,suburb,6,337,1,5,3.5
6,0,suffer,6,338,2,4,9.75
6,0,sum,3,339,2,1,1
6,0,supply,6,340,2,4,2.75
6,0,surge,5,341,2,3,2.25
6,0,symbol,6,342,1,5,10.25
6,0,tag,3,343,0,3,2
6,0,tax,3,344,2,1,1
6,0,tell,4,345,1,3,2
6,0,tenure,6,346,2,4,3
6,0,than,4,347,1,3,8.5
6,0,theirs,6,348,2,4,3
6,0,then,4,349,3,1,1.25
6,0,there,5,350,3,2,1.75
6,0,thief,5,351,2,3,2.25
6,0,thin,4,352,3,1,7.5
6,0,think,5,353,4,1,1.5
6,0,though,6,354,2,4,3
6,0,tiny,4,355,1,3,2
6,0,ton,3,356,1,2,1.5
6,0,total,5,357,2,3,2.25
6,0,touch,5,358,2,3,9
6,0,toy,3,359,2,1,1
6,0,trace,5,360,1,4,2.75
6,0,true,4,361,2,2,1.75
6,0,truly,5,362,3,2,1.75
6,0,trust,5,363,3,2,8.5
6,0,truth,5,364,3,2,2
6,0,tunnel,6,365,1,5,3.25
6,0,twenty,6,366,1,5,3.25
6,0,under,5,367,0,5,9.75
6,0,unit,4,368,2,2,1.75
6,0,unless,6,369,2,4,2.75
6,0,unlike,6,370,3,3,5.75
6,0,up,2,371,1,1,4.5
6,0,upper,5,372,2,3,2.25
6,0,use,3,373,1,2,1.5
6,0,used,4,374,3,1,1
6,0,user,4,375,3,1,1
6,0,valid,5,376,0,5,3.25
6,0,vast,4,377,2,2,8.25
6,0,very,4,378,1,3,2.25
6,0,victim,6,379,1,5,3.25
6,0,volume,6,380,1,5,10.25
6,0,vote,4,381,2,2,1.75
6,0,wage,4,382,0,4,2.5
6,0,ward,4,383,2,2,1.75
6,0,we,2,384,1,1,0.75
6,0,wet,3,385,2,1,1
6,0,wheat,5,386,1,4,10
6,0,where,5,387,3,2,2
6,0,winter,6,388,1,5,3.5
6,0,wise,4,389,2,2,1.75
6,0,wish,4,390,3,1,1.25
6,0,worm,4,391,1,3,9
6,0,wound,5,392,2,3,2.5
6,0,writer,6,393,1,5,3.5
6,0,you,3,394,0,3,2
6,0,yours,5,395,3,2,8.75
6,0,zero,4,396,0,4,2.5
6,0,zone,4,397,1,3,2.25
6,1,about,5,0,0,5,13.25
6,1,abroad,6,1,2,4,3
6,1,access,6,2,1,5,3.25
6,1,adhere,6,3,1,5,10
6,1,affair,6,4,1,5,3.25
6,1,afraid,6,5,2,4,3
6,1,aged,4,6,1,3,8.75
6,1,agent,5,7,3,2,2
6,1,aid,3,8,1,2,1.5
6,1,air,3,9,2,1,1
6,1,alert,5,10,1,4,2.75
6,1,alike,5,11,2,3,8.75
6,1,allege,6,12,2,4,3
6,1,allow,5,13,3,2,1.75
6,1,alone,5,14,2,3,2.25
6,1,along,5,15,4,1,1.25
6,1,amid,4,16,1,3,12.75
6,1,anyone,6,17,1,5,47.5
6,1,apart,5,18,1,4,5.25
6,1,apply,5,19,2,3,3
6,1,april,5,20,2,3,3
6,1,arena,5,21,1,4,13
6,1,array,5,22,2,3,3
6,1,assess,6,23,1,5,4.25
6,1,asset,5,24,4,1,1.75
6,1,author,6,25,1,5,12
6,1,avoid,5,26,1,4,3.5
6,1,aware,5,27,1,4,3.25
6,1,away,4,28,3,1,1.5
6,1,bad,3,29,0,3,9.25
6,1,bare,4,30,2,2,2
6,1,basis,5,31,2,3,2.75
6,1,basket,6,32,3,3,3
6,1,bean,4,33,1,3,11.75
6,1,bear,4,34,3,1,1.75
6,1,become,6,35,2,4,3.75
6,1,bee,3,36,2,1,1.25
6,1,beef,4,37,3,1,1.25
6,1,before,6,38,2,4,3.5
6,1,bend,4,39,2,2,17
6,1,bet,3,40,2,1,2.5
6,1,bias,4,41,1,3,3.25
6,1,bleed,5,42,1,4,4
6,1,bounce,6,43,1,5,6.75
6,1,brain,5,44,1,4,18.5
6,1,branch,6,45,3,3,3
6,1,breast,6,46,2,4,3.5
6,1,breath,6,47,4,2,2.5
6,1,brick,5,48,2,3,6.75
6,1,broad,5,49,2,3,2.25
6,1,brown,5,50,3,2,1.75
6,1,bulk,4,51,1,3,2
6,1,burial,6,52,2,4,7.5
6,1,busy,4,53,2,2,1.5
6,1,button,6,54,2,4,2.75
6,1,bye,3,55,1,2,1.5
6,1,cabin,5,56,0,5,8.25
6,1,camp,4,57,2,2,1.75
6,1,carrot,6,58,2,4,3
6,1,case,4,59,2,2,1.75
6,1,castle,6,60,3,3,3
6,1,cat,3,61,2,1,1
6,1,catch,5,62,3,2,7.5
6,1,cattle,6,63,3,3,2.5
6,1,cause,5,64,2,3,2.25
6,1,cent,4,65,1,3,2.5
6,1,centre,6,66,4,2,2.5
6,1,chat,4,67,1,3,7.75
6,1,cheek,5,68,2,3,2.25
6,1,cinema,6,69,1,5,3.25
6,1,civic,5,70,2,3,8
6,1,claim,5,71,1,4,2.75
6,1,climb,5,72,2,3,2.25
6,1,clinic,6,73,3,3,2.75
6,1,clip,4,74,3,1,1.25
6,1,cloth,5,75,2,3,7.25
6,1,clue,4,76,2,2,1
6,1,coast,5,77,1,4,1.5
6,1,coin,4,78,2,2,1
6,1,combat,6,79,2,4,1.5
6,1,commit,6,80,3,3,4.5
6,1,cook,4,81,2,2,1
6,1,cop,3,82,2,1,0.5
6,1,cotton,6,83,2,4,1.25
6,1,crash,5,84,1,4,4.5
6,1,crazy,5,85,3,2,1
6,1,cue,3,86,1,2,0.75
6,1,cult,4,87,2,2,0.75
6,1,cure,4,88,2,2,0.75
6,1,custom,6,89,2,4,1.25
6,1,data,4,90,0,4,4.5
6,1,date,4,91,3,1,0.5
6,1,deadly,6,92,1,5,1.5
6,1,dear,4,93,3,1,0.75
6,1,debris,6,94,2,4,4.5
6,1,defeat,6,95,2,4,1.5
6,1,define,6,96,3,3,1.25
6,1,depart,6,97,2,4,1.5
6,1,depend,6,98,3,3,4.75
6,1,depict,6,99,3,3,1.25
6,1,desert,6,100,2,4,1.5
6,1,desire,6,101,3,3,1.25
6,1,detail,6,102,2,4,5.25
6,1,devise,6,103,2,4,1.5
6,1,diary,5,104,1,4,1.25
6,1,dog,3,105,1,2,0.75
6,1,donate,6,106,2,4,4.75
6,1,dose,4,107,2,2,1
6,1,drain,5,108,1,4,1.25
6,1,drug,4,109,2,2,0.75
6,1,dry,3,110,2,1,0.5
6,1,dull,4,111,1,3,4.5
6,1,dump,4,112,2,2,1
6,1,easily,6,113,0,6,1.75
6,1,easy,4,114,3,1,0.75
6,1,embed,5,115,1,4,4.75
6,1,emerge,6,116,2,4,1.5
6,1,enough,6,117,1,5,1.5
6,1,equip,5,118,1,4,5.5
6,1,error,5,119,1,4,114.25
6,1,ethnic,6,120,1,5,1.75
6,1,every,5,121,1,4,1.5
6,1,exam,4,122,1,3,1
6,1,except,6,123,2,4,5.5
6,1,excess,6,124,4,2,1.25
6,1,expect,6,125,2,4,1.75
6,1,factor,6,126,0,6,5
6,1,fan,3,127,2,1,0.5
6,1,farm,4,128,2,2,0.75
6,1,favour,6,129,2,4,1.25
6,1,fence,5,130,1,4,1.25
6,1,fifth,5,131,1,4,4
6,1,fill,4,132,2,2,0.75
6,1,find,4,133,2,2,0.75
6,1,finger,6,134,3,3,1.25
6,1,fire,4,135,2,2,0.75
6,1,fish,4,136,2,2,3.75
6,1,fit,3,137,2,1,0.5
6,1,flash,5,138,1,4,1.25
6,1,flawed,6,139,3,3,1
6,1,fleet,5,140,2,3,1
6,1,float,5,141,2,3,4
6,1,flour,5,142,3,2,1
6,1,fluid,5,143,2,3,1
6,1,fond,4,144,1,3,1
6,1,fool,4,145,2,2,0.75
6,1,forge,5,146,2,3,4
6,1,formal,6,147,3,3,1.25
6,1,format,6,148,5,1,0.75
6,1,forth,5,149,3,2,0.75
6,1,forum,5,150,3,2,0.75
6,1,freeze,6,151,1,5,4.5
6,1,fully,5,152,1,4,1.25
6,1,funny,5,153,2,3,1
6,1,gang,4,154,0,4,1.25
6,1,glad,4,155,1,3,3.75
6,1,goal,4,156,1,3,1
6,1,grain,5,157,1,4,1.25
6,1,grant,5,158,3,2,0.75
6,1,great,5,159,2,3,4
6,1,guard,5,160,1,4,1.25
6,1,hand,4,161,0,4,1
6,1,happy,5,162,2,3,1
6,1,hardly,6,163,2,4,4.25
6,1,hatred,6,164,2,4,1.25
6,1,helmet,6,165,1,5,1.5
6,1,hence,5,166,2,3,4
6,1,hobby,5,167,1,4,1.25
6,1,hockey,6,168,2,4,1.25
6,1,hold,4,169,2,2,0.75
6,1,hook,4,170,2,2,0.75
6,1,hope,4,171,2,2,3.75
6,1,host,4,172,2,2,0.75
6,1,house,5,173,2,3,1
6,1,hungry,6,174,1,5,1.5
6,1,if,2,175,0,2,3.75
6,1,impact,6,176,1,5,1.5
6,1,in,2,177,1,1,0.5
6,1,induce,6,178,2,4,1.25
6,1,infect,6,179,2,4,4.25
6,1,inmate,6,180,2,4,1.5
6,1,input,5,181,2,3,1
6,1,invoke,6,182,2,4,1.25
6,1,kiss,4,183,0,4,4.25
6,1,label,5,184,0,5,1.5
6,1,lamp,4,185,2,2,0.75
6,1,laptop,6,186,2,4,4.75
6,1,late,4,187,2,2,1
6,1,lawyer,6,188,2,4,1.5
6,1,lead,4,189,1,3,1
6,1,leap,4,190,3,1,0.5
6,1,learn,5,191,3,2,0.75
6,1,legacy,6,192,2,4,4.25
6,1,lend,4,193,2,2,0.75
6,1,length,6,194,3,3,1
6,1,level,5,195,2,3,1
6,1,linger,6,196,1,5,4.25
6,1,loan,4,197,1,3,1
6,1,lobby,5,198,2,3,1
6,1,lock,4,199,2,2,0.75
6,1,loss,4,200,2,2,0.75
6,1,lower,5,201,2,3,4.25
6,1,luck,4,202,1,3,1
6,1,major,5,203,0,5,1.25
6,1,mall,4,204,2,2,0.75
6,1,march,5,205,2,3,4.25
6,1,marry,5,206,3,2,1
6,1,maybe,5,207,2,3,1
6,1,mayor,5,208,3,2,0.75
6,1,me,2,209,1,1,0.25
6,1,means,5,210,2,3,4
6,1,meet,4,211,2,2,1
6,1,menu,4,212,2,2,0.75
6,1,metal,5,213,2,3,1
6,1,mile,4,214,1,3,1
6,1,mill,4,215,3,1,0.5
6,1,miner,5,216,2,3,4
6,1,minor,5,217,3,2,1
6,1,minute,6,218,3,3,1.25
6,1,mobile,6,219,1,5,1.5
6,1,modest,6,220,2,4,4.25
6,1,motive,6,221,2,4,1.25
6,1,mount,5,222,2,3,1
6,1,myself,6,223,1,5,4.75
6,1,nerve,5,224,0,5,1.5
6,1,news,4,225,2,2,0.75
6,1,noble,5,226,1,4,1.5
6,1,nod,3,227,2,1,0.75
6,1,nose,4,228,2,2,4.75
6,1,number,6,229,1,5,1.5
6,1,nurse,5,230,2,3,1.25
6,1,o,1,231,0,1,0.25
6,1,obtain,6,232,1,5,5
6,1,occur,5,233,1,4,1.25
6,1,offer,5,234,1,4,1.25
6,1,or,2,235,1,1,0.5
6,1,order,5,236,2,3,4
6,1,over,4,237,1,3,1
6,1,owner,5,238,1,4,1.25
6,1,packet,6,239,0,6,1.75
6,1,pair,4,240,2,2,4.25
6,1,parent,6,241,2,4,1.25
6,1,parish,6,242,3,3,1.25
6,1,party,5,243,3,2,0.75
6,1,period,6,244,1,5,4.75
6,1,phase,5,245,1,4,1.25
6,1,pill,4,246,1,3,1
6,1,plug,4,247,1,3,0.75
6,1,plunge,6,248,3,3,4.25
6,1,pocket,6,249,1,5,1.5
6,1,policy,6,250,2,4,1.5
6,1,pool,4,251,2,2,0.75
6,1,port,4,252,2,2,4
6,1,powder,6,253,2,4,1.25
6,1,pray,4,254,1,3,1
6,1,preach,6,255,2,4,1.25
6,1,prefer,6,256,3,3,4.5
6,1,pretty,6,257,3,3,1.25
6,1,prey,4,258,3,1,0.5
6,1,price,5,259,2,3,1
6,1,priest,6,260,3,3,1
6,1,prince,6,261,3,3,4.25
6,1,prison,6,262,3,3,1
6,1,pub,3,263,1,2,0.75
6,1,punch,5,264,2,3,1
6,1,purely,6,265,2,4,4.5
6,1,purple,6,266,3,3,1.25
6,1,pursue,6,267,3,3,1.25
6,1,queen,5,268,0,5,1.5
6,1,queue,5,269,3,2,4
6,1,quota,5,270,2,3,1
6,1,quote,5,271,4,1,0.5
6,1,racist,6,272,0,6,1.75
6,1,radio,5,273,2,3,4.25
6,1,rapid,5,274,2,3,1.25
6,1,rare,4,275,2,2,0.75
6,1,raw,3,276,2,1,0.5
6,1,real,4,277,1,3,1
6,1,really,6,278,4,2,0.75
6,1,result,6,279,2,4,4.75
6,1,review,6,280,2,4,1.5
6,1,rid,3,281,1,2,0.75
6,1,rugby,5,282,1,4,1.25
6,1,run,3,283,2,1,0.5
6,1,runner,6,284,3,3,4.5
6,1,sadly,5,285,0,5,1.25
6,1,sail,4,286,2,2,0.75
6,1,salary,6,287,2,4,4.75
6,1,say,3,288,2,1,0.5
6,1,scale,5,289,1,4,1.25
6,1,script,6,290,2,4,3
6,1,sea,3,291,1,2,1.5
6,1,seize,5,292,2,3,7.75
6,1,senior,6,293,2,4,3
6,1,serial,6,294,2,4,3
6,1,set,3,295,2,1,1
6,1,sex,3,296,2,1,1
6,1,shade,5,297,1,4,8.25
6,1,shake,5,298,3,2,1.75
6,1,should,6,299,2,4,2.75
6,1,shout,5,300,4,1,1.25
6,1,shrug,5,301,2,3,2.25
6,1,silent,6,302,1,5,9
6,1,sing,4,303,2,2,1.75
6,1,size,4,304,2,2,1.75
6,1,sky,3,305,1,2,1.5
6,1,slave,5,306,1,4,8
6,1,sleep,5,307,2,3,2.25
6,1,slogan,6,308,2,4,3
6,1,slot,4,309,3,1,1.25
6,1,small,5,310,1,4,3
6,1,snap,4,311,1,3,7.5
6,1,soak,4,312,1,3,2
6,1,soft,4,313,2,2,1.75
6,1,solely,6,314,2,4,2.75
6,1,soon,4,315,2,2,1.75
6,1,sorry,5,316,2,3,7.5
6,1,source,6,317,2,4,3
6,1,span,4,318,1,3,2
6,1,spite,5,319,2,3,2.25
6,1,split,5,320,2,3,7.75
6,1,spoil,5,321,2,3,2.25
6,1,spoon,5,322,3,2,1.75
6,1,sport,5,323,3,2,1.75
6,1,spot,4,324,3,1,1
6,1,status,6,325,1,5,8.5
6,1,steel,5,326,2,3,2.25
6,1,steep,5,327,4,1,1.25
6,1,stiff,5,328,2,3,2.25
6,1,stream,6,329,2,4,2.75
6,1,stress,6,330,4,2,8.25
6,1,suffer,6,331,1,5,3.25
6,1,summit,6,332,2,4,3
6,1,superb,6,333,2,4,9
6,1,surge,5,334,2,3,2.25
6,1,symbol,6,335,1,5,3.5
6,1,t,1,336,0,1,0.75
6,1,tag,3,337,1,2,1.5
6,1,tennis,6,338,1,5,9.25
6,1,tent,4,339,3,1,1.25
6,1,text,4,340,2,2,1.75
6,1,then,4,341,1,3,2
6,1,thin,4,342,2,2,1.75
6,1,think,5,343,4,1,7.25
6,1,though,6,344,2,4,3
6,1,threat,6,345,2,4,3
6,1,throat,6,346,3,3,2.5
6,1,timber,6,347,1,5,9
6,1,tired,5,348,2,3,2.5
6,1,tomato,6,349,1,5,3.5
6,1,ton,3,350,2,1,1.25
6,1,tone,4,351,3,1,1.25
6,1,tongue,6,352,3,3,8.75
6,1,total,5,353,2,3,2.25
6,1,touch,5,354,2,3,2.25
6,1,towel,5,355,2,3,2.25
6,1,toy,3,356,2,1,1
6,1,try,3,357,1,2,7
6,1,tunnel,6,358,1,5,3.25
6,1,turn,4,359,2,2,1.75
6,1,type,4,360,1,3,2
6,1,under,5,361,0,5,8.5
6,1,unit,4,362,2,2,1.75
6,1,unless,6,363,2,4,2.75
6,1,upper,5,364,1,4,2.75
6,1,upset,5,365,2,3,7.75
6,1,use,3,366,1,2,1.5
6,1,user,4,367,3,1,1
6,1,versus,6,368,0,6,3.75
6,1,very,4,369,3,1,1
6,1,victim,6,370,1,5,9
6,1,volume,6,371,1,5,3.25
6,1,vote,4,372,2,2,1.75
6,1,wall,4,373,0,4,7.75
6,1,want,4,374,2,2,1.75
6,1,ward,4,375,2,2,1.5
6,1,we,2,376,1,1,0.75
6,1,weak,4,377,2,2,1.75
6,1,wear,4,378,3,1,1
6,1,web,3,379,2,1,1
6,1,week,4,380,2,2,1.5
6,1,wet,3,381,2,1,6.25
6,1,what,4,382,1,3,2.25
6,1,wheat,5,383,2,3,2.25
6,1,when,4,384,3,1,1.25
6,1,whilst,6,385,2,4,3
6,1,who,3,386,2,1,1
6,1,whole,5,387,3,2,7.5
6,1,wholly,6,388,4,2,2
6,1,widely,6,389,1,5,3.25
6,1,wooden,6,390,1,5,8.75
6,1,worm,4,391,2,2,1.75
6,1,worse,5,392,3,2,2
6,1,wrong,5,393,1,4,2.75
6,1,year,4,394,0,4,2.5
6,1,yours,5,395,1,4,8.25
6,1,zero,4,396,0,4,2.75
6,1,zone,4,397,1,3,2.25
6,2,above,5,0,0,5,6.25
6,2,abroad,6,1,2,4,3
6,2,accent,6,2,1,5,9
6,2,adhere,6,3,1,5,3.5
6,2,adult,5,4,2,3,2.5
6,2,affair,6,5,1,5,9.75
6,2,afraid,6,6,2,4,3.25
6,2,agent,5,7,1,4,2.75
6,2,ah,2,8,1,1,0.75
6,2,alien,5,9,1,4,9.25
6,2,alike,5,10,3,2,2
6,2,allege,6,11,2,4,4.75
6,2,allow,5,12,3,2,2
6,2,amid,4,13,1,3,2.25
6,2,angel,5,14,1,4,8.75
6,2,apart,5,15,1,4,3
6,2,apply,5,16,2,3,2.25
6,2,array,5,17,1,4,8.25
6,2,assign,6,18,1,5,3.25
6,2,august,6,19,1,5,3.5
6,2,banana,6,20,0,6,9.5
6,2,bank,4,21,3,1,1
6,2,bare,4,22,2,2,1.75
6,2,basis,5,23,2,3,2.25
6,2,bean,4,24,1,3,2
6,2,bee,3,25,2,1,1
6,2,beef,4,26,3,1,6.75
6,2,behind,6,27,2,4,3
6,2,being,5,28,2,3,2.25
6,2,bent,4,29,2,2,1.5
6,2,beside,6,30,2,4,8.25
6,2,bet,3,31,2,1,1.25
6,2,big,3,32,1,2,1.75
6,2,bleed,5,33,1,4,3
6,2,blend,5,34,3,2,1.75
6,2,bond,4,35,1,3,2.25
6,2,boring,6,36,2,4,8.5
6,2,breast,6,37,1,5,3.25
6,2,breath,6,38,4,2,1.75
6,2,bring,5,39,2,3,8
6,2,bulk,4,40,1,3,2.25
6,2,burst,5,41,2,3,2.25
6,2,bus,3,42,2,1,1
6,2,but,3,43,2,1,1
6,2,bye,3,44,1,2,1.5
6,2,cabin,5,45,0,5,8.75
6,2,camp,4,46,2,2,1.75
6,2,case,4,47,2,2,1.75
6,2,cat,3,48,2,1,1
6,2,catch,5,49,3,2,2
6,2,cattle,6,50,3,3,2.25
6,2,cause,5,51,2,3,8.25
6,2,cent,4,52,1,3,2.25
6,2,chance,6,53,1,5,3.75
6,2,charge,6,54,3,3,2.5
6,2,chat,4,55,3,1,7.25
6,2,chef,4,56,2,2,1.75
6,2,chest,5,57,3,2,2
6,2,cinema,6,58,1,5,3.25
6,2,cling,5,59,1,4,8.5
6,2,clinic,6,60,4,2,2
6,2,close,5,61,2,3,2.25
6,2,cloth,5,62,3,2,2
6,2,coast,5,63,1,4,2.75
6,2,coin,4,64,2,2,1.75
6,2,colour,6,65,2,4,8.75
6,2,combat,6,66,2,4,2.75
6,2,cool,4,67,2,2,1.75
6,2,copy,4,68,2,2,1.75
6,2,cotton,6,69,2,4,9.75
6,2,cream,5,70,1,4,2.75
6,2,crop,4,71,2,2,1.75
6,2,cue,3,72,1,2,1.75
6,2,custom,6,73,2,4,9
6,2,dad,3,74,0,3,2
6,2,dancer,6,75,2,4,2.75
6,2,dark,4,76,2,2,1.75
6,2,deadly,6,77,1,5,9
6,2,debate,6,78,2,4,3
6,2,debris,6,79,3,3,2.5
6,2,debut,5,80,3,2,2
6,2,deck,4,81,2,2,1.75
6,2,defeat,6,82,2,4,8.75
6,2,defend,6,83,4,2,2
6,2,defy,4,84,3,1,1.25
6,2,depict,6,85,2,4,3
6,2,derive,6,86,2,4,8.75
6,2,desert,6,87,2,4,3
6,2,detail,6,88,2,4,3
6,2,devise,6,89,2,4,3
6,2,diary,5,90,1,4,8.75
6,2,die,3,91,2,1,1
6,2,differ,6,92,2,4,3
6,2,dip,3,93,2,1,1
6,2,divert,6,94,2,4,8.5
6,2,dog,3,95,1,2,1.5
6,2,dress,5,96,1,4,2.75
6,2,drive,5,97,2,3,3
6,2,driver,6,98,5,1,1.25
6,2,drown,5,99,2,3,8.5
6,2,drunk,5,100,2,3,2.5
6,2,due,3,101,1,2,1.5
6,2,each,4,102,0,4,2.5
6,2,easily,6,103,2,4,8.75
6,2,easy,4,104,3,1,1.25
6,2,eat,3,105,2,1,0.75
6,2,echo,4,106,1,3,1.5
6,2,else,4,107,1,3,1.25
6,2,embed,5,108,1,4,1.25
6,2,employ,6,109,2,4,5
6,2,empty,5,110,3,2,1
6,2,energy,6,111,1,5,1.5
6,2,enrol,5,112,2,3,1.25
6,2,ensue,5,113,2,3,4.75
6,2,entire,6,114,2,4,1.25
6,2,entity,6,115,4,2,1
6,2,error,5,116,1,4,1.25
6,2,erupt,5,117,2,3,4.75
6,2,ethic,5,118,1,4,1.25
6,2,ethnic,6,119,3,3,1
6,2,every,5,120,1,4,1.25
6,2,evil,4,121,2,2,4.5
6,2,exam,4,122,1,3,1
6,2,except,6,123,2,4,1.25
6,2,exert,5,124,2,3,1
6,2,expect,6,125,2,4,5
6,2,export,6,126,3,3,1.25
6,2,fact,4,127,0,4,1.25
6,2,faith,5,128,2,3,1
6,2,fame,4,129,2,2,4.5
6,2,fan,3,130,2,1,0.5
6,2,feat,4,131,1,3,1
6,2,feed,4,132,2,2,0.75
6,2,feel,4,133,3,1,0.5
6,2,fifth,5,134,1,4,1.25
6,2,figure,6,135,2,4,140
6,2,film,4,136,2,2,1.25
6,2,find,4,137,2,2,1.5
6,2,first,5,138,2,3,3.5
6,2,fit,3,139,2,1,1.25
6,2,five,4,140,2,2,2.25
6,2,flaw,4,141,1,3,7.25
6,2,fleet,5,142,2,3,2
6,2,fluid,5,143,2,3,3.25
6,2,fold,4,144,1,3,3
6,2,follow,6,145,3,3,3
6,2,fond,4,146,2,2,5.5
6,2,forest,6,147,2,4,1.75
6,2,forum,5,148,3,2,1.25
6,2,fossil,6,149,2,4,1.75
6,2,freely,6,150,1,5,4.75
6,2,fruit,5,151,2,3,1.25
6,2,fund,4,152,1,3,1
6,2,funny,5,153,3,2,0.75
6,2,garden,6,154,0,6,4.25
6,2,gentle,6,155,1,5,1.75
6,2,ghost,5,156,1,4,1.25
6,2,golden,6,157,1,5,4.5
6,2,goods,5,158,2,3,1.25
6,2,grain,5,159,1,4,1.25
6,2,grand,5,160,3,2,4.25
6,2,grass,5,161,3,2,1
6,2,great,5,162,2,3,1
6,2,guard,5,163,1,4,1.25
6,2,happy,5,164,0,5,4.5
6,2,he,2,165,1,1,0.5
6,2,hear,4,166,2,2,0.75
6,2,help,4,167,2,2,0.75
6,2,here,4,168,2,2,0.75
6,2,hero,4,169,3,1,0.5
6,2,hill,4,170,1,3,1
6,2,hockey,6,171,1,5,4.5
6,2,honour,6,172,2,4,1.5
6,2,hook,4,173,2,2,0.75
6,2,hope,4,174,2,2,0.75
6,2,house,5,175,2,3,4.25
6,2,hurry,5,176,1,4,1.25
6,2,ignore,6,177,0,6,1.75
6,2,impact,6,178,1,5,4.75
6,2,infect,6,179,1,5,1.5
6,2,inmate,6,180,2,4,1.25
6,2,insect,6,181,2,4,4.5
6,2,insult,6,182,3,3,1.25
6,2,jeans,5,183,0,5,1.5
6,2,join,4,184,1,3,1.25
6,2,joint,5,185,4,1,4
6,2,keen,4,186,0,4,1.25
6,2,kill,4,187,1,3,1
6,2,kiss,4,188,2,2,1
6,2,knock,5,189,1,4,4.5
6,2,label,5,190,0,5,1.5
6,2,labour,6,191,3,3,1.25
6,2,lady,4,192,2,2,0.75
6,2,lamp,4,193,2,2,0.75
6,2,late,4,194,2,2,3.75
6,2,layout,6,195,2,4,1.5
6,2,lead,4,196,1,3,1
6,2,leap,4,197,3,1,0.5
6,2,legacy,6,198,2,4,4.25
6,2,length,6,199,2,4,1.5
6,2,less,4,200,2,2,0.75
6,2,light,5,201,1,4,1.25
6,2,loan,4,202,1,3,1
6,2,lock,4,203,2,2,4.75
6,2,logic,5,204,2,3,1.25
6,2,loom,4,205,2,2,0.75
6,2,loop,4,206,3,1,0.5
6,2,lose,4,207,2,2,0.75
6,2,lovely,6,208,2,4,4.5
6,2,lung,4,209,1,3,1
6,2,mall,4,210,0,4,1.25
6,2,marry,5,211,2,3,1
6,2,mate,4,212,2,2,0.75
6,2,maths,5,213,3,2,4
6,2,matter,6,214,3,3,1.25
6,2,maybe,5,215,2,3,1
6,2,mayor,5,216,3,2,0.75
6,2,meet,4,217,1,3,1
6,2,mile,4,218,1,3,4
6,2,milk,4,219,3,1,0.5
6,2,mill,4,220,3,1,0.5
6,2,mining,6,221,2,4,1.25
6,2,minute,6,222,3,3,1.25
6,2,mode,4,223,1,3,4
6,2,modern,6,224,4,2,1
6,2,motive,6,225,2,4,1.5
6,2,motor,5,226,3,2,1
6,2,move,4,227,2,2,0.75
6,2,mutual,6,228,1,5,4.5
6,2,myself,6,229,1,5,1.5
6,2,naval,5,230,0,5,1.5
6,2,nest,4,231,1,3,4
6,2,net,3,232,2,1,0.5
6,2,news,4,233,2,2,0.75
6,2,ninety,6,234,1,5,1.5
6,2,noble,5,235,1,4,4.25
6,2,nod,3,236,2,1,0.5
6,2,now,3,237,2,1,0.5
6,2,obey,4,238,0,4,1.25
6,2,offer,5,239,1,4,1.25
6,2,on,2,240,1,1,0.5
6,2,onto,4,241,2,2,3.75
6,2,or,2,242,1,1,0.5
6,2,order,5,243,2,3,1
6,2,our,3,244,1,2,0.75
6,2,out,3,245,2,1,0.5
6,2,overly,6,246,1,5,1.5
6,2,owner,5,247,1,4,4.5
6,2,oxygen,6,248,1,5,1.5
6,2,packet,6,249,0,6,4.75
6,2,pair,4,250,2,2,0.75
6,2,pan,3,251,2,1,0.5
6,2,paper,5,252,2,3,1
6,2,parent,6,253,2,4,1.25
6,2,parish,6,254,3,3,4.25
6,2,party,5,255,3,2,1.25
6,2,pass,4,256,2,2,1
6,2,peak,4,257,1,3,1.25
6,2,people,6,258,2,4,2.75
6,2,phase,5,259,1,4,6.5
6,2,pill,4,260,1,3,1.75
6,2,pilot,5,261,3,2,1
6,2,pitch,5,262,2,3,1.5
6,2,plain,5,263,1,4,5.5
6,2,planet,6,264,3,3,1.5
6,2,plug,4,265,2,2,1
6,2,plunge,6,266,3,3,1.5
6,2,pocket,6,267,1,5,6
6,2,policy,6,268,2,4,1.75
6,2,port,4,269,2,2,0.75
6,2,pose,4,270,2,2,0.75
6,2,powder,6,271,2,4,1.25
6,2,pray,4,272,1,3,4.75
6,2,prey,4,273,2,2,0.75
6,2,pride,5,274,2,3,1
6,2,prince,6,275,3,3,1.25
6,2,prison,6,276,3,3,4.75
6,2,punch,5,277,1,4,1.25
6,2,queue,5,278,0,5,1.5
6,2,random,6,279,0,6,5.25
6,2,rapid,5,280,2,3,1.25
6,2,rare,4,281,2,2,1
6,2,read,4,282,1,3,1
6,2,reader,6,283,4,2,0.75
6,2,real,4,284,3,1,0.5
6,2,recipe,6,285,2,4,5.25
6,2,red,3,286,2,1,0.5
6,2,rental,6,287,2,4,1.25
6,2,resume,6,288,2,4,1.25
6,2,review,6,289,2,4,4.75
6,2,rice,4,290,1,3,1
6,2,rid,3,291,2,1,0.5
6,2,riot,4,292,2,2,0.75
6,2,rock,4,293,1,3,1
6,2,role,4,294,2,2,4
6,2,rugby,5,295,1,4,1.5
6,2,rule,4,296,2,2,1.75
6,2,sad,3,297,0,3,2
6,2,sadly,5,298,3,2,1.5
6,2,say,3,299,2,1,1
6,2,scale,5,300,1,4,8.5
6,2,scream,6,301,2,4,3.25
6,2,script,6,302,3,3,2.5
6,2,sea,3,303,1,2,1.5
6,2,send,4,304,2,2,7
6,2,serial,6,305,2,4,3
6,2,set,3,306,2,1,1
6,2,sex,3,307,2,1,1
6,2,shaped,6,308,1,5,3.25
6,2,shine,5,309,2,3,7.75
6,2,shop,4,310,2,2,1.75
6,2,should,6,311,3,3,2.5
6,2,shout,5,312,4,1,1.5
6,2,shrink,6,313,2,4,3
6,2,sigh,4,314,1,3,7.5
6,2,silent,6,315,2,4,3
6,2,size,4,316,2,2,1.75
6,2,skiing,6,317,1,5,3.5
6,2,skill,5,318,3,2,7.5
6,2,sky,3,319,2,1,1.25
6,2,slogan,6,320,1,5,3.5
6,2,snap,4,321,1,3,2.25
6,2,soccer,6,322,1,5,8.75
6,2,solely,6,323,2,4,3
6,2,son,3,324,2,1,1
6,2,sort,4,325,2,2,1.75
6,2,span,4,326,1,3,2
6,2,spicy,5,327,2,3,8
6,2,spoon,5,328,2,3,2.25
6,2,sport,5,329,3,2,2
6,2,spot,4,330,3,1,1.25
6,2,spy,3,331,2,1,1
6,2,stage,5,332,1,4,2.75
6,2,stark,5,333,3,2,7
6,2,status,6,334,3,3,2.75
6,2,stress,6,335,2,4,3
6,2,strive,6,336,3,3,2.5
6,2,suburb,6,337,1,5,9
6,2,suffer,6,338,2,4,3
6,2,sum,3,339,2,1,1
6,2,summer,6,340,3,3,2.25
6,2,superb,6,341,2,4,8.25
6,2,tax,3,342,0,3,2
6,2,teach,5,343,1,4,2.75
6,2,tent,4,344,2,2,1.75
6,2,text,4,345,2,2,4.25
6,2,theft,5,346,1,4,6
6,2,them,4,347,3,1,1.25
6,2,then,4,348,3,1,1.25
6,2,they,4,349,3,1,1.25
6,2,thick,5,350,2,3,2.5
6,2,thief,5,351,3,2,2
6,2,though,6,352,2,4,8.75
6,2,thrive,6,353,2,4,3
6,2,throat,6,354,3,3,2.5
6,2,throw,5,355,4,1,1.5
6,2,timber,6,356,1,5,9
6,2,tiny,4,357,2,2,1.75
6,2,toll,4,358,1,3,2.25
6,2,ton,3,359,2,1,1
6,2,tongue,6,360,3,3,2.5
6,2,total,5,361,2,3,7.5
6,2,touch,5,362,2,3,2.25
6,2,towel,5,363,2,3,2.5
6,2,true,4,364,1,3,2
6,2,truly,5,365,3,2,1.75
6,2,trust,5,366,3,2,7.25
6,2,truth,5,367,3,2,1.75
6,2,turn,4,368,1,3,2
6,2,twist,5,369,1,4,2.75
6,2,ugly,4,370,0,4,8.25
6,2,unfold,6,371,1,5,3.5
6,2,unless,6,372,2,4,3
6,2,unlike,6,373,3,3,2.5
6,2,us,2,374,1,1,6.25
6,2,used,4,375,2,2,1.75
6,2,user,4,376,3,1,1.25
6,2,versus,6,377,0,6,4
6,2,victim,6,378,1,5,9.25
6,2,wage,4,379,0,4,2.75
6,2,want,4,380,2,2,1.75
6,2,ward,4,381,2,2,1.75
6,2,warm,4,382,3,1,1.25
6,2,weekly,6,383,1,5,9
6,2,where,5,384,1,4,3
6,2,while,5,385,2,3,2.25
6,2,whilst,6,386,4,2,2
6,2,who,3,387,2,1,1
6,2,wholly,6,388,3,3,8
6,2,widely,6,389,1,5,3.5
6,2,winner,6,390,2,4,3
6,2,wise,4,391,2,2,1.75
6,2,wooden,6,392,1,5,8.75
6,2,worm,4,393,2,2,1.75
6,2,worse,5,394,3,2,2
6,2,wrong,5,395,1,4,2.75
6,2,yell,4,396,0,4,8.25
6,2,you,3,397,1,2,1.5
6,3,about,5,0,0,5,3.25
6,3,above,5,1,3,2,7.5
6,3,abroad,6,2,2,4,3
6,3,absent,6,3,2,4,2.75
6,3,accent,6,4,1,5,8.75
6,3,access,6,5,4,2,2
6,3,act,3,6,2,1,1
6,3,adhere,6,7,1,5,3.25
6,3,adult,5,8,2,3,2.5
6,3,affair,6,9,1,5,9.25
6,3,ah,2,10,1,1,1
6,3,aid,3,11,1,2,1.5
6,3,alien,5,12,1,4,2.75
6,3,alone,5,13,2,3,2.5
6,3,along,5,14,4,1,9.5
6,3,amid,4,15,1,3,2.25
6,3,angel,5,16,1,4,2.75
6,3,answer,6,17,2,4,3
6,3,apart,5,18,1,4,12
6,3,apple,5,19,2,3,5.75
6,3,apply,5,20,4,1,1.75
6,3,april,5,21,2,3,2.5
6,3,assess,6,22,1,5,9.75
6,3,attach,6,23,1,5,3.75
6,3,attack,6,24,5,1,1.25
6,3,author,6,25,1,5,3.5
6,3,autumn,6,26,3,3,8.5
6,3,avoid,5,27,1,4,2.75
6,3,bad,3,28,0,3,2
6,3,bake,4,29,2,2,1.5
6,3,banana,6,30,2,4,8.75
6,3,bank,4,31,3,1,1.25
6,3,bare,4,32,2,2,1.5
6,3,basket,6,33,2,4,2.75
6,3,bear,4,34,1,3,2
6,3,beef,4,35,2,2,1.75
6,3,being,5,36,2,3,7.75
6,3,bend,4,37,2,2,1.5
6,3,bet,3,38,2,1,1
6,3,bias,4,39,1,3,2
6,3,blast,5,40,1,4,2.75
6,3,body,4,41,1,3,8
6,3,bold,4,42,2,2,1.75
6,3,bonus,5,43,2,3,2.5
6,3,brain,5,44,1,4,3
6,3,breast,6,45,2,4,8.75
6,3,buck,4,46,1,3,2
6,3,bulk,4,47,2,2,1.75
6,3,burst,5,48,2,3,2.25
6,3,bury,4,49,3,1,1.25
6,3,bus,3,50,2,1,1
6,3,but,3,51,2,1,6.5
6,3,cabin,5,52,0,5,3.75
6,3,case,4,53,2,2,2.25
6,3,castle,6,54,3,3,2.75
6,3,catch,5,55,2,3,5.5
6,3,cattle,6,56,3,3,5.75
6,3,cent,4,57,1,3,2.25
6,3,chance,6,58,1,5,3.25
6,3,chat,4,59,3,1,1.25
6,3,chef,4,60,2,2,7.5
6,3,claim,5,61,1,4,2.75
6,3,climb,5,62,2,3,2.25
6,3,clinic,6,63,3,3,2.5
6,3,clip,4,64,3,1,1.25
6,3,clock,5,65,2,3,8.25
6,3,close,5,66,3,2,2
6,3,clue,4,67,2,2,1.75
6,3,comic,5,68,1,4,3
6,3,commit,6,69,3,3,2.5
6,3,cook,4,70,2,2,8.5
6,3,cool,4,71,3,1,1.25
6,3,cop,3,72,2,1,1
6,3,copy,4,73,3,1,1
6,3,cotton,6,74,2,4,2.75
6,3,crash,5,75,1,4,2.75
6,3,crazy,5,76,3,2,8
6,3,cream,5,77,2,3,2.25
6,3,crown,5,78,2,3,2.25
6,3,cue,3,79,1,2,1.5
6,3,custom,6,80,2,4,2.75
6,3,dark,4,81,0,4,8
6,3,data,4,82,2,2,1.75
6,3,deadly,6,83,1,5,3.5
6,3,dear,4,84,3,1,1.25
6,3,deck,4,85,2,2,7.5
6,3,defeat,6,86,2,4,3
6,3,defend,6,87,4,2,2
6,3,define,6,88,3,3,2.5
6,3,defy,4,89,3,1,1.25
6,3,depend,6,90,2,4,9
6,3,depict,6,91,3,3,2.5
6,3,desert,6,92,2,4,3
6,3,devise,6,93,2,4,3
6,3,diary,5,94,1,4,8.5
6,3,dip,3,95,2,1,1
6,3,divert,6,96,2,4,3
6,3,donor,5,97,1,4,2.75
6,3,door,4,98,2,2,7.5
6,3,dress,5,99,1,4,2.75
6,3,drown,5,100,2,3,2.25
6,3,drug,4,101,2,2,1.75
6,3,drum,4,102,3,1,1.25
6,3,drunk,5,103,3,2,2
6,3,dry,3,104,2,1,8
6,3,due,3,105,1,2,1.5
6,3,dump,4,106,2,2,2
6,3,during,6,107,2,4,3.25
6,3,early,5,108,0,5,10.5
6,3,easily,6,109,2,4,3
6,3,east,4,110,3,1,1.5
6,3,employ,6,111,1,5,4.5
6,3,empty,5,112,3,2,2
6,3,enrol,5,113,1,4,10.75
6,3,entire,6,114,2,4,3
6,3,equal,5,115,1,4,2.75
6,3,equip,5,116,3,2,2
6,3,era,3,117,1,2,8
6,3,error,5,118,2,3,2.25
6,3,erupt,5,119,2,3,2.5
6,3,ethnic,6,120,1,5,3.25
6,3,evil,4,121,1,3,8
6,3,exam,4,122,1,3,2.25
6,3,exert,5,123,2,3,2.5
6,3,expect,6,124,2,4,3
6,3,fact,4,125,0,4,8.75
6,3,faith,5,126,2,3,2.25
6,3,fame,4,127,2,2,1.75
6,3,fan,3,128,2,1,1
6,3,farm,4,129,2,2,1.5
6,3,feed,4,130,1,3,7.75
6,3,fence,5,131,2,3,2.5
6,3,fifth,5,132,1,4,2.75
6,3,figure,6,133,2,4,3
6,3,film,4,134,2,2,8
6,3,final,5,135,2,3,2.25
6,3,finish,6,136,3,3,2.5
6,3,fire,4,137,2,2,1.5
6,3,first,5,138,3,2,1.75
6,3,five,4,139,2,2,1.75
6,3,flash,5,140,1,4,8.75
6,3,fleet,5,141,2,3,2.25
6,3,float,5,142,2,3,2.25
6,3,flour,5,143,3,2,2
6,3,fluid,5,144,2,3,8.5
6,3,fold,4,145,1,3,2.25
6,3,follow,6,146,3,3,2.5
6,3,fool,4,147,2,2,1.75
6,3,formal,6,148,2,4,3
6,3,format,6,149,5,1,7.75
6,3,forth,5,150,3,2,2
6,3,fossil,6,151,2,4,2.75
6,3,frame,5,152,1,4,2.75
6,3,freely,6,153,2,4,9
6,3,freeze,6,154,4,2,2
6,3,from,4,155,2,2,1.5
6,3,fruit,5,156,2,3,2.25
6,3,fully,5,157,1,4,2.75
6,3,fun,3,158,2,1,7
6,3,gang,4,159,0,4,2.5
6,3,garden,6,160,2,4,3
6,3,gentle,6,161,1,5,3.25
6,3,glad,4,162,1,3,8
6,3,goods,5,163,1,4,2.75
6,3,grant,5,164,1,4,2.75
6,3,great,5,165,2,3,8
6,3,half,4,166,0,4,2.5
6,3,hand,4,167,2,2,1.75
6,3,happy,5,168,2,3,2.25
6,3,hear,4,169,1,3,2.25
6,3,hello,5,170,2,3,8.25
6,3,helmet,6,171,3,3,2.5
6,3,help,4,172,3,1,1.25
6,3,here,4,173,2,2,1.75
6,3,hero,4,174,3,1,1.25
6,3,hidden,6,175,1,5,9
6,3,hide,4,176,3,1,1
6,3,holy,4,177,1,3,2
6,3,hook,4,178,2,2,1.75
6,3,host,4,179,2,2,1.5
6,3,house,5,180,2,3,2.25
6,3,ignore,6,181,0,6,10
6,3,impact,6,182,1,5,2.25
6,3,in,2,183,1,1,0.5
6,3,indeed,6,184,2,4,5
6,3,infect,6,185,2,4,1.5
6,3,inmate,6,186,2,4,1.5
6,3,input,5,187,2,3,1
6,3,insect,6,188,2,4,5
6,3,insult,6,189,3,3,1.25
6,3,invent,6,190,2,4,1.5
6,3,invoke,6,191,3,3,1.25
6,3,jam,3,192,0,3,4.5
6,3,jeans,5,193,1,4,1.25
6,3,joint,5,194,1,4,1.25
6,3,keen,4,195,0,4,4.75
6,3,kiss,4,196,1,3,1
6,3,knock,5,197,1,4,1.25
6,3,labour,6,198,0,6,7.25
6,3,ladder,6,199,2,4,187.75
6,3,lamp,4,200,2,2,1.75
6,3,laptop,6,201,2,4,2.25
6,3,late,4,202,2,2,1.25
6,3,lately,6,203,4,2,1.25
6,3,leap,4,204,1,3,6.75
6,3,legal,5,205,2,3,1.75
6,3,light,5,206,1,4,3.25
6,3,linger,6,207,2,4,2.5
6,3,lively,6,208,2,4,15
6,3,loan,4,209,1,3,5
6,3,lovely,6,210,2,4,3.75
6,3,lower,5,211,2,3,3.25
6,3,major,5,212,0,5,11
6,3,marker,6,213,2,4,3
6,3,matter,6,214,2,4,3
6,3,maybe,5,215,2,3,6.75
6,3,mayor,5,216,3,2,2
6,3,meet,4,217,1,3,2
6,3,mile,4,218,1,3,2
6,3,milk,4,219,3,1,1
6,3,mill,4,220,3,1,1
6,3,miner,5,221,2,3,7.25
6,3,mining,6,222,3,3,2.75
6,3,minor,5,223,3,2,2
6,3,modern,6,224,1,5,3.25
6,3,modest,6,225,4,2,7.75
6,3,monk,4,226,2,2,1.75
6,3,motive,6,227,2,4,2.75
6,3,mount,5,228,2,3,2.25
6,3,native,6,229,0,6,8.75
6,3,naval,5,230,2,3,2.5
6,3,nerve,5,231,1,4,2.75
6,3,net,3,232,2,1,1
6,3,news,4,233,2,2,1.75
6,3,next,4,234,2,2,6.5
6,3,ninety,6,235,1,5,3.25
6,3,nod,3,236,1,2,1.5
6,3,o,1,237,0,1,0.75
6,3,object,6,238,1,5,8.5
6,3,offer,5,239,1,4,3
6,3,onto,4,240,1,3,2
6,3,open,4,241,1,3,2
6,3,or,2,242,1,1,0.75
6,3,oral,4,243,2,2,6.75
6,3,oven,4,244,1,3,2.25
6,3,over,4,245,3,1,1
6,3,overly,6,246,4,2,1.75
6,3,own,3,247,1,2,1.5
6,3,packet,6,248,0,6,8.75
6,3,palm,4,249,2,2,1.75
6,3,pan,3,250,2,1,1
6,3,paper,5,251,2,3,2
6,3,parish,6,252,2,4,2.75
6,3,party,5,253,3,2,7.5
6,3,pass,4,254,2,2,1.5
6,3,people,6,255,1,5,3.5
6,3,period,6,256,2,4,3
6,3,phase,5,257,1,4,9.5
6,3,pill,4,258,1,3,2.25
6,3,pitch,5,259,2,3,2.25
6,3,planet,6,260,1,5,3.25
6,3,player,6,261,3,3,8.5
6,3,pocket,6,262,1,5,3.25
6,3,policy,6,263,2,4,3.25
6,3,pool,4,264,2,2,7.75
6,3,preach,6,265,1,5,4.25
6,3,pride,5,266,2,3,2.5
6,3,priest,6,267,3,3,2.5
6,3,prince,6,268,3,3,8
6,3,punch,5,269,1,4,2.75
6,3,purely,6,270,2,4,3
6,3,pursue,6,271,3,3,2.5
6,3,queue,5,272,0,5,8.75
6,3,quote,5,273,2,3,2.25
6,3,radio,5,274,0,5,3.25
6,3,rain,4,275,2,2,7
6,3,random,6,276,2,4,3
6,3,raw,3,277,2,1,1
6,3,read,4,278,1,3,2
6,3,reader,6,279,4,2,1.75
6,3,recipe,6,280,2,4,8
6,3,refuge,6,281,2,4,3
6,3,regret,6,282,2,4,2.75
6,3,rely,4,283,2,2,1.5
6,3,result,6,284,2,4,8.75
6,3,resume,6,285,4,2,2.25
6,3,rhythm,6,286,1,5,3.5
6,3,rice,4,287,1,3,2.25
6,3,rumour,6,288,1,5,8.5
6,3,sadly,5,289,0,5,3.25
6,3,saint,5,290,2,3,2.25
6,3,say,3,291,2,1,1
6,3,scale,5,292,1,4,7.75
6,3,script,6,293,2,4,3
6,3,seize,5,294,1,4,2.75
6,3,self,4,295,2,2,1.75
6,3,send,4,296,2,2,6.75
6,3,sex,3,297,2,1,1
6,3,shade,5,298,1,4,2.75
6,3,shadow,6,299,4,2,1.75
6,3,shaped,6,300,3,3,2.25
6,3,shop,4,301,2,2,7
6,3,show,4,302,3,1,1.25
6,3,sigh,4,303,1,3,2.25
6,3,silent,6,304,2,4,3
6,3,size,4,305,2,2,1.75
6,3,skiing,6,306,1,5,8.75
6,3,sky,3,307,2,1,1.25
6,3,slogan,6,308,1,5,3.25
6,3,slow,4,309,3,1,1.25
6,3,small,5,310,1,4,2.75
6,3,snap,4,311,1,3,7.5
6,3,soar,4,312,1,3,2.25
6,3,solely,6,313,2,4,3
6,3,son,3,314,2,1,1
6,3,soon,4,315,2,2,1.75
6,3,sorry,5,316,2,3,7.5
6,3,sort,4,317,3,1,1.25
6,3,spicy,5,318,1,4,2.75
6,3,spill,5,319,3,2,1.75
6,3,spite,5,320,3,2,1.75
6,3,spoil,5,321,2,3,7.75
6,3,spot,4,322,3,1,1.25
6,3,stage,5,323,1,4,2.75
6,3,stark,5,324,3,2,1.75
6,3,status,6,325,3,3,2.25
6,3,steel,5,326,2,3,7.25
6,3,steep,5,327,4,1,1.25
6,3,stream,6,328,2,4,2.75
6,3,stress,6,329,4,2,2
6,3,strive,6,330,3,3,2.25
6,3,style,5,331,2,3,7.25
6,3,suburb,6,332,1,5,3.5
6,3,suffer,6,333,2,4,3
6,3,summit,6,334,2,4,8.25
6,3,supply,6,335,2,4,3
6,3,swing,5,336,1,4,2.75
6,3,symbol,6,337,1,5,3.25
6,3,t,1,338,0,1,6
6,3,tag,3,339,1,2,1.5
6,3,tax,3,340,2,1,1
6,3,teach,5,341,1,4,2.75
6,3,tennis,6,342,2,4,3
6,3,tent,4,343,3,1,1.25
6,3,tenure,6,344,3,3,7.75
6,3,text,4,345,2,2,1.75
6,3,that,4,346,1,3,2
6,3,theft,5,347,2,3,2.25
6,3,their,5,348,3,2,1.75
6,3,then,4,349,3,1,4.25
6,3,there,5,350,3,2,1
6,3,thick,5,351,2,3,1
6,3,thief,5,352,3,2,0.75
6,3,threat,6,353,2,4,1.25
6,3,throat,6,354,3,3,4.5
6,3,tiny,4,355,1,3,1
6,3,tired,5,356,2,3,1
6,3,toll,4,357,1,3,1
6,3,tomato,6,358,2,4,4.5
6,3,tone,4,359,2,2,0.75
6,3,touch,5,360,2,3,1
6,3,toy,3,361,2,1,0.5
6,3,trace,5,362,1,4,1.25
6,3,true,4,363,2,2,0.75
6,3,truly,5,364,3,2,4.25
6,3,trust,5,365,3,2,1
6,3,truth,5,366,3,2,0.75
6,3,try,3,367,2,1,0.5
6,3,twenty,6,368,1,5,1.5
6,3,unfold,6,369,0,6,5.5
6,3,unless,6,370,2,4,1.5
6,3,up,2,371,1,1,0.5
6,3,upper,5,372,2,3,1
6,3,upset,5,373,2,3,4.5
6,3,us,2,374,1,1,0.25
6,3,use,3,375,2,1,0.5
6,3,valid,5,376,0,5,1.25
6,3,vast,4,377,2,2,0.75
6,3,victim,6,378,1,5,5
6,3,volume,6,379,1,5,1.5
6,3,vote,4,380,2,2,0.75
6,3,wage,4,381,0,4,4.25
6,3,want,4,382,2,2,0.75
6,3,warm,4,383,2,2,0.75
6,3,weak,4,384,1,3,0.75
6,3,wear,4,385,3,1,0.5
6,3,web,3,386,2,1,0.5
6,3,what,4,387,1,3,1
6,3,wheat,5,388,2,3,4.5
6,3,when,4,389,3,1,0.75
6,3,where,5,390,3,2,0.75
6,3,who,3,391,2,1,0.5
6,3,wide,4,392,1,3,1
6,3,worse,5,393,1,4,4.25
6,3,worst,5,394,4,1,0.75
6,3,writer,6,395,1,5,1.5
6,3,yours,5,396,0,5,1.5
6,3,zone,4,397,0,4,4.5
6,4,about,5,0,0,5,1.5
6,4,abroad,6,1,2,4,1.25
6,4,absent,6,2,2,4,4.5
6,4,accent,6,3,1,5,1.5
6,4,access,6,4,4,2,1
6,4,adhere,6,5,1,5,4.75
6,4,afford,6,6,1,5,1.5
6,4,agent,5,7,1,4,1.25
6,4,aid,3,8,1,2,0.75
6,4,air,3,9,2,1,4
6,4,alert,5,10,1,4,1.25
6,4,alien,5,11,2,3,1
6,4,along,5,12,2,3,1
6,4,amid,4,13,1,3,4.25
6,4,angel,5,14,1,4,1.25
6,4,answer,6,15,2,4,1.25
6,4,anyone,6,16,2,4,1.25
6,4,apple,5,17,1,4,4.75
6,4,apply,5,18,4,1,0.5
6,4,april,5,19,2,3,1
6,4,arena,5,20,1,4,1.25
6,4,armed,5,21,2,3,4.5
6,4,asset,5,22,1,4,1.25
6,4,assign,6,23,3,3,1
6,4,attack,6,24,1,5,1.5
6,4,august,6,25,1,5,5
6,4,author,6,26,2,4,1.25
6,4,away,4,27,1,3,1
6,4,back,4,28,0,4,4.75
6,4,ballot,6,29,2,4,1.25
6,4,banana,6,30,2,4,1.25
6,4,bear,4,31,1,3,1
6,4,bee,3,32,2,1,4
6,4,beef,4,33,3,1,0.75
6,4,being,5,34,2,3,1.25
6,4,bend,4,35,2,2,0.75
6,4,beside,6,36,2,4,1.25
6,4,blend,5,37,1,4,4.75
6,4,bold,4,38,1,3,1
6,4,bond,4,39,2,2,0.75
6,4,bounce,6,40,2,4,1.25
6,4,breast,6,41,1,5,4.75
6,4,brick,5,42,2,3,1
6,4,bring,5,43,3,2,1
6,4,broad,5,44,2,3,1
6,4,busy,4,45,1,3,1
6,4,bye,3,46,1,2,4
6,4,calm,4,47,0,4,1.25
6,4,case,4,48,2,2,0.75
6,4,cat,3,49,2,1,0.5
6,4,catch,5,50,3,2,0.75
6,4,cent,4,51,1,3,4.25
6,4,centre,6,52,4,2,1.25
6,4,chaos,5,53,1,4,1.25
6,4,chef,4,54,2,2,0.75
6,4,cinema,6,55,1,5,5
6,4,civic,5,56,2,3,1.25
6,4,claim,5,57,1,4,1.25
6,4,climb,5,58,2,3,1
6,4,clinic,6,59,3,3,1.25
6,4,clip,4,60,3,1,4
6,4,close,5,61,2,3,1
6,4,cloth,5,62,3,2,0.75
6,4,coin,4,63,1,3,1
6,4,colour,6,64,2,4,1.25
6,4,combat,6,65,2,4,4.75
6,4,cook,4,66,2,2,0.75
6,4,cop,3,67,2,1,0.5
6,4,copy,4,68,3,1,0.5
6,4,cotton,6,69,2,4,1.25
6,4,cow,3,70,2,1,0.25
6,4,crash,5,71,1,4,4.5
6,4,crazy,5,72,3,2,0.75
6,4,cream,5,73,2,3,1
6,4,crown,5,74,2,3,1
6,4,cue,3,75,1,2,4.25
6,4,cure,4,76,2,2,1
6,4,custom,6,77,2,4,1.25
6,4,dad,3,78,0,3,0.75
6,4,dancer,6,79,2,4,1.25
6,4,dark,4,80,2,2,4.25
6,4,data,4,81,2,2,0.75
6,4,debate,6,82,1,5,1.5
6,4,debris,6,83,3,3,1.25
6,4,defend,6,84,2,4,5
6,4,depict,6,85,2,4,1.25
6,4,derive,6,86,2,4,1.25
6,4,desire,6,87,2,4,5
6,4,devise,6,88,2,4,1.25
6,4,diary,5,89,1,4,1.25
6,4,dip,3,90,2,1,0.5
6,4,divert,6,91,2,4,4.75
6,4,door,4,92,1,3,1
6,4,dozen,5,93,2,3,1
6,4,drag,4,94,1,3,1
6,4,driver,6,95,2,4,4.75
6,4,drown,5,96,2,3,1.25
6,4,drug,4,97,2,2,0.75
6,4,drunk,5,98,3,2,0.75
6,4,dry,3,99,2,1,0.5
6,4,during,6,100,1,5,5
6,4,duty,4,101,2,2,0.75
6,4,early,5,102,0,5,1.5
6,4,easily,6,103,2,4,1.5
6,4,east,4,104,3,1,0.75
6,4,echo,4,105,1,3,4.75
6,4,employ,6,106,1,5,1.5
6,4,ensue,5,107,1,4,1.25
6,4,era,3,108,1,2,0.75
6,4,erupt,5,109,2,3,4.75
6,4,escape,6,110,1,5,1.5
6,4,ethnic,6,111,1,5,1.5
6,4,every,5,112,1,4,4.75
6,4,exam,4,113,1,3,1
6,4,except,6,114,2,4,1.25
6,4,excess,6,115,4,2,1
6,4,exotic,6,116,2,4,5
6,4,expect,6,117,2,4,1.25
6,4,factor,6,118,0,6,1.75
6,4,favour,6,119,2,4,5.25
6,4,feat,4,120,1,3,1
6,4,feed,4,121,2,2,1
6,4,feel,4,122,3,1,0.75
6,4,fence,5,123,2,3,1.25
6,4,fifth,5,124,1,4,5.25
6,4,film,4,125,2,2,1
6,4,filter,6,126,3,3,1.25
6,4,finger,6,127,2,4,1.25
6,4,finish,6,128,3,3,4.75
6,4,fire,4,129,2,2,0.75
6,4,first,5,130,3,2,1
6,4,fish,4,131,2,2,0.75
6,4,fit,3,132,2,1,0.5
6,4,five,4,133,2,2,0.75
6,4,flame,5,134,1,4,5.5
6,4,flash,5,135,3,2,1
6,4,float,5,136,2,3,1
6,4,fluid,5,137,2,3,1
6,4,fold,4,138,1,3,1
6,4,follow,6,139,3,3,4.75
6,4,fond,4,140,2,2,0.75
6,4,fool,4,141,2,2,0.75
6,4,forest,6,142,2,4,1.25
6,4,forge,5,143,3,2,1
6,4,fork,4,144,3,1,0.75
6,4,forum,5,145,3,2,4.75
6,4,from,4,146,1,3,1
6,4,fun,3,147,1,2,0.75
6,4,funny,5,148,3,2,0.75
6,4,gang,4,149,0,4,1.25
6,4,garden,6,150,2,4,5
6,4,gas,3,151,2,1,0.5
6,4,glad,4,152,1,3,1
6,4,goods,5,153,1,4,1.25
6,4,grain,5,154,1,4,5
6,4,grand,5,155,3,2,1
6,4,grass,5,156,3,2,1
6,4,great,5,157,2,3,1
6,4,guard,5,158,1,4,5
6,4,half,4,159,0,4,1.25
6,4,halt,4,160,3,1,0.5
6,4,hear,4,161,1,3,1
6,4,helmet,6,162,2,4,1.25
6,4,hence,5,163,2,3,4.75
6,4,hobby,5,164,1,4,1.25
6,4,host,4,165,2,2,0.75
6,4,hungry,6,166,1,5,1.5
6,4,if,2,167,0,2,4.25
6,4,ignore,6,168,1,5,1.5
6,4,impact,6,169,1,5,1.5
6,4,indeed,6,170,1,5,5
6,4,indoor,6,171,3,3,1.25
6,4,induce,6,172,3,3,1.25
6,4,insect,6,173,2,4,1.25
6,4,invoke,6,174,2,4,5.25
6,4,jam,3,175,0,3,0.75
6,4,joint,5,176,1,4,1.25
6,4,july,4,177,1,3,4.75
6,4,kidnap,6,178,0,6,1.75
6,4,kind,4,179,2,2,0.75
6,4,kiss,4,180,2,2,0.75
6,4,lady,4,181,0,4,5
6,4,lamp,4,182,2,2,0.75
6,4,lane,4,183,2,2,0.75
6,4,lately,6,184,2,4,1.25
6,4,lawyer,6,185,2,4,1.25
6,4,layout,6,186,2,4,5
6,4,learn,5,187,1,4,1.25
6,4,leave,5,188,3,2,1
6,4,legacy,6,189,2,4,5.25
6,4,lend,4,190,2,2,0.75
6,4,length,6,191,3,3,1.25
6,4,limit,5,192,1,4,1.25
6,4,linger,6,193,2,4,1.25
6,4,lock,4,194,1,3,4.75
6,4,logic,5,195,2,3,1
6,4,loom,4,196,2,2,0.75
6,4,loop,4,197,3,1,0.5
6,4,lose,4,198,2,2,0.75
6,4,lovely,6,199,2,4,5
6,4,luck,4,200,1,3,1
6,4,lung,4,201,2,2,0.75
6,4,major,5,202,0,5,1.5
6,4,mall,4,203,2,2,4.5
6,4,manner,6,204,2,4,1.25
6,4,march,5,205,2,3,1
6,4,marker,6,206,3,3,1
6,4,marry,5,207,3,2,0.75
6,4,me,2,208,1,1,4
6,4,means,5,209,2,3,1
6,4,metal,5,210,2,3,1
6,4,milk,4,211,1,3,1
6,4,mine,4,212,2,2,0.75
6,4,mode,4,213,1,3,4.5
6,4,monk,4,214,2,2,1
6,4,motive,6,215,2,4,1.5
6,4,motor,5,216,3,2,1
6,4,mount,5,217,2,3,1
6,4,mutual,6,218,1,5,5.25
6,4,myself,6,219,1,5,1.5
6,4,nail,4,220,0,4,1
6,4,native,6,221,2,4,8.25
6,4,naval,5,222,2,3,2.25
6,4,news,4,223,1,3,2
6,4,noble,5,224,1,4,2.75
6,4,noon,4,225,2,2,7.75
6,4,now,3,226,2,1,1
6,4,nurse,5,227,1,4,2.75
6,4,o,1,228,0,1,0.75
6,4,obey,4,229,1,3,2
6,4,obtain,6,230,2,4,9.75
6,4,of,2,231,1,1,1
6,4,offer,5,232,2,3,2.25
6,4,on,2,233,1,1,0.75
6,4,onto,4,234,2,2,1.5
6,4,or,2,235,1,1,0.75
6,4,oral,4,236,2,2,1.5
6,4,order,5,237,2,3,8.25
6,4,our,3,238,1,2,1.5
6,4,out,3,239,2,1,1
6,4,oven,4,240,1,3,2
6,4,over,4,241,3,1,1
6,4,overly,6,242,4,2,1.75
6,4,own,3,243,1,2,1.5
6,4,pan,3,244,0,3,8
6,4,paper,5,245,2,3,2.25
6,4,parent,6,246,2,4,2.75
6,4,parish,6,247,3,3,2.5
6,4,partly,6,248,3,3,8.75
6,4,party,5,249,4,1,1.5
6,4,peak,4,250,1,3,2
6,4,person,6,251,2,4,3
6,4,pill,4,252,1,3,2
6,4,pilot,5,253,3,2,8.25
6,4,pink,4,254,2,2,1.75
6,4,pitch,5,255,2,3,2.5
6,4,player,6,256,1,5,3.5
6,4,plug,4,257,2,2,8.25
6,4,pocket,6,258,1,5,3.75
6,4,poetry,6,259,2,4,3.25
6,4,pop,3,260,2,1,1.25
6,4,port,4,261,2,2,1.75
6,4,pose,4,262,2,2,8.5
6,4,powder,6,263,2,4,3
6,4,pray,4,264,1,3,2.25
6,4,preach,6,265,2,4,3
6,4,pretty,6,266,3,3,9
6,4,pride,5,267,2,3,2.25
6,4,priest,6,268,3,3,2.5
6,4,prince,6,269,3,3,2.5
6,4,prison,6,270,3,3,8.5
6,4,pub,3,271,1,2,1.5
6,4,purely,6,272,2,4,3
6,4,pursue,6,273,3,3,2.75
6,4,queue,5,274,0,5,9.75
6,4,quota,5,275,2,3,2.5
6,4,quote,5,276,4,1,1.25
6,4,radio,5,277,0,5,3.25
6,4,random,6,278,2,4,9.75
6,4,range,5,279,3,2,1.75
6,4,rapid,5,280,2,3,2.25
6,4,read,4,281,1,3,2
6,4,recipe,6,282,2,4,2.75
6,4,refuge,6,283,2,4,9
6,4,regret,6,284,2,4,2.75
6,4,rely,4,285,2,2,1.5
6,4,remote,6,286,2,4,9
6,4,report,6,287,2,4,3
6,4,result,6,288,2,4,2.75
6,4,rhythm,6,289,1,5,3.25
6,4,rid,3,290,1,2,7.75
6,4,riot,4,291,2,2,1.75
6,4,role,4,292,1,3,2
6,4,rugby,5,293,1,4,2.75
6,4,rumour,6,294,2,4,9.25
6,4,runner,6,295,2,4,3
6,4,sadly,5,296,0,5,3.25
6,4,saint,5,297,2,3,9.25
6,4,scream,6,298,1,5,3.5
6,4,script,6,299,3,3,3
6,4,sea,3,300,1,2,1.5
6,4,see,3,301,2,1,1
6,4,seize,5,302,2,3,8.25
6,4,seldom,6,303,2,4,3
6,4,self,4,304,3,1,1.25
6,4,shade,5,305,1,4,2.75
6,4,shadow,6,306,4,2,1.75
6,4,shake,5,307,3,2,8.25
6,4,shine,5,308,2,3,2.25
6,4,shop,4,309,2,2,1.5
6,4,short,5,310,3,2,1.75
6,4,shot,4,311,3,1,1
6,4,shout,5,312,3,2,1.5
6,4,show,4,313,3,1,1.25
6,4,shrug,5,314,2,3,8.5
6,4,silent,6,315,1,5,3.25
6,4,silly,5,316,3,2,1.75
6,4,skiing,6,317,1,5,9.5
6,4,skill,5,318,3,2,2
6,4,sky,3,319,2,1,1
6,4,sleep,5,320,1,4,2.75
6,4,slot,4,321,2,2,1.75
6,4,slow,4,322,3,1,1.25
6,4,small,5,323,1,4,8.75
6,4,smash,5,324,3,2,2
6,4,soccer,6,325,1,5,3.5
6,4,sorry,5,326,2,3,2.5
6,4,spite,5,327,1,4,9.5
6,4,spot,4,328,2,2,1.75
6,4,status,6,329,1,5,3.25
6,4,strive,6,330,2,4,3
6,4,style,5,331,2,3,8.5
6,4,sum,3,332,1,2,1.5
6,4,summer,6,333,3,3,2.25
6,4,summit,6,334,4,2,1.75
6,4,supply,6,335,2,4,3
6,4,surge,5,336,2,3,8.5
6,4,sweet,5,337,1,4,2.75
6,4,tax,3,338,0,3,2
6,4,tennis,6,339,1,5,9.5
6,4,tent,4,340,3,1,1.25
6,4,tenure,6,341,3,3,2.5
6,4,text,4,342,2,2,1.75
6,4,that,4,343,1,3,2
6,4,their,5,344,2,3,8.75
6,4,then,4,345,3,1,1.25
6,4,there,5,346,3,2,2
6,4,thief,5,347,2,3,2.25
6,4,though,6,348,2,4,3
6,4,throw,5,349,2,3,8.75
6,4,tiny,4,350,1,3,2.25
6,4,tired,5,351,2,3,2.5
6,4,toll,4,352,1,3,2
6,4,tomato,6,353,2,4,3
6,4,ton,3,354,2,1,7.5
6,4,tone,4,355,3,1,1.25
6,4,tongue,6,356,3,3,2.25
6,4,total,5,357,2,3,2.25
6,4,towel,5,358,2,3,2.25
6,4,toy,3,359,2,1,1
6,4,trace,5,360,1,4,9
6,4,truly,5,361,2,3,2.25
6,4,trust,5,362,3,2,2
6,4,truth,5,363,3,2,2
6,4,tunnel,6,364,1,5,9.5
6,4,turn,4,365,2,2,1.75
6,4,twenty,6,366,1,5,3.5
6,4,twist,5,367,2,3,2.25
6,4,ugly,4,368,0,4,9
6,4,under,5,369,1,4,2.75
6,4,unit,4,370,2,2,1.75
6,4,unlike,6,371,2,4,3
6,4,up,2,372,1,1,0.75
6,4,use,3,373,1,2,8
6,4,used,4,374,3,1,1
6,4,valid,5,375,0,5,3.25
6,4,vast,4,376,2,2,1.75
6,4,victim,6,377,1,5,10.25
6,4,wage,4,378,0,4,2.75
6,4,wall,4,379,2,2,1.75
6,4,want,4,380,2,2,1.75
6,4,warm,4,381,2,2,1.75
6,4,week,4,382,1,3,8.5
6,4,when,4,383,1,3,2
6,4,whilst,6,384,2,4,3
6,4,who,3,385,2,1,1
6,4,whole,5,386,3,2,1.75
6,4,wholly,6,387,4,2,8.5
6,4,widely,6,388,1,5,3.25
6,4,winner,6,389,2,4,3
6,4,winter,6,390,3,3,2.75
6,4,wish,4,391,2,2,8.25
6,4,worm,4,392,1,3,2.25
6,4,worse,5,393,3,2,2
6,4,wound,5,394,2,3,2.5
6,4,year,4,395,0,4,2.5
6,4,zero,4,396,0,4,9
6,4,zone,4,397,1,3,2.25
6,5,able,4,0,0,4,2.5
6,5,about,5,1,2,3,8.5
6,5,above,5,2,3,2,2
6,5,abroad,6,3,2,4,3
6,5,absent,6,4,2,4,2.75
6,5,accent,6,5,1,5,10.25
6,5,adult,5,6,1,4,2.75
6,5,afford,6,7,1,5,3.25
6,5,afraid,6,8,2,4,9.5
6,5,air,3,9,1,2,1.5
6,5,alert,5,10,1,4,2.75
6,5,allow,5,11,2,3,2.25
6,5,along,5,12,2,3,8.75
6,5,also,4,13,2,2,1.75
6,5,amid,4,14,1,3,2
6,5,angel,5,15,1,4,2.75
6,5,angry,5,16,3,2,1.75
6,5,answer,6,17,2,4,9.5
6,5,anyone,6,18,2,4,3
6,5,april,5,19,1,4,2.75
6,5,armed,5,20,1,4,9.5
6,5,attack,6,21,1,5,3.25
6,5,attend,6,22,3,3,2.5
6,5,author,6,23,1,5,10.75
6,5,autumn,6,24,3,3,2.75
6,5,aware,5,25,1,4,2.75
6,5,back,4,26,0,4,2.75
6,5,ballot,6,27,2,4,6.5
6,5,basis,5,28,2,3,1
6,5,bean,4,29,1,3,1
6,5,bear,4,30,3,1,0.5
6,5,become,6,31,2,4,5.25
6,5,bee,3,32,2,1,0.5
6,5,behind,6,33,2,4,1.25
6,5,being,5,34,2,3,1
6,5,bend,4,35,2,2,0.75
6,5,bent,4,36,3,1,0.5
6,5,blast,5,37,1,4,47.75
6,5,blend,5,38,2,3,1.75
6,5,bold,4,39,1,3,1.5
6,5,bonus,5,40,2,3,2.25
6,5,born,4,41,2,2,2
6,5,bounce,6,42,2,4,8.25
6,5,bread,5,43,1,4,1.75
6,5,breast,6,44,4,2,1
6,5,bring,5,45,2,3,1.5
6,5,broad,5,46,2,3,6
6,5,brown,5,47,3,2,1.25
6,5,bulk,4,48,1,3,1.25
6,5,burial,6,49,2,4,1.75
6,5,bus,3,50,2,1,0.75
6,5,busy,4,51,3,1,0.75
6,5,cabin,5,52,0,5,5.75
6,5,calm,4,53,2,2,1
6,5,case,4,54,2,2,1
6,5,castle,6,55,3,3,1.75
6,5,cat,3,56,2,1,0.75
6,5,cattle,6,57,3,3,5
6,5,cent,4,58,1,3,1.25
6,5,chance,6,59,1,5,1.75
6,5,chat,4,60,3,1,0.75
6,5,cheek,5,61,2,3,1.25
6,5,chef,4,62,3,1,9
6,5,cinema,6,63,1,5,2.5
6,5,civic,5,64,2,3,1.5
6,5,claim,5,65,1,4,1.75
6,5,class,5,66,3,2,11.5
6,5,cling,5,67,2,3,3.5
6,5,clinic,6,68,4,2,3
6,5,close,5,69,2,3,1.75
6,5,clue,4,70,2,2,1
6,5,coast,5,71,1,4,5.25
6,5,coin,4,72,2,2,1
6,5,comic,5,73,2,3,1.5
6,5,cook,4,74,2,2,0.75
6,5,cool,4,75,3,1,0.75
6,5,crack,5,76,1,4,5.25
6,5,crazy,5,77,3,2,1.25
6,5,crop,4,78,2,2,1
6,5,cue,3,79,1,2,0.75
6,5,dad,3,80,0,3,1
6,5,dark,4,81,2,2,1.25
6,5,data,4,82,2,2,4.5
6,5,date,4,83,3,1,0.75
6,5,deadly,6,84,1,5,1.75
6,5,debate,6,85,2,4,1.5
6,5,debris,6,86,3,3,5
6,5,deck,4,87,2,2,0.75
6,5,defend,6,88,2,4,1.25
6,5,defy,4,89,3,1,0.75
6,5,depart,6,90,2,4,1.25
6,5,depend,6,91,3,3,4.5
6,5,depict,6,92,3,3,1.25
6,5,derive,6,93,2,4,1.25
6,5,desire,6,94,2,4,1.25
6,5,diary,5,95,1,4,5.75
6,5,die,3,96,2,1,0.5
6,5,differ,6,97,2,4,1.25
6,5,dip,3,98,2,1,0.5
6,5,divert,6,99,2,4,1.25
6,5,donate,6,100,1,5,4.75
6,5,donor,5,101,3,2,1
6,5,dose,4,102,2,2,1
6,5,dozen,5,103,2,3,1
6,5,drain,5,104,1,4,4.5
6,5,dress,5,105,2,3,1.25
6,5,driver,6,106,2,4,1.5
6,5,drown,5,107,2,3,1
6,5,drug,4,108,2,2,4.5
6,5,drum,4,109,3,1,0.75
6,5,drunk,5,110,3,2,1
6,5,dry,3,111,2,1,0.5
6,5,due,3,112,1,2,0.75
6,5,dump,4,113,2,2,0.75
6,5,duty,4,114,2,2,0.75
6,5,each,4,115,0,4,4.5
6,5,early,5,116,2,3,1.25
6,5,easily,6,117,2,4,1.25
6,5,easy,4,118,3,1,0.75
6,5,eat,3,119,2,1,0.5
6,5,embed,5,120,1,4,4.75
6,5,emerge,6,121,2,4,1.5
6,5,empire,6,122,2,4,1.25
6,5,employ,6,123,3,3,1.25
6,5,enrol,5,124,1,4,4.5
6,5,ensue,5,125,2,3,1.25
6,5,entire,6,126,2,4,1.5
6,5,entity,6,127,4,2,1
6,5,equip,5,128,1,4,5
6,5,era,3,129,1,2,0.75
6,5,ethnic,6,130,1,5,1.75
6,5,every,5,131,1,4,4
6,5,evil,4,132,2,2,1.25
6,5,exam,4,133,1,3,1.25
6,5,exotic,6,134,2,4,1.5
6,5,expect,6,135,2,4,4.25
6,5,export,6,136,3,3,1.25
6,5,fact,4,137,0,4,1.25
6,5,faith,5,138,2,3,1.25
6,5,fame,4,139,2,2,0.75
6,5,fence,5,140,1,4,4.25
6,5,fifth,5,141,1,4,1.25
6,5,final,5,142,2,3,1
6,5,fire,4,143,2,2,0.75
6,5,fish,4,144,2,2,3.5
6,5,fit,3,145,2,1,0.5
6,5,flame,5,146,1,4,1.25
6,5,flash,5,147,3,2,1
6,5,flaw,4,148,3,1,0.5
6,5,flawed,6,149,4,2,0.75
6,5,float,5,150,2,3,3.75
6,5,flood,5,151,3,2,1
6,5,fluid,5,152,2,3,1
6,5,forge,5,153,1,4,1.25
6,5,fork,4,154,3,1,0.5
6,5,formal,6,155,3,3,4
6,5,forth,5,156,3,2,0.75
6,5,freely,6,157,1,5,1.5
6,5,freeze,6,158,4,2,1
6,5,fund,4,159,1,3,1
6,5,garden,6,160,0,6,5
6,5,gentle,6,161,1,5,1.75
6,5,get,3,162,2,1,0.75
6,5,ghost,5,163,1,4,4.25
6,5,glad,4,164,1,3,1.25
6,5,golden,6,165,1,5,1.5
6,5,grass,5,166,1,4,4.25
6,5,halt,4,167,0,4,1.25
6,5,happy,5,168,2,3,1
6,5,hardly,6,169,2,4,1.5
6,5,hear,4,170,1,3,4.25
6,5,hello,5,171,2,3,1.25
6,5,hence,5,172,2,3,1
6,5,hero,4,173,2,2,0.75
6,5,hill,4,174,1,3,1
6,5,hockey,6,175,1,5,4.75
6,5,hold,4,176,2,2,0.75
6,5,honour,6,177,2,4,1.75
6,5,hope,4,178,2,2,1
6,5,host,4,179,2,2,4
6,5,house,5,180,2,3,1.25
6,5,hurry,5,181,1,4,1.25
6,5,impact,6,182,0,6,1.75
6,5,induce,6,183,1,5,4.75
6,5,infect,6,184,2,4,1.5
6,5,inmate,6,185,2,4,1.25
6,5,insect,6,186,2,4,4.5
6,5,jeans,5,187,0,5,1.5
6,5,join,4,188,1,3,1
6,5,joint,5,189,4,1,0.5
6,5,knock,5,190,0,5,4.5
6,5,label,5,191,0,5,1.5
6,5,lady,4,192,2,2,0.75
6,5,lamp,4,193,2,2,0.75
6,5,lately,6,194,2,4,4.5
6,5,layout,6,195,2,4,1.5
6,5,lead,4,196,1,3,1
6,5,leap,4,197,3,1,0.5
6,5,leave,5,198,3,2,4
6,5,less,4,199,2,2,0.75
6,5,lesson,6,200,4,2,0.75
6,5,let,3,201,2,1,0.5
6,5,limit,5,202,1,4,1.25
6,5,lively,6,203,2,4,4.75
6,5,loan,4,204,1,3,1
6,5,lock,4,205,2,2,0.75
6,5,logic,5,206,2,3,1
6,5,logo,4,207,3,1,0.75
6,5,loop,4,208,2,2,0.75
6,5,lose,4,209,2,2,4.25
6,5,loss,4,210,3,1,0.75
6,5,lost,4,211,3,1,0.75
6,5,mall,4,212,0,4,1.25
6,5,march,5,213,2,3,1
6,5,marry,5,214,3,2,1
6,5,matter,6,215,2,4,7.75
6,5,me,2,216,1,1,349
6,5,menu,4,217,2,2,2.75
6,5,mill,4,218,1,3,3
6,5,miner,5,219,2,3,2.5
6,5,minor,5,220,3,2,2
6,5,monk,4,221,1,3,9.25
6,5,moral,5,222,2,3,3.5
6,5,mount,5,223,2,3,3.5
6,5,mutual,6,224,1,5,5
6,5,myself,6,225,1,5,10.75
6,5,nerve,5,226,0,5,3.25
6,5,nest,4,227,2,2,1.75
6,5,news,4,228,2,2,1.75
6,5,next,4,229,2,2,6.75
6,5,ninety,6,230,1,5,3.5
6,5,noon,4,231,1,3,2
6,5,nurse,5,232,1,4,2.75
6,5,object,6,233,0,6,9
6,5,occur,5,234,1,4,2.75
6,5,of,2,235,1,1,1
6,5,onto,4,236,1,3,2
6,5,our,3,237,1,2,6.5
6,5,out,3,238,2,1,1
6,5,overly,6,239,1,5,3.25
6,5,oxygen,6,240,1,5,3.25
6,5,paper,5,241,0,5,8.25
6,5,partly,6,242,2,4,3
6,5,party,5,243,4,1,1.25
6,5,pass,4,244,2,2,1.75
6,5,peak,4,245,1,3,7.25
6,5,people,6,246,2,4,3
6,5,period,6,247,2,4,3
6,5,person,6,248,3,3,2.75
6,5,phase,5,249,1,4,8.25
6,5,pill,4,250,1,3,2.25
6,5,pink,4,251,2,2,1.75
6,5,pit,3,252,2,1,1
6,5,plate,5,253,1,4,2.75
6,5,plug,4,254,2,2,6.75
6,5,poet,4,255,1,3,2.25
6,5,poetry,6,256,4,2,1.75
6,5,pole,4,257,2,2,1.75
6,5,pool,4,258,2,2,1.5
6,5,pop,3,259,2,1,1
6,5,pose,4,260,2,2,6.5
6,5,powder,6,261,2,4,3
6,5,pray,4,262,1,3,2.25
6,5,preach,6,263,2,4,3
6,5,prefer,6,264,3,3,7.75
6,5,pretty,6,265,3,3,2.5
6,5,prey,4,266,3,1,1.25
6,5,pride,5,267,2,3,2.25
6,5,prince,6,268,3,3,2.5
6,5,prison,6,269,3,3,8
6,5,punch,5,270,1,4,2.75
6,5,purple,6,271,2,4,3
6,5,queen,5,272,0,5,8.5
6,5,quota,5,273,2,3,2.5
6,5,radio,5,274,0,5,3.25
6,5,rain,4,275,2,2,1.75
6,5,random,6,276,2,4,8.75
6,5,range,5,277,3,2,2
6,5,rapid,5,278,2,3,2.25
6,5,rare,4,279,2,2,1.75
6,5,raw,3,280,2,1,1
6,5,read,4,281,1,3,2.25
6,5,reader,6,282,4,2,7.5
6,5,really,6,283,3,3,2.5
6,5,recipe,6,284,2,4,3
6,5,red,3,285,2,1,1
6,5,regret,6,286,2,4,3
6,5,remote,6,287,2,4,8.5
6,5,report,6,288,2,4,3
6,5,result,6,289,2,4,3
6,5,resume,6,290,4,2,7.25
6,5,rhythm,6,291,1,5,3.25
6,5,rice,4,292,1,3,2.25
6,5,rid,3,293,2,1,1
6,5,riot,4,294,2,2,1.75
6,5,royal,5,295,1,4,8.5
6,5,rule,4,296,1,3,3
6,5,rumour,6,297,2,4,3
6,5,run,3,298,2,1,1
6,5,sail,4,299,0,4,8.25
6,5,saint,5,300,3,2,2
6,5,scream,6,301,1,5,3.5
6,5,script,6,302,3,3,2.75
6,5,see,3,303,1,2,1.5
6,5,seize,5,304,2,3,8
6,5,send,4,305,2,2,1.75
6,5,set,3,306,2,1,1
6,5,sex,3,307,2,1,1
6,5,shadow,6,308,1,5,3.5
6,5,shake,5,309,3,2,7.25
6,5,shall,5,310,3,2,1.75
6,5,sheet,5,311,2,3,2.25
6,5,shock,5,312,2,3,2.25
6,5,short,5,313,3,2,1.75
6,5,should,6,314,3,3,7.5
6,5,show,4,315,3,1,1.25
6,5,sigh,4,316,1,3,2
6,5,sir,3,317,2,1,1
6,5,skill,5,318,1,4,2.75
6,5,sky,3,319,2,1,1
6,5,slot,4,320,1,3,7.25
6,5,smart,5,321,1,4,2.75
6,5,snap,4,322,1,3,2
6,5,soar,4,323,1,3,2
6,5,soon,4,324,2,2,1.75
6,5,sort,4,325,2,2,7
6,5,source,6,326,2,4,3
6,5,spite,5,327,1,4,2.75
6,5,spoil,5,328,2,3,2.25
6,5,spoon,5,329,3,2,7.5
6,5,spy,3,330,2,1,1
6,5,stark,5,331,1,4,2.75
6,5,status,6,332,3,3,2.5
6,5,steel,5,333,2,3,2.25
6,5,steep,5,334,4,1,1.25
6,5,stream,6,335,2,4,8.25
6,5,stupid,6,336,2,4,3
6,5,summit,6,337,1,5,3.25
6,5,superb,6,338,2,4,8.25
6,5,swing,5,339,1,4,3
6,5,t,1,340,0,1,0.75
6,5,tag,3,341,1,2,1.5
6,5,tax,3,342,2,1,1
6,5,teach,5,343,1,4,8
6,5,tennis,6,344,2,4,3
6,5,tenure,6,345,3,3,2.5
6,5,their,5,346,1,4,2.75
6,5,then,4,347,3,1,6.75
6,5,there,5,348,3,2,1.75
6,5,they,4,349,3,1,1.25
6,5,thick,5,350,2,3,2.25
6,5,thief,5,351,3,2,1.75
6,5,thing,5,352,3,2,1.75
6,5,think,5,353,4,1,1.25
6,5,threat,6,354,2,4,8.25
6,5,thrive,6,355,3,3,2.5
6,5,throat,6,356,3,3,2.5
6,5,throw,5,357,4,1,1.25
6,5,total,5,358,1,4,2.75
6,5,towel,5,359,2,3,7
6,5,toy,3,360,2,1,0.5
6,5,true,4,361,1,3,1
6,5,truly,5,362,3,2,0.75
6,5,trust,5,363,3,2,0.75
6,5,try,3,364,2,1,0.5
6,5,tunnel,6,365,1,5,4.75
6,5,turn,4,366,2,2,1
6,5,ugly,4,367,0,4,1.25
6,5,unfold,6,368,1,5,5
6,5,unless,6,369,2,4,1.5
6,5,upper,5,370,1,4,1.25
6,5,used,4,371,1,3,1
6,5,user,4,372,3,1,3.75
6,5,valid,5,373,0,5,1.5
6,5,vast,4,374,2,2,0.75
6,5,very,4,375,1,3,1
6,5,victim,6,376,1,5,4.75
6,5,volume,6,377,1,5,1.5
6,5,vote,4,378,2,2,0.75
6,5,wage,4,379,0,4,1.25
6,5,we,2,380,1,1,3.5
6,5,wear,4,381,2,2,0.75
6,5,web,3,382,2,1,0.5
6,5,week,4,383,2,2,0.75
6,5,weekly,6,384,4,2,0.75
6,5,wet,3,385,2,1,0.5
6,5,when,4,386,1,3,1
6,5,while,5,387,2,3,4.25
6,5,wholly,6,388,2,4,1.25
6,5,winter,6,389,1,5,1.5
6,5,wooden,6,390,1,5,5
6,5,worst,5,391,2,3,1
6,5,wound,5,392,2,3,1
6,5,writer,6,393,1,5,1.5
6,5,wrong,5,394,2,3,4.5
6,5,you,3,395,0,3,0.75
6,5,yours,5,396,3,2,0.75
6,5,zone,4,397,0,4,1
6,6,able,4,0,0,4,1.25
6,6,abroad,6,1,2,4,1.5
6,6,afford,6,2,1,5,5
6,6,afraid,6,3,2,4,1.5
6,6,agent,5,4,1,4,1.25
6,6,aid,3,5,1,2,0.5
6,6,alike,5,6,1,4,4.5
6,6,allege,6,7,2,4,1.5
6,6,allow,5,8,3,2,1
6,6,alone,5,9,2,3,1.25
6,6,amid,4,10,1,3,4.25
6,6,angel,5,11,1,4,1.5
6,6,angry,5,12,3,2,0.75
6,6,answer,6,13,2,4,1.25
6,6,anyone,6,14,2,4,4.75
6,6,apart,5,15,1,4,1.25
6,6,april,5,16,2,3,1
6,6,arena,5,17,1,4,1.25
6,6,array,5,18,2,3,4.25
6,6,assign,6,19,1,5,1.5
6,6,attach,6,20,1,5,1.5
6,6,attend,6,21,3,3,4.5
6,6,author,6,22,1,5,1.5
6,6,autumn,6,23,3,3,1
6,6,avoid,5,24,1,4,1.25
6,6,aware,5,25,1,4,4.5
6,6,away,4,26,3,1,0.75
6,6,bad,3,27,0,3,0.75
6,6,ballot,6,28,2,4,1.25
6,6,bank,4,29,2,2,4.25
6,6,basis,5,30,2,3,1.25
6,6,bean,4,31,1,3,1
6,6,bear,4,32,3,1,0.5
6,6,beef,4,33,2,2,0.75
6,6,bent,4,34,2,2,0.75
6,6,beside,6,35,2,4,4.5
6,6,bias,4,36,1,3,1
6,6,big,3,37,2,1,0.5
6,6,blast,5,38,1,4,1
6,6,bleed,5,39,2,3,1
6,6,blood,5,40,2,3,4.5
6,6,born,4,41,1,3,1
6,6,bounce,6,42,2,4,1.25
6,6,branch,6,43,1,5,5
6,6,breast,6,44,2,4,1.25
6,6,breath,6,45,4,2,1
6,6,brick,5,46,2,3,1
6,6,bring,5,47,3,2,0.75
6,6,brown,5,48,2,3,4.5
6,6,buck,4,49,1,3,1
6,6,bulk,4,50,2,2,0.75
6,6,burial,6,51,2,4,1.25
6,6,busy,4,52,2,2,0.75
6,6,but,3,53,2,1,3.75
6,6,button,6,54,3,3,1
6,6,bye,3,55,1,2,0.75
6,6,cabin,5,56,0,5,1.25
6,6,camp,4,57,2,2,0.75
6,6,carrot,6,58,2,4,5.25
6,6,castle,6,59,2,4,1.25
6,6,catch,5,60,2,3,1
6,6,cattle,6,61,3,3,4.5
6,6,cent,4,62,1,3,1
6,6,centre,6,63,4,2,0.75
6,6,chaos,5,64,1,4,1.25
6,6,chat,4,65,3,1,0.5
6,6,chef,4,66,2,2,0.75
6,6,cinema,6,67,1,5,4.75
6,6,claim,5,68,1,4,1.25
6,6,clip,4,69,2,2,0.75
6,6,close,5,70,2,3,1
6,6,clue,4,71,2,2,4.25
6,6,coin,4,72,1,3,1
6,6,common,6,73,2,4,1.25
6,6,copy,4,74,2,2,0.75
6,6,cow,3,75,2,1,0.5
6,6,crash,5,76,1,4,4.5
6,6,crazy,5,77,3,2,1
6,6,cream,5,78,2,3,1
6,6,crop,4,79,2,2,0.75
6,6,crown,5,80,3,2,0.75
6,6,custom,6,81,1,5,5
6,6,dancer,6,82,0,6,1.75
6,6,data,4,83,2,2,0.75
6,6,date,4,84,3,1,0.75
6,6,deadly,6,85,1,5,5
6,6,deck,4,86,2,2,0.75
6,6,defeat,6,87,2,4,1.25
6,6,define,6,88,3,3,1
6,6,defy,4,89,3,1,4
6,6,denial,6,90,2,4,1.5
6,6,depict,6,91,2,4,1.25
6,6,desert,6,92,2,4,1.25
6,6,desire,6,93,3,3,4.75
6,6,detail,6,94,2,4,1.25
6,6,devise,6,95,2,4,1.25
6,6,differ,6,96,1,5,5
6,6,dip,3,97,2,1,0.5
6,6,donate,6,98,1,5,1.5
6,6,door,4,99,2,2,0.75
6,6,dose,4,100,2,2,0.75
6,6,dozen,5,101,2,3,5
6,6,drain,5,102,1,4,1.25
6,6,dress,5,103,2,3,1
6,6,drug,4,104,2,2,0.75
6,6,drum,4,105,3,1,0.5
6,6,drunk,5,106,3,2,4.25
6,6,dry,3,107,2,1,0.75
6,6,duty,4,108,1,3,1
6,6,early,5,109,0,5,1.5
6,6,easily,6,110,2,4,1.25
6,6,easy,4,111,3,1,4
6,6,eat,3,112,2,1,0.5
6,6,echo,4,113,1,3,1
6,6,else,4,114,1,3,0.75
6,6,emerge,6,115,1,5,1.5
6,6,empire,6,116,2,4,5
6,6,energy,6,117,1,5,1.5
6,6,entity,6,118,2,4,1.5
6,6,equip,5,119,1,4,4.75
6,6,error,5,120,1,4,1.25
6,6,erupt,5,121,2,3,1
6,6,escape,6,122,1,5,5
6,6,ethic,5,123,1,4,1.25
6,6,ethnic,6,124,3,3,1.25
6,6,every,5,125,1,4,1.25
6,6,except,6,126,1,5,5.25
6,6,exotic,6,127,2,4,1.25
6,6,expect,6,128,2,4,1.25
6,6,faith,5,129,0,5,5
6,6,fame,4,130,2,2,0.75
6,6,feat,4,131,1,3,1.25
6,6,fence,5,132,2,3,1.25
6,6,figure,6,133,1,5,5.5
6,6,film,4,134,2,2,0.75
6,6,final,5,135,2,3,1
6,6,fire,4,136,2,2,0.75
6,6,first,5,137,3,2,0.75
6,6,fish,4,138,2,2,4.75
6,6,fleet,5,139,1,4,1.25
6,6,float,5,140,2,3,1
6,6,flour,5,141,3,2,1
6,6,fold,4,142,1,3,1
6,6,follow,6,143,3,3,4.75
6,6,fool,4,144,2,2,0.75
6,6,forge,5,145,2,3,1
6,6,fork,4,146,3,1,0.5
6,6,formal,6,147,3,3,1
6,6,format,6,148,5,1,0.75
6,6,forth,5,149,3,2,4.75
6,6,fossil,6,150,2,4,1.25
6,6,frame,5,151,1,4,1.25
6,6,freely,6,152,2,4,5
6,6,fruit,5,153,2,3,1.25
6,6,fund,4,154,1,3,1
6,6,garden,6,155,0,6,1.75
6,6,gas,3,156,2,1,4
6,6,get,3,157,1,2,0.75
6,6,glad,4,158,1,3,1
6,6,grand,5,159,1,4,1
6,6,half,4,160,0,4,1.25
6,6,hand,4,161,2,2,4.25
6,6,hear,4,162,1,3,1
6,6,hello,5,163,2,3,1
6,6,help,4,164,3,1,0.5
6,6,hidden,6,165,1,5,5.25
6,6,hill,4,166,2,2,0.75
6,6,hobby,5,167,1,4,1.25
6,6,holy,4,168,2,2,0.75
6,6,honour,6,169,2,4,1.25
6,6,hook,4,170,2,2,4.25
6,6,host,4,171,2,2,0.75
6,6,hurry,5,172,1,4,1.25
6,6,impact,6,173,0,6,1.75
6,6,indoor,6,174,1,5,5.25
6,6,induce,6,175,3,3,1.25
6,6,infect,6,176,2,4,1.25
6,6,input,5,177,2,3,4.75
6,6,insult,6,178,2,4,1.25
6,6,invoke,6,179,2,4,1.25
6,6,jeans,5,180,0,5,5
6,6,joint,5,181,1,4,1.25
6,6,july,4,182,1,3,1
6,6,kill,4,183,0,4,1
6,6,kiss,4,184,2,2,4.5
6,6,knock,5,185,1,4,1.25
6,6,labour,6,186,0,6,1.5
6,6,lamp,4,187,2,2,0.75
6,6,laptop,6,188,2,4,5
6,6,lead,4,189,1,3,1
6,6,leap,4,190,3,1,0.5
6,6,learn,5,191,3,2,0.75
6,6,length,6,192,2,4,1.25
6,6,lesson,6,193,2,4,4.75
6,6,level,5,194,2,3,1
6,6,light,5,195,1,4,1.25
6,6,lively,6,196,2,4,5.25
6,6,loan,4,197,1,3,1
6,6,lock,4,198,2,2,0.75
6,6,logo,4,199,2,2,0.75
6,6,lose,4,200,2,2,0.75
6,6,loss,4,201,3,1,0.75
6,6,lovely,6,202,2,4,5.25
6,6,major,5,203,0,5,1.5
6,6,mall,4,204,2,2,0.75
6,6,man,3,205,2,1,0.5
6,6,maths,5,206,2,3,4.5
6,6,matter,6,207,3,3,1.25
6,6,mayor,5,208,2,3,1
6,6,me,2,209,1,1,0.25
6,6,meet,4,210,2,2,0.75
6,6,menu,4,211,2,2,0.75
6,6,mine,4,212,1,3,4.5
6,6,miner,5,213,4,1,0.75
6,6,minute,6,214,3,3,1.25
6,6,modest,6,215,1,5,1.5
6,6,moral,5,216,2,3,1
6,6,motive,6,217,2,4,5.25
6,6,move,4,218,2,2,0.75
6,6,native,6,219,0,6,1.75
6,6,naval,5,220,2,3,4.75
6,6,nerve,5,221,1,4,1.25
6,6,noble,5,222,1,4,1.25
6,6,nod,3,223,2,1,0.5
6,6,noon,4,224,2,2,0.75
6,6,nose,4,225,2,2,4.5
6,6,nurse,5,226,1,4,1.25
6,6,occur,5,227,0,5,1.5
6,6,offer,5,228,1,4,6.5
6,6,onion,5,229,1,4,3
6,6,onto,4,230,2,2,1.75
6,6,or,2,231,1,1,0.75
6,6,orange,6,232,2,4,2.75
6,6,our,3,233,1,2,7.75
6,6,oven,4,234,1,3,2.25
6,6,overly,6,235,3,3,2.25
6,6,oxygen,6,236,1,5,3.25
6,6,packet,6,237,0,6,10
6,6,pan,3,238,2,1,1
6,6,paper,5,239,2,3,2.25
6,6,parish,6,240,2,4,3
6,6,party,5,241,3,2,7.75
6,6,peak,4,242,1,3,2
6,6,people,6,243,2,4,3
6,6,period,6,244,2,4,3
6,6,pill,4,245,1,3,8.25
6,6,pilot,5,246,3,2,2
6,6,planet,6,247,1,5,3.25
6,6,player,6,248,3,3,2.5
6,6,plug,4,249,2,2,1.75
6,6,pool,4,250,1,3,9
6,6,pose,4,251,2,2,1.75
6,6,pray,4,252,1,3,2
6,6,prefer,6,253,2,4,3
6,6,prey,4,254,3,1,1.25
6,6,price,5,255,2,3,8.75
6,6,prince,6,256,3,3,2.5
6,6,pub,3,257,1,2,1.5
6,6,punch,5,258,2,3,2.25
6,6,purple,6,259,2,4,9.75
6,6,pursue,6,260,3,3,2.5
6,6,queen,5,261,0,5,3.25
6,6,queue,5,262,3,2,1.75
6,6,quote,5,263,2,3,8.75
6,6,rain,4,264,0,4,2.75
6,6,rare,4,265,2,2,1.75
6,6,raw,3,266,2,1,1
6,6,read,4,267,1,3,2
6,6,reader,6,268,4,2,1.75
6,6,real,4,269,3,1,7.25
6,6,red,3,270,2,1,1
6,6,refuge,6,271,2,4,3
6,6,regret,6,272,2,4,2.75
6,6,report,6,273,2,4,9
6,6,resume,6,274,2,4,3
6,6,review,6,275,2,4,3
6,6,rice,4,276,1,3,2.25
6,6,rid,3,277,2,1,1.5
6,6,risk,4,278,2,2,10
6,6,rock,4,279,1,3,2.5
6,6,role,4,280,2,2,1.75
6,6,route,5,281,2,3,2.5
6,6,royal,5,282,2,3,2.25
6,6,rule,4,283,1,3,9.25
6,6,run,3,284,2,1,1
6,6,runner,6,285,3,3,2.5
6,6,sad,3,286,0,3,2
6,6,sadly,5,287,3,2,1.5
6,6,sail,4,288,2,2,1.75
6,6,salary,6,289,2,4,9.5
6,6,scope,5,290,1,4,2.75
6,6,scream,6,291,2,4,3
6,6,script,6,292,3,3,8.75
6,6,sea,3,293,1,2,1.5
6,6,see,3,294,2,1,1
6,6,seize,5,295,2,3,2.25
6,6,seldom,6,296,2,4,2.75
6,6,send,4,297,2,2,7.5
6,6,senior,6,298,3,3,3
6,6,sex,3,299,2,1,1
6,6,shall,5,300,1,4,2.75
6,6,shaped,6,301,3,3,2.5
6,6,shop,4,302,2,2,8
6,6,short,5,303,3,2,1.75
6,6,shot,4,304,3,1,1.25
6,6,should,6,305,3,3,2.5
6,6,shrink,6,306,2,4,2.75
6,6,silent,6,307,1,5,9.75
6,6,silly,5,308,3,2,1.75
6,6,sing,4,309,2,2,1.75
6,6,sir,3,310,2,1,1
6,6,size,4,311,2,2,1.5
6,6,skiing,6,312,1,5,9.5
6,6,skill,5,313,3,2,2
6,6,sky,3,314,2,1,1
6,6,sleep,5,315,1,4,2.75
6,6,slogan,6,316,2,4,3
6,6,slot,4,317,3,1,1.25
6,6,slow,4,318,3,1,7.5
6,6,smash,5,319,1,4,2.75
6,6,soar,4,320,1,3,2.25
6,6,soccer,6,321,2,4,2.75
6,6,span,4,322,1,3,8.5
6,6,spicy,5,323,2,3,2.5
6,6,spill,5,324,3,2,2
6,6,split,5,325,2,3,2.25
6,6,spoil,5,326,2,3,2.5
6,6,spoon,5,327,3,2,8.5
6,6,sport,5,328,3,2,2
6,6,spot,4,329,3,1,1.25
6,6,stage,5,330,1,4,2.75
6,6,status,6,331,3,3,2.5
6,6,steel,5,332,2,3,8.5
6,6,steep,5,333,4,1,1.5
6,6,stiff,5,334,2,3,2.5
6,6,stress,6,335,2,4,3.25
6,6,style,5,336,2,3,2.5
6,6,suburb,6,337,1,5,9.75
6,6,suffer,6,338,2,4,3
6,6,sum,3,339,2,1,1
6,6,summit,6,340,3,3,2.25
6,6,superb,6,341,2,4,9.5
6,6,supply,6,342,3,3,2.5
6,6,surge,5,343,2,3,2.25
6,6,sweet,5,344,1,4,2.75
6,6,swing,5,345,2,3,8.5
6,6,t,1,346,0,1,0.75
6,6,tell,4,347,1,3,2
6,6,tennis,6,348,2,4,2.75
6,6,tent,4,349,3,1,1.25
6,6,tenure,6,350,3,3,8.5
6,6,their,5,351,1,4,2.75
6,6,them,4,352,3,1,1.25
6,6,thief,5,353,2,3,2.25
6,6,thin,4,354,3,1,1.25
6,6,thing,5,355,4,1,1.25
6,6,though,6,356,2,4,8.75
6,6,threat,6,357,2,4,3
6,6,thrive,6,358,3,3,2.5
6,6,throat,6,359,3,3,2.5
6,6,timber,6,360,1,5,9.75
6,6,tired,5,361,2,3,2.5
6,6,toll,4,362,1,3,2
6,6,ton,3,363,2,1,1
6,6,tone,4,364,3,1,1
6,6,tongue,6,365,3,3,8.75
6,6,toy,3,366,2,1,1
6,6,true,4,367,1,3,2.25
6,6,trust,5,368,3,2,1.75
6,6,twist,5,369,1,4,2.75
6,6,ugly,4,370,0,4,9.25
6,6,unit,4,371,1,3,2.25
6,6,up,2,372,1,1,1
6,6,upper,5,373,2,3,2.25
6,6,us,2,374,1,1,0.75
6,6,use,3,375,2,1,1
6,6,user,4,376,3,1,1
6,6,vast,4,377,0,4,9
6,6,versus,6,378,1,5,3.25
6,6,we,2,379,0,2,1.25
6,6,wear,4,380,2,2,1.5
6,6,week,4,381,2,2,8
6,6,while,5,382,1,4,2.75
6,6,whilst,6,383,4,2,1.75
6,6,who,3,384,2,1,1.25
6,6,whole,5,385,3,2,1.75
6,6,wholly,6,386,4,2,2
6,6,wish,4,387,1,3,8.75
6,6,wooden,6,388,1,5,3.5
6,6,worm,4,389,2,2,1.75
6,6,worse,5,390,3,2,2
6,6,worst,5,391,4,1,1.5
6,6,wound,5,392,2,3,9
6,6,writer,6,393,1,5,3.5
6,6,yell,4,394,0,4,2.5
6,6,you,3,395,1,2,1.5
6,6,yours,5,396,3,2,8.5
6,6,zone,4,397,0,4,2.75
6,7,able,4,0,0,4,2.5
6,7,abroad,6,1,2,4,12.25
6,7,absent,6,2,2,4,3
6,7,accent,6,3,1,5,3.75
6,7,access,6,4,4,2,2
6,7,adhere,6,5,1,5,10
6,7,affair,6,6,1,5,3.5
6,7,agent,5,7,1,4,2.75
6,7,ah,2,8,1,1,7.25
6,7,aid,3,9,1,2,1.5
6,7,alert,5,10,1,4,2.75
6,7,alike,5,11,2,3,2.25
6,7,all,3,12,2,1,1
6,7,allege,6,13,3,3,9.5
6,7,allow,5,14,3,2,2.25
6,7,alone,5,15,2,3,2.5
6,7,along,5,16,4,1,1.25
6,7,also,4,17,2,2,1.75
6,7,amid,4,18,1,3,2.25
6,7,apple,5,19,1,4,10.25
6,7,armed,5,20,1,4,2.75
6,7,array,5,21,2,3,2.25
6,7,assess,6,22,1,5,10.75
6,7,asset,5,23,4,1,1.75
6,7,attach,6,24,1,5,3.5
6,7,attack,6,25,5,1,1.25
6,7,attend,6,26,3,3,2.5
6,7,august,6,27,1,5,10.25
6,7,autumn,6,28,2,4,3
6,7,aware,5,29,1,4,2.75
6,7,back,4,30,0,4,9.5
6,7,ballot,6,31,2,4,3
6,7,banana,6,32,2,4,2.75
6,7,basis,5,33,2,3,2.25
6,7,basket,6,34,3,3,9
6,7,become,6,35,1,5,3.25
6,7,bee,3,36,2,1,1
6,7,beef,4,37,3,1,1
6,7,before,6,38,2,4,3
6,7,behind,6,39,2,4,7.5
6,7,being,5,40,2,3,1
6,7,bleed,5,41,1,4,1.25
6,7,body,4,42,1,3,1
6,7,bold,4,43,2,2,5
6,7,bond,4,44,2,2,0.75
6,7,bonus,5,45,3,2,1
6,7,born,4,46,2,2,0.75
6,7,brain,5,47,1,4,1.25
6,7,branch,6,48,3,3,5.25
6,7,breast,6,49,2,4,1.25
6,7,brick,5,50,2,3,1
6,7,bulk,4,51,1,3,1
6,7,burial,6,52,2,4,5.5
6,7,burst,5,53,3,2,1
6,7,bus,3,54,2,1,0.5
6,7,busy,4,55,3,1,0.5
6,7,but,3,56,2,1,0.5
6,7,calm,4,57,0,4,1.25
6,7,carrot,6,58,2,4,5.5
6,7,case,4,59,2,2,0.75
6,7,castle,6,60,3,3,1.25
6,7,cat,3,61,2,1,0.5
6,7,chance,6,62,1,5,1.5
6,7,cheek,5,63,2,3,5.25
6,7,cinema,6,64,1,5,1.5
6,7,cloth,5,65,1,4,1.25
6,7,clue,4,66,2,2,5
6,7,coin,4,67,1,3,1
6,7,commit,6,68,2,4,1.5
6,7,common,6,69,4,2,1
6,7,cook,4,70,2,2,1
6,7,cool,4,71,3,1,0.75
6,7,cop,3,72,2,1,4.5
6,7,crash,5,73,1,4,1.25
6,7,crazy,5,74,3,2,1
6,7,crop,4,75,2,2,1
6,7,crown,5,76,3,2,1
6,7,cue,3,77,1,2,0.75
6,7,cult,4,78,2,2,5.25
6,7,custom,6,79,2,4,1.5
6,7,dad,3,80,0,3,1
6,7,dancer,6,81,2,4,1.5
6,7,dark,4,82,2,2,5.5
6,7,data,4,83,2,2,1
6,7,date,4,84,3,1,0.75
6,7,deadly,6,85,1,5,2.25
6,7,dear,4,86,3,1,1
6,7,debate,6,87,2,4,6.75
6,7,debut,5,88,3,2,1
6,7,deck,4,89,2,2,1
6,7,defeat,6,90,2,4,1.5
6,7,defend,6,91,4,2,1.75
6,7,denial,6,92,2,4,6.75
6,7,derive,6,93,2,4,1.5
6,7,desire,6,94,2,4,1.5
6,7,die,3,95,1,2,0.75
6,7,differ,6,96,2,4,6
6,7,dog,3,97,1,2,0.75
6,7,donate,6,98,2,4,1.5
6,7,dose,4,99,2,2,0.75
6,7,dozen,5,100,2,3,1
6,7,draw,4,101,1,3,5
6,7,drive,5,102,2,3,1.25
6,7,drown,5,103,2,3,1
6,7,drum,4,104,2,2,0.75
6,7,dull,4,105,1,3,5.25
6,7,early,5,106,0,5,1.5
6,7,easily,6,107,2,4,1.5
6,7,east,4,108,3,1,0.75
6,7,edge,4,109,1,3,5.5
6,7,else,4,110,1,3,1
6,7,emerge,6,111,1,5,1.5
6,7,empire,6,112,2,4,1.25
6,7,empty,5,113,3,2,5.25
6,7,entity,6,114,1,5,1.5
6,7,era,3,115,1,2,0.75
6,7,error,5,116,2,3,1
6,7,ethnic,6,117,1,5,6.75
6,7,every,5,118,1,4,1.75
6,7,evil,4,119,2,2,1
6,7,except,6,120,1,5,9
6,7,exotic,6,121,2,4,125.5
6,7,expect,6,122,2,4,3.5
6,7,fact,4,123,0,4,2.75
6,7,faith,5,124,2,3,2.5
6,7,fame,4,125,2,2,6.75
6,7,fan,3,126,2,1,1
6,7,feat,4,127,1,3,1.5
6,7,feed,4,128,2,2,1.25
6,7,fence,5,129,2,3,1.75
6,7,fifth,5,130,1,4,6.75
6,7,film,4,131,2,2,1.25
6,7,filter,6,132,3,3,1.75
6,7,finish,6,133,2,4,2
6,7,fire,4,134,2,2,1.25
6,7,first,5,135,3,2,6
6,7,fish,4,136,2,2,1.25
6,7,fit,3,137,2,1,0.75
6,7,flaw,4,138,1,3,1.25
6,7,flawed,6,139,4,2,1
6,7,fleet,5,140,2,3,1.25
6,7,float,5,141,2,3,6
6,7,flood,5,142,3,2,1.5
6,7,flour,5,143,3,2,1.5
6,7,fold,4,144,1,3,1.25
6,7,follow,6,145,3,3,1.5
6,7,fond,4,146,2,2,10.25
6,7,fool,4,147,2,2,2.25
6,7,forge,5,148,2,3,1.75
6,7,fork,4,149,3,1,1
6,7,frame,5,150,1,4,2
6,7,freely,6,151,2,4,8.25
6,7,from,4,152,2,2,1
6,7,fund,4,153,1,3,1.25
6,7,gang,4,154,0,4,1.25
6,7,garden,6,155,2,4,6.25
6,7,gas,3,156,2,1,0.5
6,7,ghost,5,157,1,4,1.25
6,7,grain,5,158,1,4,1.5
6,7,great,5,159,2,3,1.25
6,7,half,4,160,0,4,4.75
6,7,halt,4,161,3,1,0.5
6,7,happy,5,162,2,3,1.25
6,7,hardly,6,163,2,4,1.5
6,7,hatred,6,164,2,4,5
6,7,he,2,165,1,1,0.5
6,7,hello,5,166,2,3,1
6,7,help,4,167,3,1,0.5
6,7,hence,5,168,2,3,1
6,7,here,4,169,2,2,0.75
6,7,hero,4,170,3,1,4
6,7,hobby,5,171,1,4,1.25
6,7,hold,4,172,2,2,0.75
6,7,hope,4,173,2,2,0.75
6,7,house,5,174,2,3,1
6,7,hurry,5,175,1,4,4.75
6,7,if,2,176,0,2,0.75
6,7,in,2,177,1,1,0.5
6,7,indeed,6,178,2,4,1.25
6,7,insect,6,179,2,4,1.25
6,7,insult,6,180,3,3,4.75
6,7,invoke,6,181,2,4,1.5
6,7,join,4,182,0,4,1.25
6,7,joint,5,183,4,1,0.5
6,7,kill,4,184,0,4,4.5
6,7,knock,5,185,1,4,1.5
6,7,ladder,6,186,0,6,1.75
6,7,lady,4,187,3,1,0.75
6,7,lamp,4,188,2,2,4.5
6,7,lane,4,189,2,2,1
6,7,laptop,6,190,2,4,1.25
6,7,lately,6,191,2,4,1.25
6,7,layout,6,192,2,4,5
6,7,lead,4,193,1,3,1.25
6,7,leap,4,194,3,1,0.75
6,7,legacy,6,195,2,4,1.5
6,7,legal,5,196,4,1,0.75
6,7,length,6,197,2,4,5
6,7,less,4,198,2,2,0.75
6,7,lesson,6,199,4,2,0.75
6,7,limit,5,200,1,4,1.25
6,7,linger,6,201,2,4,5
6,7,lively,6,202,2,4,1.25
6,7,lobby,5,203,1,4,1.25
6,7,lock,4,204,2,2,0.75
6,7,logic,5,205,2,3,4.5
6,7,loop,4,206,2,2,0.75
6,7,lovely,6,207,2,4,1.25
6,7,lower,5,208,2,3,1
6,7,mall,4,209,0,4,4.25
6,7,march,5,210,2,3,1
6,7,marker,6,211,3,3,1.25
6,7,marry,5,212,3,2,1
6,7,mate,4,213,2,2,0.75
6,7,maths,5,214,3,2,1
6,7,maybe,5,215,2,3,4.25
6,7,mayor,5,216,3,2,1
6,7,means,5,217,1,4,1.25
6,7,meet,4,218,2,2,1.5
6,7,menu,4,219,2,2,1.75
6,7,mile,4,220,1,3,7
6,7,mill,4,221,3,1,1.25
6,7,miner,5,222,2,3,2.25
6,7,mining,6,223,3,3,2.5
6,7,minute,6,224,3,3,2.5
6,7,mode,4,225,1,3,7.25
6,7,modern,6,226,4,2,1.75
6,7,modest,6,227,4,2,1.75
6,7,mount,5,228,2,3,2.25
6,7,mutual,6,229,1,5,8.5
6,7,nail,4,230,0,4,2.5
6,7,native,6,231,2,4,3
6,7,naval,5,232,2,3,2.25
6,7,nest,4,233,1,3,7.75
6,7,news,4,234,2,2,1.75
6,7,noble,5,235,1,4,2.75
6,7,nod,3,236,2,1,1
6,7,now,3,237,2,1,1
6,7,o,1,238,0,1,0.75
6,7,object,6,239,1,5,8.5
6,7,obtain,6,240,2,4,3
6,7,on,2,241,1,1,0.75
6,7,onion,5,242,2,3,2
6,7,onto,4,243,2,2,1.5
6,7,open,4,244,1,3,7.25
6,7,oral,4,245,1,3,2.25
6,7,order,5,246,2,3,2.25
6,7,our,3,247,1,2,1.5
6,7,oven,4,248,1,3,2
6,7,pair,4,249,0,4,7.75
6,7,palm,4,250,2,2,1.75
6,7,paper,5,251,2,3,2.25
6,7,parent,6,252,2,4,2.75
6,7,partly,6,253,3,3,8
6,7,pass,4,254,2,2,1.75
6,7,people,6,255,1,5,3.25
6,7,phase,5,256,1,4,2.75
6,7,pill,4,257,1,3,7.5
6,7,pink,4,258,2,2,1.75
6,7,pit,3,259,2,1,1
6,7,plain,5,260,1,4,3.5
6,7,plate,5,261,3,2,2
6,7,player,6,262,3,3,10.25
6,7,poet,4,263,1,3,2.5
6,7,pole,4,264,2,2,1.75
6,7,policy,6,265,3,3,2.75
6,7,pool,4,266,2,2,1.75
6,7,pop,3,267,2,1,1.25
6,7,port,4,268,2,2,7.5
6,7,powder,6,269,2,4,3
6,7,pray,4,270,1,3,2.25
6,7,preach,6,271,2,4,3
6,7,pride,5,272,2,3,7.75
6,7,prison,6,273,3,3,2.5
6,7,pub,3,274,1,2,1.5
6,7,purple,6,275,2,4,3
6,7,pursue,6,276,3,3,7.5
6,7,queen,5,277,0,5,3.25
6,7,quote,5,278,2,3,2.25
6,7,racist,6,279,0,6,8.75
6,7,radio,5,280,2,3,2.5
6,7,rain,4,281,2,2,1.75
6,7,random,6,282,2,4,3
6,7,rapid,5,283,2,3,2.25
6,7,raw,3,284,2,1,6.25
6,7,read,4,285,1,3,2.25
6,7,reader,6,286,4,2,1.75
6,7,real,4,287,3,1,1
6,7,really,6,288,4,2,1.75
6,7,red,3,289,2,1,1.25
6,7,rely,4,290,2,2,1.75
6,7,rental,6,291,2,4,8.5
6,7,report,6,292,2,4,3
6,7,resume,6,293,2,4,2.75
6,7,review,6,294,2,4,8
6,7,rice,4,295,1,3,2.25
6,7,rid,3,296,2,1,1
6,7,riot,4,297,2,2,1.5
6,7,rock,4,298,1,3,2
6,7,route,5,299,2,3,7.5
6,7,royal,5,300,2,3,2.5
6,7,rumour,6,301,1,5,3.5
6,7,sad,3,302,0,3,2
6,7,saint,5,303,2,3,7.25
6,7,scale,5,304,1,4,2.75
6,7,sea,3,305,1,2,1.5
6,7,seize,5,306,2,3,2.25
6,7,send,4,307,2,2,1.5
6,7,senior,6,308,3,3,7.75
6,7,serial,6,309,2,4,3
6,7,sex,3,310,2,1,1
6,7,shade,5,311,1,4,2.75
6,7,shine,5,312,2,3,7.5
6,7,shop,4,313,2,2,1.5
6,7,shot,4,314,3,1,1.25
6,7,shout,5,315,3,2,1.75
6,7,shrink,6,316,2,4,2.75
6,7,shrug,5,317,3,2,1.75
6,7,sigh,4,318,1,3,7.25
6,7,silly,5,319,2,3,2.25
6,7,sing,4,320,2,2,1.5
6,7,sir,3,321,2,1,1
6,7,sixty,5,322,2,3,2.25
6,7,size,4,323,2,2,1.5
6,7,skiing,6,324,1,5,8.5
6,7,skill,5,325,3,2,1.75
6,7,sky,3,326,2,1,1
6,7,small,5,327,1,4,2.75
6,7,smash,5,328,3,2,1.75
6,7,snap,4,329,1,3,7.75
6,7,soar,4,330,1,3,2
6,7,soccer,6,331,2,4,2.75
6,7,son,3,332,2,1,1
6,7,source,6,333,2,4,8.25
6,7,spite,5,334,1,4,2.75
6,7,split,5,335,2,3,2.5
6,7,spoil,5,336,2,3,2.5
6,7,spoon,5,337,3,2,7.25
6,7,sport,5,338,3,2,2.25
6,7,status,6,339,1,5,3.25
6,7,steep,5,340,2,3,2.25
6,7,stiff,5,341,2,3,2.5
6,7,stream,6,342,2,4,9
6,7,strive,6,343,3,3,2.75
6,7,style,5,344,2,3,2.5
6,7,summer,6,345,1,5,9
6,7,supply,6,346,2,4,3
6,7,sweet,5,347,1,4,2.75
6,7,swing,5,348,2,3,2.25
6,7,tag,3,349,0,3,7.25
6,7,teach,5,350,1,4,2.75
6,7,tent,4,351,2,2,1.75
6,7,than,4,352,1,3,2
6,7,that,4,353,3,1,1.25
6,7,their,5,354,2,3,7.75
6,7,them,4,355,3,1,1.25
6,7,they,4,356,3,1,1.25
6,7,thick,5,357,2,3,2.25
6,7,think,5,358,3,2,2
6,7,third,5,359,3,2,1.75
6,7,throat,6,360,2,4,8.75
6,7,throw,5,361,4,1,1.5
6,7,timber,6,362,1,5,3.25
6,7,tiny,4,363,2,2,1.75
6,7,tired,5,364,2,3,2.5
6,7,ton,3,365,1,2,7.25
6,7,touch,5,366,2,3,2.25
6,7,towel,5,367,2,3,2.25
6,7,true,4,368,1,3,2
6,7,truth,5,369,3,2,1.75
6,7,try,3,370,2,1,7
6,7,turn,4,371,1,3,2.25
6,7,twenty,6,372,1,5,3.25
6,7,type,4,373,1,3,2
6,7,ugly,4,374,0,4,8
6,7,under,5,375,1,4,2.75
6,7,unfold,6,376,2,4,3
6,7,unit,4,377,2,2,1.75
6,7,unlike,6,378,2,4,8.25
6,7,up,2,379,1,1,0.75
6,7,upper,5,380,2,3,2.25
6,7,use,3,381,1,2,1.5
6,7,vast,4,382,0,4,2.5
6,7,very,4,383,1,3,7.5
6,7,victim,6,384,1,5,3.25
6,7,wage,4,385,0,4,2.5
6,7,warm,4,386,2,2,1.75
6,7,wash,4,387,2,2,7
6,7,web,3,388,1,2,1.5
6,7,wet,3,389,2,1,1
6,7,what,4,390,1,3,2
6,7,who,3,391,2,1,1
6,7,wide,4,392,1,3,2
6,7,wooden,6,393,1,5,8.5
6,7,worm,4,394,2,2,1.75
6,7,worse,5,395,3,2,2
6,7,yours,5,396,0,5,3.25
6,7,zone,4,397,0,4,8.25
6,8,able,4,0,0,4,2.5
6,8,above,5,1,2,3,2.25
6,8,abroad,6,2,2,4,8.5
6,8,absent,6,3,2,4,3.25
6,8,action,6,4,1,5,3.75
6,8,afford,6,5,1,5,12.75
6,8,afraid,6,6,2,4,3.25
6,8,ah,2,7,1,1,0.75
6,8,aid,3,8,1,2,1.5
6,8,alike,5,9,1,4,9
6,8,allege,6,10,2,4,3
6,8,allow,5,11,3,2,2
6,8,along,5,12,2,3,2.5
6,8,also,4,13,2,2,1.75
6,8,angel,5,14,1,4,8.75
6,8,angry,5,15,3,2,1.75
6,8,anyone,6,16,2,4,3
6,8,apart,5,17,1,4,2.75
6,8,apple,5,18,2,3,12
6,8,april,5,19,2,3,2.25
6,8,assess,6,20,1,5,3.25
6,8,assign,6,21,3,3,8
6,8,attack,6,22,1,5,3.25
6,8,attend,6,23,3,3,2.5
6,8,august,6,24,1,5,3.25
6,8,author,6,25,2,4,8.5
6,8,autumn,6,26,3,3,2.5
6,8,aware,5,27,1,4,2.75
6,8,away,4,28,3,1,1.25
6,8,back,4,29,0,4,8.25
6,8,bad,3,30,2,1,1
6,8,bare,4,31,2,2,1.5
6,8,become,6,32,1,5,3.5
6,8,before,6,33,2,4,8.5
6,8,bent,4,34,2,2,1.75
6,8,beside,6,35,2,4,2.75
6,8,bias,4,36,1,3,2
6,8,blend,5,37,1,4,6.25
6,8,blood,5,38,2,3,1.25
6,8,bold,4,39,1,3,1
6,8,boring,6,40,2,4,1.5
6,8,breath,6,41,1,5,5
6,8,brick,5,42,2,3,1
6,8,bring,5,43,3,2,1
6,8,broad,5,44,2,3,1
6,8,brown,5,45,3,2,1
6,8,buck,4,46,1,3,4.75
6,8,burial,6,47,2,4,1.5
6,8,burst,5,48,3,2,1
6,8,bury,4,49,3,1,0.5
6,8,busy,4,50,2,2,0.75
6,8,button,6,51,2,4,4.5
6,8,cabin,5,52,0,5,1.5
6,8,case,4,53,2,2,0.75
6,8,castle,6,54,3,3,1.25
6,8,cause,5,55,2,3,4.25
6,8,cent,4,56,1,3,1
6,8,charge,6,57,1,5,1.5
6,8,chat,4,58,3,1,0.5
6,8,cheek,5,59,2,3,4.25
6,8,chef,4,60,3,1,0.75
6,8,chest,5,61,3,2,1
6,8,civic,5,62,1,4,1.25
6,8,claim,5,63,1,4,1.25
6,8,cling,5,64,2,3,4.5
6,8,clue,4,65,2,2,1
6,8,coast,5,66,1,4,1.25
6,8,comic,5,67,2,3,1
6,8,commit,6,68,3,3,1.25
6,8,common,6,69,4,2,4.5
6,8,cook,4,70,2,2,0.75
6,8,cool,4,71,3,1,0.5
6,8,copy,4,72,2,2,0.75
6,8,cotton,6,73,2,4,1.25
6,8,crack,5,74,1,4,4.75
6,8,crash,5,75,3,2,1
6,8,crazy,5,76,3,2,0.75
6,8,crop,4,77,2,2,0.75
6,8,crown,5,78,3,2,0.75
6,8,cue,3,79,1,2,0.5
6,8,dad,3,80,0,3,4.25
6,8,dancer,6,81,2,4,1.25
6,8,dark,4,82,2,2,0.75
6,8,date,4,83,2,2,0.75
6,8,deadly,6,84,1,5,4.75
6,8,dear,4,85,3,1,0.75
6,8,debate,6,86,2,4,1.25
6,8,debris,6,87,3,3,1
6,8,debut,5,88,3,2,0.75
6,8,deck,4,89,2,2,0.75
6,8,defend,6,90,2,4,4.75
6,8,define,6,91,3,3,1.25
6,8,denial,6,92,2,4,1.5
6,8,depart,6,93,2,4,5.5
6,8,depend,6,94,3,3,1.25
6,8,detail,6,95,2,4,1.5
6,8,dip,3,96,1,2,0.75
6,8,divert,6,97,2,4,6
6,8,donate,6,98,1,5,1.75
6,8,donor,5,99,3,2,1
6,8,door,4,100,2,2,1
6,8,draw,4,101,1,3,1
6,8,dress,5,102,2,3,5.25
6,8,drown,5,103,2,3,1.25
6,8,drum,4,104,2,2,1
6,8,due,3,105,1,2,0.75
6,8,dump,4,106,2,2,0.75
6,8,duty,4,107,2,2,5
6,8,east,4,108,0,4,1.25
6,8,easy,4,109,3,1,0.5
6,8,eat,3,110,2,1,0.5
6,8,emerge,6,111,1,5,1.75
6,8,empty,5,112,2,3,5.5
6,8,enrol,5,113,1,4,1.25
6,8,entire,6,114,2,4,1.5
6,8,equal,5,115,1,4,3.25
6,8,era,3,116,1,2,2.75
6,8,escape,6,117,1,5,1.75
6,8,ethic,5,118,1,4,1.25
6,8,ethnic,6,119,3,3,5
6,8,every,5,120,1,4,1.5
6,8,evolve,6,121,2,4,1.5
6,8,exam,4,122,1,3,1
6,8,except,6,123,2,4,5.25
6,8,excess,6,124,4,2,1.25
6,8,exert,5,125,2,3,1
6,8,exotic,6,126,2,4,1.25
6,8,expect,6,127,2,4,5
6,8,fame,4,128,0,4,1.25
6,8,fan,3,129,2,1,0.5
6,8,farm,4,130,2,2,0.75
6,8,feed,4,131,1,3,0.75
6,8,fifth,5,132,1,4,5.25
6,8,figure,6,133,2,4,1.5
6,8,fill,4,134,2,2,0.75
6,8,find,4,135,2,2,0.75
6,8,finger,6,136,3,3,4.75
6,8,finish,6,137,3,3,1.25
6,8,first,5,138,2,3,1
6,8,fit,3,139,2,1,0.5
6,8,five,4,140,2,2,0.75
6,8,flame,5,141,1,4,4.5
6,8,flawed,6,142,3,3,1.25
6,8,fleet,5,143,2,3,1
6,8,float,5,144,2,3,1
6,8,flood,5,145,3,2,1
6,8,flour,5,146,3,2,1
6,8,follow,6,147,1,5,152.75
6,8,fond,4,148,2,2,2.25
6,8,forest,6,149,2,4,3.25
6,8,forge,5,150,3,2,2.25
6,8,fork,4,151,3,1,1.5
6,8,format,6,152,3,3,3
6,8,frame,5,153,1,4,9
6,8,freely,6,154,2,4,2.25
6,8,freeze,6,155,4,2,1.5
6,8,from,4,156,2,2,1.75
6,8,fruit,5,157,2,3,7.25
6,8,fully,5,158,1,4,2.75
6,8,funny,5,159,2,3,1.5
6,8,gang,4,160,0,4,1.5
6,8,garden,6,161,2,4,7.25
6,8,goal,4,162,1,3,1
6,8,golden,6,163,2,4,1.5
6,8,grand,5,164,1,4,4.25
6,8,great,5,165,2,3,1.25
6,8,guard,5,166,1,4,1.5
6,8,half,4,167,0,4,1.25
6,8,halt,4,168,3,1,0.5
6,8,happy,5,169,2,3,4.75
6,8,hardly,6,170,2,4,1.5
6,8,hear,4,171,1,3,1
6,8,hidden,6,172,1,5,4.5
6,8,hockey,6,173,1,5,1.5
6,8,hold,4,174,2,2,0.75
6,8,holy,4,175,3,1,0.75
6,8,honour,6,176,2,4,1.25
6,8,hook,4,177,2,2,3.75
6,8,hungry,6,178,1,5,1.5
6,8,if,2,179,0,2,0.5
6,8,impact,6,180,1,5,4.5
6,8,in,2,181,1,1,0.5
6,8,indoor,6,182,2,4,1.25
6,8,infect,6,183,2,4,1.25
6,8,input,5,184,2,3,1
6,8,insult,6,185,2,4,4.25
6,8,invent,6,186,2,4,1.25
6,8,jeans,5,187,0,5,1.25
6,8,join,4,188,1,3,4
6,8,joint,5,189,4,1,0.75
6,8,keen,4,190,0,4,1
6,8,kind,4,191,1,3,1
6,8,knock,5,192,1,4,4
6,8,labour,6,193,0,6,1.75
6,8,lady,4,194,2,2,0.75
6,8,lamp,4,195,2,2,0.75
6,8,laptop,6,196,2,4,4.25
6,8,lawyer,6,197,2,4,1.25
6,8,lead,4,198,1,3,1
6,8,leap,4,199,3,1,0.5
6,8,learn,5,200,3,2,0.75
6,8,leave,5,201,3,2,1
6,8,legal,5,202,2,3,4.25
6,8,less,4,203,2,2,0.75
6,8,lesson,6,204,4,2,1
6,8,let,3,205,2,1,0.5
6,8,level,5,206,2,3,1
6,8,linger,6,207,1,5,5
6,8,lively,6,208,2,4,1.5
6,8,lobby,5,209,1,4,1.25
6,8,loom,4,210,2,2,1
6,8,loop,4,211,3,1,4.5
6,8,lose,4,212,2,2,1
6,8,loss,4,213,3,1,0.75
6,8,lost,4,214,3,1,0.75
6,8,lovely,6,215,2,4,1.25
6,8,lower,5,216,2,3,1.25
6,8,major,5,217,0,5,7.25
6,8,mall,4,218,2,2,1.75
6,8,manner,6,219,2,4,3
6,8,marker,6,220,2,4,3
6,8,marry,5,221,3,2,7.25
6,8,maths,5,222,2,3,2.25
6,8,means,5,223,1,4,2.75
6,8,metal,5,224,2,3,2.25
6,8,mile,4,225,1,3,7.25
6,8,milk,4,226,3,1,1.25
6,8,mill,4,227,3,1,1.25
6,8,mine,4,228,2,2,1.75
6,8,mining,6,229,3,3,2.5
6,8,minute,6,230,3,3,2.5
6,8,mobile,6,231,1,5,8.5
6,8,mode,4,232,2,2,1.75
6,8,modest,6,233,4,2,1.75
6,8,nail,4,234,0,4,2.5
6,8,native,6,235,2,4,8.25
6,8,naval,5,236,2,3,2.25
6,8,nest,4,237,1,3,2
6,8,net,3,238,2,1,1
6,8,ninety,6,239,1,5,8.5
6,8,noble,5,240,1,4,2.75
6,8,nod,3,241,2,1,1
6,8,nose,4,242,2,2,1.75
6,8,number,6,243,1,5,3.25
6,8,nurse,5,244,2,3,7.5
6,8,occur,5,245,0,5,3.25
6,8,onion,5,246,1,4,2.75
6,8,orange,6,247,1,5,8.5
6,8,own,3,248,1,2,1.5
6,8,packet,6,249,0,6,3.75
6,8,pair,4,250,2,2,1.75
6,8,palm,4,251,2,2,6.75
6,8,pan,3,252,2,1,1
6,8,parish,6,253,2,4,2.75
6,8,pass,4,254,2,2,1.75
6,8,peak,4,255,1,3,2
6,8,pill,4,256,1,3,7
6,8,pitch,5,257,2,3,2.5
6,8,plain,5,258,1,4,2.75
6,8,player,6,259,3,3,2.5
6,8,plug,4,260,2,2,1.75
6,8,plunge,6,261,3,3,8
6,8,pocket,6,262,1,5,3.25
6,8,pole,4,263,2,2,1.75
6,8,policy,6,264,3,3,2.5
6,8,pool,4,265,2,2,7
6,8,powder,6,266,2,4,3
6,8,preach,6,267,1,5,3.25
6,8,pretty,6,268,3,3,7.5
6,8,prey,4,269,3,1,1.25
6,8,price,5,270,2,3,2.25
6,8,priest,6,271,3,3,2.5
6,8,prince,6,272,3,3,2.5
6,8,prison,6,273,3,3,2.5
6,8,pub,3,274,1,2,6.75
6,8,punch,5,275,2,3,2.25
6,8,purely,6,276,2,4,2.75
6,8,pursue,6,277,3,3,2.5
6,8,queue,5,278,0,5,8.25
6,8,quote,5,279,2,3,2.25
6,8,radio,5,280,0,5,3.25
6,8,rain,4,281,2,2,7.25
6,8,random,6,282,2,4,3
6,8,range,5,283,3,2,2
6,8,rapid,5,284,2,3,2.25
6,8,raw,3,285,2,1,1
6,8,reader,6,286,1,5,9
6,8,real,4,287,3,1,1.25
6,8,really,6,288,4,2,2
6,8,recipe,6,289,2,4,3
6,8,regret,6,290,2,4,3
6,8,rely,4,291,2,2,7
6,8,rental,6,292,2,4,3
6,8,report,6,293,2,4,2.75
6,8,rhythm,6,294,1,5,8.75
6,8,rice,4,295,1,3,2.25
6,8,role,4,296,1,3,2.25
6,8,route,5,297,2,3,2.25
6,8,run,3,298,1,2,1.5
6,8,sad,3,299,0,3,7.5
6,8,sail,4,300,2,2,1.5
6,8,salary,6,301,2,4,2.75
6,8,scope,5,302,1,4,2.75
6,8,script,6,303,2,4,8.5
6,8,seldom,6,304,1,5,3.25
6,8,senior,6,305,2,4,3
6,8,serial,6,306,2,4,9
6,8,sheet,5,307,1,4,2.75
6,8,shop,4,308,2,2,1.75
6,8,short,5,309,3,2,2
6,8,shot,4,310,3,1,1.25
6,8,shout,5,311,3,2,2
6,8,show,4,312,3,1,6.75
6,8,shrink,6,313,2,4,2.75
6,8,shrug,5,314,3,2,2.25
6,8,silent,6,315,1,5,3.5
6,8,sing,4,316,2,2,7.5
6,8,sir,3,317,2,1,1
6,8,skiing,6,318,1,5,3.5
6,8,skill,5,319,3,2,1.75
6,8,sky,3,320,2,1,1
6,8,slave,5,321,1,4,8
6,8,slot,4,322,2,2,1.75
6,8,slow,4,323,3,1,1.25
6,8,smart,5,324,1,4,2.75
6,8,soak,4,325,1,3,2
6,8,soar,4,326,3,1,1
6,8,soccer,6,327,2,4,8.5
6,8,soft,4,328,2,2,1.75
6,8,son,3,329,2,1,1
6,8,soon,4,330,2,2,1.75
6,8,sort,4,331,2,2,1.75
6,8,span,4,332,1,3,2
6,8,spicy,5,333,2,3,7.5
6,8,spoil,5,334,2,3,2.25
6,8,spy,3,335,2,1,1
6,8,stark,5,336,1,4,2.75
6,8,status,6,337,3,3,2.5
6,8,steep,5,338,2,3,7.75
6,8,stiff,5,339,2,3,2.25
6,8,stream,6,340,2,4,3
6,8,stress,6,341,4,2,2
6,8,stupid,6,342,2,4,8.5
6,8,style,5,343,2,3,2.25
6,8,suffer,6,344,1,5,3.25
6,8,sum,3,345,2,1,1
6,8,swing,5,346,1,4,8
6,8,tent,4,347,0,4,2.5
6,8,that,4,348,1,3,2.25
6,8,theft,5,349,2,3,2.25
6,8,their,5,350,3,2,7
6,8,theirs,6,351,5,1,1.5
6,8,them,4,352,3,1,1.25
6,8,then,4,353,3,1,1
6,8,they,4,354,3,1,1
6,8,thick,5,355,2,3,2.25
6,8,think,5,356,3,2,1.75
6,8,third,5,357,3,2,1.75
6,8,though,6,358,2,4,9
6,8,thrive,6,359,2,4,3
6,8,throat,6,360,3,3,2.5
6,8,timber,6,361,1,5,8.75
6,8,tiny,4,362,2,2,1.75
6,8,tone,4,363,1,3,2
6,8,touch,5,364,2,3,2.25
6,8,true,4,365,1,3,2
6,8,truly,5,366,3,2,7.25
6,8,trust,5,367,3,2,2
6,8,truth,5,368,3,2,2
6,8,tunnel,6,369,1,5,3.25
6,8,turn,4,370,2,2,1.75
6,8,twenty,6,371,1,5,9
6,8,twist,5,372,2,3,2.25
6,8,type,4,373,1,3,2
6,8,ugly,4,374,0,4,8.25
6,8,upper,5,375,1,4,2.75
6,8,us,2,376,1,1,0.75
6,8,use,3,377,2,1,1
6,8,user,4,378,3,1,1
6,8,versus,6,379,0,6,9.75
6,8,wall,4,380,0,4,2.75
6,8,want,4,381,2,2,1.75
6,8,ward,4,382,2,2,1.75
6,8,warm,4,383,3,1,1.25
6,8,weak,4,384,1,3,2
6,8,wear,4,385,3,1,6.75
6,8,web,3,386,2,1,1
6,8,weekly,6,387,2,4,3
6,8,wet,3,388,2,1,1
6,8,while,5,389,1,4,2.75
6,8,wholly,6,390,2,4,8.25
6,8,widely,6,391,1,5,3.25
6,8,wooden,6,392,1,5,3.25
6,8,worm,4,393,2,2,1.75
6,8,worse,5,394,3,2,7.75
6,8,yell,4,395,0,4,2.5
6,8,yours,5,396,1,4,2.75
6,8,zero,4,397,0,4,8
6,9,able,4,0,0,4,2.5
6,9,abroad,6,1,2,4,3
6,9,act,3,2,1,2,1.5
6,9,affair,6,3,1,5,8.75
6,9,afford,6,4,3,3,2.5
6,9,afraid,6,5,2,4,3
6,9,aged,4,6,1,3,8
6,9,agent,5,7,3,2,1.75
6,9,air,3,8,1,2,1.5
6,9,alike,5,9,1,4,2.75
6,9,allege,6,10,2,4,3
6,9,allow,5,11,3,2,8
6,9,alone,5,12,2,3,2.25
6,9,also,4,13,2,2,1.75
6,9,amid,4,14,1,3,2
6,9,answer,6,15,1,5,9.25
6,9,anyone,6,16,2,4,3
6,9,apply,5,17,1,4,2.75
6,9,arena,5,18,1,4,2.75
6,9,array,5,19,2,3,8.5
6,9,assess,6,20,1,5,3.25
6,9,assign,6,21,3,3,2.5
6,9,attend,6,22,1,5,9.5
6,9,audit,5,23,1,4,2.75
6,9,august,6,24,2,4,2.75
6,9,bad,3,25,0,3,2
6,9,ballot,6,26,2,4,9
6,9,basket,6,27,2,4,3
6,9,become,6,28,1,5,3.25
6,9,bee,3,29,2,1,6.5
6,9,bend,4,30,2,2,1.75
6,9,bent,4,31,3,1,1.25
6,9,beside,6,32,2,4,2.75
6,9,bet,3,33,2,1,1
6,9,big,3,34,1,2,1.5
6,9,bleed,5,35,1,4,5.25
6,9,blend,5,36,3,2,1
6,9,blood,5,37,2,3,1
6,9,body,4,38,1,3,1
6,9,bond,4,39,2,2,0.75
6,9,boring,6,40,2,4,4.75
6,9,bounce,6,41,2,4,1.5
6,9,branch,6,42,1,5,1.5
6,9,breast,6,43,2,4,5
6,9,breath,6,44,4,2,1
6,9,broad,5,45,2,3,1
6,9,buck,4,46,1,3,1
6,9,burial,6,47,2,4,5
6,9,bury,4,48,3,1,0.75
6,9,but,3,49,2,1,0.5
6,9,bye,3,50,1,2,0.75
6,9,castle,6,51,0,6,2
6,9,cat,3,52,2,1,0.5
6,9,cattle,6,53,3,3,5
6,9,cause,5,54,2,3,1
6,9,centre,6,55,1,5,1.5
6,9,chance,6,56,1,5,5.25
6,9,chaos,5,57,3,2,1
6,9,charge,6,58,3,3,1.25
6,9,chat,4,59,3,1,0.5
6,9,chest,5,60,2,3,1
6,9,cinema,6,61,1,5,5.25
6,9,class,5,62,1,4,1.25
6,9,clinic,6,63,2,4,1.5
6,9,clue,4,64,2,2,1
6,9,coast,5,65,1,4,4.75
6,9,coin,4,66,2,2,0.75
6,9,combat,6,67,2,4,1.25
6,9,comic,5,68,3,2,1
6,9,cool,4,69,2,2,0.75
6,9,copy,4,70,2,2,4.5
6,9,cotton,6,71,2,4,1.5
6,9,crack,5,72,1,4,1.25
6,9,crash,5,73,3,2,1.25
6,9,crop,4,74,2,2,0.75
6,9,custom,6,75,1,5,5.25
6,9,dad,3,76,0,3,1
6,9,dancer,6,77,2,4,1.5
6,9,dark,4,78,2,2,0.75
6,9,dead,4,79,1,3,4.75
6,9,dear,4,80,3,1,0.5
6,9,debate,6,81,2,4,1.5
6,9,defend,6,82,2,4,1.25
6,9,define,6,83,3,3,4.75
6,9,depart,6,84,2,4,1.5
6,9,depend,6,85,3,3,1.25
6,9,derive,6,86,2,4,1.25
6,9,devise,6,87,2,4,5.25
6,9,die,3,88,1,2,0.75
6,9,differ,6,89,2,4,1.25
6,9,divert,6,90,2,4,1.25
6,9,dog,3,91,1,2,4.5
6,9,donor,5,92,2,3,1
6,9,drag,4,93,1,3,1
6,9,dress,5,94,2,3,1
6,9,drive,5,95,2,3,5.75
6,9,driver,6,96,5,1,1.25
6,9,drown,5,97,2,3,1.25
6,9,drum,4,98,2,2,1
6,9,dull,4,99,1,3,1
6,9,dump,4,100,2,2,0.75
6,9,during,6,101,2,4,5.75
6,9,early,5,102,0,5,1.75
6,9,easily,6,103,2,4,1.5
6,9,easy,4,104,3,1,0.75
6,9,eat,3,105,2,1,4.5
6,9,echo,4,106,1,3,1.25
6,9,edge,4,107,1,3,1
6,9,embed,5,108,1,4,1.5
6,9,empire,6,109,2,4,5
6,9,employ,6,110,3,3,1.5
6,9,energy,6,111,1,5,1.75
6,9,enough,6,112,2,4,1.25
6,9,enrol,5,113,2,3,4.75
6,9,equal,5,114,1,4,1.25
6,9,equip,5,115,3,2,1
6,9,era,3,116,1,2,0.75
6,9,erupt,5,117,2,3,4.75
6,9,escape,6,118,1,5,1.5
6,9,evil,4,119,1,3,1
6,9,evolve,6,120,2,4,1.25
6,9,except,6,121,1,5,5.25
6,9,excess,6,122,4,2,1
6,9,exert,5,123,2,3,1.25
6,9,expect,6,124,2,4,1.25
6,9,fan,3,125,0,3,4.25
6,9,farm,4,126,2,2,0.75
6,9,fence,5,127,1,4,1.25
6,9,fifth,5,128,1,4,1.25
6,9,figure,6,129,2,4,5.25
6,9,filter,6,130,2,4,1.5
6,9,final,5,131,2,3,1.25
6,9,find,4,132,3,1,0.5
6,9,finger,6,133,3,3,4.75
6,9,finish,6,134,3,3,1.25
6,9,fire,4,135,2,2,1
6,9,fish,4,136,2,2,0.75
6,9,flame,5,137,1,4,1.25
6,9,flash,5,138,3,2,5
6,9,flaw,4,139,3,1,0.5
6,9,fleet,5,140,2,3,1
6,9,fluid,5,141,2,3,1
6,9,fond,4,142,1,3,1
6,9,fool,4,143,2,2,0.75
6,9,formal,6,144,2,4,5.25
6,9,format,6,145,5,1,1
6,9,forum,5,146,3,2,1
6,9,frame,5,147,1,4,1.25
6,9,freeze,6,148,2,4,4.75
6,9,from,4,149,2,2,0.75
6,9,fruit,5,150,2,3,1
6,9,fully,5,151,1,4,1.25
6,9,fund,4,152,2,2,0.75
6,9,funny,5,153,3,2,4.75
6,9,gang,4,154,0,4,1.25
6,9,gas,3,155,2,1,0.5
6,9,gentle,6,156,1,5,1.5
6,9,get,3,157,2,1,0.5
6,9,ghost,5,158,1,4,4.75
6,9,glad,4,159,1,3,1
6,9,golden,6,160,1,5,1.5
6,9,grant,5,161,1,4,5
6,9,great,5,162,2,3,1.25
6,9,hand,4,163,0,4,1.25
6,9,happy,5,164,2,3,1
6,9,hatred,6,165,2,4,5.25
6,9,he,2,166,1,1,0.5
6,9,hear,4,167,2,2,0.75
6,9,hello,5,168,2,3,1
6,9,help,4,169,3,1,0.5
6,9,here,4,170,2,2,0.75
6,9,hidden,6,171,1,5,5.25
6,9,hill,4,172,2,2,1
6,9,hockey,6,173,1,5,1.5
6,9,hook,4,174,2,2,0.75
6,9,host,4,175,2,2,4.5
6,9,house,5,176,2,3,1.25
6,9,hungry,6,177,1,5,1.5
6,9,hurry,5,178,2,3,1.25
6,9,if,2,179,0,2,0.5
6,9,ignore,6,180,1,5,5.5
6,9,in,2,181,1,1,0.5
6,9,indoor,6,182,2,4,1.25
6,9,infect,6,183,2,4,4.75
6,9,input,5,184,2,3,1
6,9,insect,6,185,2,4,1.25
6,9,insult,6,186,3,3,1.25
6,9,jam,3,187,0,3,4.75
6,9,jeans,5,188,1,4,1.25
6,9,july,4,189,1,3,1
6,9,keen,4,190,0,4,1.25
6,9,kidnap,6,191,1,5,5.25
6,9,kill,4,192,2,2,1
6,9,kind,4,193,2,2,0.75
6,9,knock,5,194,1,4,1.25
6,9,label,5,195,0,5,5.25
6,9,ladder,6,196,2,4,1.25
6,9,lady,4,197,3,1,0.75
6,9,lamp,4,198,2,2,0.75
6,9,lately,6,199,2,4,4.75
6,9,layout,6,200,2,4,1.5
6,9,lead,4,201,1,3,1
6,9,leap,4,202,3,1,0.5
6,9,leave,5,203,3,2,0.75
6,9,legacy,6,204,2,4,5
6,9,legal,5,205,4,1,0.75
6,9,length,6,206,2,4,1.25
6,9,level,5,207,2,3,1
6,9,limit,5,208,1,4,1.25
6,9,loan,4,209,1,3,5
6,9,lobby,5,210,2,3,1
6,9,lock,4,211,2,2,0.75
6,9,logo,4,212,2,2,0.75
6,9,loom,4,213,2,2,0.75
6,9,loop,4,214,3,1,0.5
6,9,loss,4,215,2,2,4.25
6,9,lost,4,216,3,1,0.75
6,9,lovely,6,217,2,4,1.25
6,9,lower,5,218,2,3,1
6,9,lung,4,219,1,3,1
6,9,major,5,220,0,5,5.25
6,9,mall,4,221,2,2,0.75
6,9,march,5,222,2,3,1
6,9,mate,4,223,2,2,0.75
6,9,maybe,5,224,2,3,4.75
6,9,menu,4,225,1,3,1
6,9,metal,5,226,2,3,1.25
6,9,mill,4,227,1,3,1
6,9,minute,6,228,2,4,5.25
6,9,mobile,6,229,1,5,1.5
6,9,modern,6,230,2,4,1.25
6,9,monk,4,231,2,2,0.75
6,9,motive,6,232,2,4,5
6,9,mount,5,233,2,3,1
6,9,nail,4,234,0,4,1
6,9,news,4,235,1,3,1
6,9,next,4,236,2,2,4.75
6,9,noon,4,237,1,3,1
6,9,now,3,238,2,1,0.5
6,9,number,6,239,1,5,1.5
6,9,obey,4,240,0,4,7
6,9,object,6,241,2,4,427.25
6,9,onion,5,242,1,4,4.5
6,9,onto,4,243,2,2,4.5
6,9,orange,6,244,1,5,6.5
6,9,order,5,245,2,3,16.75
6,9,out,3,246,1,2,3.5
6,9,owner,5,247,1,4,6.25
6,9,pair,4,248,0,4,6.25
6,9,pan,3,249,2,1,2.75
6,9,parent,6,250,2,4,14.75
6,9,parish,6,251,3,3,5.25
6,9,party,5,252,3,2,3.5
6,9,peak,4,253,1,3,2.75
6,9,person,6,254,2,4,10.25
6,9,pill,4,255,1,3,2.25
6,9,pink,4,256,2,2,1.75
6,9,pit,3,257,2,1,1
6,9,pitch,5,258,3,2,1.75
6,9,plain,5,259,1,4,7.75
6,9,planet,6,260,3,3,2.75
6,9,plate,5,261,3,2,2
6,9,plug,4,262,2,2,1.75
6,9,plunge,6,263,3,3,3
6,9,poet,4,264,1,3,7.5
6,9,poetry,6,265,4,2,1.75
6,9,pole,4,266,2,2,1.75
6,9,policy,6,267,3,3,2.5
6,9,port,4,268,2,2,1.75
6,9,pose,4,269,2,2,1.5
6,9,pray,4,270,1,3,7.75
6,9,prefer,6,271,2,4,3.5
6,9,prince,6,272,2,4,3
6,9,pub,3,273,1,2,1.5
6,9,pursue,6,274,2,4,8
6,9,queen,5,275,0,5,3.25
6,9,quote,5,276,2,3,2.25
6,9,racist,6,277,0,6,9
6,9,radio,5,278,2,3,2.5
6,9,rain,4,279,2,2,1.75
6,9,range,5,280,2,3,2.25
6,9,rare,4,281,2,2,1.75
6,9,real,4,282,1,3,7.5
6,9,recipe,6,283,2,4,3
6,9,refuge,6,284,2,4,3
6,9,rely,4,285,2,2,1.75
6,9,rhythm,6,286,1,5,8.75
6,9,rid,3,287,1,2,1.5
6,9,riot,4,288,2,2,1.75
6,9,role,4,289,1,3,2.25
6,9,route,5,290,2,3,7.75
6,9,rugby,5,291,1,4,2.75
6,9,rule,4,292,2,2,1.75
6,9,rumour,6,293,2,4,3
6,9,run,3,294,2,1,1
6,9,runner,6,295,3,3,7.5
6,9,saint,5,296,0,5,3.25
6,9,salary,6,297,2,4,3
6,9,scale,5,298,1,4,8.25
6,9,scope,5,299,2,3,2.75
6,9,scream,6,300,2,4,3
6,9,sea,3,301,1,2,1.5
6,9,see,3,302,2,1,1
6,9,seldom,6,303,2,4,8
6,9,self,4,304,3,1,1.25
6,9,serial,6,305,2,4,3
6,9,set,3,306,2,1,1
6,9,shade,5,307,1,4,3
6,9,shadow,6,308,4,2,8.75
6,9,shake,5,309,3,2,2
6,9,shall,5,310,3,2,1.75
6,9,shaped,6,311,3,3,2.5
6,9,shine,5,312,2,3,2.25
6,9,shock,5,313,2,3,8.5
6,9,shot,4,314,3,1,1.5
6,9,shout,5,315,3,2,2
6,9,shrink,6,316,2,4,3
6,9,sing,4,317,1,3,2
6,9,sixty,5,318,2,3,8.5
6,9,skiing,6,319,1,5,3.25
6,9,sleep,5,320,1,4,2.75
6,9,slot,4,321,2,2,1.75
6,9,snap,4,322,1,3,8
6,9,soak,4,323,1,3,2.25
6,9,soar,4,324,3,1,1
6,9,soccer,6,325,2,4,3
6,9,soft,4,326,2,2,1.75
6,9,solely,6,327,2,4,9.25
6,9,spicy,5,328,1,4,3
6,9,spill,5,329,3,2,2
6,9,spoil,5,330,2,3,2.75
6,9,spoon,5,331,3,2,2
6,9,sport,5,332,3,2,7.5
6,9,spot,4,333,3,1,1.25
6,9,spy,3,334,2,1,1
6,9,stark,5,335,1,4,4.25
6,9,steep,5,336,2,3,2.5
6,9,stiff,5,337,2,3,8.75
6,9,stupid,6,338,2,4,3.25
6,9,style,5,339,2,3,2.5
6,9,suffer,6,340,1,5,3.75
6,9,sum,3,341,2,1,7.75
6,9,summit,6,342,3,3,2.5
6,9,t,1,343,0,1,0.75
6,9,teach,5,344,1,4,2.75
6,9,tell,4,345,2,2,1.75
6,9,tent,4,346,2,2,1.75
6,9,tenure,6,347,3,3,8.75
6,9,text,4,348,2,2,1.75
6,9,them,4,349,1,3,2.25
6,9,then,4,350,3,1,1
6,9,there,5,351,3,2,1.75
6,9,thick,5,352,2,3,2.25
6,9,thief,5,353,3,2,7.25
6,9,third,5,354,3,2,1.75
6,9,throw,5,355,2,3,1.75
6,9,tiny,4,356,1,3,1.5
6,9,tired,5,357,2,3,1.5
6,9,ton,3,358,1,2,4.25
6,9,tongue,6,359,3,3,1
6,9,total,5,360,2,3,1
6,9,touch,5,361,2,3,1
6,9,towel,5,362,2,3,4.25
6,9,truly,5,363,1,4,1.25
6,9,unfold,6,364,0,6,1.75
6,9,unit,4,365,2,2,1
6,9,up,2,366,1,1,0.5
6,9,us,2,367,1,1,3.75
6,9,used,4,368,2,2,0.75
6,9,user,4,369,3,1,0.5
6,9,valid,5,370,0,5,1.5
6,9,vast,4,371,2,2,0.75
6,9,very,4,372,1,3,4.25
6,9,volume,6,373,1,5,1.5
6,9,wage,4,374,0,4,1.25
6,9,wall,4,375,2,2,0.75
6,9,warm,4,376,2,2,4.5
6,9,weak,4,377,1,3,1.25
6,9,web,3,378,2,1,0.5
6,9,weekly,6,379,2,4,1.25
6,9,well,4,380,2,2,0.75
6,9,wet,3,381,2,1,0.5
6,9,what,4,382,1,3,4.25
6,9,wheat,5,383,2,3,1.25
6,9,who,3,384,2,1,0.5
6,9,winner,6,385,1,5,1.5
6,9,winter,6,386,3,3,4.5
6,9,wish,4,387,2,2,1
6,9,wooden,6,388,1,5,1.5
6,9,worm,4,389,2,2,0.75
6,9,worse,5,390,3,2,1
6,9,worst,5,391,4,1,0.75
6,9,wound,5,392,2,3,4.5
6,9,writer,6,393,1,5,1.5
6,9,wrong,5,394,2,3,1.25
6,9,year,4,395,0,4,4.75
6,9,yell,4,396,2,2,0.75
6,9,zero,4,397,0,4,1.25
7,0,ability,7,0,0,7,5.25
7,0,absent,6,1,2,4,1.25
7,0,academy,7,2,1,6,1.75
7,0,access,6,3,2,4,4.75
7,0,adhere,6,4,1,5,1.5
7,0,advance,7,5,2,5,1.5
7,0,afford,6,6,1,5,4.75
7,0,afraid,6,7,2,4,1.5
7,0,air,3,8,1,2,0.75
7,0,alert,5,9,1,4,4.5
7,0,all,3,10,2,1,0.5
7,0,allow,5,11,3,2,0.75
7,0,alone,5,12,2,3,1
7,0,along,5,13,4,1,0.5
7,0,amid,4,14,1,3,0.75
7,0,angel,5,15,1,4,4.5
7,0,angry,5,16,3,2,1
7,0,apart,5,17,1,4,1.25
7,0,apple,5,18,2,3,1
7,0,apply,5,19,4,1,0.5
7,0,april,5,20,2,3,4.5
7,0,arena,5,21,1,4,1.25
7,0,armed,5,22,2,3,1.25
7,0,arrival,7,23,2,5,5
7,0,athlete,7,24,1,6,1.75
7,0,attach,6,25,2,4,1.75
7,0,attend,6,26,3,3,1.25
7,0,audit,5,27,1,4,4.75
7,0,august,6,28,2,4,1.5
7,0,author,6,29,2,4,1.5
7,0,autumn,6,30,3,3,4.75
7,0,back,4,31,0,4,1.25
7,0,bad,3,32,2,1,0.5
7,0,bake,4,33,2,2,0.75
7,0,banana,6,34,2,4,1.25
7,0,bare,4,35,2,2,4.25
7,0,basis,5,36,2,3,1
7,0,bear,4,37,1,3,1
7,0,become,6,38,2,4,1.25
7,0,behind,6,39,2,4,5
7,0,being,5,40,2,3,1
7,0,big,3,41,1,2,0.75
7,0,biology,7,42,2,5,1.5
7,0,blast,5,43,1,4,4.75
7,0,bleed,5,44,2,3,1
7,0,blood,5,45,2,3,1
7,0,body,4,46,1,3,1
7,0,bold,4,47,2,2,4.25
7,0,bonus,5,48,2,3,1
7,0,booking,7,49,2,5,1.5
7,0,born,4,50,2,2,0.75
7,0,bounce,6,51,2,4,4.75
7,0,breath,6,52,1,5,1.5
7,0,briefly,7,53,2,5,1.75
7,0,bring,5,54,3,2,1
7,0,brother,7,55,2,5,5
7,0,bulk,4,56,1,3,1
7,0,burial,6,57,2,4,1.25
7,0,bus,3,58,2,1,0.5
7,0,busy,4,59,3,1,4
7,0,but,3,60,2,1,0.5
7,0,button,6,61,3,3,1.25
7,0,bye,3,62,1,2,0.75
7,0,calm,4,63,0,4,1.25
7,0,capture,7,64,2,5,5.5
7,0,castle,6,65,2,4,1.25
7,0,cent,4,66,1,3,1
7,0,chance,6,67,1,5,5
7,0,chaos,5,68,3,2,1
7,0,charge,6,69,3,3,1.25
7,0,chat,4,70,3,1,0.5
7,0,cheek,5,71,2,3,1
7,0,chef,4,72,3,1,0.5
7,0,chest,5,73,3,2,1.25
7,0,cinema,6,74,1,5,5.25
7,0,claim,5,75,1,4,1.25
7,0,clarify,7,76,3,4,1.5
7,0,class,5,77,3,2,4.5
7,0,climate,7,78,2,5,1.75
7,0,cloth,5,79,2,3,1.25
7,0,clothes,7,80,5,2,1
7,0,coin,4,81,1,3,5
7,0,college,7,82,2,5,1.75
7,0,colour,6,83,3,3,1.25
7,0,combat,6,84,2,4,1.25
7,0,combine,7,85,4,3,5.25
7,0,comic,5,86,3,2,1
7,0,commit,6,87,3,3,1.25
7,0,compare,7,88,3,4,1.5
7,0,compose,7,89,4,3,5
7,0,confirm,7,90,2,5,1.5
7,0,confuse,7,91,4,3,1.25
7,0,consume,7,92,3,4,1.5
7,0,contact,7,93,3,4,5
7,0,contest,7,94,4,3,1.25
7,0,convert,7,95,3,4,1.25
7,0,cook,4,96,2,2,0.75
7,0,cool,4,97,3,1,4
7,0,corrupt,7,98,2,5,1.75
7,0,council,7,99,2,5,1.75
7,0,covered,7,100,2,5,5
7,0,crack,5,101,1,4,1.25
7,0,crash,5,102,3,2,1
7,0,creator,7,103,2,5,1.5
7,0,crop,4,104,2,2,4.25
7,0,crown,5,105,3,2,1
7,0,cue,3,106,1,2,0.75
7,0,custom,6,107,2,4,1.25
7,0,dancer,6,108,0,6,5.25
7,0,dark,4,109,2,2,0.75
7,0,date,4,110,2,2,0.75
7,0,deadly,6,111,1,5,1.5
7,0,debris,6,112,2,4,5
7,0,debut,5,113,3,2,1
7,0,defeat,6,114,2,4,1.5
7,0,depend,6,115,2,4,1.25
7,0,depict,6,116,3,3,5
7,0,desire,6,117,2,4,1.5
7,0,destroy,7,118,3,4,1.5
7,0,devise,6,119,2,4,1.25
7,0,diary,5,120,1,4,8.25
7,0,differ,6,121,2,4,2.25
7,0,dip,3,122,2,1,1
7,0,discard,7,123,2,5,7
7,0,dispute,7,124,3,4,2.75
7,0,disturb,7,125,3,4,2.25
7,0,donate,6,126,1,5,2.25
7,0,dose,4,127,2,2,6.25
7,0,drain,5,128,1,4,2.25
7,0,dress,5,129,2,3,1.25
7,0,drive,5,130,2,3,1.25
7,0,driver,6,131,5,1,0.75
7,0,drown,5,132,2,3,6
7,0,drug,4,133,2,2,1.75
7,0,due,3,134,1,2,1.5
7,0,dynamic,7,135,1,6,3.75
7,0,each,4,136,0,4,5.75
7,0,easily,6,137,2,4,1.5
7,0,east,4,138,3,1,0.75
7,0,eastern,7,139,4,3,1.5
7,0,easy,4,140,3,1,0.75
7,0,echo,4,141,1,3,4.75
7,0,element,7,142,1,6,1.75
7,0,emerge,6,143,1,5,1.5
7,0,empire,6,144,2,4,5.5
7,0,enough,6,145,1,5,1.5
7,0,entire,6,146,2,4,1.25
7,0,entity,6,147,4,2,5
7,0,equal,5,148,1,4,1.25
7,0,era,3,149,1,2,0.75
7,0,erupt,5,150,2,3,1
7,0,escape,6,151,1,5,5.25
7,0,ethical,7,152,1,6,1.75
7,0,every,5,153,1,4,1.25
7,0,evil,4,154,2,2,4.5
7,0,exam,4,155,1,3,1
7,0,excess,6,156,2,4,1.25
7,0,export,6,157,2,4,1.25
7,0,extract,7,158,2,5,5.25
7,0,fact,4,159,0,4,1
7,0,faction,7,160,4,3,1
7,0,factor,6,161,4,2,0.75
7,0,factory,7,162,6,1,0.5
7,0,faith,5,163,2,3,4.75
7,0,favour,6,164,2,4,1.25
7,0,feat,4,165,1,3,1
7,0,feather,7,166,4,3,1
7,0,feature,7,167,4,3,4.75
7,0,fifth,5,168,1,4,1.25
7,0,fill,4,169,2,2,0.75
7,0,final,5,170,2,3,1
7,0,find,4,171,3,1,0.5
7,0,finish,6,172,3,3,5
7,0,fire,4,173,2,2,0.75
7,0,firearm,7,174,4,3,1
7,0,fish,4,175,2,2,0.75
7,0,fit,3,176,2,1,0.5
7,0,flame,5,177,1,4,5.25
7,0,flaw,4,178,3,1,0.75
7,0,fleet,5,179,2,3,1
7,0,flour,5,180,2,3,1
7,0,forest,6,181,1,5,1.5
7,0,forever,7,182,4,3,5.5
7,0,fork,4,183,3,1,0.5
7,0,format,6,184,3,3,1
7,0,forth,5,185,3,2,0.75
7,0,fossil,6,186,2,4,1.25
7,0,frame,5,187,1,4,5.25
7,0,frankly,7,188,3,4,1.25
7,0,freely,6,189,2,4,1.25
7,0,freeze,6,190,4,2,1
7,0,from,4,191,2,2,4.5
7,0,fully,5,192,1,4,1.25
7,0,fun,3,193,2,1,0.5
7,0,furious,7,194,2,5,1.75
7,0,garden,6,195,0,6,5.5
7,0,get,3,196,1,2,0.75
7,0,ghost,5,197,1,4,1.5
7,0,goal,4,198,1,3,8.5
7,0,grass,5,199,1,4,2.75
7,0,greatly,7,200,2,5,3.5
7,0,half,4,201,0,4,2.5
7,0,halt,4,202,3,1,7
7,0,hand,4,203,2,2,1.5
7,0,harmony,7,204,2,5,3.5
7,0,he,2,205,1,1,0.75
7,0,hear,4,206,2,2,1.5
7,0,hearing,7,207,4,3,8.25
7,0,heating,7,208,3,4,3.25
7,0,heavily,7,209,3,4,3
7,0,helmet,6,210,2,4,2.75
7,0,hidden,6,211,1,5,9.5
7,0,hide,4,212,3,1,1.25
7,0,highway,7,213,2,5,3.5
7,0,hold,4,214,1,3,2
7,0,honour,6,215,2,4,9.25
7,0,hostile,7,216,2,5,3.75
7,0,house,5,217,2,3,2.25
7,0,hungry,6,218,1,5,10
7,0,ignore,6,219,0,6,3.75
7,0,imagine,7,220,1,6,10.25
7,0,immense,7,221,2,5,3.5
7,0,impress,7,222,2,5,3.5
7,0,indoors,7,223,1,6,10
7,0,indulge,7,224,3,4,3
7,0,infect,6,225,2,4,2.75
7,0,insect,6,226,2,4,8.75
7,0,insight,7,227,3,4,3
7,0,insult,6,228,3,3,2.5
7,0,invoke,6,229,2,4,9
7,0,jam,3,230,0,3,2
7,0,join,4,231,1,3,2.25
7,0,joint,5,232,4,1,1
7,0,july,4,233,1,3,2.25
7,0,kill,4,234,0,4,8.5
7,0,kind,4,235,2,2,1.75
7,0,knock,5,236,1,4,3
7,0,label,5,237,0,5,3.25
7,0,labour,6,238,3,3,12.75
7,0,ladder,6,239,2,4,2.75
7,0,laptop,6,240,2,4,2.75
7,0,lawyer,6,241,2,4,9.25
7,0,layout,6,242,2,4,3
7,0,lead,4,243,1,3,2.25
7,0,leap,4,244,3,1,1
7,0,learn,5,245,3,2,1.75
7,0,leave,5,246,3,2,1.75
7,0,leisure,7,247,2,5,10.75
7,0,lend,4,248,2,2,1.75
7,0,length,6,249,3,3,2.5
7,0,lesson,6,250,2,4,3
7,0,let,3,251,2,1,8.25
7,0,light,5,252,1,4,2.75
7,0,limit,5,253,2,3,2.5
7,0,linger,6,254,2,4,3.25
7,0,logo,4,255,1,3,8.75
7,0,loom,4,256,2,2,1.75
7,0,loop,4,257,3,1,1.25
7,0,lose,4,258,2,2,1.75
7,0,loss,4,259,3,1,1.25
7,0,lovely,6,260,2,4,3.25
7,0,lower,5,261,2,3,8.5
7,0,luck,4,262,1,3,2.25
7,0,magical,7,263,0,7,4.5
7,0,mall,4,264,2,2,1.75
7,0,march,5,265,2,3,8.75
7,0,marker,6,266,3,3,2.5
7,0,massive,7,267,2,5,3.5
7,0,mate,4,268,2,2,1.5
7,0,matter,6,269,3,3,8.75
7,0,me,2,270,1,1,1
7,0,measure,7,271,2,5,3.5
7,0,meet,4,272,2,2,1.5
7,0,menu,4,273,2,2,1.5
7,0,metal,5,274,2,3,8.25
7,0,miner,5,275,1,4,2.75
7,0,minor,5,276,3,2,1.75
7,0,miracle,7,277,2,5,3.5
7,0,missile,7,278,2,5,9.75
7,0,mistake,7,279,3,4,3
7,0,mobile,6,280,1,5,9.5
7,0,moral,5,281,2,3,2.5
7,0,motive,6,282,2,4,3
7,0,motor,5,283,3,2,1.75
7,0,mount,5,284,2,3,2.25
7,0,naval,5,285,0,5,9.5
7,0,news,4,286,1,3,2.25
7,0,next,4,287,2,2,1.75
7,0,nod,3,288,1,2,1.5
7,0,notable,7,289,2,5,10
7,0,now,3,290,2,1,1.25
7,0,nursery,7,291,1,6,4
7,0,obey,4,292,0,4,10.5
7,0,object,6,293,2,4,3
7,0,obvious,7,294,2,5,3.5
7,0,of,2,295,1,1,0.75
7,0,offer,5,296,2,3,2.25
7,0,ongoing,7,297,1,6,10.5
7,0,onion,5,298,2,3,2.25
7,0,onto,4,299,2,2,1.75
7,0,open,4,300,1,3,8.25
7,0,operate,7,301,3,4,3.25
7,0,opinion,7,302,2,5,3.5
7,0,or,2,303,1,1,0.75
7,0,our,3,304,1,2,1.5
7,0,out,3,305,2,1,7.75
7,0,outrage,7,306,3,4,3.5
7,0,oven,4,307,1,3,2
7,0,over,4,308,3,1,1
7,0,overly,6,309,4,2,1.75
7,0,owner,5,310,1,4,8.75
7,0,pair,4,311,0,4,2.5
7,0,palm,4,312,2,2,1.75
7,0,paper,5,313,2,3,2.5
7,0,partly,6,314,2,4,9.25
7,0,party,5,315,4,1,1.5
7,0,pass,4,316,2,2,1.5
7,0,passage,7,317,4,3,2.25
7,0,passing,7,318,4,3,2.25
7,0,passion,7,319,5,2,2
7,0,pathway,7,320,2,5,9.75
7,0,payment,7,321,2,5,3.5
7,0,peak,4,322,1,3,2
7,0,penalty,7,323,2,5,9.75
7,0,period,6,324,2,4,2.75
7,0,physics,7,325,1,6,4
7,0,pilot,5,326,1,4,9.5
7,0,pink,4,327,2,2,1.75
7,0,pit,3,328,2,1,1.25
7,0,pitch,5,329,3,2,2
7,0,planet,6,330,1,5,9.75
7,0,plate,5,331,3,2,2.25
7,0,player,6,332,3,3,2.75
7,0,plug,4,333,2,2,1.75
7,0,plunge,6,334,3,3,2.5
7,0,pocket,6,335,1,5,9.75
7,0,pole,4,336,2,2,1.75
7,0,policy,6,337,3,3,2.5
7,0,pool,4,338,2,2,1.5
7,0,pop,3,339,2,1,1
7,0,popular,7,340,3,4,9.25
7,0,port,4,341,2,2,1.5
7,0,portray,7,342,4,3,2.5
7,0,pose,4,343,2,2,1.5
7,0,poverty,7,344,2,5,3.5
7,0,powder,6,345,2,4,9.5
7,0,precede,7,346,1,6,4
7,0,present,7,347,3,4,3
7,0,pretty,6,348,3,3,9
7,0,prey,4,349,3,1,1.25
7,0,pride,5,350,2,3,2.25
7,0,priest,6,351,3,3,2.25
7,0,prince,6,352,3,3,2.75
7,0,prison,6,353,3,3,9.25
7,0,proceed,7,354,2,5,3.5
7,0,promote,7,355,3,4,3
7,0,protein,7,356,3,4,10
7,0,provide,7,357,3,4,3
7,0,punch,5,358,1,4,2.75
7,0,pursue,6,359,2,4,9.75
7,0,qualify,7,360,0,7,4.5
7,0,quietly,7,361,2,5,3.5
7,0,quote,5,362,2,3,9
7,0,range,5,363,0,5,3.25
7,0,rapid,5,364,2,3,2.5
7,0,rare,4,365,2,2,1.75
7,0,reader,6,366,1,5,10.5
7,0,reading,7,367,4,3,2.75
7,0,real,4,368,3,1,1.25
7,0,realize,7,369,4,3,2.5
7,0,receive,7,370,2,5,10.5
7,0,red,3,371,2,1,1
7,0,refuge,6,372,2,4,3
7,0,refugee,7,373,6,1,1.25
7,0,remains,7,374,2,5,9.75
7,0,report,6,375,2,4,3
7,0,respect,7,376,2,5,3.5
7,0,resume,6,377,3,3,2.5
7,0,rhythm,6,378,1,5,10
7,0,rid,3,379,1,2,1.25
7,0,riot,4,380,2,2,1.25
7,0,rock,4,381,1,3,1.25
7,0,role,4,382,2,2,1
7,0,route,5,383,2,3,5.25
7,0,run,3,384,1,2,0.75
7,0,sad,3,385,0,3,1
7,0,saint,5,386,2,3,1
7,0,say,3,387,2,1,0.5
7,0,scope,5,388,1,4,5.25
7,0,scratch,7,389,2,5,1.75
7,0,sea,3,390,1,2,0.75
7,0,see,3,391,2,1,0.5
7,0,seize,5,392,2,3,1
7,0,seldom,6,393,2,4,5.5
7,0,self,4,394,3,1,0.5
7,0,senator,7,395,2,5,1.5
7,0,session,7,396,2,5,5.75
7,0,set,3,397,2,1,0.5
7,0,seventy,7,398,2,5,1.5
7,0,shade,5,399,1,4,1.25
7,0,shake,5,400,3,2,4.75
7,0,shall,5,401,3,2,0.75
7,0,shaped,6,402,3,3,1
7,0,sheet,5,403,2,3,1
7,0,shine,5,404,2,3,1
7,0,short,5,405,2,3,5.5
7,0,should,6,406,3,3,1.25
7,0,shout,5,407,4,1,1
7,0,silence,7,408,1,6,2
7,0,silly,5,409,3,2,1
7,0,sincere,7,410,2,5,5.75
7,0,sing,4,411,3,1,0.5
7,0,sixty,5,412,2,3,1
7,0,size,4,413,2,2,0.75
7,0,skill,5,414,1,4,5.25
7,0,sky,3,415,2,1,0.5
7,0,small,5,416,1,4,1.25
7,0,smart,5,417,3,2,0.75
7,0,solely,6,418,1,5,5.5
7,0,son,3,419,2,1,0.5
7,0,spite,5,420,1,4,1.25
7,0,spoil,5,421,2,3,1
7,0,sponsor,7,422,3,4,1.5
7,0,sport,5,423,3,2,5
7,0,spot,4,424,3,1,0.75
7,0,spy,3,425,2,1,0.5
7,0,squeeze,7,426,1,6,1.75
7,0,status,6,427,1,5,5.75
7,0,steel,5,428,2,3,1
7,0,strive,6,429,2,4,1.25
7,0,student,7,430,2,5,1.5
7,0,suburb,6,431,1,5,5.75
7,0,success,7,432,2,5,1.75
7,0,suffer,6,433,2,4,1.25
7,0,suicide,7,434,2,5,5.75
7,0,summer,6,435,2,4,1.25
7,0,surface,7,436,2,5,5.75
7,0,sustain,7,437,2,5,1.75
7,0,sweet,5,438,1,4,1.25
7,0,swing,5,439,2,3,1
7,0,symbol,6,440,1,5,5.75
7,0,t,1,441,0,1,0.25
7,0,tag,3,442,1,2,0.75
7,0,tax,3,443,2,1,0.5
7,0,teach,5,444,1,4,1.25
7,0,teenage,7,445,2,5,5.75
7,0,tell,4,446,2,2,0.75
7,0,tenure,6,447,2,4,1.25
7,0,testing,7,448,2,5,5.75
7,0,than,4,449,1,3,1
7,0,that,4,450,3,1,0.75
7,0,theatre,7,451,2,5,1.5
7,0,theft,5,452,3,2,1
7,0,them,4,453,3,1,0.75
7,0,then,4,454,3,1,5
7,0,they,4,455,3,1,0.75
7,0,thin,4,456,2,2,0.75
7,0,though,6,457,2,4,1.25
7,0,thought,7,458,6,1,0.5
7,0,thrive,6,459,2,4,1.25
7,0,throat,6,460,3,3,5.5
7,0,throw,5,461,4,1,0.75
7,0,tone,4,462,1,3,1
7,0,tongue,6,463,3,3,1
7,0,touch,5,464,2,3,1
7,0,towel,5,465,2,3,5.25
7,0,trace,5,466,1,4,1.25
7,0,trading,7,467,3,4,1.5
7,0,true,4,468,2,2,0.75
7,0,truly,5,469,3,2,5.25
7,0,trust,5,470,3,2,1
7,0,trustee,7,471,5,2,1
7,0,try,3,472,2,1,0.5
7,0,tunnel,6,473,1,5,1.5
7,0,turn,4,474,2,2,0.75
7,0,twenty,6,475,1,5,6.25
7,0,twist,5,476,2,3,1
7,0,ugly,4,477,0,4,1.25
7,0,unlike,6,478,1,5,5.75
7,0,upper,5,479,1,4,1.25
7,0,upset,5,480,2,3,1.25
7,0,us,2,481,1,1,0.5
7,0,use,3,482,2,1,0.5
7,0,used,4,483,3,1,4.75
7,0,vast,4,484,0,4,1.25
7,0,versus,6,485,1,5,1.5
7,0,vicious,7,486,1,6,6
7,0,violate,7,487,2,5,1.75
7,0,vitamin,7,488,2,5,1.75
7,0,volume,6,489,1,5,5.75
7,0,ward,4,490,0,4,1.25
7,0,warfare,7,491,3,4,1.5
7,0,we,2,492,1,1,0.5
7,0,wear,4,493,2,2,5
7,0,website,7,494,2,5,1.75
7,0,weekly,6,495,2,4,1.25
7,0,well,4,496,2,2,0.75
7,0,wet,3,497,2,1,0.5
7,0,where,5,498,1,4,5.75
7,0,while,5,499,2,3,1.25
7,0,whisper,7,500,3,4,1.75
7,0,who,3,501,2,1,1
7,0,whole,5,502,3,2,8.5
7,0,wholly,6,503,4,2,2.25
7,0,wide,4,504,1,3,2
7,0,widely,6,505,4,2,1.75
7,0,wise,4,506,2,2,1.75
7,0,wooden,6,507,1,5,10
7,0,worse,5,508,2,3,2.25
7,0,worst,5,509,4,1,1.25
7,0,writer,6,510,1,5,3.25
7,0,writing,7,511,4,3,2.5
7,0,wrong,5,512,2,3,9.25
7,0,year,4,513,0,4,2.5
7,0,zero,4,514,0,4,2.5
7,0,zone,4,515,1,3,9
7,1,ability,7,0,0,7,4.5
7,1,able,4,1,2,2,1.75
7,1,abolish,7,2,2,5,10.25
7,1,about,5,3,3,2,2
7,1,above,5,4,3,2,2
7,1,abroad,6,5,2,4,2.75
7,1,access,6,6,1,5,10
7,1,acquire,7,7,2,5,3.5
7,1,affair,6,8,1,5,3.25
7,1,afford,6,9,3,3,9.75
7,1,agent,5,10,1,4,2.75
7,1,alert,5,11,1,4,2.75
7,1,alike,5,12,2,3,2.25
7,1,allow,5,13,2,3,9.25
7,1,alone,5,14,2,3,2.75
7,1,amid,4,15,1,3,2.25
7,1,angel,5,16,1,4,2.75
7,1,angry,5,17,3,2,8.75
7,1,answer,6,18,2,4,3
7,1,anyone,6,19,2,4,3
7,1,apart,5,20,1,4,9.75
7,1,appoint,7,21,2,5,3.5
7,1,april,5,22,2,3,2.25
7,1,archive,7,23,1,6,11.25
7,1,arena,5,24,2,3,2.25
7,1,array,5,25,2,3,2.25
7,1,arrival,7,26,3,4,3
7,1,assess,6,27,1,5,10.75
7,1,asset,5,28,4,1,1.25
7,1,athlete,7,29,1,6,4
7,1,attempt,7,30,2,5,10.75
7,1,attend,6,31,4,2,2.25
7,1,august,6,32,1,5,3.25
7,1,avoid,5,33,1,4,2.75
7,1,back,4,34,0,4,9.75
7,1,bad,3,35,2,1,1
7,1,banana,6,36,2,4,2.75
7,1,barrier,7,37,2,5,3.5
7,1,basis,5,38,2,3,9.25
7,1,basket,6,39,3,3,2.5
7,1,bean,4,40,1,3,2
7,1,bee,3,41,2,1,1
7,1,being,5,42,2,3,2.25
7,1,beside,6,43,2,4,10
7,1,bet,3,44,2,1,1
7,1,big,3,45,1,2,1.5
7,1,biology,7,46,2,5,3.5
7,1,blast,5,47,1,4,9.75
7,1,bleed,5,48,2,3,2.5
7,1,blend,5,49,3,2,2
7,1,bold,4,50,1,3,2
7,1,bonus,5,51,2,3,2.25
7,1,booking,7,52,2,5,10.75
7,1,boring,6,53,2,4,3
7,1,born,4,54,3,1,1.25
7,1,brick,5,55,1,4,2.75
7,1,broad,5,56,2,3,18.5
7,1,broadly,7,57,5,2,131.75
7,1,brown,5,58,3,2,3.25
7,1,bulk,4,59,1,3,2.75
7,1,burial,6,60,2,4,4.25
7,1,burst,5,61,3,2,5
7,1,bury,4,62,3,1,11.25
7,1,bus,3,63,2,1,1.5
7,1,busy,4,64,3,1,1.5
7,1,button,6,65,2,4,4
7,1,cabinet,7,66,0,7,13.25
7,1,calm,4,67,2,2,1.75
7,1,camp,4,68,2,2,1.5
7,1,capture,7,69,2,5,2.5
7,1,carrot,6,70,2,4,1.75
7,1,cattle,6,71,2,4,5.75
7,1,cause,5,72,2,3,1.25
7,1,chaos,5,73,1,4,1.5
7,1,charge,6,74,3,3,5.25
7,1,cheek,5,75,2,3,1.5
7,1,chest,5,76,3,2,1.25
7,1,cinema,6,77,1,5,2
7,1,civic,5,78,2,3,9.25
7,1,clarify,7,79,1,6,2.25
7,1,class,5,80,3,2,1.25
7,1,classic,7,81,5,2,1.25
7,1,climb,5,82,2,3,1.5
7,1,clip,4,83,3,1,9.25
7,1,close,5,84,2,3,1.25
7,1,clothes,7,85,3,4,2
7,1,coast,5,86,1,4,1.75
7,1,coastal,7,87,5,2,10.5
7,1,colour,6,88,2,4,2
7,1,combine,7,89,2,5,2
7,1,comic,5,90,3,2,1
7,1,common,6,91,3,3,4.5
7,1,compose,7,92,3,4,1.5
7,1,confirm,7,93,2,5,1.75
7,1,consist,7,94,3,4,5
7,1,consume,7,95,4,3,1.5
7,1,contact,7,96,3,4,1.5
7,1,context,7,97,4,3,1.25
7,1,convert,7,98,3,4,4.75
7,1,convict,7,99,4,3,1.5
7,1,cook,4,100,2,2,0.75
7,1,cool,4,101,3,1,0.5
7,1,copy,4,102,2,2,0.75
7,1,corrupt,7,103,2,5,5
7,1,costume,7,104,2,5,1.75
7,1,cotton,6,105,2,4,1.5
7,1,cow,3,106,2,1,0.5
7,1,cream,5,107,1,4,4.75
7,1,creator,7,108,4,3,1.25
7,1,crop,4,109,2,2,0.75
7,1,crown,5,110,3,2,1
7,1,crystal,7,111,2,5,5.5
7,1,custody,7,112,1,6,2
7,1,dark,4,113,0,4,1.5
7,1,date,4,114,2,2,1
7,1,dead,4,115,1,3,4.75
7,1,dear,4,116,3,1,0.75
7,1,debris,6,117,2,4,1.5
7,1,defeat,6,118,2,4,1.25
7,1,define,6,119,3,3,4.75
7,1,denial,6,120,2,4,1.5
7,1,depart,6,121,2,4,1.25
7,1,depend,6,122,3,3,1.25
7,1,depict,6,123,3,3,4.5
7,1,derive,6,124,2,4,2
7,1,descent,7,125,2,5,1.5
7,1,desert,6,126,3,3,1.25
7,1,detail,6,127,2,4,5
7,1,devise,6,128,2,4,1.5
7,1,dip,3,129,1,2,0.75
7,1,disease,7,130,2,5,5.25
7,1,dispute,7,131,3,4,1.5
7,1,divert,6,132,2,4,1.5
7,1,divorce,7,133,3,4,1.5
7,1,dog,3,134,1,2,4.25
7,1,door,4,135,2,2,1
7,1,dose,4,136,2,2,0.75
7,1,draw,4,137,1,3,1
7,1,dress,5,138,2,3,1
7,1,drive,5,139,2,3,4.5
7,1,driver,6,140,5,1,1
7,1,drown,5,141,2,3,1
7,1,drug,4,142,2,2,0.75
7,1,drunk,5,143,3,2,1
7,1,dry,3,144,2,1,0.5
7,1,dull,4,145,1,3,4.5
7,1,during,6,146,2,4,1.75
7,1,dynamic,7,147,1,6,2
7,1,east,4,148,0,4,4.75
7,1,echo,4,149,1,3,1
7,1,economy,7,150,2,5,1.75
7,1,edge,4,151,1,3,1
7,1,element,7,152,1,6,5.5
7,1,else,4,153,2,2,1
7,1,emerge,6,154,1,5,1.5
7,1,empty,5,155,2,3,4.25
7,1,endorse,7,156,1,6,2
7,1,enough,6,157,2,4,1.5
7,1,enrol,5,158,2,3,4.25
7,1,entire,6,159,2,4,1.5
7,1,equal,5,160,1,4,1.25
7,1,error,5,161,1,4,1.25
7,1,ethic,5,162,1,4,4.25
7,1,ethical,7,163,5,2,1
7,1,ethnic,6,164,3,3,1.25
7,1,evil,4,165,1,3,1
7,1,exam,4,166,1,3,3.75
7,1,excess,6,167,2,4,1.25
7,1,exclude,7,168,3,4,1.5
7,1,exert,5,169,2,3,1
7,1,expect,6,170,2,4,4.25
7,1,export,6,171,3,3,1.25
7,1,faction,7,172,0,7,2
7,1,fan,3,173,2,1,3.5
7,1,favour,6,174,2,4,1.5
7,1,feat,4,175,1,3,1
7,1,feather,7,176,4,3,1
7,1,feed,4,177,2,2,0.75
7,1,figure,6,178,1,5,5
7,1,fill,4,179,2,2,1
7,1,filter,6,180,3,3,1.25
7,1,find,4,181,2,2,0.75
7,1,finger,6,182,3,3,4.25
7,1,fire,4,183,2,2,0.75
7,1,firearm,7,184,4,3,1.25
7,1,five,4,185,2,2,0.75
7,1,flame,5,186,1,4,1.25
7,1,flash,5,187,3,2,4
7,1,flawed,6,188,3,3,1.25
7,1,float,5,189,2,3,1
7,1,flour,5,190,3,2,0.75
7,1,fluid,5,191,2,3,1
7,1,fond,4,192,1,3,4
7,1,forest,6,193,2,4,1.5
7,1,forge,5,194,3,2,1
7,1,forgive,7,195,4,3,1.25
7,1,fork,4,196,3,1,0.5
7,1,forth,5,197,3,2,3.75
7,1,frame,5,198,1,4,1.25
7,1,freely,6,199,2,4,1.25
7,1,from,4,200,2,2,0.75
7,1,fruit,5,201,2,3,1
7,1,fun,3,202,1,2,4
7,1,fund,4,203,3,1,0.5
7,1,gang,4,204,0,4,1
7,1,garden,6,205,2,4,1.25
7,1,goal,4,206,1,3,4
7,1,grass,5,207,1,4,1.25
7,1,guard,5,208,1,4,1.25
7,1,half,4,209,0,4,1
7,1,hand,4,210,2,2,4
7,1,happy,5,211,2,3,1
7,1,heavily,7,212,1,6,1.75
7,1,helmet,6,213,2,4,4.5
7,1,help,4,214,3,1,0.75
7,1,here,4,215,2,2,0.75
7,1,hide,4,216,1,3,1
7,1,hill,4,217,2,2,0.75
7,1,hobby,5,218,1,4,1.25
7,1,holy,4,219,2,2,4
7,1,honour,6,220,2,4,1.5
7,1,hook,4,221,2,2,0.75
7,1,hope,4,222,2,2,0.75
7,1,host,4,223,2,2,0.75
7,1,hungry,6,224,1,5,4.75
7,1,hurry,5,225,2,3,1.25
7,1,if,2,226,0,2,0.5
7,1,illness,7,227,1,6,5
7,1,imagine,7,228,1,6,1.75
7,1,immense,7,229,2,5,1.75
7,1,impact,6,230,2,4,4.5
7,1,indoor,6,231,1,5,1.5
7,1,induce,6,232,3,3,1.25
7,1,indulge,7,233,4,3,1.5
7,1,infect,6,234,2,4,4.5
7,1,inmate,6,235,2,4,1.25
7,1,input,5,236,2,3,1
7,1,insect,6,237,2,4,4.5
7,1,insider,7,238,3,4,1.5
7,1,insight,7,239,4,3,1.25
7,1,inspire,7,240,3,4,1.5
7,1,insult,6,241,3,3,4.25
7,1,invent,6,242,2,4,1.25
7,1,invoke,6,243,3,3,1.25
7,1,jam,3,244,0,3,0.75
7,1,join,4,245,1,3,4.25
7,1,joint,5,246,4,1,0.75
7,1,july,4,247,1,3,1
7,1,keen,4,248,0,4,1
7,1,kind,4,249,1,3,1.25
7,1,knock,5,250,1,4,4.75
7,1,lane,4,251,0,4,1.25
7,1,laptop,6,252,2,4,1.5
7,1,lawsuit,7,253,2,5,5
7,1,lawyer,6,254,3,3,1.25
7,1,lead,4,255,1,3,1
7,1,leap,4,256,3,1,0.5
7,1,learn,5,257,3,2,1
7,1,leave,5,258,3,2,4.25
7,1,legacy,6,259,2,4,1.25
7,1,legal,5,260,4,1,0.75
7,1,length,6,261,2,4,1.25
7,1,less,4,262,2,2,0.75
7,1,lobby,5,263,1,4,4.5
7,1,lock,4,264,2,2,1
7,1,logic,5,265,2,3,1.25
7,1,loom,4,266,2,2,0.75
7,1,loop,4,267,3,1,0.5
7,1,lose,4,268,2,2,0.75
7,1,lung,4,269,1,3,4.25
7,1,marker,6,270,0,6,1.75
7,1,massive,7,271,2,5,1.75
7,1,matter,6,272,2,4,4.75
7,1,maybe,5,273,2,3,1
7,1,me,2,274,1,1,0.5
7,1,meaning,7,275,2,5,1.5
7,1,means,5,276,4,1,4.25
7,1,medical,7,277,2,5,1.5
7,1,mile,4,278,1,3,1
7,1,milk,4,279,3,1,0.5
7,1,mill,4,280,3,1,0.5
7,1,miner,5,281,2,3,4.25
7,1,mining,6,282,3,3,1.25
7,1,missile,7,283,2,5,1.5
7,1,mobile,6,284,1,5,1.5
7,1,modern,6,285,2,4,606
7,1,monk,4,286,2,2,1
7,1,morning,7,287,2,5,1.75
7,1,motive,6,288,2,4,1.5
7,1,motor,5,289,3,2,5.5
7,1,mount,5,290,2,3,1.25
7,1,move,4,291,2,2,1
7,1,musical,7,292,1,6,2.25
7,1,myself,6,293,1,5,5.75
7,1,nail,4,294,0,4,1.5
7,1,native,6,295,2,4,1.75
7,1,net,3,296,1,2,5
7,1,network,7,297,3,4,1.75
7,1,next,4,298,2,2,1
7,1,ninety,6,299,1,5,1.75
7,1,nod,3,300,1,2,1
7,1,noon,4,301,2,2,5
7,1,notable,7,302,2,5,1.75
7,1,notably,7,303,6,1,0.75
7,1,nurse,5,304,1,4,1.25
7,1,nursery,7,305,5,2,4
7,1,o,1,306,0,1,0.25
7,1,object,6,307,1,5,1.5
7,1,obtain,6,308,2,4,1.25
7,1,of,2,309,1,1,0.25
7,1,on,2,310,1,1,0.25
7,1,ongoing,7,311,2,5,5
7,1,open,4,312,1,3,1
7,1,operate,7,313,3,4,1.25
7,1,oral,4,314,1,3,4.5
7,1,orange,6,315,3,3,1.25
7,1,our,3,316,1,2,0.75
7,1,outrage,7,317,2,5,1.5
7,1,oven,4,318,1,3,4.25
7,1,owner,5,319,1,4,1.25
7,1,oxygen,6,320,1,5,1.5
7,1,palm,4,321,0,4,4.5
7,1,pan,3,322,2,1,0.5
7,1,partly,6,323,2,4,1.25
7,1,party,5,324,4,1,0.5
7,1,pass,4,325,2,2,0.75
7,1,passing,7,326,4,3,1
7,1,passion,7,327,5,2,4.25
7,1,payment,7,328,2,5,1.75
7,1,peak,4,329,1,3,1
7,1,penalty,7,330,2,5,1.5
7,1,people,6,331,2,4,4.75
7,1,period,6,332,2,4,1.25
7,1,pink,4,333,1,3,1
7,1,pitch,5,334,2,3,4.5
7,1,plain,5,335,1,4,1.25
7,1,player,6,336,3,3,1.25
7,1,plug,4,337,2,2,1
7,1,poet,4,338,1,3,1
7,1,pole,4,339,2,2,4.5
7,1,policy,6,340,3,3,1.25
7,1,pop,3,341,2,1,0.5
7,1,prefer,6,342,1,5,1.5
7,1,premium,7,343,3,4,4.75
7,1,prepare,7,344,3,4,1.5
7,1,pretty,6,345,3,3,1
7,1,prevent,7,346,3,4,1.25
7,1,prey,4,347,3,1,0.5
7,1,price,5,348,2,3,4.5
7,1,priest,6,349,3,3,1.25
7,1,prince,6,350,3,3,1
7,1,proceed,7,351,2,5,5
7,1,provide,7,352,3,4,1.5
7,1,pub,3,353,1,2,0.75
7,1,pursue,6,354,2,4,1.25
7,1,quarter,7,355,0,7,5.25
7,1,queen,5,356,2,3,1
7,1,quietly,7,357,2,5,1.5
7,1,quota,5,358,2,3,4.5
7,1,racist,6,359,0,6,1.75
7,1,random,6,360,2,4,1.25
7,1,range,5,361,3,2,1
7,1,rapid,5,362,2,3,4.25
7,1,rare,4,363,2,2,0.75
7,1,raw,3,364,2,1,0.5
7,1,read,4,365,1,3,0.75
7,1,reader,6,366,4,2,0.75
7,1,readily,7,367,4,3,4.25
7,1,reading,7,368,5,2,1.25
7,1,realize,7,369,3,4,1.25
7,1,recipe,6,370,2,4,1.25
7,1,refuge,6,371,2,4,4.75
7,1,regret,6,372,2,4,1.25
7,1,rely,4,373,2,2,0.75
7,1,rental,6,374,2,4,1.25
7,1,respect,7,375,2,5,4.75
7,1,result,6,376,3,3,1.25
7,1,rhythm,6,377,1,5,1.5
7,1,rid,3,378,1,2,0.5
7,1,royal,5,379,1,4,4.75
7,1,rugby,5,380,1,4,1.25
7,1,rule,4,381,2,2,0.75
7,1,rumour,6,382,2,4,1.25
7,1,run,3,383,2,1,4
7,1,sad,3,384,0,3,1
7,1,sadly,5,385,3,2,0.75
7,1,sail,4,386,2,2,0.75
7,1,salary,6,387,2,4,1.25
7,1,say,3,388,2,1,0.5
7,1,scale,5,389,1,4,5.5
7,1,scream,6,390,2,4,3
7,1,script,6,391,3,3,2.5
7,1,sea,3,392,1,2,1.5
7,1,see,3,393,2,1,6.25
7,1,seize,5,394,2,3,2.25
7,1,self,4,395,2,2,1.75
7,1,senator,7,396,2,5,3.5
7,1,serial,6,397,2,4,8.25
7,1,session,7,398,2,5,3.5
7,1,sex,3,399,2,1,1
7,1,shade,5,400,1,4,2.75
7,1,shall,5,401,3,2,1.75
7,1,sheet,5,402,2,3,8.25
7,1,shine,5,403,2,3,2.25
7,1,shock,5,404,2,3,2.25
7,1,shop,4,405,3,1,1.25
7,1,shout,5,406,3,2,1.75
7,1,show,4,407,3,1,1
7,1,sigh,4,408,1,3,7.5
7,1,silence,7,409,2,5,3.5
7,1,silent,6,410,5,1,1.5
7,1,silly,5,411,3,2,2
7,1,sing,4,412,2,2,1.75
7,1,sixty,5,413,2,3,8
7,1,skiing,6,414,1,5,3.5
7,1,sky,3,415,2,1,1.25
7,1,slave,5,416,1,4,2.75
7,1,slogan,6,417,2,4,9
7,1,smart,5,418,1,4,2.75
7,1,soak,4,419,1,3,2
7,1,soccer,6,420,2,4,8.5
7,1,soft,4,421,2,2,1.75
7,1,son,3,422,2,1,1
7,1,soon,4,423,2,2,1.75
7,1,sorry,5,424,2,3,2.25
7,1,source,6,425,2,4,3
7,1,spicy,5,426,1,4,8.5
7,1,spill,5,427,3,2,1.75
7,1,spoon,5,428,2,3,2.25
7,1,sport,5,429,3,2,2
7,1,spot,4,430,3,1,1.25
7,1,spy,3,431,2,1,1
7,1,squeeze,7,432,1,6,9.75
7,1,stage,5,433,1,4,2.75
7,1,station,7,434,3,4,8.75
7,1,status,6,435,4,2,2.25
7,1,stream,6,436,2,4,3
7,1,suffer,6,437,1,5,3.25
7,1,suicide,7,438,2,5,9.5
7,1,sum,3,439,2,1,1
7,1,summit,6,440,3,3,2.5
7,1,superb,6,441,2,4,3
7,1,sustain,7,442,2,5,9.25
7,1,symbol,6,443,1,5,3.5
7,1,tag,3,444,0,3,2
7,1,tax,3,445,2,1,1
7,1,teach,5,446,1,4,8.5
7,1,tennis,6,447,2,4,3
7,1,tent,4,448,3,1,1.25
7,1,tenure,6,449,3,3,2.25
7,1,testify,7,450,2,5,9.5
7,1,testing,7,451,5,2,2.25
7,1,text,4,452,2,2,1.75
7,1,that,4,453,1,3,2
7,1,their,5,454,2,3,2.25
7,1,them,4,455,3,1,1.25
7,1,then,4,456,3,1,7
7,1,they,4,457,3,1,1.25
7,1,thick,5,458,2,3,2.25
7,1,thief,5,459,3,2,1.75
7,1,thought,7,460,2,5,3.25
7,1,thrive,6,461,2,4,8.5
7,1,throat,6,462,3,3,2.5
7,1,throw,5,463,4,1,1.5
7,1,tired,5,464,1,4,2.75
7,1,tobacco,7,465,1,6,9.75
7,1,ton,3,466,2,1,1
7,1,tongue,6,467,3,3,2.25
7,1,touch,5,468,2,3,2.25
7,1,towards,7,469,2,5,9
7,1,towel,5,470,3,2,2
7,1,true,4,471,1,3,2
7,1,trust,5,472,3,2,1.75
7,1,tuition,7,473,1,6,10
7,1,tunnel,6,474,2,4,3
7,1,turn,4,475,2,2,1.75
7,1,under,5,476,0,5,3.25
7,1,unless,6,477,2,4,8.75
7,1,up,2,478,1,1,0.75
7,1,upper,5,479,2,3,2.25
7,1,upset,5,480,2,3,2.25
7,1,us,2,481,1,1,0.75
7,1,use,3,482,2,1,0.75
7,1,used,4,483,3,1,1
7,1,valid,5,484,0,5,8.75
7,1,vast,4,485,2,2,1.75
7,1,very,4,486,1,3,2.25
7,1,village,7,487,1,6,10
7,1,vitamin,7,488,2,5,3.5
7,1,volume,6,489,1,5,3.25
7,1,want,4,490,0,4,8.5
7,1,warfare,7,491,2,5,3.5
7,1,warm,4,492,3,1,1.25
7,1,we,2,493,1,1,0.75
7,1,website,7,494,2,5,13.5
7,1,wedding,7,495,2,5,3.5
7,1,what,4,496,1,3,2
7,1,when,4,497,2,2,1.75
7,1,while,5,498,2,3,8
7,1,whilst,6,499,4,2,2.25
7,1,who,3,500,2,1,1
7,1,whole,5,501,3,2,1.75
7,1,wide,4,502,1,3,2
7,1,widely,6,503,4,2,1.75
7,1,winter,6,504,2,4,9.25
7,1,wise,4,505,2,2,1.75
7,1,wish,4,506,3,1,1.25
7,1,wooden,6,507,1,5,3.75
7,1,workout,7,508,2,5,9.75
7,1,worm,4,509,3,1,1.25
7,1,writer,6,510,1,5,3.5
7,1,wrong,5,511,2,3,2.5
7,1,year,4,512,0,4,8.5
7,1,yell,4,513,2,2,1.75
7,1,you,3,514,1,2,1.5
7,1,zone,4,515,0,4,2.5
7,2,ability,7,0,0,7,10.5
7,2,abolish,7,1,2,5,3.5
7,2,academy,7,2,1,6,10.25
7,2,accent,6,3,2,4,3
7,2,account,7,4,3,4,3.25
7,2,adult,5,5,1,4,9
7,2,advance,7,6,2,5,3.5
7,2,afford,6,7,1,5,3.25
7,2,agent,5,8,1,4,9
7,2,ah,2,9,1,1,0.75
7,2,aid,3,10,1,2,1.5
7,2,air,3,11,2,1,1
7,2,alike,5,12,1,4,2.75
7,2,all,3,13,2,1,1
7,2,allow,5,14,3,2,1.75
7,2,along,5,15,2,3,8.25
7,2,anyone,6,16,1,5,3.25
7,2,apart,5,17,1,4,2.75
7,2,apple,5,18,2,3,8.25
7,2,apply,5,19,4,1,1.5
7,2,appoint,7,20,3,4,3.25
7,2,arena,5,21,1,4,2.75
7,2,armed,5,22,2,3,2.75
7,2,article,7,23,2,5,9.75
7,2,assess,6,24,1,5,3.25
7,2,assign,6,25,3,3,2.5
7,2,attempt,7,26,1,6,10
7,2,attend,6,27,4,2,2
7,2,autumn,6,28,1,5,3.5
7,2,aware,5,29,1,4,8.75
7,2,away,4,30,3,1,1.25
7,2,bake,4,31,0,4,2.5
7,2,ballot,6,32,2,4,3
7,2,banana,6,33,2,4,9
7,2,bank,4,34,3,1,1.25
7,2,bare,4,35,2,2,1.5
7,2,barrier,7,36,3,4,3.25
7,2,basket,6,37,2,4,9
7,2,bean,4,38,1,3,2.25
7,2,bear,4,39,3,1,1
7,2,beef,4,40,2,2,1.75
7,2,bend,4,41,2,2,1.75
7,2,beneath,7,42,3,4,3
7,2,bent,4,43,3,1,7.5
7,2,bias,4,44,1,3,2.25
7,2,bicycle,7,45,2,5,3.5
7,2,big,3,46,2,1,1
7,2,blanket,7,47,1,6,10.25
7,2,bleed,5,48,2,3,2.5
7,2,body,4,49,1,3,2.25
7,2,bold,4,50,2,2,1.75
7,2,bond,4,51,2,2,1.75
7,2,bonus,5,52,3,2,8.75
7,2,booking,7,53,2,5,3.5
7,2,born,4,54,2,2,1.5
7,2,brain,5,55,1,4,2.75
7,2,branch,6,56,3,3,8.75
7,2,brick,5,57,2,3,2.25
7,2,briefly,7,58,3,4,3
7,2,broad,5,59,2,3,2.25
7,2,broadly,7,60,5,2,1.75
7,2,brother,7,61,3,4,10.75
7,2,brown,5,62,3,2,2.25
7,2,buck,4,63,1,3,3.5
7,2,burial,6,64,2,4,3
7,2,bury,4,65,3,1,9.25
7,2,cabinet,7,66,0,7,5.25
7,2,calm,4,67,2,2,1.75
7,2,camp,4,68,2,2,1.75
7,2,carrot,6,69,2,4,9.5
7,2,case,4,70,2,2,1.75
7,2,catch,5,71,2,3,2.25
7,2,cattle,6,72,3,3,2.5
7,2,cent,4,73,1,3,1.25
7,2,centre,6,74,4,2,5
7,2,charge,6,75,1,5,1.75
7,2,chef,4,76,2,2,0.75
7,2,chest,5,77,3,2,1
7,2,claim,5,78,1,4,5
7,2,class,5,79,3,2,1
7,2,classic,7,80,5,2,1
7,2,climb,5,81,2,3,1
7,2,clinic,6,82,3,3,1.25
7,2,clip,4,83,3,1,0.5
7,2,close,5,84,2,3,4.75
7,2,cloth,5,85,3,2,1
7,2,coast,5,86,1,4,1.25
7,2,coastal,7,87,5,2,0.75
7,2,college,7,88,2,5,5.25
7,2,combat,6,89,2,4,1.25
7,2,comic,5,90,3,2,1
7,2,commit,6,91,3,3,1
7,2,compose,7,92,3,4,5
7,2,confirm,7,93,2,5,1.75
7,2,confuse,7,94,4,3,1.25
7,2,contact,7,95,3,4,5.25
7,2,contest,7,96,4,3,1.25
7,2,cook,4,97,2,2,0.75
7,2,cooking,7,98,4,3,1
7,2,courage,7,99,2,5,5.25
7,2,cow,3,100,2,1,0.5
7,2,crazy,5,101,1,4,1.25
7,2,cream,5,102,2,3,1
7,2,creator,7,103,4,3,1.25
7,2,crown,5,104,2,3,6.25
7,2,custody,7,105,1,6,2
7,2,custom,6,106,5,1,0.5
7,2,cutting,7,107,2,5,1.5
7,2,dad,3,108,0,3,4.75
7,2,dancer,6,109,2,4,1.25
7,2,dead,4,110,1,3,1
7,2,dear,4,111,3,1,0.5
7,2,debate,6,112,2,4,5
7,2,deck,4,113,2,2,1
7,2,define,6,114,2,4,1.25
7,2,defy,4,115,3,1,0.5
7,2,denial,6,116,2,4,1.25
7,2,depart,6,117,2,4,5.25
7,2,depict,6,118,3,3,1.25
7,2,derive,6,119,2,4,1.5
7,2,desert,6,120,2,4,5.25
7,2,desire,6,121,3,3,1.25
7,2,detail,6,122,2,4,1.5
7,2,diary,5,123,1,4,1.25
7,2,die,3,124,2,1,0.5
7,2,differ,6,125,2,4,5.5
7,2,discard,7,126,2,5,1.75
7,2,dispose,7,127,3,4,1.5
7,2,disturb,7,128,3,4,5.25
7,2,divert,6,129,2,4,1.25
7,2,dog,3,130,1,2,0.75
7,2,drag,4,131,1,3,1
7,2,draw,4,132,3,1,0.5
7,2,drive,5,133,2,3,5
7,2,driver,6,134,5,1,0.75
7,2,drown,5,135,2,3,1.25
7,2,drunk,5,136,2,3,1
7,2,dry,3,137,2,1,0.5
7,2,due,3,138,1,2,0.75
7,2,dull,4,139,2,2,4.75
7,2,dynamic,7,140,1,6,1.75
7,2,east,4,141,0,4,1
7,2,eastern,7,142,4,3,5.25
7,2,eat,3,143,2,1,0.5
7,2,economy,7,144,1,6,2
7,2,elevate,7,145,1,6,5.75
7,2,else,4,146,2,2,1
7,2,emerge,6,147,1,5,1.5
7,2,employ,6,148,2,4,1.5
7,2,endorse,7,149,1,6,5.75
7,2,energy,6,150,2,4,1.5
7,2,enhance,7,151,2,5,2
7,2,enquire,7,152,2,5,6
7,2,ensue,5,153,2,3,1
7,2,equal,5,154,1,4,1.25
7,2,equip,5,155,3,2,4.75
7,2,error,5,156,1,4,1.25
7,2,erupt,5,157,2,3,1.25
7,2,ethic,5,158,1,4,1.25
7,2,evil,4,159,1,3,5
7,2,excess,6,160,1,5,1.5
7,2,exotic,6,161,2,4,1.5
7,2,expect,6,162,2,4,5.5
7,2,export,6,163,3,3,1.5
7,2,extra,5,164,2,3,1
7,2,extract,7,165,5,2,0.75
7,2,factor,6,166,0,6,6
7,2,fan,3,167,2,1,0.5
7,2,farm,4,168,2,2,0.75
7,2,favour,6,169,2,4,1.25
7,2,feat,4,170,1,3,1
7,2,feather,7,171,4,3,5
7,2,fence,5,172,2,3,1.25
7,2,figure,6,173,1,5,1.5
7,2,fill,4,174,2,2,0.75
7,2,finger,6,175,2,4,5.5
7,2,finish,6,176,3,3,1.25
7,2,fire,4,177,2,2,0.75
7,2,flame,5,178,1,4,1.25
7,2,flaw,4,179,3,1,0.5
7,2,flawed,6,180,4,2,4.75
7,2,float,5,181,2,3,1.25
7,2,flour,5,182,3,2,1
7,2,follow,6,183,1,5,1.5
7,2,forever,7,184,2,5,5.75
7,2,forge,5,185,3,2,1
7,2,fork,4,186,3,1,0.5
7,2,formal,6,187,3,3,1.25
7,2,frame,5,188,1,4,1.25
7,2,freely,6,189,2,4,5.25
7,2,fruit,5,190,2,3,1
7,2,fund,4,191,1,3,1
7,2,gang,4,192,0,4,1
7,2,garden,6,193,2,4,5.5
7,2,generic,7,194,1,6,1.75
7,2,genuine,7,195,3,4,1.5
7,2,ghost,5,196,1,4,5.5
7,2,glad,4,197,1,3,1
7,2,golden,6,198,1,5,1.5
7,2,grass,5,199,1,4,5.25
7,2,great,5,200,2,3,1.25
7,2,guard,5,201,1,4,1.25
7,2,half,4,202,0,4,1.25
7,2,harmony,7,203,2,5,6
7,2,he,2,204,1,1,0.5
7,2,hear,4,205,2,2,0.75
7,2,hearing,7,206,4,3,1
7,2,heavily,7,207,3,4,5.5
7,2,help,4,208,2,2,0.75
7,2,helpful,7,209,4,3,1
7,2,hence,5,210,2,3,1
7,2,hide,4,211,1,3,1
7,2,hill,4,212,2,2,4.75
7,2,history,7,213,2,5,1.75
7,2,hobby,5,214,1,4,1.25
7,2,hook,4,215,2,2,1
7,2,hope,4,216,2,2,4.75
7,2,horizon,7,217,2,5,1.5
7,2,host,4,218,2,2,0.75
7,2,housing,7,219,2,5,1.5
7,2,hungry,6,220,1,5,5.5
7,2,hurry,5,221,2,3,1
7,2,ignore,6,222,0,6,1.5
7,2,imagine,7,223,1,6,5.75
7,2,immense,7,224,2,5,1.5
7,2,indeed,6,225,1,5,5.5
7,2,indoor,6,226,3,3,1.25
7,2,injured,7,227,2,5,1.5
7,2,inmate,6,228,2,4,5.5
7,2,insect,6,229,2,4,1.5
7,2,insider,7,230,3,4,1.5
7,2,insight,7,231,4,3,1.25
7,2,inspire,7,232,3,4,5.25
7,2,insult,6,233,3,3,1.25
7,2,invent,6,234,2,4,1.25
7,2,jam,3,235,0,3,0.75
7,2,jeans,5,236,1,4,5.75
7,2,join,4,237,1,3,1
7,2,justice,7,238,1,6,1.75
7,2,keen,4,239,0,4,5.25
7,2,kind,4,240,1,3,1
7,2,kiss,4,241,2,2,1
7,2,knock,5,242,1,4,1.25
7,2,label,5,243,0,5,5.5
7,2,labour,6,244,3,3,1.25
7,2,ladder,6,245,2,4,1.25
7,2,lady,4,246,3,1,0.75
7,2,lamp,4,247,2,2,0.75
7,2,landing,7,248,2,5,5.5
7,2,lane,4,249,3,1,0.5
7,2,laptop,6,250,2,4,1.25
7,2,lately,6,251,2,4,5.5
7,2,lawsuit,7,252,2,5,1.75
7,2,layout,6,253,2,4,1.25
7,2,leave,5,254,1,4,5.75
7,2,legal,5,255,2,3,1.25
7,2,lend,4,256,2,2,0.75
7,2,lesson,6,257,2,4,1.25
7,2,light,5,258,1,4,1.25
7,2,limit,5,259,2,3,5.25
7,2,lively,6,260,2,4,1.25
7,2,loop,4,261,1,3,1
7,2,lord,4,262,2,2,0.75
7,2,lose,4,263,2,2,5.25
7,2,lost,4,264,3,1,0.75
7,2,lovely,6,265,2,4,1.25
7,2,lower,5,266,2,3,1
7,2,lung,4,267,1,3,1
7,2,mall,4,268,0,4,5.25
7,2,manner,6,269,2,4,1.25
7,2,marker,6,270,2,4,1.25
7,2,maths,5,271,2,3,1
7,2,matter,6,272,3,3,5.5
7,2,maybe,5,273,2,3,1
7,2,means,5,274,1,4,1.25
7,2,measure,7,275,3,4,5.75
7,2,menu,4,276,2,2,0.75
7,2,metal,5,277,2,3,1
7,2,mile,4,278,1,3,1
7,2,milk,4,279,3,1,0.5
7,2,miner,5,280,2,3,1
7,2,mining,6,281,3,3,5.25
7,2,missile,7,282,2,5,1.75
7,2,mistake,7,283,3,4,1.5
7,2,modern,6,284,1,5,6
7,2,monitor,7,285,2,5,1.75
7,2,monk,4,286,3,1,0.75
7,2,moral,5,287,2,3,1
7,2,mount,5,288,2,3,5
7,2,mutual,6,289,1,5,1.5
7,2,myself,6,290,1,5,1.5
7,2,nail,4,291,0,4,5.25
7,2,native,6,292,2,4,1.25
7,2,neglect,7,293,1,6,1.75
7,2,nest,4,294,2,2,5
7,2,net,3,295,2,1,0.5
7,2,network,7,296,3,4,1.25
7,2,noble,5,297,1,4,1.25
7,2,nod,3,298,2,1,0.5
7,2,now,3,299,2,1,0.5
7,2,number,6,300,1,5,5.75
7,2,nursery,7,301,2,5,1.75
7,2,nursing,7,302,4,3,1.25
7,2,o,1,303,0,1,0.25
7,2,obey,4,304,1,3,8.25
7,2,object,6,305,2,4,3
7,2,obvious,7,306,2,5,3.5
7,2,offer,5,307,1,4,9.5
7,2,on,2,308,1,1,1
7,2,ongoing,7,309,2,5,3.5
7,2,onion,5,310,2,3,2.25
7,2,open,4,311,1,3,9
7,2,operate,7,312,3,4,3.25
7,2,opinion,7,313,2,5,3.75
7,2,or,2,314,1,1,0.75
7,2,order,5,315,2,3,2.5
7,2,our,3,316,1,2,8.5
7,2,out,3,317,2,1,1
7,2,outrage,7,318,3,4,3
7,2,oven,4,319,1,3,2
7,2,overly,6,320,3,3,2.25
7,2,own,3,321,1,2,8.5
7,2,owner,5,322,3,2,1.75
7,2,packet,6,323,0,6,3.75
7,2,pan,3,324,2,1,1
7,2,paper,5,325,2,3,9
7,2,parish,6,326,2,4,2.75
7,2,pass,4,327,2,2,1.5
7,2,passing,7,328,4,3,2.5
7,2,pathway,7,329,2,5,10
7,2,peak,4,330,1,3,2.25
7,2,peasant,7,331,3,4,3
7,2,penalty,7,332,2,5,3.5
7,2,pilot,5,333,1,4,9.5
7,2,pink,4,334,2,2,1.75
7,2,pitch,5,335,2,3,2.25
7,2,plate,5,336,1,4,2.75
7,2,player,6,337,3,3,9.75
7,2,plunge,6,338,2,4,3
7,2,pocket,6,339,1,5,3.25
7,2,pole,4,340,2,2,1.75
7,2,pool,4,341,2,2,8.5
7,2,popular,7,342,2,5,3.5
7,2,port,4,343,2,2,1.5
7,2,poverty,7,344,2,5,10.5
7,2,powder,6,345,2,4,3
7,2,pray,4,346,1,3,2
7,2,preach,6,347,2,4,2.75
7,2,precede,7,348,3,4,9.75
7,2,prefer,6,349,3,3,2.5
7,2,present,7,350,3,4,3
7,2,pretty,6,351,3,3,2.5
7,2,prevent,7,352,3,4,10.25
7,2,price,5,353,2,3,2.25
7,2,pride,5,354,3,2,1.75
7,2,promote,7,355,2,5,3.5
7,2,protect,7,356,3,4,10.5
7,2,provide,7,357,3,4,3.25
7,2,pub,3,358,1,2,1.5
7,2,punch,5,359,2,3,2.25
7,2,quarter,7,360,0,7,11.5
7,2,queen,5,361,2,3,2.25
7,2,quote,5,362,2,3,2.25
7,2,racist,6,363,0,6,10.75
7,2,radio,5,364,2,3,2.25
7,2,rain,4,365,2,2,1.75
7,2,range,5,366,2,3,2.25
7,2,read,4,367,1,3,9
7,2,reader,6,368,4,2,2
7,2,realize,7,369,3,4,3
7,2,really,6,370,4,2,2
7,2,receive,7,371,2,5,10.5
7,2,refuge,6,372,2,4,3
7,2,refugee,7,373,6,1,1.25
7,2,regret,6,374,2,4,2.75
7,2,report,6,375,2,4,9.5
7,2,respect,7,376,2,5,3.5
7,2,resume,6,377,3,3,2.5
7,2,riot,4,378,1,3,2
7,2,risk,4,379,2,2,8.75
7,2,role,4,380,1,3,2.25
7,2,route,5,381,2,3,2.25
7,2,royal,5,382,2,3,2.25
7,2,run,3,383,1,2,1.5
7,2,runner,6,384,3,3,9.5
7,2,sad,3,385,0,3,2
7,2,sail,4,386,2,2,1.5
7,2,saint,5,387,3,2,1.75
7,2,salary,6,388,2,4,2.75
7,2,scope,5,389,1,4,9.5
7,2,scream,6,390,2,4,3
7,2,seize,5,391,1,4,2.75
7,2,seldom,6,392,2,4,9.75
7,2,self,4,393,3,1,1.25
7,2,senator,7,394,2,5,3.5
7,2,send,4,395,3,1,1.25
7,2,senior,6,396,3,3,2.25
7,2,session,7,397,2,5,10.5
7,2,set,3,398,2,1,1
7,2,seventy,7,399,2,5,3.5
7,2,several,7,400,4,3,2.5
7,2,shade,5,401,1,4,10.25
7,2,shadow,6,402,4,2,1.75
7,2,shake,5,403,3,2,1.75
7,2,shot,4,404,2,2,1.75
7,2,should,6,405,3,3,2.75
7,2,show,4,406,3,1,1.25
7,2,shrink,6,407,2,4,9.75
7,2,shrug,5,408,3,2,1.75
7,2,silence,7,409,1,6,4
7,2,silent,6,410,5,1,1.25
7,2,silly,5,411,3,2,8.75
7,2,sincere,7,412,2,5,3.5
7,2,sir,3,413,2,1,1
7,2,sixty,5,414,2,3,2.25
7,2,skiing,6,415,1,5,10.5
7,2,sleep,5,416,1,4,2.75
7,2,slow,4,417,2,2,1.75
7,2,small,5,418,1,4,2.75
7,2,smash,5,419,3,2,9
7,2,soak,4,420,1,3,2
7,2,soar,4,421,3,1,1
7,2,soccer,6,422,2,4,2.75
7,2,son,3,423,2,1,1
7,2,source,6,424,2,4,10
7,2,spicy,5,425,1,4,2.75
7,2,spill,5,426,3,2,1.75
7,2,spoil,5,427,2,3,2.5
7,2,sponsor,7,428,3,4,10
7,2,sport,5,429,3,2,2
7,2,spy,3,430,2,1,1
7,2,stage,5,431,1,4,2.75
7,2,status,6,432,3,3,2.5
7,2,steel,5,433,2,3,9.75
7,2,stiff,5,434,2,3,2.5
7,2,stress,6,435,2,4,3
7,2,strive,6,436,3,3,2.5
7,2,stupid,6,437,2,4,10
7,2,suffer,6,438,1,5,3.25
7,2,suicide,7,439,2,5,3.5
7,2,summit,6,440,2,4,10
7,2,superb,6,441,2,4,3
7,2,surface,7,442,2,5,3.5
7,2,surge,5,443,3,2,1.75
7,2,sustain,7,444,2,5,10.75
7,2,symbol,6,445,1,5,3.5
7,2,t,1,446,0,1,0.75
7,2,teach,5,447,1,4,9.5
7,2,teenage,7,448,2,5,3.5
7,2,tennis,6,449,2,4,3
7,2,tenure,6,450,3,3,2.5
7,2,testify,7,451,2,5,10.75
7,2,testing,7,452,5,2,2.25
7,2,than,4,453,1,3,2
7,2,that,4,454,3,1,1.25
7,2,theatre,7,455,2,5,10.75
7,2,theft,5,456,3,2,2
7,2,their,5,457,3,2,1.75
7,2,theirs,6,458,5,1,1.25
7,2,then,4,459,3,1,1.25
7,2,they,4,460,3,1,1
7,2,thief,5,461,2,3,2.25
7,2,thin,4,462,3,1,1.25
7,2,thing,5,463,4,1,14.25
7,2,think,5,464,4,1,4.25
7,2,threat,6,465,2,4,691.25
7,2,thrive,6,466,3,3,6.5
7,2,throat,6,467,3,3,5.5
7,2,throw,5,468,4,1,1.75
7,2,timber,6,469,1,5,15.25
7,2,ton,3,470,1,2,3
7,2,tone,4,471,3,1,1.75
7,2,tongue,6,472,3,3,3
7,2,tourist,7,473,2,5,13.25
7,2,towel,5,474,2,3,5.75
7,2,true,4,475,1,3,5.75
7,2,trust,5,476,3,2,4.5
7,2,tuesday,7,477,1,6,18.5
7,2,typical,7,478,1,6,5.5
7,2,unless,6,479,0,6,5.75
7,2,unlike,6,480,3,3,8.5
7,2,upper,5,481,1,4,2.75
7,2,upset,5,482,2,3,2.5
7,2,upwards,7,483,2,5,11.25
7,2,us,2,484,1,1,1
7,2,used,4,485,2,2,1.5
7,2,user,4,486,3,1,1.25
7,2,valid,5,487,0,5,4.25
7,2,vast,4,488,2,2,2.5
7,2,vehicle,7,489,1,6,10.25
7,2,very,4,490,2,2,1.75
7,2,vote,4,491,1,3,2.25
7,2,wage,4,492,0,4,8.5
7,2,ward,4,493,2,2,1.75
7,2,warm,4,494,3,1,1.25
7,2,wash,4,495,2,2,1.5
7,2,we,2,496,1,1,0.75
7,2,weather,7,497,2,5,3.25
7,2,wedding,7,498,2,5,9.5
7,2,week,4,499,2,2,1.5
7,2,weekly,6,500,4,2,1.75
7,2,wet,3,501,2,1,1
7,2,where,5,502,1,4,2.75
7,2,whisper,7,503,2,5,10
7,2,who,3,504,2,1,1
7,2,wholly,6,505,3,3,2.25
7,2,wide,4,506,1,3,2
7,2,widely,6,507,4,2,1.75
7,2,winter,6,508,2,4,9.25
7,2,wise,4,509,2,2,1.5
7,2,workout,7,510,1,6,4
7,2,worm,4,511,3,1,1.25
7,2,worse,5,512,3,2,8.25
7,2,worst,5,513,4,1,1.25
7,2,year,4,514,0,4,2.5
7,2,yell,4,515,2,2,1.75
7,3,ability,7,0,0,7,10.75
7,3,able,4,1,2,2,1.75
7,3,abolish,7,2,2,5,3.5
7,3,abroad,6,3,2,4,9.75
7,3,academy,7,4,1,6,4
7,3,access,6,5,2,4,2.75
7,3,adhere,6,6,1,5,10
7,3,adult,5,7,2,3,2.5
7,3,advance,7,8,2,5,3.5
7,3,affair,6,9,1,5,9.75
7,3,afford,6,10,3,3,2.5
7,3,afraid,6,11,2,4,3
7,3,aged,4,12,1,3,2.25
7,3,agent,5,13,3,2,8.25
7,3,aid,3,14,1,2,1.5
7,3,air,3,15,2,1,1.25
7,3,alert,5,16,1,4,2.75
7,3,alike,5,17,2,3,2.25
7,3,all,3,18,2,1,1
7,3,allege,6,19,3,3,8.75
7,3,alone,5,20,2,3,2.5
7,3,along,5,21,4,1,1.25
7,3,also,4,22,2,2,2
7,3,angel,5,23,1,4,3
7,3,answer,6,24,2,4,9.25
7,3,anyone,6,25,2,4,2.75
7,3,apart,5,26,1,4,2.75
7,3,appoint,7,27,2,5,9.5
7,3,arena,5,28,1,4,2.75
7,3,array,5,29,2,3,2.25
7,3,arrival,7,30,3,4,9.25
7,3,article,7,31,2,5,3.5
7,3,assess,6,32,1,5,3.25
7,3,asset,5,33,4,1,1.25
7,3,athlete,7,34,1,6,9.75
7,3,attach,6,35,2,4,3
7,3,attend,6,36,3,3,2.5
7,3,audit,5,37,1,4,9
7,3,avoid,5,38,1,4,2.75
7,3,aware,5,39,1,4,2.75
7,3,away,4,40,3,1,1.25
7,3,bad,3,41,0,3,2
7,3,ballot,6,42,2,4,8.75
7,3,basis,5,43,2,3,2.25
7,3,beef,4,44,1,3,2.25
7,3,before,6,45,2,4,9
7,3,beside,6,46,2,4,2.75
7,3,bicycle,7,47,1,6,4
7,3,bond,4,48,1,3,8
7,3,booking,7,49,2,5,3.75
7,3,boring,6,50,2,4,3
7,3,born,4,51,3,1,1.25
7,3,brain,5,52,1,4,9
7,3,branch,6,53,3,3,2.5
7,3,bread,5,54,2,3,2.25
7,3,breast,6,55,4,2,2
7,3,briefly,7,56,2,5,9.75
7,3,broadly,7,57,2,5,3.75
7,3,brother,7,58,3,4,3.5
7,3,buck,4,59,1,3,2.25
7,3,bulk,4,60,2,2,9
7,3,burst,5,61,2,3,2.75
7,3,bus,3,62,2,1,1
7,3,busy,4,63,3,1,1
7,3,bye,3,64,1,2,1.75
7,3,cabin,5,65,0,5,3.25
7,3,cabinet,7,66,5,2,8.75
7,3,camp,4,67,2,2,1.5
7,3,captain,7,68,2,5,3.5
7,3,case,4,69,2,2,1.5
7,3,cat,3,70,2,1,1
7,3,cattle,6,71,3,3,8.75
7,3,cause,5,72,2,3,2.25
7,3,caution,7,73,3,4,3
7,3,cent,4,74,1,3,2
7,3,chaos,5,75,1,4,9
7,3,chef,4,76,2,2,1.75
7,3,chest,5,77,3,2,2
7,3,civic,5,78,1,4,2.75
7,3,claim,5,79,1,4,9.5
7,3,class,5,80,3,2,2
7,3,classic,7,81,5,2,2
7,3,climb,5,82,2,3,2.5
7,3,clip,4,83,3,1,1.25
7,3,closure,7,84,2,5,9.75
7,3,coast,5,85,1,4,2.75
7,3,coastal,7,86,5,2,1.75
7,3,coin,4,87,2,2,1.75
7,3,college,7,88,2,5,10
7,3,combine,7,89,2,5,3.5
7,3,comic,5,90,3,2,2
7,3,common,6,91,3,3,2.5
7,3,complex,7,92,3,4,9.5
7,3,confirm,7,93,2,5,3.5
7,3,consume,7,94,3,4,3
7,3,contest,7,95,3,4,9
7,3,cop,3,96,2,1,1
7,3,copy,4,97,3,1,1
7,3,costume,7,98,2,5,3.25
7,3,crack,5,99,1,4,2.75
7,3,crash,5,100,3,2,8
7,3,crazy,5,101,3,2,2
7,3,crop,4,102,2,2,1.5
7,3,cue,3,103,1,2,1.5
7,3,cult,4,104,2,2,1.75
7,3,custom,6,105,2,4,2.75
7,3,cutting,7,106,2,5,8.5
7,3,dad,3,107,0,3,1
7,3,dark,4,108,2,2,0.75
7,3,deadly,6,109,1,5,5.25
7,3,debate,6,110,2,4,1.5
7,3,debris,6,111,3,3,1.25
7,3,defeat,6,112,2,4,1.25
7,3,defy,4,113,3,1,0.75
7,3,depart,6,114,2,4,5.25
7,3,depend,6,115,3,3,1.25
7,3,depict,6,116,3,3,1.25
7,3,descend,7,117,2,5,5.75
7,3,descent,7,118,6,1,1
7,3,desert,6,119,3,3,1.25
7,3,destroy,7,120,3,4,1.5
7,3,diary,5,121,1,4,1.25
7,3,die,3,122,2,1,4.25
7,3,dilemma,7,123,2,5,1.75
7,3,dip,3,124,2,1,0.5
7,3,discard,7,125,2,5,1.5
7,3,disease,7,126,3,4,5.25
7,3,disturb,7,127,3,4,1.5
7,3,diverse,7,128,2,5,1.5
7,3,divert,6,129,5,1,0.75
7,3,divorce,7,130,3,4,5.5
7,3,donor,5,131,1,4,1.25
7,3,door,4,132,2,2,0.75
7,3,drive,5,133,1,4,1.25
7,3,drug,4,134,2,2,4.75
7,3,drum,4,135,3,1,0.75
7,3,drunk,5,136,3,2,0.75
7,3,dull,4,137,1,3,1
7,3,dump,4,138,2,2,0.75
7,3,during,6,139,2,4,5
7,3,duty,4,140,2,2,0.75
7,3,easily,6,141,0,6,1.75
7,3,echo,4,142,1,3,1
7,3,edge,4,143,1,3,4.75
7,3,element,7,144,1,6,1.75
7,3,elevate,7,145,3,4,1.5
7,3,else,4,146,2,2,0.75
7,3,emerge,6,147,1,5,5.25
7,3,empire,6,148,2,4,1.25
7,3,employ,6,149,3,3,1.25
7,3,endorse,7,150,1,6,5.75
7,3,enhance,7,151,2,5,1.75
7,3,enquire,7,152,2,5,5.5
7,3,enrol,5,153,2,3,1.25
7,3,ensue,5,154,2,3,1
7,3,entity,6,155,2,4,1.25
7,3,error,5,156,1,4,5
7,3,erupt,5,157,2,3,1
7,3,escape,6,158,1,5,1.5
7,3,ethical,7,159,1,6,6
7,3,ethnic,6,160,3,3,1.25
7,3,except,6,161,1,5,1.5
7,3,exert,5,162,2,3,1
7,3,exotic,6,163,2,4,5.25
7,3,extract,7,164,2,5,1.75
7,3,farm,4,165,0,4,1.25
7,3,feat,4,166,1,3,5
7,3,feeling,7,167,2,5,1.75
7,3,film,4,168,1,3,1
7,3,filter,6,169,3,3,1.25
7,3,final,5,170,2,3,5
7,3,find,4,171,3,1,0.5
7,3,finger,6,172,3,3,1.25
7,3,finish,6,173,3,3,1
7,3,fish,4,174,2,2,0.75
7,3,fit,3,175,2,1,0.5
7,3,five,4,176,2,2,4.75
7,3,flash,5,177,1,4,1.25
7,3,fleet,5,178,2,3,1
7,3,float,5,179,2,3,1
7,3,fold,4,180,1,3,4.75
7,3,follow,6,181,3,3,1.25
7,3,fond,4,182,2,2,0.75
7,3,fool,4,183,2,2,0.75
7,3,forest,6,184,2,4,1.25
7,3,forever,7,185,4,3,5.5
7,3,forgive,7,186,3,4,1.5
7,3,formal,6,187,3,3,1.25
7,3,forum,5,188,3,2,1
7,3,fossil,6,189,2,4,5.5
7,3,freeze,6,190,1,5,1.5
7,3,fruit,5,191,2,3,1
7,3,fun,3,192,1,2,0.75
7,3,funny,5,193,3,2,4.5
7,3,furious,7,194,2,5,1.75
7,3,gang,4,195,0,4,1
7,3,gas,3,196,2,1,0.5
7,3,gentle,6,197,1,5,5.25
7,3,ghost,5,198,1,4,1.25
7,3,glad,4,199,1,3,1
7,3,golden,6,200,1,5,5.75
7,3,grand,5,201,1,4,1.25
7,3,grant,5,202,4,1,0.5
7,3,grass,5,203,3,2,0.75
7,3,halt,4,204,0,4,1.25
7,3,happy,5,205,2,3,5
7,3,hardly,6,206,2,4,1.5
7,3,harmony,7,207,3,4,1.5
7,3,hatred,6,208,2,4,1.25
7,3,he,2,209,1,1,4.5
7,3,hear,4,210,2,2,0.75
7,3,heavily,7,211,3,4,1.5
7,3,hello,5,212,2,3,1
7,3,helpful,7,213,3,4,5.75
7,3,hill,4,214,1,3,1
7,3,holy,4,215,1,3,1
7,3,honour,6,216,2,4,1.25
7,3,hook,4,217,2,2,0.75
7,3,horizon,7,218,2,5,6
7,3,hungry,6,219,1,5,1.5
7,3,husband,7,220,2,5,5.75
7,3,if,2,221,0,2,0.75
7,3,ignore,6,222,1,5,1.5
7,3,imagine,7,223,1,6,1.75
7,3,immense,7,224,2,5,5.75
7,3,impress,7,225,2,5,1.75
7,3,in,2,226,1,1,0.5
7,3,indeed,6,227,2,4,5.25
7,3,indoor,6,228,3,3,1.25
7,3,induce,6,229,3,3,1
7,3,indulge,7,230,4,3,1.25
7,3,infect,6,231,2,4,5.75
7,3,injured,7,232,2,5,1.75
7,3,inmate,6,233,2,4,1.25
7,3,input,5,234,2,3,1
7,3,inspire,7,235,2,5,5.75
7,3,invoke,6,236,2,4,1.25
7,3,july,4,237,0,4,1.25
7,3,justice,7,238,2,5,5.75
7,3,keen,4,239,0,4,1.25
7,3,kidnap,6,240,1,5,1.5
7,3,kill,4,241,2,2,5.5
7,3,kind,4,242,2,2,1
7,3,kiss,4,243,2,2,0.75
7,3,labour,6,244,0,6,1.75
7,3,ladder,6,245,2,4,5.75
7,3,lady,4,246,3,1,0.75
7,3,lane,4,247,2,2,0.75
7,3,laptop,6,248,2,4,1.25
7,3,late,4,249,2,2,0.75
7,3,lately,6,250,4,2,5
7,3,lawsuit,7,251,2,5,1.75
7,3,layout,6,252,2,4,1.25
7,3,leap,4,253,1,3,1
7,3,learn,5,254,3,2,5.25
7,3,lend,4,255,2,2,0.75
7,3,less,4,256,2,2,0.75
7,3,lesson,6,257,4,2,0.75
7,3,level,5,258,2,3,1
7,3,light,5,259,1,4,5.25
7,3,limit,5,260,2,3,1.25
7,3,linger,6,261,2,4,1.25
7,3,lively,6,262,2,4,1.25
7,3,logo,4,263,1,3,5
7,3,loom,4,264,2,2,0.75
7,3,lord,4,265,2,2,0.75
7,3,lose,4,266,2,2,0.75
7,3,loss,4,267,3,1,0.5
7,3,lovely,6,268,2,4,1.25
7,3,luck,4,269,1,3,5
7,3,mall,4,270,0,4,1.25
7,3,manner,6,271,2,4,1.25
7,3,marker,6,272,2,4,5.5
7,3,mate,4,273,2,2,0.75
7,3,maybe,5,274,2,3,1
7,3,me,2,275,1,1,0.25
7,3,means,5,276,2,3,1
7,3,measure,7,277,3,4,5.5
7,3,meet,4,278,2,2,0.75
7,3,menu,4,279,2,2,0.75
7,3,metal,5,280,2,3,1
7,3,mile,4,281,1,3,1
7,3,mine,4,282,2,2,0.75
7,3,miner,5,283,4,1,5
7,3,minor,5,284,3,2,1
7,3,minute,6,285,3,3,1.25
7,3,missile,7,286,2,5,1.5
7,3,modern,6,287,1,5,6
7,3,monitor,7,288,2,5,1.75
7,3,monk,4,289,3,1,0.75
7,3,moral,5,290,2,3,1
7,3,motive,6,291,2,4,5.75
7,3,motor,5,292,3,2,1
7,3,move,4,293,2,2,0.75
7,3,musical,7,294,1,6,1.75
7,3,myself,6,295,1,5,6
7,3,mystery,7,296,3,4,1.5
7,3,native,6,297,0,6,1.75
7,3,naval,5,298,2,3,5.25
7,3,nest,4,299,1,3,1
7,3,network,7,300,2,5,1.75
7,3,nod,3,301,1,2,0.75
7,3,notably,7,302,2,5,6.25
7,3,now,3,303,2,1,0.5
7,3,number,6,304,1,5,1.5
7,3,nurse,5,305,2,3,5.25
7,3,nursery,7,306,5,2,1.25
7,3,nursing,7,307,4,3,1.25
7,3,o,1,308,0,1,0.25
7,3,observe,7,309,1,6,1.75
7,3,obtain,6,310,2,4,5.5
7,3,obvious,7,311,2,5,1.75
7,3,of,2,312,1,1,0.5
7,3,on,2,313,1,1,0.25
7,3,onion,5,314,2,3,1
7,3,open,4,315,1,3,5
7,3,opinion,7,316,2,5,1.75
7,3,order,5,317,1,4,1.25
7,3,our,3,318,1,2,5
7,3,outrage,7,319,2,5,1.75
7,3,oven,4,320,1,3,1
7,3,over,4,321,3,1,0.5
7,3,owner,5,322,1,4,1.25
7,3,oxygen,6,323,1,5,6
7,3,packet,6,324,0,6,1.75
7,3,pair,4,325,2,2,1
7,3,parish,6,326,2,4,6
7,3,pass,4,327,2,2,0.75
7,3,passage,7,328,4,3,1
7,3,passing,7,329,4,3,1.25
7,3,passion,7,330,5,2,5.25
7,3,payment,7,331,2,5,1.75
7,3,peak,4,332,1,3,1
7,3,pension,7,333,2,5,1.5
7,3,period,6,334,2,4,5.5
7,3,phase,5,335,1,4,1.25
7,3,pill,4,336,1,3,1
7,3,pit,3,337,2,1,0.5
7,3,plain,5,338,1,4,8.5
7,3,plate,5,339,3,2,2
7,3,player,6,340,3,3,2.75
7,3,plug,4,341,2,2,1.75
7,3,poetry,6,342,1,5,10.5
7,3,pole,4,343,2,2,1.75
7,3,pool,4,344,2,2,1.75
7,3,pop,3,345,2,1,1
7,3,popular,7,346,3,4,2.75
7,3,portray,7,347,2,5,10
7,3,pose,4,348,2,2,1.75
7,3,pray,4,349,1,3,2
7,3,premium,7,350,2,5,3.75
7,3,present,7,351,3,4,10.25
7,3,pretty,6,352,3,3,2.5
7,3,prevent,7,353,3,4,3
7,3,pride,5,354,2,3,2.25
7,3,priest,6,355,3,3,10
7,3,proceed,7,356,2,5,3.5
7,3,protein,7,357,3,4,3
7,3,provoke,7,358,3,4,9.75
7,3,pub,3,359,1,2,1.5
7,3,punch,5,360,2,3,2.25
7,3,qualify,7,361,0,7,11
7,3,queen,5,362,2,3,2.25
7,3,queue,5,363,3,2,1.75
7,3,quickly,7,364,2,5,3.25
7,3,quota,5,365,2,3,2.25
7,3,racist,6,366,0,6,10.75
7,3,radio,5,367,2,3,2.25
7,3,rain,4,368,2,2,1.75
7,3,random,6,369,2,4,11
7,3,range,5,370,3,2,2
7,3,rare,4,371,2,2,1.5
7,3,raw,3,372,2,1,1
7,3,read,4,373,1,3,2
7,3,readily,7,374,4,3,2.25
7,3,reading,7,375,5,2,9.5
7,3,real,4,376,3,1,1
7,3,receive,7,377,2,5,3.5
7,3,recipe,6,378,3,3,2.5
7,3,red,3,379,2,1,1
7,3,regret,6,380,2,4,10
7,3,release,7,381,2,5,3.5
7,3,rely,4,382,3,1,1.25
7,3,remote,6,383,2,4,2.75
7,3,result,6,384,2,4,10
7,3,retreat,7,385,2,5,3.75
7,3,review,6,386,2,4,3
7,3,rhythm,6,387,1,5,11
7,3,rice,4,388,1,3,2
7,3,risk,4,389,2,2,2
7,3,rock,4,390,1,3,2.5
7,3,royal,5,391,2,3,9.5
7,3,rugby,5,392,1,4,2.75
7,3,rule,4,393,2,2,1.75
7,3,runner,6,394,2,4,3
7,3,sadly,5,395,0,5,10.5
7,3,sail,4,396,2,2,1.75
7,3,salary,6,397,2,4,2.75
7,3,say,3,398,2,1,1
7,3,scratch,7,399,1,6,11
7,3,section,7,400,1,6,4
7,3,see,3,401,2,1,1
7,3,seize,5,402,2,3,2.25
7,3,senator,7,403,2,5,10.25
7,3,set,3,404,2,1,1
7,3,shake,5,405,1,4,2.75
7,3,shall,5,406,3,2,1.75
7,3,shaped,6,407,3,3,9.75
7,3,sheet,5,408,2,3,2.25
7,3,shine,5,409,2,3,2.25
7,3,shock,5,410,2,3,2.25
7,3,shop,4,411,3,1,1.25
7,3,short,5,412,3,2,1.75
7,3,shot,4,413,3,1,8.5
7,3,shout,5,414,3,2,2
7,3,show,4,415,3,1,1.25
7,3,shrink,6,416,2,4,2.75
7,3,shrug,5,417,3,2,1.75
7,3,sigh,4,418,1,3,2
7,3,silence,7,419,2,5,10.5
7,3,sing,4,420,2,2,1.75
7,3,sky,3,421,1,2,1.5
7,3,slot,4,422,1,3,2.25
7,3,small,5,423,1,4,9.75
7,3,soar,4,424,1,3,2.25
7,3,society,7,425,2,5,3.5
7,3,soft,4,426,2,2,1.5
7,3,son,3,427,2,1,1
7,3,sorry,5,428,2,3,9.5
7,3,source,6,429,2,4,3
7,3,span,4,430,1,3,2
7,3,sponsor,7,431,2,5,10.75
7,3,sport,5,432,3,2,2
7,3,spot,4,433,3,1,1.25
7,3,spy,3,434,2,1,1
7,3,station,7,435,1,6,4.25
7,3,status,6,436,4,2,2
7,3,steel,5,437,2,3,9.25
7,3,steep,5,438,4,1,1.25
7,3,stiff,5,439,2,3,2.25
7,3,stream,6,440,2,4,2.75
7,3,strive,6,441,3,3,9.75
7,3,student,7,442,2,5,3.5
7,3,sum,3,443,1,2,1.5
7,3,summer,6,444,3,3,2.25
7,3,summit,6,445,4,2,1.75
7,3,surge,5,446,2,3,9.5
7,3,survive,7,447,3,4,3
7,3,sustain,7,448,2,5,3.5
7,3,sweet,5,449,1,4,9.75
7,3,swing,5,450,2,3,2.25
7,3,t,1,451,0,1,0.75
7,3,tag,3,452,1,2,1.5
7,3,tax,3,453,2,1,1
7,3,teach,5,454,1,4,2.5
7,3,tennis,6,455,2,4,10.25
7,3,tent,4,456,3,1,1.25
7,3,testify,7,457,2,5,3.5
7,3,than,4,458,1,3,2
7,3,that,4,459,3,1,8.5
7,3,their,5,460,2,3,2.25
7,3,theirs,6,461,5,1,1.25
7,3,then,4,462,3,1,1.25
7,3,thin,4,463,2,2,1.5
7,3,thing,5,464,4,1,1
7,3,think,5,465,4,1,1
7,3,threat,6,466,2,4,9.5
7,3,throat,6,467,3,3,1.5
7,3,ton,3,468,1,2,0.75
7,3,tongue,6,469,3,3,1
7,3,total,5,470,2,3,1
7,3,towel,5,471,2,3,5.5
7,3,trading,7,472,1,6,1.75
7,3,true,4,473,2,2,0.75
7,3,truly,5,474,3,2,1
7,3,trustee,7,475,3,4,6
7,3,truth,5,476,3,2,1
7,3,try,3,477,2,1,0.5
7,3,tuition,7,478,1,6,1.75
7,3,turnout,7,479,2,5,6.25
7,3,twist,5,480,1,4,1.25
7,3,type,4,481,1,3,1
7,3,typical,7,482,3,4,5.75
7,3,ugly,4,483,0,4,1.25
7,3,under,5,484,1,4,1.25
7,3,unit,4,485,2,2,0.75
7,3,unless,6,486,2,4,5.75
7,3,upwards,7,487,1,6,2
7,3,user,4,488,1,3,1
7,3,utterly,7,489,1,6,6.5
7,3,village,7,490,0,7,2
7,3,wage,4,491,0,4,1.25
7,3,wall,4,492,2,2,6
7,3,warfare,7,493,2,5,1.75
7,3,warm,4,494,3,1,0.75
7,3,wash,4,495,2,2,0.75
7,3,we,2,496,1,1,0.25
7,3,weak,4,497,2,2,0.75
7,3,weather,7,498,3,4,6.25
7,3,web,3,499,2,1,0.5
7,3,website,7,500,3,4,1.25
7,3,wedding,7,501,2,5,6
7,3,week,4,502,2,2,1
7,3,well,4,503,2,2,0.75
7,3,wet,3,504,2,1,0.5
7,3,wheat,5,505,1,4,1.25
7,3,whilst,6,506,2,4,1.25
7,3,wooden,6,507,1,5,6.5
7,3,worm,4,508,2,2,1
7,3,worst,5,509,3,2,1
7,3,writing,7,510,1,6,6.5
7,3,wrong,5,511,2,3,1.25
7,3,year,4,512,0,4,1.25
7,3,you,3,513,1,2,1
7,3,yours,5,514,3,2,1
7,3,zone,4,515,0,4,5.75
7,4,able,4,0,0,4,1.25
7,4,abolish,7,1,2,5,6
7,4,about,5,2,3,2,1
7,4,above,5,3,3,2,0.75
7,4,abroad,6,4,2,4,1.25
7,4,accent,6,5,1,5,6.5
7,4,acquire,7,6,2,5,1.75
7,4,act,3,7,2,1,0.5
7,4,action,6,8,3,3,1
7,4,adhere,6,9,1,5,6.25
7,4,afford,6,10,1,5,1.5
7,4,aged,4,11,1,3,1
7,4,ah,2,12,1,1,0.25
7,4,aid,3,13,1,2,0.5
7,4,alien,5,14,1,4,6
7,4,alike,5,15,3,2,1
7,4,all,3,16,2,1,0.5
7,4,allow,5,17,3,2,0.75
7,4,angry,5,18,1,4,1.25
7,4,anyone,6,19,2,4,6.25
7,4,apple,5,20,1,4,1.25
7,4,april,5,21,2,3,1.25
7,4,archive,7,22,1,6,7
7,4,armed,5,23,2,3,1.25
7,4,arrival,7,24,2,5,1.75
7,4,assess,6,25,1,5,6.5
7,4,asset,5,26,4,1,0.75
7,4,assign,6,27,3,3,1.25
7,4,athlete,7,28,1,6,1.75
7,4,attempt,7,29,2,5,6.25
7,4,audit,5,30,1,4,1.25
7,4,author,6,31,2,4,1.25
7,4,autumn,6,32,3,3,10.25
7,4,avoid,5,33,1,4,40.25
7,4,away,4,34,1,3,1.5
7,4,awkward,7,35,2,5,2.5
7,4,back,4,36,0,4,7
7,4,banana,6,37,2,4,2.25
7,4,bank,4,38,3,1,1
7,4,bare,4,39,2,2,1.25
7,4,basket,6,40,2,4,2
7,4,bear,4,41,1,3,6.75
7,4,become,6,42,2,4,2
7,4,bee,3,43,2,1,0.75
7,4,beef,4,44,3,1,1
7,4,behind,6,45,2,4,2
7,4,being,5,46,2,3,6.75
7,4,bend,4,47,2,2,1.25
7,4,beneath,7,48,3,4,2
7,4,bent,4,49,3,1,1
7,4,bet,3,50,2,1,0.75
7,4,bleed,5,51,1,4,1.75
7,4,bold,4,52,1,3,5.75
7,4,booking,7,53,2,5,2.25
7,4,born,4,54,2,2,1.25
7,4,brain,5,55,1,4,10.25
7,4,bread,5,56,2,3,1.75
7,4,breast,6,57,4,2,1.5
7,4,broad,5,58,2,3,1.75
7,4,brother,7,59,3,4,2.25
7,4,brown,5,60,3,2,11
7,4,burst,5,61,1,4,1.75
7,4,bury,4,62,3,1,1
7,4,bus,3,63,2,1,0.75
7,4,busy,4,64,3,1,1
7,4,button,6,65,2,4,2.25
7,4,bye,3,66,1,2,12
7,4,cabin,5,67,0,5,4.25
7,4,calm,4,68,2,2,2.25
7,4,capture,7,69,2,5,3.5
7,4,case,4,70,2,2,11.5
7,4,cat,3,71,2,1,0.75
7,4,cause,5,72,2,3,1.75
7,4,caution,7,73,3,4,3
7,4,cent,4,74,1,3,1.5
7,4,centre,6,75,4,2,6.75
7,4,chance,6,76,1,5,2
7,4,charge,6,77,3,3,1.75
7,4,chest,5,78,2,3,1.25
7,4,civic,5,79,1,4,4.75
7,4,class,5,80,1,4,1.25
7,4,classic,7,81,5,2,0.75
7,4,climb,5,82,2,3,1.25
7,4,clinic,6,83,3,3,4.75
7,4,closure,7,84,2,5,1.75
7,4,clue,4,85,2,2,0.75
7,4,coast,5,86,1,4,1.25
7,4,coin,4,87,2,2,5
7,4,colour,6,88,2,4,1.75
7,4,combat,6,89,2,4,1.75
7,4,combine,7,90,4,3,3
7,4,commit,6,91,3,3,4.75
7,4,compare,7,92,3,4,1.5
7,4,confirm,7,93,2,5,1.75
7,4,confuse,7,94,4,3,4.75
7,4,consume,7,95,3,4,1.5
7,4,context,7,96,3,4,1.5
7,4,convict,7,97,3,4,1.5
7,4,cooking,7,98,2,5,5.25
7,4,copy,4,99,2,2,0.75
7,4,courage,7,100,2,5,1.5
7,4,covered,7,101,2,5,4.5
7,4,crazy,5,102,1,4,1.25
7,4,cream,5,103,2,3,1.25
7,4,crown,5,104,2,3,1.25
7,4,cult,4,105,1,3,4
7,4,custody,7,106,2,5,2
7,4,custom,6,107,5,1,0.75
7,4,cutting,7,108,2,5,1.75
7,4,date,4,109,0,4,4
7,4,dead,4,110,1,3,1
7,4,deadly,6,111,4,2,0.75
7,4,dear,4,112,3,1,0.5
7,4,debris,6,113,2,4,4.25
7,4,debut,5,114,3,2,1
7,4,deck,4,115,2,2,0.75
7,4,defend,6,116,2,4,1.25
7,4,defy,4,117,3,1,0.5
7,4,denial,6,118,2,4,4.5
7,4,derive,6,119,2,4,1.5
7,4,descend,7,120,2,5,1.75
7,4,descent,7,121,6,1,0.75
7,4,desire,6,122,3,3,2.5
7,4,detail,6,123,2,4,3
7,4,die,3,124,1,2,0.75
7,4,dilemma,7,125,2,5,1.5
7,4,discard,7,126,2,5,4.75
7,4,dispose,7,127,3,4,1.5
7,4,dispute,7,128,4,3,1.5
7,4,disrupt,7,129,3,4,4.5
7,4,disturb,7,130,3,4,1.5
7,4,diverse,7,131,2,5,1.5
7,4,divert,6,132,5,1,0.75
7,4,donate,6,133,1,5,4.5
7,4,door,4,134,2,2,1
7,4,dose,4,135,2,2,1.75
7,4,dozen,5,136,2,3,2.25
7,4,drive,5,137,1,4,3
7,4,driver,6,138,5,1,6.5
7,4,drug,4,139,2,2,1.75
7,4,drunk,5,140,3,2,1.75
7,4,dull,4,141,1,3,2
7,4,duty,4,142,2,2,1.75
7,4,each,4,143,0,4,7.5
7,4,early,5,144,2,3,2.25
7,4,eastern,7,145,2,5,3.5
7,4,eat,3,146,2,1,1
7,4,economy,7,147,1,6,9
7,4,element,7,148,1,6,4
7,4,else,4,149,2,2,1.75
7,4,embed,5,150,1,4,7.75
7,4,empire,6,151,2,4,3
7,4,employ,6,152,3,3,2.5
7,4,empty,5,153,3,2,2
7,4,endorse,7,154,1,6,9
7,4,enhance,7,155,2,5,3.5
7,4,enrol,5,156,2,3,2.25
7,4,ensue,5,157,2,3,2.25
7,4,entity,6,158,2,4,7.75
7,4,equal,5,159,1,4,2.75
7,4,equip,5,160,3,2,1.75
7,4,era,3,161,1,2,1.5
7,4,erupt,5,162,2,3,8
7,4,eternal,7,163,1,6,5
7,4,ethical,7,164,2,5,4.25
7,4,every,5,165,1,4,9.25
7,4,evolve,6,166,2,4,3.5
7,4,example,7,167,1,6,4.25
7,4,except,6,168,2,4,8.5
7,4,excess,6,169,4,2,2
7,4,exotic,6,170,2,4,3
7,4,export,6,171,2,4,8.75
7,4,extra,5,172,2,3,2.5
7,4,faction,7,173,0,7,4.5
7,4,factory,7,174,4,3,2.5
7,4,faith,5,175,2,3,7.25
7,4,farm,4,176,2,2,1.5
7,4,feel,4,177,1,3,2
7,4,feeling,7,178,4,3,2.25
7,4,fence,5,179,2,3,7.25
7,4,film,4,180,1,3,2
7,4,filter,6,181,3,3,2.25
7,4,fire,4,182,2,2,1.75
7,4,fishing,7,183,2,5,3.5
7,4,fit,3,184,2,1,8
7,4,five,4,185,2,2,5.75
7,4,flash,5,186,1,4,424
7,4,flaw,4,187,3,1,1.25
7,4,flawed,6,188,4,2,2
7,4,fleet,5,189,2,3,2.25
7,4,float,5,190,2,3,2.5
7,4,flood,5,191,3,2,9.75
7,4,flour,5,192,3,2,2.25
7,4,fool,4,193,1,3,2.25
7,4,forest,6,194,2,4,3
7,4,forgive,7,195,3,4,9.5
7,4,fork,4,196,3,1,1.25
7,4,formal,6,197,3,3,2.5
7,4,format,6,198,5,1,1.25
7,4,forum,5,199,3,2,1.75
7,4,frame,5,200,1,4,2.75
7,4,frankly,7,201,3,4,8.25
7,4,freely,6,202,2,4,2.75
7,4,fruit,5,203,2,3,2.25
7,4,fully,5,204,1,4,7.75
7,4,funny,5,205,2,3,2.5
7,4,furious,7,206,2,5,3.5
7,4,gas,3,207,0,3,2
7,4,generic,7,208,1,6,9.25
7,4,genuine,7,209,3,4,3
7,4,get,3,210,2,1,1
7,4,ghost,5,211,1,4,2.75
7,4,grain,5,212,1,4,8.25
7,4,greatly,7,213,2,5,3.5
7,4,half,4,214,0,4,2.5
7,4,halt,4,215,3,1,6
7,4,hand,4,216,2,2,1.5
7,4,harmful,7,217,2,5,3.5
7,4,hear,4,218,1,3,2
7,4,hearing,7,219,4,3,7.5
7,4,heating,7,220,3,4,3.25
7,4,heavily,7,221,3,4,2.5
7,4,hello,5,222,2,3,1.25
7,4,helmet,6,223,3,3,4.5
7,4,help,4,224,3,1,0.5
7,4,hence,5,225,2,3,1
7,4,highway,7,226,1,6,1.75
7,4,himself,7,227,2,5,4.75
7,4,history,7,228,2,5,1.5
7,4,hockey,6,229,1,5,1.5
7,4,hold,4,230,2,2,4
7,4,holy,4,231,3,1,0.75
7,4,hope,4,232,2,2,0.75
7,4,host,4,233,2,2,0.75
7,4,hostile,7,234,4,3,1
7,4,house,5,235,2,3,1
7,4,hungry,6,236,1,5,5
7,4,hurry,5,237,2,3,1
7,4,husband,7,238,2,5,1.75
7,4,ignore,6,239,0,6,4.75
7,4,illness,7,240,1,6,1.75
7,4,imagine,7,241,1,6,5
7,4,immense,7,242,2,5,1.75
7,4,indoor,6,243,1,5,1.5
7,4,indoors,7,244,6,1,4
7,4,induce,6,245,3,3,1.25
7,4,infect,6,246,2,4,1.25
7,4,initial,7,247,2,5,1.5
7,4,inmate,6,248,2,4,4.75
7,4,insect,6,249,2,4,1.25
7,4,inspire,7,250,3,4,1.5
7,4,insult,6,251,3,3,4.25
7,4,invent,6,252,2,4,1.5
7,4,invoke,6,253,3,3,1.25
7,4,join,4,254,0,4,1
7,4,joint,5,255,4,1,0.5
7,4,july,4,256,1,3,4.25
7,4,justice,7,257,2,5,1.75
7,4,keen,4,258,0,4,1
7,4,kidnap,6,259,1,5,4.75
7,4,kill,4,260,2,2,1
7,4,knock,5,261,1,4,1.25
7,4,labour,6,262,0,6,4.75
7,4,ladder,6,263,2,4,1.25
7,4,landing,7,264,2,5,1.5
7,4,lane,4,265,3,1,0.75
7,4,laptop,6,266,2,4,4.5
7,4,late,4,267,2,2,0.75
7,4,lead,4,268,1,3,1
7,4,legacy,6,269,2,4,1.25
7,4,leisure,7,270,2,5,5
7,4,lesson,6,271,2,4,1.25
7,4,light,5,272,1,4,1.25
7,4,limit,5,273,2,3,1
7,4,linger,6,274,2,4,4.75
7,4,loan,4,275,1,3,1
7,4,lobby,5,276,2,3,1.25
7,4,logic,5,277,2,3,1.25
7,4,loop,4,278,2,2,4
7,4,lose,4,279,2,2,0.75
7,4,lower,5,280,2,3,1
7,4,man,3,281,0,3,1
7,4,manner,6,282,3,3,1
7,4,marry,5,283,2,3,4.5
7,4,massive,7,284,2,5,1.5
7,4,mate,4,285,2,2,0.75
7,4,maths,5,286,3,2,0.75
7,4,maybe,5,287,2,3,4.25
7,4,me,2,288,1,1,0.5
7,4,measure,7,289,2,5,1.5
7,4,meet,4,290,2,2,0.75
7,4,metal,5,291,2,3,1
7,4,milk,4,292,1,3,4
7,4,mine,4,293,2,2,0.75
7,4,mining,6,294,3,3,1.25
7,4,minor,5,295,3,2,1
7,4,miracle,7,296,2,5,4.75
7,4,missile,7,297,2,5,1.75
7,4,mode,4,298,1,3,1
7,4,modest,6,299,4,2,0.75
7,4,monitor,7,300,2,5,5
7,4,moral,5,301,2,3,1
7,4,motive,6,302,2,4,1.25
7,4,motor,5,303,3,2,1
7,4,mount,5,304,2,3,4.25
7,4,mutual,6,305,1,5,1.5
7,4,native,6,306,0,6,1.75
7,4,naval,5,307,2,3,4.25
7,4,nerve,5,308,1,4,1.25
7,4,net,3,309,2,1,0.5
7,4,network,7,310,3,4,1.5
7,4,news,4,311,2,2,0.75
7,4,noble,5,312,1,4,4.5
7,4,nod,3,313,2,1,0.5
7,4,nose,4,314,2,2,0.75
7,4,notable,7,315,2,5,1.5
7,4,notably,7,316,6,1,0.75
7,4,number,6,317,1,5,4.75
7,4,nursery,7,318,2,5,1.75
7,4,observe,7,319,0,7,5.25
7,4,obtain,6,320,2,4,1.25
7,4,offer,5,321,1,4,1.25
7,4,on,2,322,1,1,0.25
7,4,ongoing,7,323,2,5,5.25
7,4,or,2,324,1,1,0.5
7,4,order,5,325,2,3,1
7,4,our,3,326,1,2,0.75
7,4,oven,4,327,1,3,1
7,4,over,4,328,3,1,0.5
7,4,overly,6,329,4,2,4.5
7,4,own,3,330,1,2,0.75
7,4,owner,5,331,3,2,0.75
7,4,pair,4,332,0,4,1.25
7,4,palm,4,333,2,2,0.75
7,4,parent,6,334,2,4,4.5
7,4,pass,4,335,2,2,0.75
7,4,passage,7,336,4,3,1
7,4,pathway,7,337,2,5,1.5
7,4,payment,7,338,2,5,5
7,4,peasant,7,339,1,6,1.75
7,4,penalty,7,340,2,5,5.25
7,4,people,6,341,2,4,1.5
7,4,period,6,342,2,4,1.5
7,4,physics,7,343,1,6,5.5
7,4,pilot,5,344,1,4,1.25
7,4,pink,4,345,2,2,1
7,4,pit,3,346,2,1,0.5
7,4,plate,5,347,1,4,1.25
7,4,plug,4,348,2,2,4.5
7,4,plunge,6,349,3,3,1.25
7,4,poet,4,350,1,3,1
7,4,pole,4,351,2,2,0.75
7,4,pop,3,352,2,1,0.5
7,4,port,4,353,2,2,0.75
7,4,preach,6,354,1,5,5.25
7,4,precede,7,355,3,4,1.5
7,4,premium,7,356,3,4,1.5
7,4,present,7,357,3,4,5.25
7,4,price,5,358,2,3,1
7,4,prince,6,359,3,3,1.25
7,4,prison,6,360,3,3,1.5
7,4,promote,7,361,2,5,5.25
7,4,protect,7,362,3,4,1.5
7,4,provide,7,363,3,4,1.5
7,4,punch,5,364,1,4,4.75
7,4,purely,6,365,2,4,1.5
7,4,purple,6,366,3,3,1.25
7,4,pursue,6,367,3,3,1.25
7,4,quarter,7,368,0,7,5.75
7,4,queen,5,369,2,3,1.25
7,4,quickly,7,370,2,5,5
7,4,racist,6,371,0,6,1.75
7,4,random,6,372,2,4,1.5
7,4,range,5,373,3,2,1
7,4,rapid,5,374,2,3,4.5
7,4,rare,4,375,2,2,0.75
7,4,reader,6,376,1,5,1.5
7,4,real,4,377,3,1,0.5
7,4,realize,7,378,4,3,1
7,4,receive,7,379,2,5,5
7,4,red,3,380,2,1,0.5
7,4,refuge,6,381,2,4,1.25
7,4,refugee,7,382,6,1,0.5
7,4,regret,6,383,2,4,4.5
7,4,remains,7,384,2,5,1.5
7,4,rental,6,385,2,4,1.25
7,4,report,6,386,2,4,4.75
7,4,result,6,387,2,4,1.25
7,4,resume,6,388,4,2,1
7,4,retreat,7,389,2,5,1.5
7,4,review,6,390,2,4,4.75
7,4,rhythm,6,391,1,5,1.5
7,4,rice,4,392,1,3,1
7,4,risk,4,393,2,2,0.75
7,4,role,4,394,1,3,4.5
7,4,rugby,5,395,1,4,1.25
7,4,rule,4,396,2,2,0.75
7,4,run,3,397,2,1,0.5
7,4,sail,4,398,0,4,1
7,4,salary,6,399,2,4,4.75
7,4,scale,5,400,1,4,1.25
7,4,scope,5,401,2,3,1.5
7,4,scratch,7,402,2,5,5
7,4,scream,6,403,3,3,1.25
7,4,sea,3,404,1,2,0.75
7,4,see,3,405,2,1,0.5
7,4,senator,7,406,2,5,5
7,4,send,4,407,3,1,0.75
7,4,serial,6,408,2,4,1.25
7,4,set,3,409,2,1,0.5
7,4,seventy,7,410,2,5,1.5
7,4,several,7,411,4,3,4.75
7,4,sex,3,412,2,1,0.5
7,4,shadow,6,413,1,5,1.75
7,4,shake,5,414,3,2,1
7,4,shall,5,415,3,2,0.75
7,4,shout,5,416,2,3,4.75
7,4,show,4,417,3,1,0.75
7,4,shrink,6,418,2,4,1.25
7,4,sigh,4,419,1,3,1
7,4,silence,7,420,2,5,5.25
7,4,silent,6,421,5,1,0.75
7,4,silly,5,422,3,2,1
7,4,sing,4,423,2,2,0.75
7,4,sir,3,424,2,1,0.5
7,4,sixty,5,425,2,3,1
7,4,size,4,426,2,2,0.75
7,4,skill,5,427,1,4,4.75
7,4,sky,3,428,2,1,0.5
7,4,slave,5,429,1,4,1.25
7,4,small,5,430,1,4,1.25
7,4,snap,4,431,1,3,4.25
7,4,soak,4,432,1,3,1
7,4,soar,4,433,3,1,0.5
7,4,soft,4,434,2,2,0.75
7,4,solely,6,435,2,4,1.25
7,4,soon,4,436,2,2,0.75
7,4,span,4,437,1,3,4.5
7,4,spite,5,438,2,3,1
7,4,sport,5,439,2,3,1
7,4,spy,3,440,2,1,0.5
7,4,stark,5,441,1,4,4.5
7,4,station,7,442,3,4,1.75
7,4,stress,6,443,2,4,1.5
7,4,strive,6,444,3,3,1.25
7,4,student,7,445,2,5,5.5
7,4,style,5,446,2,3,1
7,4,success,7,447,1,6,1.75
7,4,summit,6,448,2,4,5
7,4,superb,6,449,2,4,1.25
7,4,supply,6,450,3,3,1.25
7,4,surge,5,451,2,3,1
7,4,swing,5,452,1,4,4.75
7,4,t,1,453,0,1,0.25
7,4,tax,3,454,1,2,0.5
7,4,teenage,7,455,1,6,1.75
7,4,tent,4,456,2,2,4.25
7,4,testify,7,457,2,5,1.75
7,4,testing,7,458,5,2,1
7,4,than,4,459,1,3,1
7,4,that,4,460,3,1,0.5
7,4,their,5,461,2,3,4.75
7,4,theirs,6,462,5,1,0.75
7,4,then,4,463,3,1,0.75
7,4,there,5,464,3,2,0.75
7,4,they,4,465,3,1,0.5
7,4,think,5,466,2,3,1.25
7,4,thought,7,467,2,5,5.25
7,4,timber,6,468,1,5,1.5
7,4,toll,4,469,1,3,1
7,4,tongue,6,470,2,4,5
7,4,towel,5,471,2,3,1.25
7,4,trading,7,472,1,6,1.75
7,4,true,4,473,2,2,0.75
7,4,trustee,7,474,3,4,6.75
7,4,truth,5,475,3,2,1.75
7,4,tuition,7,476,1,6,4
7,4,tunnel,6,477,2,4,8.75
7,4,turn,4,478,2,2,1.5
7,4,twist,5,479,1,4,2.75
7,4,ugly,4,480,0,4,2.75
7,4,unit,4,481,1,3,8
7,4,unlike,6,482,2,4,3
7,4,up,2,483,1,1,0.75
7,4,upper,5,484,2,3,2
7,4,upset,5,485,2,3,2
7,4,upwards,7,486,2,5,9
7,4,used,4,487,1,3,2.25
7,4,valid,5,488,0,5,3.25
7,4,vehicle,7,489,1,6,9.75
7,4,village,7,490,1,6,4
7,4,vitamin,7,491,2,5,10
7,4,volume,6,492,1,5,3.5
7,4,vote,4,493,2,2,1.75
7,4,wage,4,494,0,4,2.5
7,4,ward,4,495,2,2,7.5
7,4,warfare,7,496,3,4,3
7,4,wash,4,497,2,2,1.5
7,4,weather,7,498,1,6,3.75
7,4,week,4,499,2,2,7.75
7,4,well,4,500,2,2,1.75
7,4,wet,3,501,2,1,1
7,4,where,5,502,1,4,2.75
7,4,whisper,7,503,2,5,3.5
7,4,wholly,6,504,2,4,9
7,4,wide,4,505,1,3,2.25
7,4,widely,6,506,4,2,1.75
7,4,winter,6,507,2,4,3
7,4,wish,4,508,2,2,8.75
7,4,worm,4,509,1,3,2.25
7,4,worse,5,510,3,2,1.75
7,4,worst,5,511,4,1,1.25
7,4,year,4,512,0,4,2.5
7,4,yell,4,513,2,2,8
7,4,you,3,514,1,2,1.75
7,4,zone,4,515,0,4,2.75
7,5,about,5,0,0,5,5.75
7,5,above,5,1,3,2,5.25
7,5,absent,6,2,2,4,3
7,5,accent,6,3,1,5,3.25
7,5,account,7,4,3,4,9.25
7,5,action,6,5,2,4,3
7,5,adult,5,6,1,4,2.75
7,5,advance,7,7,2,5,9.75
7,5,afraid,6,8,1,5,3.5
7,5,ah,2,9,1,1,0.75
7,5,air,3,10,1,2,1.5
7,5,alert,5,11,1,4,2.75
7,5,alien,5,12,2,3,8.75
7,5,alike,5,13,3,2,2
7,5,alone,5,14,2,3,2.25
7,5,along,5,15,4,1,1.25
7,5,also,4,16,2,2,1.75
7,5,anyone,6,17,1,5,9.5
7,5,apple,5,18,1,4,2.75
7,5,archive,7,19,1,6,4
7,5,armed,5,20,2,3,8.75
7,5,article,7,21,2,5,3.5
7,5,athlete,7,22,1,6,4
7,5,attach,6,23,2,4,9.25
7,5,attack,6,24,5,1,1.25
7,5,attempt,7,25,3,4,3
7,5,august,6,26,1,5,9
7,5,author,6,27,2,4,2.75
7,5,autumn,6,28,3,3,2.5
7,5,avoid,5,29,1,4,2.75
7,5,awkward,7,30,1,6,10
7,5,bad,3,31,0,3,2
7,5,bank,4,32,2,2,1.5
7,5,bare,4,33,2,2,1.5
7,5,basis,5,34,2,3,8.5
7,5,bear,4,35,1,3,3
7,5,because,7,36,2,5,3.75
7,5,become,6,37,3,3,2.5
7,5,bee,3,38,2,1,1
7,5,behind,6,39,2,4,8.5
7,5,beneath,7,40,2,5,3.75
7,5,bias,4,41,1,3,2.25
7,5,biology,7,42,2,5,9.5
7,5,blanket,7,43,1,6,4
7,5,blast,5,44,3,2,1.75
7,5,blend,5,45,2,3,8.75
7,5,blood,5,46,2,3,2.25
7,5,body,4,47,1,3,2.25
7,5,booking,7,48,2,5,3.75
7,5,boring,6,49,2,4,9.25
7,5,bounce,6,50,2,4,3
7,5,branch,6,51,1,5,3.25
7,5,breast,6,52,2,4,9
7,5,brick,5,53,2,3,2.25
7,5,broad,5,54,2,3,2.25
7,5,broadly,7,55,5,2,1.75
7,5,brother,7,56,3,4,9.5
7,5,burst,5,57,1,4,2.75
7,5,bury,4,58,3,1,1.25
7,5,but,3,59,2,1,1
7,5,button,6,60,3,3,2.75
7,5,camp,4,61,0,4,2.75
7,5,captain,7,62,2,5,11
7,5,castle,6,63,2,4,3
7,5,catch,5,64,2,3,2.25
7,5,caution,7,65,2,5,9.75
7,5,centre,6,66,1,5,3.25
7,5,chance,6,67,1,5,3.25
7,5,chest,5,68,2,3,8.5
7,5,cinema,6,69,1,5,3.25
7,5,climb,5,70,1,4,2.75
7,5,cling,5,71,3,2,7.75
7,5,closure,7,72,2,5,3.5
7,5,cloth,5,73,3,2,2
7,5,coast,5,74,1,4,3
7,5,coastal,7,75,5,2,8
7,5,colour,6,76,2,4,2.75
7,5,combat,6,77,2,4,2.75
7,5,common,6,78,3,3,2.5
7,5,compare,7,79,3,4,9.5
7,5,complex,7,80,4,3,2.75
7,5,compose,7,81,4,3,2.5
7,5,confirm,7,82,2,5,3.5
7,5,contact,7,83,3,4,10
7,5,context,7,84,4,3,2.75
7,5,convert,7,85,3,4,3
7,5,convict,7,86,4,3,2.5
7,5,cooking,7,87,2,5,9.5
7,5,cool,4,88,3,1,1.25
7,5,corrupt,7,89,2,5,3.25
7,5,cotton,6,90,2,4,9
7,5,courage,7,91,2,5,3.5
7,5,cow,3,92,2,1,1
7,5,crazy,5,93,1,4,2.75
7,5,cream,5,94,2,3,8.5
7,5,creator,7,95,4,3,2.75
7,5,crop,4,96,2,2,1.5
7,5,crown,5,97,3,2,1.75
7,5,custody,7,98,1,6,10.75
7,5,cutting,7,99,2,5,3.5
7,5,dancer,6,100,0,6,3.75
7,5,dark,4,101,2,2,8.5
7,5,date,4,102,2,2,2
7,5,dear,4,103,1,3,2.25
7,5,debris,6,104,2,4,3
7,5,deck,4,105,2,2,1.75
7,5,define,6,106,2,4,9.5
7,5,defy,4,107,3,1,1.25
7,5,denial,6,108,2,4,2.75
7,5,depart,6,109,2,4,2.75
7,5,descend,7,110,2,5,9.75
7,5,descent,7,111,6,1,1.75
7,5,desert,6,112,3,3,2.5
7,5,desire,6,113,3,3,2.5
7,5,devise,6,114,2,4,9
7,5,diary,5,115,1,4,2.75
7,5,dilemma,7,116,2,5,3.5
7,5,dip,3,117,2,1,1
7,5,discard,7,118,2,5,9.75
7,5,disease,7,119,3,4,3.25
7,5,disturb,7,120,3,4,3.25
7,5,diverse,7,121,2,5,9.75
7,5,donor,5,122,1,4,2.75
7,5,drain,5,123,1,4,2.75
7,5,driver,6,124,2,4,9.25
7,5,due,3,125,1,2,1.5
7,5,dull,4,126,2,2,1.75
7,5,during,6,127,2,4,2.75
7,5,duty,4,128,2,2,1.5
7,5,dynamic,7,129,1,6,10.25
7,5,early,5,130,0,5,3.25
7,5,easily,6,131,2,4,3
7,5,eastern,7,132,3,4,9.25
7,5,easy,4,133,3,1,1.25
7,5,eat,3,134,2,1,1
7,5,edge,4,135,1,3,2
7,5,elevate,7,136,1,6,9.5
7,5,emerge,6,137,1,5,1.75
7,5,empire,6,138,2,4,1.5
7,5,employ,6,139,3,3,1.25
7,5,energy,6,140,1,5,5.5
7,5,enforce,7,141,2,5,1.75
7,5,enhance,7,142,2,5,5.75
7,5,enquire,7,143,2,5,1.75
7,5,enrol,5,144,2,3,1
7,5,ensue,5,145,2,3,1
7,5,entire,6,146,2,4,5.5
7,5,equal,5,147,1,4,1.25
7,5,era,3,148,1,2,0.75
7,5,error,5,149,2,3,1
7,5,eternal,7,150,1,6,5.75
7,5,ethical,7,151,2,5,1.75
7,5,ethnic,6,152,3,3,1.25
7,5,exam,4,153,1,3,5
7,5,example,7,154,4,3,1.25
7,5,except,6,155,2,4,1.25
7,5,exclude,7,156,3,4,1.5
7,5,export,6,157,2,4,5.5
7,5,extra,5,158,2,3,1
7,5,fact,4,159,0,4,1
7,5,faction,7,160,4,3,1
7,5,factor,6,161,4,2,5
7,5,factory,7,162,6,1,0.75
7,5,fame,4,163,2,2,0.75
7,5,fan,3,164,2,1,0.5
7,5,farm,4,165,2,2,0.75
7,5,favour,6,166,2,4,1.25
7,5,feat,4,167,1,3,5
7,5,feature,7,168,4,3,1.25
7,5,feed,4,169,2,2,0.75
7,5,feel,4,170,3,1,0.5
7,5,feeling,7,171,4,3,1
7,5,fence,5,172,2,3,1
7,5,figure,6,173,1,5,5.75
7,5,fill,4,174,2,2,0.75
7,5,film,4,175,3,1,0.75
7,5,finish,6,176,2,4,1.25
7,5,fishing,7,177,2,5,5.5
7,5,five,4,178,2,2,0.75
7,5,flame,5,179,1,4,1.25
7,5,fleet,5,180,2,3,1
7,5,float,5,181,2,3,5
7,5,flood,5,182,3,2,1
7,5,flour,5,183,3,2,1
7,5,fluid,5,184,2,3,1
7,5,follow,6,185,1,5,5.75
7,5,fond,4,186,2,2,1
7,5,fool,4,187,2,2,0.75
7,5,forge,5,188,2,3,1
7,5,forgive,7,189,4,3,1.25
7,5,formal,6,190,3,3,5
7,5,format,6,191,5,1,1
7,5,forth,5,192,3,2,1
7,5,forum,5,193,3,2,0.75
7,5,fossil,6,194,2,4,1.25
7,5,frame,5,195,1,4,5.5
7,5,frankly,7,196,3,4,1.5
7,5,freely,6,197,2,4,1.75
7,5,freeze,6,198,4,2,1
7,5,from,4,199,2,2,0.75
7,5,fully,5,200,1,4,5.25
7,5,fund,4,201,2,2,1
7,5,gentle,6,202,0,6,1.75
7,5,genuine,7,203,3,4,5.5
7,5,grain,5,204,1,4,1.25
7,5,grant,5,205,3,2,1
7,5,grass,5,206,3,2,0.75
7,5,great,5,207,2,3,1
7,5,half,4,208,0,4,5.25
7,5,happy,5,209,2,3,1
7,5,harmful,7,210,2,5,1.75
7,5,harmony,7,211,4,3,5.5
7,5,he,2,212,1,1,0.5
7,5,hello,5,213,2,3,1
7,5,help,4,214,3,1,0.5
7,5,hence,5,215,2,3,1
7,5,hide,4,216,1,3,1
7,5,highway,7,217,2,5,6
7,5,hill,4,218,2,2,0.75
7,5,history,7,219,2,5,1.5
7,5,hobby,5,220,1,4,5.5
7,5,holy,4,221,2,2,0.75
7,5,hook,4,222,2,2,0.75
7,5,hope,4,223,2,2,0.75
7,5,horizon,7,224,2,5,1.5
7,5,host,4,225,2,2,4.75
7,5,hostile,7,226,4,3,1.25
7,5,housing,7,227,2,5,1.5
7,5,hurry,5,228,1,4,1.25
7,5,ignore,6,229,0,6,5.75
7,5,immense,7,230,1,6,1.75
7,5,in,2,231,1,1,0.5
7,5,indeed,6,232,2,4,5.25
7,5,indoor,6,233,3,3,1.25
7,5,induce,6,234,3,3,1.25
7,5,indulge,7,235,4,3,1.25
7,5,initial,7,236,2,5,6
7,5,injured,7,237,2,5,1.75
7,5,inmate,6,238,2,4,1.5
7,5,insect,6,239,2,4,6
7,5,insight,7,240,3,4,1.5
7,5,inspire,7,241,3,4,1.75
7,5,invent,6,242,2,4,7
7,5,joint,5,243,0,5,1.75
7,5,july,4,244,1,3,1
7,5,justice,7,245,2,5,7
7,5,keen,4,246,0,4,1.25
7,5,kill,4,247,1,3,1.25
7,5,killing,7,248,4,3,1.25
7,5,kiss,4,249,2,2,5.5
7,5,labour,6,250,0,6,2
7,5,laptop,6,251,2,4,1.5
7,5,layout,6,252,2,4,6.25
7,5,leap,4,253,1,3,1.25
7,5,learn,5,254,3,2,1
7,5,leave,5,255,3,2,1
7,5,legacy,6,256,2,4,1.5
7,5,lend,4,257,2,2,8
7,5,length,6,258,3,3,436.75
7,5,less,4,259,2,2,4.25
7,5,let,3,260,2,1,2.25
7,5,level,5,261,2,3,3.25
7,5,limit,5,262,1,4,7.5
7,5,linger,6,263,2,4,18.5
7,5,lobby,5,264,1,4,6.5
7,5,logic,5,265,2,3,3.75
7,5,loop,4,266,2,2,2.5
7,5,lord,4,267,2,2,2.25
7,5,lose,4,268,2,2,11.75
7,5,loss,4,269,3,1,2.5
7,5,lovely,6,270,2,4,4.5
7,5,lower,5,271,2,3,6
7,5,magical,7,272,0,7,20
7,5,major,5,273,2,3,3
7,5,manner,6,274,2,4,3.75
7,5,marry,5,275,2,3,3
7,5,mate,4,276,2,2,10.5
7,5,maybe,5,277,2,3,2.25
7,5,meaning,7,278,1,6,4
7,5,measure,7,279,3,4,9
7,5,medical,7,280,2,5,4
7,5,meet,4,281,2,2,1.75
7,5,metal,5,282,2,3,2.75
7,5,milk,4,283,1,3,9
7,5,minor,5,284,2,3,2.25
7,5,missile,7,285,2,5,4.75
7,5,mistake,7,286,3,4,3.75
7,5,mobile,6,287,1,5,10.25
7,5,mode,4,288,2,2,1.75
7,5,modern,6,289,4,2,2
7,5,modest,6,290,4,2,1.75
7,5,monitor,7,291,2,5,8.75
7,5,monk,4,292,3,1,1.25
7,5,morning,7,293,2,5,3.5
7,5,motor,5,294,2,3,2.25
7,5,mount,5,295,2,3,7.5
7,5,move,4,296,2,2,1.75
7,5,myself,6,297,1,5,3.25
7,5,mystery,7,298,3,4,3
7,5,nest,4,299,0,4,7.75
7,5,net,3,300,2,1,1
7,5,network,7,301,3,4,3
7,5,ninety,6,302,1,5,3.25
7,5,nod,3,303,1,2,6.75
7,5,notable,7,304,2,5,3.75
7,5,notably,7,305,6,1,1.5
7,5,number,6,306,1,5,3.5
7,5,nursery,7,307,2,5,9
7,5,o,1,308,0,1,0.75
7,5,obey,4,309,1,3,2
7,5,observe,7,310,2,5,3.5
7,5,of,2,311,1,1,6
7,5,offer,5,312,2,3,2.5
7,5,onion,5,313,1,4,2.75
7,5,onto,4,314,2,2,1.75
7,5,open,4,315,1,3,2
7,5,opinion,7,316,2,5,8.75
7,5,or,2,317,1,1,0.75
7,5,oral,4,318,2,2,1.5
7,5,outrage,7,319,1,6,4
7,5,own,3,320,1,2,7
7,5,owner,5,321,3,2,1.75
7,5,oxygen,6,322,1,5,3.25
7,5,pair,4,323,0,4,2.5
7,5,palm,4,324,2,2,7
7,5,pan,3,325,2,1,1
7,5,parish,6,326,2,4,2.75
7,5,pass,4,327,2,2,1.5
7,5,passing,7,328,4,3,2.25
7,5,payment,7,329,2,5,8.75
7,5,peak,4,330,1,3,2
7,5,penalty,7,331,2,5,3.5
7,5,period,6,332,2,4,9
7,5,phase,5,333,1,4,2.75
7,5,pit,3,334,1,2,1.5
7,5,pitch,5,335,3,2,1.5
7,5,player,6,336,1,5,8.75
7,5,plug,4,337,2,2,1.75
7,5,poetry,6,338,1,5,3.25
7,5,portray,7,339,2,5,3.5
7,5,poverty,7,340,2,5,9.25
7,5,precede,7,341,1,6,4
7,5,prepare,7,342,3,4,9.5
7,5,present,7,343,3,4,3
7,5,prevent,7,344,3,4,3
7,5,prey,4,345,3,1,1.25
7,5,price,5,346,2,3,2.5
7,5,priest,6,347,3,3,8.5
7,5,prince,6,348,3,3,2.5
7,5,proceed,7,349,2,5,6.25
7,5,protect,7,350,3,4,9.25
7,5,protein,7,351,5,2,2.5
7,5,purely,6,352,1,5,3.25
7,5,pursue,6,353,3,3,2.5
7,5,qualify,7,354,0,7,10.25
7,5,quarter,7,355,3,4,3.25
7,5,queen,5,356,2,3,2.25
7,5,queue,5,357,3,2,7.5
7,5,quickly,7,358,2,5,3.5
7,5,quota,5,359,2,3,2.25
7,5,racist,6,360,0,6,9.25
7,5,rapid,5,361,2,3,2.25
7,5,readily,7,362,1,6,4
7,5,really,6,363,3,3,2.5
7,5,receive,7,364,2,5,9.25
7,5,red,3,365,2,1,1
7,5,refugee,7,366,2,5,3.5
7,5,release,7,367,2,5,8.75
7,5,rely,4,368,3,1,1.25
7,5,remains,7,369,2,5,3.5
7,5,remote,6,370,3,3,2.5
7,5,report,6,371,2,4,8.75
7,5,retreat,7,372,2,5,3.5
7,5,review,6,373,2,4,3
7,5,rhythm,6,374,1,5,8.75
7,5,rid,3,375,1,2,1.5
7,5,riot,4,376,2,2,1.75
7,5,risk,4,377,2,2,1.5
7,5,route,5,378,1,4,2.75
7,5,royal,5,379,2,3,7.75
7,5,sad,3,380,0,3,2
7,5,sail,4,381,2,2,1.5
7,5,say,3,382,2,1,1
7,5,scope,5,383,1,4,2.5
7,5,scratch,7,384,2,5,6.25
7,5,seize,5,385,1,4,1.25
7,5,seldom,6,386,2,4,1.5
7,5,senator,7,387,2,5,5
7,5,senior,6,388,3,3,1.25
7,5,serial,6,389,2,4,1.25
7,5,set,3,390,2,1,0.5
7,5,seventy,7,391,2,5,4.75
7,5,several,7,392,4,3,1.25
7,5,shade,5,393,1,4,1.25
7,5,short,5,394,2,3,1.25
7,5,shot,4,395,3,1,4
7,5,should,6,396,3,3,1.25
7,5,shout,5,397,4,1,0.75
7,5,shrug,5,398,2,3,1
7,5,sigh,4,399,1,3,1
7,5,silent,6,400,2,4,5
7,5,sir,3,401,2,1,0.5
7,5,sixty,5,402,2,3,1
7,5,skiing,6,403,1,5,1.5
7,5,slave,5,404,1,4,5
7,5,sleep,5,405,2,3,1.25
7,5,smart,5,406,1,4,1.25
7,5,soccer,6,407,1,5,1.5
7,5,society,7,408,3,4,5.5
7,5,soft,4,409,2,2,0.75
7,5,solely,6,410,2,4,1.25
7,5,soon,4,411,2,2,0.75
7,5,sorry,5,412,2,3,4.75
7,5,sort,4,413,3,1,0.75
7,5,spite,5,414,1,4,1.25
7,5,spoil,5,415,2,3,1
7,5,sponsor,7,416,3,4,1.5
7,5,sport,5,417,3,2,4.75
7,5,station,7,418,1,6,1.75
7,5,status,6,419,4,2,1
7,5,steel,5,420,2,3,1
7,5,steep,5,421,4,1,4.25
7,5,stiff,5,422,2,3,1
7,5,stream,6,423,2,4,1.25
7,5,stress,6,424,4,2,1
7,5,strive,6,425,3,3,1.25
7,5,student,7,426,2,5,5
7,5,style,5,427,2,3,1.25
7,5,suburb,6,428,1,5,1.5
7,5,suffer,6,429,2,4,4.75
7,5,suicide,7,430,2,5,1.5
7,5,sum,3,431,2,1,0.5
7,5,supply,6,432,2,4,1.25
7,5,surface,7,433,2,5,5
7,5,survive,7,434,3,4,1.5
7,5,symbol,6,435,1,5,1.5
7,5,teach,5,436,0,5,4.75
7,5,teenage,7,437,2,5,1.5
7,5,tent,4,438,2,2,0.75
7,5,testing,7,439,2,5,5
7,5,text,4,440,2,2,0.75
7,5,than,4,441,1,3,1
7,5,that,4,442,3,1,0.5
7,5,theatre,7,443,2,5,5
7,5,them,4,444,3,1,0.75
7,5,then,4,445,3,1,0.5
7,5,there,5,446,3,2,0.75
7,5,they,4,447,3,1,0.5
7,5,thief,5,448,2,3,1
7,5,thin,4,449,3,1,0.5
7,5,thing,5,450,4,1,0.5
7,5,think,5,451,4,1,0.5
7,5,though,6,452,2,4,4.75
7,5,thought,7,453,6,1,0.75
7,5,throat,6,454,2,4,1.25
7,5,throw,5,455,4,1,0.5
7,5,timber,6,456,1,5,5.5
7,5,tiny,4,457,2,2,0.75
7,5,tired,5,458,2,3,1
7,5,ton,3,459,1,2,0.5
7,5,tone,4,460,3,1,0.5
7,5,total,5,461,2,3,1
7,5,touch,5,462,2,3,4.5
7,5,tourist,7,463,3,4,1.5
7,5,towards,7,464,2,5,1.5
7,5,towel,5,465,3,2,0.75
7,5,trace,5,466,1,4,5
7,5,trust,5,467,2,3,1.25
7,5,trustee,7,468,5,2,1
7,5,try,3,469,2,1,0.5
7,5,tuesday,7,470,1,6,5.5
7,5,tuition,7,471,2,5,1.75
7,5,tunnel,6,472,2,4,1.5
7,5,twenty,6,473,1,5,5.25
7,5,twist,5,474,2,3,1.25
7,5,typical,7,475,1,6,2
7,5,ugly,4,476,0,4,5
7,5,under,5,477,1,4,1.5
7,5,unit,4,478,2,2,1
7,5,unlike,6,479,2,4,1.5
7,5,up,2,480,1,1,0.5
7,5,upper,5,481,2,3,5.25
7,5,upset,5,482,2,3,1.25
7,5,us,2,483,1,1,0.5
7,5,use,3,484,2,1,0.5
7,5,used,4,485,3,1,0.5
7,5,valid,5,486,0,5,5.5
7,5,versus,6,487,1,5,1.5
7,5,violate,7,488,1,6,2
7,5,volume,6,489,1,5,5.25
7,5,vote,4,490,2,2,1
7,5,ward,4,491,0,4,1.5
7,5,warfare,7,492,3,4,1.5
7,5,wash,4,493,2,2,4.75
7,5,we,2,494,1,1,0.5
7,5,wear,4,495,2,2,0.75
7,5,weekly,6,496,2,4,1.25
7,5,well,4,497,2,2,0.75
7,5,where,5,498,1,4,5
7,5,whilst,6,499,2,4,1.25
7,5,whisper,7,500,3,4,1.75
7,5,whole,5,501,2,3,1.25
7,5,wholly,6,502,4,2,4.75
7,5,wide,4,503,1,3,1
7,5,widely,6,504,4,2,0.75
7,5,winner,6,505,2,4,1.25
7,5,winter,6,506,3,3,1.25
7,5,wish,4,507,2,2,4.5
7,5,worse,5,508,1,4,1.25
7,5,worst,5,509,4,1,0.5
7,5,writer,6,510,1,5,1.5
7,5,year,4,511,0,4,4.75
7,5,yell,4,512,2,2,0.75
7,5,you,3,513,1,2,0.75
7,5,zero,4,514,0,4,1.25
7,5,zone,4,515,1,3,5
7,6,abolish,7,0,0,7,2
7,6,abroad,6,1,2,4,5
7,6,academy,7,2,1,6,1.75
7,6,accent,6,3,2,4,1.25
7,6,access,6,4,4,2,1
7,6,acquire,7,5,2,5,5.25
7,6,action,6,6,2,4,1.25
7,6,adhere,6,7,1,5,1.5
7,6,adult,5,8,2,3,5
7,6,affair,6,9,1,5,1.5
7,6,agent,5,10,1,4,1.25
7,6,ah,2,11,1,1,0.25
7,6,air,3,12,1,2,4.5
7,6,alien,5,13,1,4,1.25
7,6,allow,5,14,2,3,1.25
7,6,along,5,15,2,3,1
7,6,angry,5,16,1,4,5
7,6,answer,6,17,2,4,1.5
7,6,apple,5,18,1,4,1.25
7,6,apply,5,19,4,1,0.5
7,6,appoint,7,20,3,4,5.25
7,6,april,5,21,2,3,1.25
7,6,array,5,22,1,4,1.25
7,6,arrival,7,23,3,4,1.25
7,6,article,7,24,2,5,5.5
7,6,athlete,7,25,1,6,2
7,6,attach,6,26,2,4,5.25
7,6,attack,6,27,5,1,1
7,6,august,6,28,1,5,1.5
7,6,author,6,29,2,4,1.5
7,6,autumn,6,30,3,3,1.25
7,6,avoid,5,31,1,4,5.25
7,6,aware,5,32,1,4,1.25
7,6,away,4,33,3,1,0.5
7,6,back,4,34,0,4,1.25
7,6,bake,4,35,2,2,4.5
7,6,ballot,6,36,2,4,1.25
7,6,banana,6,37,2,4,1.25
7,6,become,6,38,1,5,5.25
7,6,bee,3,39,2,1,0.5
7,6,beef,4,40,3,1,0.5
7,6,behind,6,41,2,4,1.25
7,6,bend,4,42,2,2,0.75
7,6,beneath,7,43,3,4,1.25
7,6,bent,4,44,3,1,4.25
7,6,bet,3,45,2,1,0.5
7,6,bias,4,46,1,3,1
7,6,bicycle,7,47,2,5,1.5
7,6,big,3,48,2,1,0.5
7,6,blast,5,49,1,4,4.75
7,6,bleed,5,50,2,3,1
7,6,body,4,51,1,3,1
7,6,bonus,5,52,2,3,1
7,6,bounce,6,53,2,4,5.25
7,6,brain,5,54,1,4,1.25
7,6,branch,6,55,3,3,1.25
7,6,breast,6,56,2,4,1.25
7,6,breath,6,57,4,2,5
7,6,briefly,7,58,2,5,1.5
7,6,brother,7,59,2,5,1.5
7,6,brown,5,60,3,2,1
7,6,buck,4,61,1,3,5
7,6,bulk,4,62,2,2,0.75
7,6,burial,6,63,2,4,1.25
7,6,bury,4,64,3,1,0.5
7,6,bus,3,65,2,1,0.5
7,6,but,3,66,2,1,0.5
7,6,button,6,67,3,3,4.75
7,6,bye,3,68,1,2,0.75
7,6,cabinet,7,69,0,7,2
7,6,camp,4,70,2,2,0.75
7,6,captain,7,71,2,5,5.75
7,6,case,4,72,2,2,0.75
7,6,castle,6,73,3,3,1.25
7,6,cat,3,74,2,1,0.5
7,6,cause,5,75,2,3,1
7,6,caution,7,76,3,4,5.5
7,6,cent,4,77,1,3,1
7,6,cheek,5,78,1,4,1.25
7,6,chef,4,79,3,1,0.5
7,6,claim,5,80,1,4,5.25
7,6,classic,7,81,3,4,1.5
7,6,clinic,6,82,2,4,1.5
7,6,clip,4,83,3,1,0.75
7,6,clock,5,84,2,3,5
7,6,closure,7,85,3,4,1.5
7,6,clothes,7,86,3,4,1.5
7,6,clue,4,87,2,2,0.75
7,6,coast,5,88,1,4,5
7,6,coin,4,89,2,2,0.75
7,6,college,7,90,2,5,1.5
7,6,combine,7,91,2,5,5.5
7,6,commit,6,92,3,3,1.25
7,6,common,6,93,4,2,1
7,6,compare,7,94,3,4,1.5
7,6,compose,7,95,4,3,1.25
7,6,confirm,7,96,2,5,5.5
7,6,consume,7,97,3,4,1.5
7,6,contact,7,98,3,4,1.5
7,6,contest,7,99,4,3,5.25
7,6,convert,7,100,3,4,1.5
7,6,convict,7,101,4,3,1.25
7,6,cook,4,102,2,2,0.75
7,6,cool,4,103,3,1,0.75
7,6,copy,4,104,2,2,4.75
7,6,covered,7,105,2,5,1.5
7,6,cow,3,106,2,1,0.5
7,6,crash,5,107,1,4,1.25
7,6,crazy,5,108,3,2,1
7,6,crown,5,109,2,3,5
7,6,cue,3,110,1,2,0.75
7,6,cult,4,111,2,2,0.75
7,6,custom,6,112,2,4,1.25
7,6,dark,4,113,0,4,5
7,6,data,4,114,2,2,1.25
7,6,dead,4,115,1,3,2.25
7,6,deadly,6,116,4,2,1.75
7,6,debate,6,117,2,4,3
7,6,debris,6,118,3,3,10
7,6,debut,5,119,3,2,2
7,6,defeat,6,120,2,4,2.75
7,6,define,6,121,3,3,2.5
7,6,denial,6,122,2,4,10.25
7,6,depart,6,123,2,4,3.25
7,6,derive,6,124,2,4,3.25
7,6,descent,7,125,2,5,10.5
7,6,desire,6,126,3,3,2.5
7,6,destroy,7,127,3,4,3.25
7,6,discard,7,128,1,6,14.25
7,6,disease,7,129,3,4,3
7,6,dispose,7,130,3,4,3
7,6,disrupt,7,131,3,4,3
7,6,disturb,7,132,3,4,9.75
7,6,diverse,7,133,2,5,3.75
7,6,divert,6,134,5,1,1.25
7,6,dog,3,135,1,2,1.5
7,6,door,4,136,2,2,1.75
7,6,dose,4,137,2,2,8
7,6,dress,5,138,1,4,2.75
7,6,drive,5,139,2,3,2.25
7,6,drum,4,140,2,2,1.75
7,6,drunk,5,141,3,2,2
7,6,dry,3,142,2,1,10
7,6,duty,4,143,1,3,3.25
7,6,dynamic,7,144,1,6,4.5
7,6,each,4,145,0,4,10
7,6,easily,6,146,2,4,3
7,6,echo,4,147,1,3,2.25
7,6,economy,7,148,2,5,3.75
7,6,element,7,149,1,6,10.75
7,6,emerge,6,150,1,5,3.25
7,6,employ,6,151,2,4,9.75
7,6,endorse,7,152,1,6,4
7,6,ensue,5,153,2,3,2.5
7,6,entity,6,154,2,4,3
7,6,error,5,155,1,4,9.5
7,6,ethical,7,156,1,6,4
7,6,evil,4,157,1,3,2
7,6,exam,4,158,1,3,8.75
7,6,example,7,159,4,3,2.5
7,6,except,6,160,2,4,3
7,6,exclude,7,161,3,4,3
7,6,exert,5,162,2,3,8.75
7,6,export,6,163,2,4,3
7,6,fact,4,164,0,4,2.5
7,6,faction,7,165,4,3,9
7,6,factor,6,166,4,2,2
7,6,fame,4,167,2,2,1.5
7,6,fan,3,168,2,1,1
7,6,farm,4,169,2,2,1.5
7,6,feather,7,170,1,6,10.75
7,6,feature,7,171,4,3,2.5
7,6,feed,4,172,2,2,1.75
7,6,feel,4,173,3,1,1.25
7,6,find,4,174,1,3,2
7,6,finger,6,175,3,3,2.25
7,6,finish,6,176,3,3,9.75
7,6,fire,4,177,2,2,1.5
7,6,firearm,7,178,4,3,2.5
7,6,first,5,179,3,2,1.75
7,6,fit,3,180,2,1,1
7,6,flame,5,181,1,4,9.25
7,6,flaw,4,182,3,1,1
7,6,fluid,5,183,2,3,2.25
7,6,follow,6,184,1,5,3.25
7,6,forge,5,185,2,3,2.25
7,6,fork,4,186,3,1,8
7,6,formal,6,187,3,3,2.5
7,6,forum,5,188,3,2,1.75
7,6,fully,5,189,1,4,2.75
7,6,fun,3,190,2,1,1
7,6,funny,5,191,3,2,1.75
7,6,furious,7,192,2,5,10.25
7,6,gang,4,193,0,4,2.5
7,6,gas,3,194,2,1,1
7,6,genuine,7,195,1,6,10.75
7,6,get,3,196,2,1,1
7,6,ghost,5,197,1,4,2.75
7,6,goods,5,198,1,4,2.75
7,6,grand,5,199,1,4,9.25
7,6,grant,5,200,4,1,1.5
7,6,grass,5,201,3,2,2
7,6,greatly,7,202,2,5,3.75
7,6,half,4,203,0,4,9.25
7,6,hatred,6,204,2,4,2.75
7,6,hear,4,205,1,3,2.25
7,6,heavily,7,206,3,4,3
7,6,hello,5,207,2,3,9
7,6,helmet,6,208,3,3,2.5
7,6,hidden,6,209,1,5,3.25
7,6,highway,7,210,2,5,10
7,6,himself,7,211,2,5,3.5
7,6,hobby,5,212,1,4,2.75
7,6,hockey,6,213,2,4,2.75
7,6,holy,4,214,2,2,8.5
7,6,honour,6,215,2,4,2.75
7,6,hook,4,216,2,2,1.5
7,6,hope,4,217,2,2,1.5
7,6,host,4,218,2,2,1.5
7,6,hostile,7,219,4,3,9
7,6,hungry,6,220,1,5,3.25
7,6,illness,7,221,0,7,11.5
7,6,imagine,7,222,1,6,4
7,6,impress,7,223,2,5,3.75
7,6,in,2,224,1,1,0.75
7,6,indeed,6,225,2,4,9.5
7,6,indoor,6,226,3,3,2.5
7,6,induce,6,227,3,3,2.5
7,6,indulge,7,228,4,3,2.75
7,6,initial,7,229,2,5,10.25
7,6,input,5,230,2,3,2.5
7,6,insect,6,231,2,4,3
7,6,insight,7,232,3,4,9.5
7,6,invent,6,233,2,4,3
7,6,invoke,6,234,3,3,2.5
7,6,jam,3,235,0,3,2
7,6,keen,4,236,0,4,8.75
7,6,kidnap,6,237,1,5,3.5
7,6,kill,4,238,2,2,1.75
7,6,kiss,4,239,2,2,1.75
7,6,knock,5,240,1,4,9.5
7,6,label,5,241,0,5,3.25
7,6,labour,6,242,3,3,2.5
7,6,lamp,4,243,2,2,1.75
7,6,landing,7,244,2,5,10.25
7,6,laptop,6,245,2,4,2.75
7,6,lately,6,246,2,4,2.75
7,6,lawsuit,7,247,2,5,10
7,6,lead,4,248,1,3,2
7,6,legacy,6,249,2,4,3
7,6,legal,5,250,4,1,1.25
7,6,length,6,251,2,4,9.5
7,6,less,4,252,2,2,1.5
7,6,let,3,253,2,1,1
7,6,loan,4,254,1,3,2.25
7,6,loom,4,255,2,2,1.75
7,6,loop,4,256,3,1,1.5
7,6,loss,4,257,2,2,2
7,6,lost,4,258,3,1,1.5
7,6,lovely,6,259,2,4,10.75
7,6,lower,5,260,2,3,2.25
7,6,luck,4,261,1,3,2.5
7,6,lung,4,262,2,2,2
7,6,major,5,263,0,5,10.25
7,6,man,3,264,2,1,1
7,6,manner,6,265,3,3,2.5
7,6,march,5,266,2,3,2.25
7,6,marker,6,267,3,3,9.25
7,6,marry,5,268,3,2,2
7,6,massive,7,269,2,5,3.5
7,6,maths,5,270,2,3,2.25
7,6,meaning,7,271,1,6,10.75
7,6,measure,7,272,3,4,3
7,6,medical,7,273,2,5,3.5
7,6,meet,4,274,2,2,8.25
7,6,menu,4,275,2,2,1.5
7,6,metal,5,276,2,3,2.25
7,6,mile,4,277,1,3,2
7,6,mill,4,278,3,1,1
7,6,miner,5,279,2,3,2.25
7,6,mining,6,280,3,3,9.25
7,6,missile,7,281,2,5,3.5
7,6,mobile,6,282,1,5,3.25
7,6,modern,6,283,2,4,9.75
7,6,monitor,7,284,2,5,3.5
7,6,monk,4,285,3,1,1.25
7,6,morning,7,286,2,5,10.25
7,6,motive,6,287,2,4,3.25
7,6,motor,5,288,3,2,2
7,6,musical,7,289,1,6,4
7,6,mutual,6,290,2,4,9.75
7,6,myself,6,291,1,5,3.25
7,6,mystery,7,292,3,4,3.25
7,6,nail,4,293,0,4,7
7,6,native,6,294,2,4,1.5
7,6,naval,5,295,2,3,1
7,6,nerve,5,296,1,4,5.25
7,6,nest,4,297,2,2,1
7,6,net,3,298,2,1,0.5
7,6,news,4,299,2,2,0.75
7,6,noon,4,300,1,3,1
7,6,notably,7,301,2,5,1.5
7,6,now,3,302,2,1,4.5
7,6,number,6,303,1,5,1.5
7,6,object,6,304,0,6,1.5
7,6,obvious,7,305,2,5,5.75
7,6,occur,5,306,1,4,1.25
7,6,offer,5,307,1,4,1.25
7,6,on,2,308,1,1,0.25
7,6,onion,5,309,2,3,5.75
7,6,onto,4,310,2,2,1
7,6,open,4,311,1,3,1.5
7,6,or,2,312,1,1,0.5
7,6,oral,4,313,2,2,1.75
7,6,orange,6,314,3,3,2.5
7,6,our,3,315,1,2,6.25
7,6,outrage,7,316,2,5,2
7,6,oven,4,317,1,3,1
7,6,over,4,318,3,1,0.5
7,6,overly,6,319,4,2,1
7,6,owner,5,320,1,4,6.5
7,6,paper,5,321,0,5,1.5
7,6,parish,6,322,2,4,1.5
7,6,partly,6,323,3,3,5.5
7,6,pass,4,324,2,2,0.75
7,6,payment,7,325,2,5,1.5
7,6,pension,7,326,1,6,6.25
7,6,people,6,327,2,4,1.5
7,6,person,6,328,2,4,1.25
7,6,pill,4,329,1,3,1
7,6,pit,3,330,2,1,4.75
7,6,plain,5,331,1,4,1.25
7,6,plunge,6,332,2,4,1.25
7,6,poet,4,333,1,3,1
7,6,pole,4,334,2,2,6.25
7,6,pop,3,335,2,1,0.5
7,6,portray,7,336,2,5,1.75
7,6,powder,6,337,2,4,1.5
7,6,precede,7,338,1,6,6.75
7,6,prefer,6,339,3,3,1.25
7,6,premium,7,340,3,4,1.5
7,6,pretty,6,341,3,3,1
7,6,prey,4,342,3,1,4.75
7,6,price,5,343,2,3,1.25
7,6,proceed,7,344,2,5,1.5
7,6,promote,7,345,3,4,1.5
7,6,protein,7,346,3,4,6.25
7,6,provide,7,347,3,4,1.5
7,6,pub,3,348,1,2,0.75
7,6,punch,5,349,2,3,1
7,6,purely,6,350,2,4,5.5
7,6,qualify,7,351,0,7,2
7,6,quarter,7,352,3,4,5.5
7,6,quote,5,353,2,3,1.25
7,6,racist,6,354,0,6,1.75
7,6,rain,4,355,2,2,0.75
7,6,rare,4,356,2,2,0.75
7,6,read,4,357,1,3,5.5
7,6,readily,7,358,4,3,1.25
7,6,reading,7,359,5,2,1.25
7,6,real,4,360,3,1,0.75
7,6,receive,7,361,2,5,5.75
7,6,recipe,6,362,3,3,1.25
7,6,refuge,6,363,2,4,1.25
7,6,refugee,7,364,6,1,0.5
7,6,regret,6,365,2,4,1.25
7,6,remains,7,366,2,5,5.75
7,6,remote,6,367,3,3,1.25
7,6,report,6,368,2,4,1.25
7,6,respect,7,369,2,5,6
7,6,result,6,370,3,3,1.25
7,6,resume,6,371,4,2,1
7,6,retreat,7,372,2,5,1.5
7,6,reverse,7,373,2,5,5.75
7,6,rice,4,374,1,3,1
7,6,rid,3,375,2,1,0.5
7,6,riot,4,376,2,2,0.75
7,6,risk,4,377,2,2,0.75
7,6,role,4,378,1,3,5
7,6,route,5,379,2,3,1.25
7,6,royal,5,380,2,3,1.25
7,6,rule,4,381,1,3,1
7,6,rumour,6,382,2,4,5.5
7,6,runner,6,383,2,4,1.5
7,6,sad,3,384,0,3,1
7,6,sadly,5,385,3,2,0.75
7,6,salary,6,386,2,4,5.75
7,6,say,3,387,2,1,0.5
7,6,scale,5,388,1,4,1.25
7,6,scope,5,389,2,3,1
7,6,scream,6,390,2,4,5.5
7,6,script,6,391,3,3,1.25
7,6,see,3,392,1,2,0.75
7,6,seldom,6,393,2,4,1.25
7,6,self,4,394,3,1,0.75
7,6,senator,7,395,2,5,5.75
7,6,senior,6,396,3,3,1.25
7,6,serial,6,397,2,4,1.25
7,6,set,3,398,2,1,0.5
7,6,seventy,7,399,2,5,6
7,6,several,7,400,4,3,1.5
7,6,sex,3,401,2,1,0.5
7,6,shadow,6,402,1,5,1.5
7,6,shall,5,403,3,2,1
7,6,sheet,5,404,2,3,5.5
7,6,shop,4,405,2,2,0.75
7,6,short,5,406,3,2,1
7,6,shot,4,407,3,1,0.5
7,6,shout,5,408,3,2,0.75
7,6,show,4,409,3,1,0.5
7,6,shrink,6,410,2,4,5.5
7,6,sigh,4,411,1,3,1.25
7,6,silence,7,412,2,5,1.75
7,6,skiing,6,413,1,5,6
7,6,skill,5,414,3,2,1
7,6,slave,5,415,1,4,1.25
7,6,sleep,5,416,2,3,1.25
7,6,slogan,6,417,2,4,5.75
7,6,smart,5,418,1,4,1.5
7,6,snap,4,419,1,3,1
7,6,soccer,6,420,1,5,1.5
7,6,society,7,421,3,4,6.25
7,6,soft,4,422,2,2,0.75
7,6,soldier,7,423,2,5,1.75
7,6,solely,6,424,3,3,1.25
7,6,source,6,425,2,4,6
7,6,spicy,5,426,1,4,1.25
7,6,spill,5,427,3,2,1
7,6,sponsor,7,428,2,5,6
7,6,spoon,5,429,3,2,1
7,6,sport,5,430,3,2,1
7,6,spot,4,431,3,1,0.5
7,6,spy,3,432,2,1,0.5
7,6,squeeze,7,433,1,6,1.75
7,6,stage,5,434,1,4,919.75
7,6,stark,5,435,3,2,3.75
7,6,status,6,436,3,3,4.75
7,6,steel,5,437,2,3,5.5
7,6,steep,5,438,4,1,3
7,6,style,5,439,2,3,4.25
7,6,suburb,6,440,1,5,15.25
7,6,success,7,441,2,5,4
7,6,summer,6,442,2,4,7.5
7,6,summit,6,443,4,2,1.75
7,6,survive,7,444,2,5,2.75
7,6,sweet,5,445,1,4,2
7,6,swing,5,446,2,3,6.75
7,6,symbol,6,447,1,5,3
7,6,tag,3,448,0,3,1.5
7,6,tax,3,449,2,1,1
7,6,teenage,7,450,1,6,10.25
7,6,tell,4,451,2,2,2
7,6,tennis,6,452,2,4,3
7,6,tent,4,453,3,1,1.25
7,6,testing,7,454,2,5,9.5
7,6,text,4,455,2,2,1.75
7,6,than,4,456,1,3,1.5
7,6,theft,5,457,2,3,2.25
7,6,their,5,458,3,2,1.75
7,6,theirs,6,459,5,1,1.5
7,6,then,4,460,3,1,1.25
7,6,thief,5,461,2,3,6.25
7,6,thin,4,462,3,1,0.75
7,6,thing,5,463,4,1,0.75
7,6,think,5,464,4,1,0.75
7,6,third,5,465,3,2,1
7,6,though,6,466,2,4,1.5
7,6,thrive,6,467,2,4,5.25
7,6,throat,6,468,3,3,1.25
7,6,toll,4,469,1,3,1
7,6,touch,5,470,2,3,1.25
7,6,tourist,7,471,3,4,5.5
7,6,towel,5,472,2,3,1.25
7,6,toy,3,473,2,1,0.5
7,6,trace,5,474,1,4,1.25
7,6,trust,5,475,2,3,6.25
7,6,truth,5,476,3,2,1
7,6,tuition,7,477,1,6,1.75
7,6,tunnel,6,478,2,4,1.5
7,6,typical,7,479,1,6,6.5
7,6,under,5,480,0,5,1.75
7,6,unit,4,481,2,2,1.25
7,6,unless,6,482,2,4,5.75
7,6,up,2,483,1,1,0.5
7,6,upset,5,484,2,3,1
7,6,upwards,7,485,2,5,1.75
7,6,us,2,486,1,1,0.5
7,6,use,3,487,2,1,4.5
7,6,user,4,488,3,1,0.75
7,6,victim,6,489,0,6,2
7,6,village,7,490,2,5,1.75
7,6,volume,6,491,1,5,5.5
7,6,wall,4,492,0,4,1.25
7,6,wash,4,493,2,2,0.75
7,6,weak,4,494,1,3,1
7,6,wear,4,495,3,1,4.5
7,6,web,3,496,2,1,0.5
7,6,website,7,497,3,4,1.5
7,6,wedding,7,498,2,5,1.75
7,6,weekly,6,499,2,4,5.75
7,6,well,4,500,2,2,1
7,6,wet,3,501,2,1,0.5
7,6,what,4,502,1,3,1
7,6,wheat,5,503,2,3,1.25
7,6,when,4,504,3,1,0.75
7,6,whilst,6,505,2,4,5.25
7,6,whisper,7,506,3,4,1.5
7,6,wide,4,507,1,3,1
7,6,wise,4,508,2,2,1
7,6,worm,4,509,1,3,5
7,6,worst,5,510,3,2,1
7,6,writing,7,511,1,6,1.75
7,6,wrong,5,512,2,3,1
7,6,yell,4,513,0,4,4.75
7,6,you,3,514,1,2,1
7,6,zero,4,515,0,4,1.75
7,7,abolish,7,0,0,7,7.25
7,7,absent,6,1,2,4,2.25
7,7,accent,6,2,1,5,2
7,7,access,6,3,4,2,6.5
7,7,account,7,4,3,4,1.75
7,7,action,6,5,2,4,1.75
7,7,advance,7,6,1,6,6.5
7,7,affair,6,7,1,5,1.75
7,7,agent,5,8,1,4,1.5
7,7,alike,5,9,1,4,5.75
7,7,allege,6,10,2,4,1.5
7,7,allow,5,11,3,2,1
7,7,along,5,12,2,3,1.5
7,7,angry,5,13,1,4,5.75
7,7,apart,5,14,1,4,1.5
7,7,apple,5,15,2,3,1.5
7,7,apply,5,16,4,1,0.75
7,7,appoint,7,17,3,4,6.5
7,7,april,5,18,2,3,1.25
7,7,archive,7,19,1,6,2.5
7,7,arena,5,20,2,3,1.5
7,7,arrival,7,21,2,5,6.25
7,7,asset,5,22,1,4,1.5
7,7,assign,6,23,3,3,1.25
7,7,athlete,7,24,1,6,6.75
7,7,attack,6,25,2,4,1.75
7,7,attempt,7,26,3,4,2
7,7,attend,6,27,4,2,1.25
7,7,august,6,28,1,5,5.75
7,7,author,6,29,2,4,1.5
7,7,avoid,5,30,1,4,1.25
7,7,aware,5,31,1,4,5.75
7,7,away,4,32,3,1,0.75
7,7,awkward,7,33,2,5,1.75
7,7,back,4,34,0,4,1.25
7,7,bake,4,35,2,2,5
7,7,ballot,6,36,2,4,1.5
7,7,banana,6,37,2,4,1.5
7,7,basis,5,38,2,3,1
7,7,bean,4,39,1,3,5.25
7,7,bear,4,40,3,1,0.5
7,7,because,7,41,2,5,1.75
7,7,bee,3,42,2,1,0.5
7,7,beef,4,43,3,1,0.5
7,7,bend,4,44,2,2,0.75
7,7,beside,6,45,2,4,5.75
7,7,bet,3,46,2,1,1
7,7,biology,7,47,1,6,2.25
7,7,blanket,7,48,1,6,6.25
7,7,blood,5,49,2,3,1.25
7,7,body,4,50,1,3,1.25
7,7,bold,4,51,2,2,0.75
7,7,bond,4,52,2,2,0.75
7,7,bonus,5,53,3,2,4.75
7,7,booking,7,54,2,5,1.75
7,7,boring,6,55,2,4,1.25
7,7,born,4,56,3,1,0.75
7,7,bread,5,57,1,4,5.5
7,7,breast,6,58,4,2,1
7,7,brick,5,59,2,3,1
7,7,broad,5,60,2,3,1
7,7,brown,5,61,3,2,1
7,7,burial,6,62,1,5,5.75
7,7,burst,5,63,3,2,1
7,7,bus,3,64,2,1,0.5
7,7,button,6,65,2,4,1.25
7,7,bye,3,66,1,2,0.75
7,7,cabin,5,67,0,5,5.25
7,7,camp,4,68,2,2,0.75
7,7,carrot,6,69,2,4,1.25
7,7,castle,6,70,2,4,5
7,7,cat,3,71,2,1,0.5
7,7,cattle,6,72,3,3,1
7,7,cause,5,73,2,3,1
7,7,centre,6,74,1,5,5.25
7,7,charge,6,75,1,5,1.75
7,7,chat,4,76,3,1,0.5
7,7,cheek,5,77,2,3,1
7,7,chef,4,78,3,1,0.5
7,7,chest,5,79,3,2,0.75
7,7,civic,5,80,1,4,5
7,7,clarify,7,81,1,6,1.75
7,7,climate,7,82,2,5,5.5
7,7,climb,5,83,4,1,0.75
7,7,cling,5,84,3,2,1
7,7,clinic,6,85,4,2,1
7,7,clock,5,86,2,3,1
7,7,close,5,87,3,2,0.75
7,7,cloth,5,88,3,2,0.75
7,7,clothes,7,89,5,2,5.25
7,7,coast,5,90,1,4,1.25
7,7,college,7,91,2,5,1.5
7,7,combat,6,92,2,4,5
7,7,common,6,93,3,3,1.25
7,7,complex,7,94,3,4,1.5
7,7,confirm,7,95,2,5,1.5
7,7,consist,7,96,3,4,5.5
7,7,context,7,97,3,4,1.5
7,7,convict,7,98,3,4,1.25
7,7,cooking,7,99,2,5,5.5
7,7,cop,3,100,2,1,0.5
7,7,copy,4,101,3,1,0.5
7,7,corrupt,7,102,2,5,1.5
7,7,costume,7,103,2,5,6
7,7,cotton,6,104,2,4,1.25
7,7,courage,7,105,2,5,2.25
7,7,crash,5,106,1,4,5.25
7,7,crop,4,107,2,2,0.75
7,7,crystal,7,108,2,5,1.5
7,7,dancer,6,109,0,6,6.25
7,7,dead,4,110,1,3,1
7,7,deck,4,111,2,2,0.75
7,7,defeat,6,112,2,4,1.25
7,7,define,6,113,3,3,1.25
7,7,depict,6,114,2,4,5.25
7,7,descend,7,115,2,5,1.5
7,7,descent,7,116,6,1,0.75
7,7,desert,6,117,3,3,1.25
7,7,desire,6,118,3,3,5.25
7,7,destroy,7,119,3,4,1.5
7,7,devise,6,120,2,4,1.25
7,7,diary,5,121,1,4,5
7,7,dip,3,122,2,1,0.5
7,7,discard,7,123,2,5,1.5
7,7,disease,7,124,3,4,1.25
7,7,dispose,7,125,3,4,5.25
7,7,disrupt,7,126,3,4,1.5
7,7,disturb,7,127,3,4,1.5
7,7,diverse,7,128,2,5,5.5
7,7,divert,6,129,5,1,0.75
7,7,divorce,7,130,3,4,1.5
7,7,dog,3,131,1,2,1.5
7,7,donate,6,132,2,4,3
7,7,door,4,133,2,2,7.75
7,7,drag,4,134,1,3,2.25
7,7,draw,4,135,3,1,1
7,7,drive,5,136,2,3,2.25
7,7,drug,4,137,2,2,1.5
7,7,dry,3,138,2,1,1
7,7,dull,4,139,1,3,8.75
7,7,during,6,140,2,4,3
7,7,duty,4,141,2,2,1.75
7,7,dynamic,7,142,1,6,4
7,7,each,4,143,0,4,9
7,7,easy,4,144,2,2,1.75
7,7,elevate,7,145,1,6,4
7,7,empire,6,146,1,5,10.25
7,7,endorse,7,147,1,6,4
7,7,enforce,7,148,2,5,10
7,7,enrol,5,149,2,3,2.5
7,7,entity,6,150,2,4,2.75
7,7,equal,5,151,1,4,2.75
7,7,era,3,152,1,2,1.5
7,7,error,5,153,2,3,8.75
7,7,escape,6,154,1,5,3.25
7,7,ethical,7,155,1,6,10.75
7,7,every,5,156,1,4,2.75
7,7,example,7,157,1,6,4
7,7,excess,6,158,2,4,9.25
7,7,exert,5,159,2,3,2.25
7,7,exotic,6,160,2,4,3
7,7,expect,6,161,2,4,6.5
7,7,export,6,162,3,3,10
7,7,extract,7,163,2,5,3.5
7,7,fact,4,164,0,4,2.75
7,7,faction,7,165,4,3,2.25
7,7,faith,5,166,2,3,9.75
7,7,fan,3,167,2,1,1
7,7,farm,4,168,2,2,1.75
7,7,favour,6,169,2,4,3.5
7,7,feat,4,170,1,3,2.25
7,7,feeling,7,171,2,5,10.5
7,7,fifth,5,172,1,4,2.75
7,7,figure,6,173,2,4,3
7,7,fill,4,174,2,2,10
7,7,final,5,175,2,3,2.25
7,7,find,4,176,3,1,1.25
7,7,finger,6,177,3,3,2.75
7,7,finish,6,178,3,3,2.5
7,7,fire,4,179,2,2,8.5
7,7,five,4,180,2,2,1.75
7,7,flame,5,181,1,4,2.75
7,7,flash,5,182,3,2,1.75
7,7,flaw,4,183,3,1,1.25
7,7,flood,5,184,2,3,2.25
7,7,fluid,5,185,2,3,9
7,7,fond,4,186,1,3,3.25
7,7,forever,7,187,2,5,4.5
7,7,forge,5,188,3,2,2.25
7,7,forgive,7,189,4,3,10
7,7,formal,6,190,3,3,2.75
7,7,frame,5,191,1,4,2.75
7,7,freely,6,192,2,4,3
7,7,freeze,6,193,4,2,9.25
7,7,fruit,5,194,2,3,2.25
7,7,fully,5,195,1,4,2.75
7,7,fund,4,196,2,2,1.75
7,7,funny,5,197,3,2,2
7,7,gang,4,198,0,4,9.25
7,7,generic,7,199,1,6,4
7,7,genuine,7,200,3,4,3.25
7,7,glad,4,201,1,3,8.75
7,7,goal,4,202,1,3,2.25
7,7,golden,6,203,2,4,3
7,7,grand,5,204,1,4,2.75
7,7,grant,5,205,4,1,8
7,7,great,5,206,2,3,2.25
7,7,hardly,6,207,0,6,3.75
7,7,harmony,7,208,3,4,9.5
7,7,hatred,6,209,2,4,3
7,7,hearing,7,210,1,6,4
7,7,heating,7,211,3,4,9.25
7,7,helmet,6,212,2,4,2.75
7,7,help,4,213,3,1,1.25
7,7,helpful,7,214,4,3,2.5
7,7,hence,5,215,2,3,2.25
7,7,hero,4,216,2,2,8.25
7,7,history,7,217,1,6,4
7,7,hold,4,218,1,3,2
7,7,holy,4,219,3,1,1.25
7,7,hook,4,220,2,2,1.75
7,7,hostile,7,221,2,5,11
7,7,house,5,222,2,3,2.75
7,7,housing,7,223,4,3,2.75
7,7,hurry,5,224,1,4,10
7,7,husband,7,225,2,5,3.5
7,7,if,2,226,0,2,1.5
7,7,impress,7,227,1,6,11.25
7,7,indeed,6,228,1,5,3.25
7,7,indoor,6,229,3,3,2.5
7,7,induce,6,230,3,3,2.5
7,7,indulge,7,231,4,3,9.25
7,7,initial,7,232,2,5,3.5
7,7,inmate,6,233,2,4,3
7,7,insight,7,234,2,5,10
7,7,invoke,6,235,2,4,3
7,7,jeans,5,236,0,5,3.25
7,7,july,4,237,1,3,9
7,7,justice,7,238,2,5,3.75
7,7,keen,4,239,0,4,2.75
7,7,kidnap,6,240,1,5,10.25
7,7,kill,4,241,2,2,1.75
7,7,killing,7,242,4,3,2.5
7,7,kiss,4,243,2,2,1.75
7,7,label,5,244,0,5,3.25
7,7,labour,6,245,3,3,9
7,7,lady,4,246,2,2,1.5
7,7,lane,4,247,2,2,1.5
7,7,laptop,6,248,2,4,2.75
7,7,lawsuit,7,249,2,5,10
7,7,layout,6,250,2,4,3
7,7,leave,5,251,1,4,2.75
7,7,leisure,7,252,2,5,10.5
7,7,lend,4,253,2,2,1.5
7,7,lesson,6,254,2,4,2.75
7,7,light,5,255,1,4,2.75
7,7,limit,5,256,2,3,9
7,7,linger,6,257,2,4,2.75
7,7,loan,4,258,1,3,2.5
7,7,lobby,5,259,2,3,2.5
7,7,lock,4,260,2,2,5
7,7,logo,4,261,2,2,5.5
7,7,loom,4,262,2,2,1.75
7,7,lord,4,263,2,2,1.5
7,7,lose,4,264,2,2,1.5
7,7,lovely,6,265,2,4,2.75
7,7,luck,4,266,1,3,9
7,7,magical,7,267,0,7,4.5
7,7,mall,4,268,2,2,1.75
7,7,man,3,269,2,1,1
7,7,manner,6,270,3,3,8.75
7,7,march,5,271,2,3,2.25
7,7,marry,5,272,3,2,1.75
7,7,massive,7,273,2,5,3.5
7,7,maths,5,274,2,3,9
7,7,matter,6,275,3,3,2.5
7,7,maybe,5,276,2,3,2.25
7,7,mayor,5,277,3,2,1.75
7,7,me,2,278,1,1,0.75
7,7,means,5,279,2,3,8.75
7,7,menu,4,280,2,2,1.5
7,7,metal,5,281,2,3,2.25
7,7,mile,4,282,1,3,2
7,7,milk,4,283,3,1,1
7,7,mill,4,284,3,1,1
7,7,miner,5,285,2,3,2.25
7,7,minor,5,286,3,2,8.5
7,7,minute,6,287,3,3,2.5
7,7,mobile,6,288,1,5,3.25
7,7,mode,4,289,2,2,1.75
7,7,modest,6,290,4,2,8.5
7,7,monitor,7,291,2,5,3.5
7,7,morning,7,292,2,5,3.5
7,7,motive,6,293,2,4,9.5
7,7,motor,5,294,3,2,2
7,7,move,4,295,2,2,1.5
7,7,musical,7,296,1,6,4
7,7,mutual,6,297,2,4,9.75
7,7,myself,6,298,1,5,3.25
7,7,mystery,7,299,3,4,3.25
7,7,neglect,7,300,0,7,11.25
7,7,nerve,5,301,2,3,2.25
7,7,net,3,302,2,1,1
7,7,next,4,303,2,2,1.5
7,7,ninety,6,304,1,5,10
7,7,noble,5,305,1,4,2.75
7,7,noon,4,306,2,2,1.75
7,7,notably,7,307,2,5,3.5
7,7,now,3,308,2,1,8
7,7,number,6,309,1,5,3
7,7,nursing,7,310,2,5,2.25
7,7,obey,4,311,0,4,5.5
7,7,object,6,312,2,4,1.5
7,7,observe,7,313,2,5,1.5
7,7,obtain,6,314,2,4,5.5
7,7,obvious,7,315,2,5,1.75
7,7,occur,5,316,1,4,1.25
7,7,of,2,317,1,1,0.25
7,7,offer,5,318,2,3,5.25
7,7,on,2,319,1,1,0.5
7,7,onto,4,320,2,2,0.75
7,7,opinion,7,321,1,6,1.75
7,7,or,2,322,1,1,0.25
7,7,oral,4,323,2,2,0.75
7,7,order,5,324,2,3,5.25
7,7,outrage,7,325,1,6,1.75
7,7,own,3,326,1,2,0.75
7,7,packet,6,327,0,6,6
7,7,pan,3,328,2,1,0.5
7,7,parish,6,329,2,4,1.25
7,7,pass,4,330,2,2,0.75
7,7,pathway,7,331,2,5,6
7,7,payment,7,332,2,5,1.75
7,7,peak,4,333,1,3,1
7,7,peasant,7,334,3,4,1.25
7,7,pension,7,335,2,5,5.75
7,7,phase,5,336,1,4,1.25
7,7,physics,7,337,2,5,5.75
7,7,pill,4,338,1,3,1
7,7,pink,4,339,2,2,0.75
7,7,pitch,5,340,2,3,1
7,7,plain,5,341,1,4,1.25
7,7,planet,6,342,3,3,5.5
7,7,player,6,343,3,3,1.25
7,7,plug,4,344,2,2,0.75
7,7,plunge,6,345,3,3,1.5
7,7,pocket,6,346,1,5,5.75
7,7,poet,4,347,2,2,0.75
7,7,pool,4,348,2,2,0.75
7,7,popular,7,349,2,5,1.5
7,7,port,4,350,2,2,0.75
7,7,portray,7,351,4,3,5.75
7,7,pose,4,352,2,2,0.75
7,7,poverty,7,353,2,5,1.75
7,7,powder,6,354,2,4,5.75
7,7,pray,4,355,1,3,1
7,7,preach,6,356,2,4,1.5
7,7,precede,7,357,3,4,1.5
7,7,prefer,6,358,3,3,5.25
7,7,premium,7,359,3,4,1.5
7,7,present,7,360,3,4,1.5
7,7,pretty,6,361,3,3,1
7,7,prey,4,362,3,1,0.5
7,7,prince,6,363,2,4,5.5
7,7,promote,7,364,2,5,1.5
7,7,purely,6,365,1,5,1.5
7,7,pursue,6,366,3,3,5.5
7,7,racist,6,367,0,6,1.75
7,7,radio,5,368,2,3,1
7,7,rain,4,369,2,2,5.25
7,7,rare,4,370,2,2,0.75
7,7,read,4,371,1,3,1
7,7,reading,7,372,4,3,1
7,7,real,4,373,3,1,0.5
7,7,realize,7,374,4,3,1
7,7,receive,7,375,2,5,6
7,7,recipe,6,376,3,3,1.25
7,7,refuge,6,377,2,4,1.25
7,7,regret,6,378,2,4,5.5
7,7,remote,6,379,2,4,1.25
7,7,rental,6,380,2,4,1.25
7,7,retreat,7,381,2,5,6
7,7,rhythm,6,382,1,5,1.5
7,7,rice,4,383,1,3,1
7,7,riot,4,384,2,2,1
7,7,risk,4,385,2,2,5.5
7,7,route,5,386,1,4,1.25
7,7,royal,5,387,2,3,1.25
7,7,rugby,5,388,1,4,1.25
7,7,rule,4,389,2,2,0.75
7,7,rumour,6,390,2,4,5.75
7,7,run,3,391,2,1,0.5
7,7,runner,6,392,3,3,1
7,7,sad,3,393,0,3,0.75
7,7,sadly,5,394,3,2,0.75
7,7,sail,4,395,2,2,5
7,7,say,3,396,2,1,0.5
7,7,scope,5,397,1,4,1.25
7,7,scratch,7,398,2,5,1.5
7,7,sea,3,399,1,2,5.5
7,7,section,7,400,2,5,1.75
7,7,seize,5,401,2,3,1
7,7,senator,7,402,2,5,1.5
7,7,set,3,403,2,1,5
7,7,several,7,404,2,5,1.75
7,7,shade,5,405,1,4,1.25
7,7,shadow,6,406,4,2,0.75
7,7,shall,5,407,3,2,5.25
7,7,shock,5,408,2,3,1.25
7,7,short,5,409,3,2,1
7,7,shout,5,410,3,2,0.75
7,7,silence,7,411,1,6,6
7,7,silent,6,412,5,1,0.75
7,7,sincere,7,413,2,5,1.5
7,7,sir,3,414,2,1,0.5
7,7,sixty,5,415,2,3,1
7,7,skill,5,416,1,4,5.5
7,7,sky,3,417,2,1,0.5
7,7,slave,5,418,1,4,1.25
7,7,small,5,419,1,4,1.25
7,7,smart,5,420,3,2,1
7,7,snap,4,421,1,3,5.5
7,7,society,7,422,1,6,1.75
7,7,soon,4,423,2,2,0.75
7,7,sorry,5,424,2,3,1
7,7,sort,4,425,3,1,5
7,7,source,6,426,2,4,1.5
7,7,split,5,427,1,4,1.25
7,7,sponsor,7,428,2,5,1.75
7,7,spoon,5,429,3,2,5.5
7,7,squeeze,7,430,1,6,1.75
7,7,stage,5,431,1,4,1.25
7,7,station,7,432,3,4,5.75
7,7,steel,5,433,2,3,1
7,7,steep,5,434,4,1,0.5
7,7,stiff,5,435,2,3,1
7,7,stream,6,436,2,4,5.75
7,7,suburb,6,437,1,5,1.5
7,7,success,7,438,2,5,1.5
7,7,summer,6,439,2,4,5.75
7,7,supply,6,440,2,4,1.25
7,7,surface,7,441,2,5,1.5
7,7,sustain,7,442,2,5,6.25
7,7,swing,5,443,1,4,1.25
7,7,symbol,6,444,1,5,1.5
7,7,tag,3,445,0,3,0.75
7,7,tax,3,446,2,1,5
7,7,teenage,7,447,1,6,1.75
7,7,tell,4,448,2,2,0.75
7,7,tennis,6,449,2,4,1.25
7,7,terrain,7,450,2,5,6
7,7,testify,7,451,2,5,1.5
7,7,testing,7,452,5,2,1
7,7,text,4,453,2,2,0.75
7,7,than,4,454,1,3,5.5
7,7,theft,5,455,2,3,1.25
7,7,their,5,456,3,2,1
7,7,theirs,6,457,5,1,0.5
7,7,them,4,458,3,1,0.5
7,7,then,4,459,3,1,0.5
7,7,there,5,460,3,2,0.75
7,7,they,4,461,3,1,5.25
7,7,thick,5,462,2,3,1
7,7,though,6,463,2,4,1.75
7,7,thought,7,464,6,1,0.75
7,7,thrive,6,465,2,4,1.5
7,7,throat,6,466,3,3,6.25
7,7,throw,5,467,4,1,0.75
7,7,tiny,4,468,1,3,1.25
7,7,toll,4,469,1,3,1
7,7,ton,3,470,2,1,0.5
7,7,tongue,6,471,3,3,6
7,7,touch,5,472,2,3,1.25
7,7,tourist,7,473,3,4,1.5
7,7,towards,7,474,2,5,1.5
7,7,toy,3,475,2,1,5.25
7,7,true,4,476,1,3,1
7,7,truly,5,477,3,2,0.75
7,7,trust,5,478,3,2,0.75
7,7,truth,5,479,3,2,0.75
7,7,try,3,480,2,1,0.5
7,7,tuesday,7,481,1,6,6.25
7,7,tunnel,6,482,2,4,1.5
7,7,twist,5,483,1,4,1.25
7,7,typical,7,484,1,6,6.5
7,7,unit,4,485,0,4,1.25
7,7,unless,6,486,2,4,1.5
7,7,us,2,487,1,1,0.5
7,7,used,4,488,2,2,5.25
7,7,user,4,489,3,1,0.75
7,7,utterly,7,490,1,6,1.75
7,7,vast,4,491,0,4,1.25
7,7,vitamin,7,492,1,6,6.5
7,7,vote,4,493,1,3,1
7,7,wage,4,494,0,4,1.25
7,7,wall,4,495,2,2,5.25
7,7,want,4,496,2,2,0.75
7,7,ward,4,497,2,2,0.75
7,7,warm,4,498,3,1,0.5
7,7,website,7,499,1,6,1.75
7,7,week,4,500,2,2,5.25
7,7,weekly,6,501,4,2,1.25
7,7,wheat,5,502,1,4,1.25
7,7,when,4,503,3,1,0.5
7,7,while,5,504,2,3,1
7,7,who,3,505,2,1,0.5
7,7,whole,5,506,3,2,5
7,7,wholly,6,507,4,2,1
7,7,winter,6,508,1,5,1.5
7,7,workout,7,509,1,6,1.75
7,7,worm,4,510,3,1,5.5
7,7,worse,5,511,3,2,1
7,7,worst,5,512,4,1,0.75
7,7,wound,5,513,2,3,1
7,7,writer,6,514,1,5,1.75
7,7,yours,5,515,0,5,6.25
7,8,abolish,7,0,0,7,2
7,8,above,5,1,3,2,5.5
7,8,absent,6,2,2,4,1.5
7,8,accent,6,3,1,5,1.5
7,8,access,6,4,4,2,1
7,8,account,7,5,3,4,10.75
7,8,acquire,7,6,2,5,12.25
7,8,action,6,7,2,4,1.75
7,8,adhere,6,8,1,5,1.75
7,8,adult,5,9,2,3,5.25
7,8,advance,7,10,2,5,2
7,8,affair,6,11,1,5,1.75
7,8,afraid,6,12,2,4,11.25
7,8,agent,5,13,1,4,4.5
7,8,alert,5,14,1,4,4
7,8,alien,5,15,2,3,10.25
7,8,allege,6,16,2,4,6.25
7,8,also,4,17,2,2,3.25
7,8,apple,5,18,1,4,4
7,8,apply,5,19,4,1,1.5
7,8,april,5,20,2,3,11.75
7,8,archive,7,21,1,6,5.25
7,8,arena,5,22,2,3,2.75
7,8,arrival,7,23,2,5,14.5
7,8,article,7,24,2,5,6
7,8,assess,6,25,1,5,9.25
7,8,assign,6,26,3,3,12
7,8,athlete,7,27,1,6,5.5
7,8,attack,6,28,2,4,6.25
7,8,attempt,7,29,3,4,13.25
7,8,audit,5,30,1,4,3.75
7,8,bake,4,31,0,4,3.5
7,8,ballot,6,32,2,4,18.75
7,8,bank,4,33,2,2,4.5
7,8,bare,4,34,2,2,2
7,8,basis,5,35,2,3,2.75
7,8,bean,4,36,1,3,2.5
7,8,because,7,37,2,5,21.5
7,8,become,6,38,3,3,2.75
7,8,before,6,39,2,4,3
7,8,behind,6,40,2,4,2.75
7,8,being,5,41,2,3,7.75
7,8,beneath,7,42,2,5,3.5
7,8,bet,3,43,2,1,1
7,8,bias,4,44,1,3,2.5
7,8,blanket,7,45,1,6,10
7,8,blast,5,46,3,2,3.25
7,8,bleed,5,47,2,3,2.75
7,8,blend,5,48,3,2,2
7,8,bond,4,49,1,3,7.25
7,8,booking,7,50,2,5,4.25
7,8,boring,6,51,2,4,5.75
7,8,born,4,52,3,1,1.25
7,8,bounce,6,53,2,4,9.25
7,8,breath,6,54,1,5,3.5
7,8,bring,5,55,2,3,2.25
7,8,broad,5,56,2,3,2.5
7,8,broadly,7,57,5,2,7.5
7,8,buck,4,58,1,3,2.25
7,8,burial,6,59,2,4,3
7,8,burst,5,60,3,2,2
7,8,bus,3,61,2,1,1
7,8,camp,4,62,0,4,7.75
7,8,captain,7,63,2,5,3.5
7,8,capture,7,64,4,3,2.75
7,8,cat,3,65,2,1,1
7,8,catch,5,66,3,2,4
7,8,cattle,6,67,3,3,175.5
7,8,cent,4,68,1,3,3.25
7,8,chaos,5,69,1,4,4.25
7,8,charge,6,70,3,3,2.75
7,8,chest,5,71,2,3,3.75
7,8,civic,5,72,1,4,8.75
7,8,claim,5,73,1,4,2.75
7,8,class,5,74,3,2,1.75
7,8,climate,7,75,2,5,8.25
7,8,climb,5,76,4,1,1.5
7,8,closure,7,77,2,5,3.5
7,8,clue,4,78,2,2,1.75
7,8,coast,5,79,1,4,7.5
7,8,coastal,7,80,5,2,2.25
7,8,college,7,81,2,5,3.5
7,8,colour,6,82,3,3,2.5
7,8,combat,6,83,2,4,8
7,8,compare,7,84,3,4,3.25
7,8,confuse,7,85,2,5,3.75
7,8,consist,7,86,3,4,8
7,8,consume,7,87,4,3,2.75
7,8,convict,7,88,3,4,3
7,8,copy,4,89,2,2,1.5
7,8,corrupt,7,90,2,5,8.75
7,8,costume,7,91,2,5,3.5
7,8,courage,7,92,2,5,3.5
7,8,covered,7,93,2,5,8.25
7,8,cow,3,94,2,1,1
7,8,crack,5,95,1,4,2.75
7,8,crash,5,96,3,2,1.75
7,8,cream,5,97,2,3,2.25
7,8,crown,5,98,2,3,7
7,8,crystal,7,99,2,5,3.5
7,8,cure,4,100,1,3,2
7,8,custody,7,101,2,5,8.5
7,8,custom,6,102,5,1,1.5
7,8,dad,3,103,0,3,2
7,8,dark,4,104,2,2,1.5
7,8,date,4,105,2,2,1.5
7,8,defeat,6,106,1,5,8
7,8,defy,4,107,3,1,1.25
7,8,denial,6,108,2,4,3
7,8,depart,6,109,2,4,2.75
7,8,depend,6,110,3,3,7.25
7,8,descend,7,111,2,5,3.75
7,8,descent,7,112,6,1,1.25
7,8,destroy,7,113,3,4,3
7,8,devise,6,114,2,4,7.5
7,8,die,3,115,1,2,1.5
7,8,differ,6,116,2,4,2.75
7,8,disease,7,117,2,5,3.5
7,8,dispute,7,118,3,4,8.25
7,8,disrupt,7,119,3,4,3
7,8,diverse,7,120,2,5,3.5
7,8,divert,6,121,5,1,1.25
7,8,divorce,7,122,3,4,8
7,8,donor,5,123,1,4,2.75
7,8,door,4,124,2,2,1.75
7,8,dose,4,125,2,2,1.75
7,8,dozen,5,126,2,3,7.25
7,8,drag,4,127,1,3,2.25
7,8,drain,5,128,3,2,1.75
7,8,driver,6,129,2,4,3
7,8,drug,4,130,2,2,1.75
7,8,drunk,5,131,3,2,7
7,8,dry,3,132,2,1,1
7,8,dump,4,133,1,3,2.25
7,8,during,6,134,2,4,3
7,8,dynamic,7,135,1,6,9
7,8,each,4,136,0,4,2.5
7,8,early,5,137,2,3,2.25
7,8,easily,6,138,2,4,3
7,8,eastern,7,139,3,4,8
7,8,easy,4,140,3,1,1.25
7,8,eat,3,141,2,1,1
7,8,economy,7,142,1,6,2.75
7,8,edge,4,143,1,3,4.5
7,8,element,7,144,1,6,2
7,8,elevate,7,145,3,4,1.5
7,8,else,4,146,2,2,0.75
7,8,embed,5,147,1,4,4.25
7,8,empire,6,148,2,4,1.5
7,8,employ,6,149,3,3,1.25
7,8,endorse,7,150,1,6,4.75
7,8,enrol,5,151,2,3,1.25
7,8,entire,6,152,2,4,1.25
7,8,entity,6,153,4,2,1
7,8,equip,5,154,1,4,4.25
7,8,era,3,155,1,2,0.75
7,8,error,5,156,2,3,1
7,8,except,6,157,1,5,1.5
7,8,excess,6,158,4,2,4
7,8,exert,5,159,2,3,1.25
7,8,exotic,6,160,2,4,1.5
7,8,extra,5,161,2,3,1.25
7,8,extract,7,162,5,2,1
7,8,fact,4,163,0,4,4.25
7,8,factor,6,164,4,2,0.75
7,8,factory,7,165,6,1,0.5
7,8,fame,4,166,2,2,0.75
7,8,farm,4,167,2,2,0.75
7,8,feat,4,168,1,3,4
7,8,feather,7,169,4,3,1.5
7,8,feature,7,170,4,3,1.25
7,8,feel,4,171,2,2,0.75
7,8,feeling,7,172,4,3,1.25
7,8,fifth,5,173,1,4,4.5
7,8,fill,4,174,2,2,0.75
7,8,final,5,175,2,3,1
7,8,find,4,176,3,1,0.5
7,8,fire,4,177,2,2,0.75
7,8,firearm,7,178,4,3,1
7,8,fishing,7,179,2,5,4.5
7,8,five,4,180,2,2,0.75
7,8,flash,5,181,1,4,1.25
7,8,flaw,4,182,3,1,0.5
7,8,flawed,6,183,4,2,4
7,8,fluid,5,184,2,3,1
7,8,fond,4,185,1,3,1
7,8,fool,4,186,2,2,0.75
7,8,forest,6,187,2,4,1.25
7,8,forgive,7,188,3,4,4.5
7,8,fork,4,189,3,1,0.75
7,8,forum,5,190,3,2,0.75
7,8,fossil,6,191,2,4,1.25
7,8,frankly,7,192,1,6,4.75
7,8,from,4,193,2,2,0.75
7,8,fruit,5,194,2,3,1.25
7,8,furious,7,195,1,6,5
7,8,gang,4,196,0,4,1.25
7,8,gas,3,197,2,1,0.5
7,8,genuine,7,198,1,6,1.75
7,8,ghost,5,199,1,4,4.25
7,8,glad,4,200,1,3,1
7,8,goods,5,201,1,4,1.25
7,8,grant,5,202,1,4,1.25
7,8,grass,5,203,3,2,4
7,8,great,5,204,2,3,1
7,8,guard,5,205,1,4,1.25
7,8,halt,4,206,0,4,1.25
7,8,happy,5,207,2,3,4.25
7,8,harmful,7,208,2,5,1.5
7,8,he,2,209,1,1,0.25
7,8,hear,4,210,2,2,0.75
7,8,hearing,7,211,4,3,4.25
7,8,heavily,7,212,3,4,1.5
7,8,hello,5,213,2,3,1
7,8,helmet,6,214,3,3,1.25
7,8,help,4,215,3,1,0.5
7,8,here,4,216,2,2,0.75
7,8,hero,4,217,3,1,3.75
7,8,hide,4,218,1,3,1
7,8,highway,7,219,2,5,1.5
7,8,hill,4,220,2,2,0.75
7,8,hockey,6,221,1,5,4.75
7,8,honour,6,222,2,4,1.25
7,8,hook,4,223,2,2,0.75
7,8,hostile,7,224,2,5,4.75
7,8,housing,7,225,2,5,1.75
7,8,hungry,6,226,1,5,1.5
7,8,imagine,7,227,0,7,5.5
7,8,in,2,228,1,1,0.5
7,8,indoor,6,229,2,4,1.25
7,8,infect,6,230,2,4,1.25
7,8,injured,7,231,2,5,4.75
7,8,inmate,6,232,2,4,1.25
7,8,input,5,233,2,3,1
7,8,insult,6,234,2,4,4.5
7,8,invoke,6,235,2,4,1.25
7,8,jam,3,236,0,3,0.75
7,8,join,4,237,1,3,1
7,8,justice,7,238,1,6,5.25
7,8,kidnap,6,239,0,6,1.75
7,8,killing,7,240,2,5,5
7,8,kind,4,241,2,2,0.75
7,8,kiss,4,242,2,2,0.75
7,8,knock,5,243,1,4,1.25
7,8,labour,6,244,0,6,4.75
7,8,ladder,6,245,2,4,1.25
7,8,lady,4,246,3,1,0.5
7,8,lamp,4,247,2,2,0.75
7,8,lane,4,248,2,2,0.75
7,8,late,4,249,2,2,3.75
7,8,lawsuit,7,250,2,5,1.75
7,8,layout,6,251,2,4,1.25
7,8,leap,4,252,1,3,1
7,8,leave,5,253,3,2,4
7,8,legacy,6,254,2,4,1.25
7,8,legal,5,255,4,1,0.75
7,8,leisure,7,256,2,5,1.5
7,8,lend,4,257,2,2,0.75
7,8,less,4,258,2,2,4
7,8,lesson,6,259,4,2,1
7,8,let,3,260,2,1,0.5
7,8,light,5,261,1,4,1.25
7,8,linger,6,262,2,4,1.25
7,8,logo,4,263,1,3,4.25
7,8,lose,4,264,2,2,1
7,8,luck,4,265,1,3,1
7,8,lung,4,266,2,2,0.75
7,8,mall,4,267,0,4,1
7,8,manner,6,268,2,4,4.75
7,8,marker,6,269,2,4,1.25
7,8,massive,7,270,2,5,1.5
7,8,mate,4,271,2,2,4
7,8,maths,5,272,3,2,1
7,8,matter,6,273,3,3,1
7,8,mayor,5,274,2,3,1
7,8,me,2,275,1,1,0.25
7,8,meaning,7,276,2,5,7.75
7,8,measure,7,277,3,4,3
7,8,medical,7,278,2,5,3.5
7,8,mill,4,279,1,3,7.25
7,8,miner,5,280,2,3,2.25
7,8,minor,5,281,3,2,1.75
7,8,minute,6,282,3,3,2.5
7,8,modern,6,283,1,5,9.5
7,8,monk,4,284,2,2,1.75
7,8,moral,5,285,2,3,2.25
7,8,motive,6,286,2,4,3
7,8,motor,5,287,3,2,2
7,8,musical,7,288,1,6,9.25
7,8,mutual,6,289,2,4,3
7,8,myself,6,290,1,5,3.25
7,8,mystery,7,291,3,4,8.5
7,8,nail,4,292,0,4,2.75
7,8,naval,5,293,2,3,2.25
7,8,nerve,5,294,1,4,8
7,8,news,4,295,2,2,1.75
7,8,next,4,296,2,2,1.75
7,8,noble,5,297,1,4,2.75
7,8,nod,3,298,2,1,1
7,8,notably,7,299,2,5,8.75
7,8,number,6,300,1,5,3.25
7,8,nursery,7,301,2,5,3.5
7,8,o,1,302,0,1,0.75
7,8,object,6,303,1,5,9
7,8,observe,7,304,2,5,3.75
7,8,occur,5,305,1,4,2.75
7,8,on,2,306,1,1,7.25
7,8,onion,5,307,2,3,2.25
7,8,onto,4,308,2,2,1.5
7,8,open,4,309,1,3,2
7,8,out,3,310,1,2,1.5
7,8,outrage,7,311,3,4,9.25
7,8,oven,4,312,1,3,2.25
7,8,over,4,313,3,1,1.25
7,8,overly,6,314,4,2,1.75
7,8,own,3,315,1,2,1.5
7,8,pair,4,316,0,4,8.25
7,8,pan,3,317,2,1,1.75
7,8,paper,5,318,2,3,2.25
7,8,parent,6,319,2,4,3
7,8,parish,6,320,3,3,2.5
7,8,payment,7,321,2,5,9
7,8,peak,4,322,1,3,2
7,8,peasant,7,323,3,4,3
7,8,penalty,7,324,2,5,8.75
7,8,people,6,325,2,4,2.75
7,8,period,6,326,2,4,2.75
7,8,physics,7,327,1,6,9.75
7,8,pill,4,328,1,3,2.25
7,8,pink,4,329,2,2,1.75
7,8,pit,3,330,2,1,1
7,8,plain,5,331,1,4,2.75
7,8,planet,6,332,3,3,14
7,8,poet,4,333,1,3,559.25
7,8,poetry,6,334,4,2,2.75
7,8,pop,3,335,2,1,1.75
7,8,portray,7,336,2,5,5
7,8,poverty,7,337,2,5,12.5
7,8,pray,4,338,1,3,2.25
7,8,preach,6,339,2,4,3
7,8,premium,7,340,3,4,10
7,8,prepare,7,341,3,4,3.25
7,8,present,7,342,3,4,3.25
7,8,pretty,6,343,3,3,2.5
7,8,price,5,344,2,3,9.25
7,8,pride,5,345,3,2,2
7,8,prince,6,346,3,3,2.5
7,8,prison,6,347,3,3,3
7,8,proceed,7,348,2,5,14
7,8,promote,7,349,3,4,3
7,8,protect,7,350,3,4,3
7,8,protein,7,351,5,2,2
7,8,pub,3,352,1,2,1.5
7,8,pursue,6,353,2,4,8.25
7,8,qualify,7,354,0,7,4.5
7,8,quarter,7,355,3,4,8.5
7,8,queue,5,356,2,3,2.25
7,8,quietly,7,357,2,5,3.5
7,8,racist,6,358,0,6,9.25
7,8,rain,4,359,2,2,1.75
7,8,range,5,360,2,3,2.25
7,8,rapid,5,361,2,3,2.25
7,8,raw,3,362,2,1,1
7,8,reader,6,363,1,5,9
7,8,readily,7,364,4,3,2.75
7,8,really,6,365,3,3,2.5
7,8,red,3,366,2,1,1
7,8,refugee,7,367,2,5,9.5
7,8,release,7,368,2,5,3.5
7,8,rely,4,369,3,1,1.25
7,8,remains,7,370,2,5,3.5
7,8,report,6,371,2,4,8.25
7,8,request,7,372,2,5,3.5
7,8,result,6,373,2,4,2.75
7,8,resume,6,374,4,2,2
7,8,retreat,7,375,2,5,9.25
7,8,review,6,376,2,4,2.75
7,8,rhythm,6,377,1,5,8.75
7,8,risk,4,378,1,3,2.25
7,8,rock,4,379,1,3,2.25
7,8,role,4,380,2,2,1.75
7,8,route,5,381,2,3,2.25
7,8,royal,5,382,2,3,7.75
7,8,rugby,5,383,1,4,2.75
7,8,rule,4,384,2,2,1.75
7,8,rumour,6,385,2,4,3
7,8,run,3,386,2,1,1
7,8,runner,6,387,3,3,8.25
7,8,sad,3,388,0,3,2
7,8,sadly,5,389,3,2,1.5
7,8,sail,4,390,2,2,2
7,8,saint,5,391,3,2,2
7,8,salary,6,392,2,4,9
7,8,scale,5,393,1,4,3
7,8,scope,5,394,2,3,2.5
7,8,scratch,7,395,2,5,9
7,8,script,6,396,3,3,2.5
7,8,sea,3,397,1,2,1.5
7,8,section,7,398,2,5,3.5
7,8,see,3,399,2,1,1
7,8,seize,5,400,2,3,7.75
7,8,self,4,401,2,2,1.75
7,8,senator,7,402,2,5,3.5
7,8,serial,6,403,2,4,2.75
7,8,seventy,7,404,2,5,9
7,8,several,7,405,4,3,2.75
7,8,sex,3,406,2,1,1
7,8,shade,5,407,1,4,2.75
7,8,shadow,6,408,4,2,7.25
7,8,shall,5,409,3,2,1.75
7,8,shot,4,410,2,2,1.5
7,8,should,6,411,3,3,2.25
7,8,show,4,412,3,1,1
7,8,shrink,6,413,2,4,2.75
7,8,sigh,4,414,1,3,7.5
7,8,silence,7,415,2,5,3.75
7,8,sir,3,416,2,1,1
7,8,sixty,5,417,2,3,2.25
7,8,size,4,418,2,2,1.75
7,8,skill,5,419,1,4,8.75
7,8,sky,3,420,2,1,1
7,8,slow,4,421,1,3,2
7,8,smart,5,422,1,4,2.75
7,8,soar,4,423,1,3,8
7,8,society,7,424,2,5,3.5
7,8,soft,4,425,2,2,1.75
7,8,solely,6,426,2,4,3
7,8,son,3,427,2,1,7.25
7,8,soon,4,428,2,2,1.75
7,8,source,6,429,2,4,3
7,8,spicy,5,430,1,4,2.75
7,8,spite,5,431,3,2,1.75
7,8,spoon,5,432,2,3,8
7,8,stage,5,433,1,4,2.75
7,8,station,7,434,3,4,3
7,8,stiff,5,435,2,3,2.25
7,8,stream,6,436,2,4,8.5
7,8,strive,6,437,3,3,2.5
7,8,student,7,438,2,5,3.5
7,8,style,5,439,2,3,8.25
7,8,success,7,440,1,6,4.25
7,8,suicide,7,441,2,5,3.75
7,8,supply,6,442,2,4,8.75
7,8,survive,7,443,2,5,3.5
7,8,sustain,7,444,2,5,3.5
7,8,sweet,5,445,1,4,8.5
7,8,symbol,6,446,1,5,3.25
7,8,t,1,447,0,1,0.75
7,8,tell,4,448,1,3,2
7,8,tenure,6,449,2,4,8.5
7,8,testing,7,450,2,5,3.5
7,8,text,4,451,2,2,1.5
7,8,their,5,452,1,4,5.5
7,8,theirs,6,453,5,1,0.75
7,8,them,4,454,3,1,0.5
7,8,they,4,455,3,1,0.5
7,8,thick,5,456,2,3,1
7,8,think,5,457,3,2,0.75
7,8,third,5,458,3,2,0.75
7,8,though,6,459,2,4,4.75
7,8,thought,7,460,6,1,1
7,8,throw,5,461,2,3,1
7,8,timber,6,462,1,5,1.5
7,8,tiny,4,463,2,2,0.75
7,8,tone,4,464,1,3,4.75
7,8,total,5,465,2,3,1.25
7,8,tourist,7,466,2,5,1.75
7,8,towards,7,467,2,5,5.25
7,8,trace,5,468,1,4,1.25
7,8,truly,5,469,2,3,1.25
7,8,truth,5,470,3,2,1
7,8,tunnel,6,471,1,5,5.75
7,8,turn,4,472,2,2,1
7,8,turnout,7,473,4,3,1.25
7,8,twenty,6,474,1,5,1.5
7,8,ugly,4,475,0,4,5.25
7,8,unit,4,476,1,3,1.25
7,8,unlike,6,477,2,4,1.5
7,8,upper,5,478,1,4,5
7,8,upwards,7,479,2,5,2
7,8,us,2,480,1,1,0.5
7,8,used,4,481,2,2,0.75
7,8,user,4,482,3,1,0.75
7,8,valid,5,483,0,5,5.25
7,8,vast,4,484,2,2,0.75
7,8,versus,6,485,1,5,1.5
7,8,very,4,486,3,1,0.75
7,8,vicious,7,487,1,6,5.25
7,8,village,7,488,2,5,1.75
7,8,violate,7,489,2,5,1.75
7,8,vote,4,490,1,3,5
7,8,ward,4,491,0,4,1.25
7,8,warfare,7,492,3,4,1.25
7,8,warm,4,493,3,1,0.5
7,8,weak,4,494,1,3,1
7,8,weather,7,495,3,4,5
7,8,wedding,7,496,2,5,1.5
7,8,weekly,6,497,2,4,1.25
7,8,well,4,498,2,2,4.75
7,8,what,4,499,1,3,1
7,8,when,4,500,2,2,0.75
7,8,while,5,501,2,3,1
7,8,whisper,7,502,3,4,5
7,8,who,3,503,2,1,0.5
7,8,whole,5,504,3,2,0.75
7,8,widely,6,505,1,5,1.5
7,8,winter,6,506,2,4,1.25
7,8,wise,4,507,2,2,4.75
7,8,wish,4,508,3,1,0.75
7,8,wooden,6,509,1,5,1.5
7,8,worm,4,510,2,2,0.75
7,8,writing,7,511,1,6,5.75
7,8,year,4,512,0,4,1.5
7,8,yell,4,513,2,2,1
7,8,you,3,514,1,2,0.75
7,8,zero,4,515,0,4,5.25
7,9,ability,7,0,0,7,2
7,9,about,5,1,2,3,1.5
7,9,above,5,2,3,2,4.75
7,9,absent,6,3,2,4,1.5
7,9,academy,7,4,1,6,2
7,9,accent,6,5,2,4,5.25
7,9,act,3,6,2,1,0.5
7,9,action,6,7,3,3,1
7,9,affair,6,8,1,5,1.5
7,9,afraid,6,9,2,4,5.5
7,9,agent,5,10,1,4,1.25
7,9,aid,3,11,1,2,0.75
7,9,alert,5,12,1,4,1.25
7,9,alone,5,13,2,3,4.75
7,9,amid,4,14,1,3,1
7,9,angry,5,15,1,4,1.25
7,9,apple,5,16,1,4,1.25
7,9,appoint,7,17,3,4,5.25
7,9,april,5,18,2,3,1.25
7,9,archive,7,19,1,6,1.75
7,9,arena,5,20,2,3,4.75
7,9,armed,5,21,2,3,1
7,9,assess,6,22,1,5,1.5
7,9,asset,5,23,4,1,0.75
7,9,assign,6,24,3,3,1.25
7,9,attack,6,25,1,5,5
7,9,attend,6,26,3,3,1
7,9,audit,5,27,1,4,1.25
7,9,autumn,6,28,2,4,5
7,9,away,4,29,1,3,1
7,9,back,4,30,0,4,1.25
7,9,banana,6,31,2,4,1.25
7,9,basis,5,32,2,3,4.75
7,9,basket,6,33,3,3,1
7,9,bean,4,34,1,3,1
7,9,because,7,35,2,5,5.5
7,9,become,6,36,3,3,1.25
7,9,bend,4,37,2,2,0.75
7,9,bent,4,38,3,1,0.5
7,9,beside,6,39,2,4,1.25
7,9,bias,4,40,1,3,4.5
7,9,big,3,41,2,1,0.5
7,9,blast,5,42,1,4,1.25
7,9,blood,5,43,2,3,1
7,9,body,4,44,1,3,1
7,9,bold,4,45,2,2,0.75
7,9,bonus,5,46,2,3,5
7,9,booking,7,47,2,5,1.5
7,9,bounce,6,48,2,4,1.25
7,9,branch,6,49,1,5,5.25
7,9,breath,6,50,2,4,1.25
7,9,brick,5,51,2,3,1
7,9,briefly,7,52,3,4,5.25
7,9,bring,5,53,3,2,1
7,9,broadly,7,54,2,5,1.5
7,9,burst,5,55,1,4,1.25
7,9,bus,3,56,2,1,0.5
7,9,but,3,57,2,1,4.5
7,9,bye,3,58,1,2,0.75
7,9,cabin,5,59,0,5,1.5
7,9,cabinet,7,60,5,2,0.75
7,9,calm,4,61,2,2,0.75
7,9,camp,4,62,2,2,4.5
7,9,carrot,6,63,2,4,1.25
7,9,case,4,64,2,2,0.75
7,9,castle,6,65,3,3,1
7,9,cause,5,66,2,3,1
7,9,centre,6,67,1,5,5.75
7,9,chance,6,68,1,5,1.5
7,9,chaos,5,69,3,2,1
7,9,cheek,5,70,2,3,4.75
7,9,cinema,6,71,1,5,1.5
7,9,civic,5,72,2,3,1.25
7,9,clarify,7,73,1,6,5.5
7,9,cling,5,74,2,3,1.25
7,9,clinic,6,75,4,2,1
7,9,clip,4,76,3,1,0.5
7,9,closure,7,77,2,5,1.5
7,9,clothes,7,78,3,4,5.25
7,9,clue,4,79,2,2,1
7,9,coast,5,80,1,4,1.25
7,9,coin,4,81,2,2,0.75
7,9,college,7,82,2,5,5.5
7,9,colour,6,83,3,3,1.25
7,9,combat,6,84,2,4,1.25
7,9,combine,7,85,4,3,1.25
7,9,commit,6,86,3,3,5.25
7,9,common,6,87,4,2,1
7,9,compare,7,88,3,4,1.5
7,9,compose,7,89,4,3,1.25
7,9,confirm,7,90,2,5,5.75
7,9,confuse,7,91,4,3,1.25
7,9,consist,7,92,3,4,1.5
7,9,consume,7,93,4,3,1.5
7,9,contact,7,94,3,4,5.5
7,9,contest,7,95,4,3,1.25
7,9,context,7,96,5,2,1.25
7,9,convert,7,97,3,4,1.5
7,9,cook,4,98,2,2,4.75
7,9,cool,4,99,3,1,0.75
7,9,cop,3,100,2,1,0.5
7,9,corrupt,7,101,2,5,1.5
7,9,cotton,6,102,2,4,1.25
7,9,courage,7,103,2,5,5.75
7,9,covered,7,104,2,5,1.5
7,9,cow,3,105,2,1,0.5
7,9,crack,5,106,1,4,5
7,9,crash,5,107,3,2,1
7,9,crazy,5,108,3,2,0.75
7,9,cream,5,109,2,3,1
7,9,crop,4,110,2,2,0.75
7,9,cue,3,111,1,2,0.75
7,9,cult,4,112,2,2,4.75
7,9,custody,7,113,2,5,1.5
7,9,custom,6,114,5,1,0.75
7,9,cutting,7,115,2,5,1.5
7,9,data,4,116,0,4,4.75
7,9,dear,4,117,1,3,1
7,9,debris,6,118,2,4,1.5
7,9,deck,4,119,2,2,0.75
7,9,defeat,6,120,2,4,5.5
7,9,defend,6,121,4,2,1.25
7,9,define,6,122,3,3,1.25
7,9,defy,4,123,3,1,0.75
7,9,denial,6,124,2,4,1.25
7,9,depart,6,125,2,4,6
7,9,derive,6,126,2,4,1.5
7,9,descend,7,127,2,5,1.75
7,9,destroy,7,128,3,4,6
7,9,devise,6,129,2,4,1.5
7,9,diary,5,130,1,4,1.25
7,9,die,3,131,2,1,0.5
7,9,differ,6,132,2,4,5.25
7,9,dispose,7,133,2,5,1.5
7,9,disrupt,7,134,3,4,1.5
7,9,divert,6,135,2,4,5.5
7,9,donate,6,136,1,5,1.5
7,9,door,4,137,2,2,0.75
7,9,dress,5,138,1,4,1.25
7,9,drive,5,139,2,3,5.25
7,9,drug,4,140,2,2,1
7,9,drunk,5,141,3,2,1
7,9,dump,4,142,1,3,1
7,9,dynamic,7,143,1,6,6.25
7,9,each,4,144,0,4,1.25
7,9,early,5,145,2,3,1.25
7,9,easily,6,146,2,4,1.5
7,9,east,4,147,3,1,5
7,9,easy,4,148,3,1,1
7,9,eat,3,149,2,1,0.5
7,9,echo,4,150,1,3,1
7,9,edge,4,151,1,3,1
7,9,else,4,152,1,3,1
7,9,emerge,6,153,1,5,6
7,9,empire,6,154,2,4,1.5
7,9,employ,6,155,3,3,1.5
7,9,empty,5,156,3,2,1
7,9,enough,6,157,1,5,5.5
7,9,enrol,5,158,2,3,1.25
7,9,entity,6,159,2,4,1.25
7,9,era,3,160,1,2,0.75
7,9,error,5,161,2,3,5.25
7,9,erupt,5,162,2,3,1
7,9,ethic,5,163,1,4,1.25
7,9,ethical,7,164,5,2,0.75
7,9,evil,4,165,1,3,5.5
7,9,example,7,166,1,6,1.75
7,9,except,6,167,2,4,1.25
7,9,exclude,7,168,3,4,5.5
7,9,exert,5,169,2,3,1
7,9,exotic,6,170,2,4,1.5
7,9,export,6,171,2,4,2.75
7,9,faction,7,172,0,7,11
7,9,factor,6,173,4,2,2
7,9,factory,7,174,6,1,1.5
7,9,feat,4,175,1,3,2.25
7,9,feather,7,176,4,3,9.25
7,9,feed,4,177,2,2,1.75
7,9,feeling,7,178,3,4,3
7,9,figure,6,179,1,5,3.25
7,9,fill,4,180,2,2,8
7,9,film,4,181,3,1,1.25
7,9,filter,6,182,3,3,2.25
7,9,final,5,183,2,3,2.25
7,9,find,4,184,3,1,1
7,9,fire,4,185,2,2,1.75
7,9,firearm,7,186,4,3,8.75
7,9,fish,4,187,2,2,1.75
7,9,fishing,7,188,4,3,2.25
7,9,flame,5,189,1,4,2.75
7,9,flawed,6,190,3,3,9.5
7,9,flood,5,191,2,3,2.25
7,9,follow,6,192,1,5,3.25
7,9,fond,4,193,2,2,1.75
7,9,fool,4,194,2,2,1.75
7,9,forest,6,195,2,4,9.5
7,9,forever,7,196,4,3,2.75
7,9,forge,5,197,3,2,1.75
7,9,forgive,7,198,4,3,2.5
7,9,fork,4,199,3,1,1
7,9,format,6,200,3,3,8.75
7,9,freeze,6,201,1,5,3.25
7,9,from,4,202,2,2,1.75
7,9,fully,5,203,1,4,2.75
7,9,fun,3,204,2,1,7.5
7,9,funny,5,205,3,2,2
7,9,furious,7,206,2,5,3.5
7,9,gang,4,207,0,4,2.5
7,9,garden,6,208,2,4,9.75
7,9,gas,3,209,2,1,1
7,9,generic,7,210,1,6,4
7,9,get,3,211,2,1,1
7,9,goal,4,212,1,3,2
7,9,golden,6,213,2,4,9.5
7,9,goods,5,214,2,3,2.25
7,9,grain,5,215,1,4,2.75
7,9,grant,5,216,3,2,1.75
7,9,grass,5,217,3,2,8.25
7,9,great,5,218,2,3,2.25
7,9,greatly,7,219,5,2,1.75
7,9,guard,5,220,1,4,2.75
7,9,half,4,221,0,4,9.25
7,9,halt,4,222,3,1,1
7,9,hand,4,223,2,2,1.5
7,9,harmony,7,224,2,5,3.25
7,9,hatred,6,225,2,4,2.75
7,9,he,2,226,1,1,7.25
7,9,hearing,7,227,2,5,3.5
7,9,helmet,6,228,2,4,2.75
7,9,help,4,229,3,1,1.25
7,9,hidden,6,230,1,5,9.75
7,9,hide,4,231,3,1,1.25
7,9,highway,7,232,2,5,3.5
7,9,himself,7,233,2,5,3.5
7,9,hobby,5,234,1,4,9.5
7,9,hockey,6,235,2,4,2.75
7,9,hold,4,236,2,2,1.75
7,9,honour,6,237,2,4,10.25
7,9,hook,4,238,2,2,1.75
7,9,hope,4,239,2,2,1.5
7,9,horizon,7,240,2,5,3.5
7,9,hurry,5,241,1,4,10
7,9,husband,7,242,2,5,3.5
7,9,if,2,243,0,2,1.25
7,9,imagine,7,244,1,6,4
7,9,immense,7,245,2,5,10
7,9,in,2,246,1,1,0.75
7,9,indulge,7,247,2,5,3.5
7,9,initial,7,248,2,5,10.25
7,9,injured,7,249,2,5,3.5
7,9,insider,7,250,2,5,3.5
7,9,insult,6,251,3,3,9.25
7,9,invent,6,252,2,4,3
7,9,invoke,6,253,3,3,2.5
7,9,join,4,254,0,4,2.75
7,9,joint,5,255,4,1,7.5
7,9,kidnap,6,256,0,6,3.75
7,9,killing,7,257,2,5,3.5
7,9,kind,4,258,2,2,2
7,9,kiss,4,259,2,2,8.5
7,9,knock,5,260,1,4,2.75
7,9,label,5,261,0,5,3.25
7,9,ladder,6,262,2,4,10
7,9,lane,4,263,2,2,1.5
7,9,laptop,6,264,2,4,2.75
7,9,lawyer,6,265,2,4,2.75
7,9,leap,4,266,1,3,9
7,9,legacy,6,267,2,4,3
7,9,legal,5,268,4,1,1.25
7,9,length,6,269,2,4,2.75
7,9,less,4,270,2,2,1.5
7,9,lesson,6,271,4,2,9
7,9,let,3,272,2,1,1
7,9,level,5,273,2,3,2.25
7,9,light,5,274,1,4,2.75
7,9,linger,6,275,2,4,3
7,9,lively,6,276,2,4,9.5
7,9,lobby,5,277,1,4,2.75
7,9,lock,4,278,2,2,1.75
7,9,logo,4,279,2,2,1.5
7,9,loom,4,280,2,2,8.5
7,9,loop,4,281,3,1,1.25
7,9,loss,4,282,2,2,1.5
7,9,lost,4,283,3,1,1
7,9,luck,4,284,1,3,2
7,9,magical,7,285,0,7,11.25
7,9,major,5,286,2,3,2.25
7,9,march,5,287,2,3,2.25
7,9,marker,6,288,3,3,2.5
7,9,massive,7,289,2,5,10.5
7,9,me,2,290,1,1,0.75
7,9,meaning,7,291,2,5,3.5
7,9,medical,7,292,2,5,4.25
7,9,meet,4,293,2,2,12.25
7,9,menu,4,294,2,2,1.75
7,9,mile,4,295,1,3,2.25
7,9,mill,4,296,3,1,1
7,9,mine,4,297,2,2,1.75
7,9,miner,5,298,4,1,1.5
7,9,miracle,7,299,2,5,10.75
7,9,missile,7,300,2,5,3.75
7,9,modern,6,301,1,5,3.25
7,9,modest,6,302,4,2,9.75
7,9,monk,4,303,2,2,1.75
7,9,morning,7,304,2,5,3.5
7,9,motive,6,305,2,4,2.75
7,9,motor,5,306,3,2,9
7,9,mount,5,307,2,3,2.25
7,9,musical,7,308,1,6,4
7,9,mutual,6,309,2,4,10.25
7,9,naval,5,310,0,5,3.25
7,9,neglect,7,311,1,6,4
7,9,nerve,5,312,2,3,9.5
7,9,nest,4,313,2,2,1.75
7,9,network,7,314,2,5,3.5
7,9,news,4,315,2,2,1.75
7,9,next,4,316,2,2,1.75
7,9,ninety,6,317,1,5,10
7,9,noble,5,318,1,4,2.75
7,9,nod,3,319,2,1,1
7,9,noon,4,320,2,2,1.75
7,9,notable,7,321,2,5,10.5
7,9,notably,7,322,6,1,1.75
7,9,number,6,323,1,5,3.5
7,9,nurse,5,324,2,3,2.5
7,9,o,1,325,0,1,0.75
7,9,obey,4,326,1,3,9.5
7,9,object,6,327,2,4,3
7,9,obtain,6,328,2,4,3
7,9,offer,5,329,1,4,9.5
7,9,ongoing,7,330,1,6,4
7,9,open,4,331,1,3,2
7,9,opinion,7,332,2,5,10.5
7,9,oral,4,333,1,3,2
7,9,our,3,334,1,2,1.5
7,9,over,4,335,1,3,2
7,9,overly,6,336,4,2,1.75
7,9,oxygen,6,337,1,5,10.5
7,9,packet,6,338,0,6,3.75
7,9,paper,5,339,2,3,2.25
7,9,parent,6,340,2,4,9.75
7,9,partly,6,341,3,3,2.5
7,9,party,5,342,4,1,1.5
7,9,pass,4,343,2,2,1.5
7,9,passage,7,344,4,3,2.25
7,9,pathway,7,345,2,5,10.75
7,9,payment,7,346,2,5,3.5
7,9,peak,4,347,1,3,2
7,9,peasant,7,348,3,4,9.75
7,9,people,6,349,2,4,2.75
7,9,period,6,350,2,4,2.75
7,9,person,6,351,3,3,2.5
7,9,phase,5,352,1,4,10
7,9,plain,5,353,1,4,2.75
7,9,plate,5,354,3,2,1.75
7,9,plunge,6,355,2,4,2
7,9,pocket,6,356,1,5,5.75
7,9,poet,4,357,2,2,0.75
7,9,poetry,6,358,4,2,1
7,9,poverty,7,359,2,5,6
7,9,pray,4,360,1,3,1
7,9,prefer,6,361,2,4,1.5
7,9,premium,7,362,3,4,1.5
7,9,prevent,7,363,3,4,5.75
7,9,pride,5,364,2,3,1
7,9,priest,6,365,3,3,1.25
7,9,prison,6,366,3,3,1.25
7,9,promote,7,367,2,5,6
7,9,protect,7,368,3,4,1.5
7,9,protein,7,369,5,2,1.25
7,9,provoke,7,370,3,4,1.5
7,9,pub,3,371,1,2,5
7,9,purple,6,372,2,4,1.5
7,9,pursue,6,373,3,3,1.25
7,9,quarter,7,374,0,7,6.25
7,9,queen,5,375,2,3,1
7,9,quietly,7,376,2,5,1.5
7,9,radio,5,377,0,5,6
7,9,random,6,378,2,4,1.5
7,9,range,5,379,3,2,1
7,9,rapid,5,380,2,3,1
7,9,raw,3,381,2,1,0.5
7,9,readily,7,382,1,6,6
7,9,realize,7,383,3,4,1.5
7,9,really,6,384,4,2,1
7,9,recipe,6,385,2,4,5.75
7,9,refuge,6,386,2,4,1.5
7,9,refugee,7,387,6,1,0.5
7,9,release,7,388,2,5,1.5
7,9,rely,4,389,3,1,0.5
7,9,remote,6,390,2,4,5.5
7,9,respect,7,391,2,5,1.5
7,9,resume,6,392,3,3,1.25
7,9,reverse,7,393,2,5,6
7,9,review,6,394,3,3,1.25
7,9,rock,4,395,1,3,1
7,9,route,5,396,2,3,1
7,9,rumour,6,397,1,5,6
7,9,run,3,398,2,1,0.5
7,9,runner,6,399,3,3,1
7,9,sadly,5,400,0,5,1.5
7,9,sail,4,401,2,2,0.75
7,9,salary,6,402,2,4,5.75
7,9,scale,5,403,1,4,1.25
7,9,scratch,7,404,2,5,1.5
7,9,script,6,405,3,3,5.75
7,9,seldom,6,406,1,5,1.5
7,9,senator,7,407,2,5,1.75
7,9,send,4,408,3,1,5
7,9,session,7,409,2,5,1.75
7,9,set,3,410,2,1,0.5
7,9,sex,3,411,2,1,0.5
7,9,shadow,6,412,1,5,1.75
7,9,shake,5,413,3,2,5.25
7,9,sheet,5,414,2,3,1
7,9,short,5,415,2,3,1
7,9,show,4,416,3,1,0.75
7,9,shrink,6,417,2,4,1.25
7,9,silent,6,418,1,5,5.75
7,9,silly,5,419,3,2,1
7,9,sir,3,420,2,1,0.5
7,9,size,4,421,2,2,0.75
7,9,skiing,6,422,1,5,5.75
7,9,sleep,5,423,1,4,1.25
7,9,slogan,6,424,2,4,1.5
7,9,slot,4,425,3,1,0.75
7,9,small,5,426,1,4,1.25
7,9,society,7,427,1,6,6.25
7,9,soldier,7,428,2,5,1.75
7,9,solely,6,429,3,3,6
7,9,soon,4,430,2,2,0.75
7,9,span,4,431,1,3,1
7,9,spicy,5,432,2,3,1
7,9,spill,5,433,3,2,1
7,9,spite,5,434,3,2,1
7,9,split,5,435,2,3,5.5
7,9,spoil,5,436,2,3,1
7,9,spoon,5,437,3,2,1
7,9,sport,5,438,3,2,1
7,9,spot,4,439,3,1,0.5
7,9,spy,3,440,2,1,0.5
7,9,squeeze,7,441,1,6,6.5
7,9,stadium,7,442,1,6,1.75
7,9,station,7,443,3,4,5.75
7,9,status,6,444,4,2,1
7,9,steel,5,445,2,3,1.25
7,9,steep,5,446,4,1,0.75
7,9,stiff,5,447,2,3,1
7,9,stupid,6,448,2,4,5.75
7,9,success,7,449,1,6,1.75
7,9,superb,6,450,2,4,1.5
7,9,supply,6,451,3,3,1.25
7,9,surge,5,452,2,3,5.5
7,9,swing,5,453,1,4,1.5
7,9,symbol,6,454,1,5,1.5
7,9,tag,3,455,0,3,5.5
7,9,teach,5,456,1,4,1.25
7,9,tent,4,457,2,2,1
7,9,testify,7,458,2,5,1.75
7,9,text,4,459,2,2,5
7,9,than,4,460,1,3,1
7,9,that,4,461,3,1,0.5
7,9,theatre,7,462,2,5,1.5
7,9,theirs,6,463,3,3,1.25
7,9,there,5,464,3,2,5.5
7,9,thick,5,465,2,3,1.25
7,9,thief,5,466,3,2,1
7,9,think,5,467,3,2,1
7,9,though,6,468,2,4,1.75
7,9,throat,6,469,2,4,870.5
7,9,throw,5,470,4,1,1.25
7,9,tobacco,7,471,1,6,2.75
7,9,toll,4,472,2,2,2
7,9,tone,4,473,2,2,2.25
7,9,tongue,6,474,3,3,9.75
7,9,touch,5,475,2,3,2.25
7,9,tourist,7,476,3,4,3.5
7,9,towel,5,477,2,3,1.75
7,9,true,4,478,1,3,8.25
7,9,truly,5,479,3,2,1.25
7,9,tunnel,6,480,1,5,2.25
7,9,turn,4,481,2,2,1.25
7,9,turnout,7,482,4,3,1.75
7,9,twenty,6,483,1,5,8.5
7,9,twist,5,484,2,3,3
7,9,typical,7,485,1,6,5.5
7,9,under,5,486,0,5,10.75
7,9,unfold,6,487,2,4,3
7,9,unlike,6,488,2,4,3
7,9,us,2,489,1,1,6.5
7,9,valid,5,490,0,5,1.75
7,9,vehicle,7,491,1,6,2.25
7,9,very,4,492,2,2,1.25
7,9,vote,4,493,1,3,6
7,9,want,4,494,0,4,1.5
7,9,warfare,7,495,2,5,2
7,9,warm,4,496,3,1,0.75
7,9,wash,4,497,2,2,5.25
7,9,we,2,498,1,1,0.5
7,9,weak,4,499,2,2,1
7,9,weather,7,500,3,4,2
7,9,weekly,6,501,2,4,1.5
7,9,well,4,502,2,2,4.25
7,9,where,5,503,1,4,1.25
7,9,whisper,7,504,2,5,2
7,9,who,3,505,2,1,0.75
7,9,wide,4,506,1,3,7.25
7,9,widely,6,507,4,2,1.25
7,9,winner,6,508,2,4,1.75
7,9,winter,6,509,3,3,1.5
7,9,worst,5,510,1,4,5.5
7,9,writer,6,511,1,5,1.5
7,9,yell,4,512,0,4,1.25
7,9,yours,5,513,1,4,1.5
7,9,zero,4,514,0,4,5.25
7,9,zone,4,515,1,3,1
8,0,able,4,0,0,4,4.75
8,0,about,5,1,2,3,1
8,0,accent,6,2,1,5,1.5
8,0,account,7,3,3,4,1.5
8,0,acquire,7,4,2,5,5.5
8,0,action,6,5,2,4,1.25
8,0,addition,8,6,1,7,6.25
8,0,adhere,6,7,2,4,1.5
8,0,advanced,8,8,2,6,2
8,0,affair,6,9,1,5,5.5
8,0,afford,6,10,3,3,1.25
8,0,afraid,6,11,2,4,1.5
8,0,aid,3,12,1,2,0.75
8,0,air,3,13,2,1,0.5
8,0,alien,5,14,1,4,5
8,0,alike,5,15,3,2,1
8,0,all,3,16,2,1,0.75
8,0,alliance,8,17,3,5,1.75
8,0,also,4,18,2,2,4.75
8,0,although,8,19,2,6,2
8,0,amid,4,20,1,3,1
8,0,angel,5,21,1,4,1.25
8,0,angry,5,22,3,2,5
8,0,anyone,6,23,2,4,1.5
8,0,apple,5,24,1,4,1.25
8,0,apply,5,25,4,1,0.5
8,0,arena,5,26,1,4,5
8,0,armed,5,27,2,3,1.25
8,0,arrival,7,28,2,5,1.5
8,0,article,7,29,2,5,5.5
8,0,asset,5,30,1,4,1.25
8,0,assign,6,31,3,3,1.25
8,0,attach,6,32,1,5,1.5
8,0,attack,6,33,5,1,4.5
8,0,attempt,7,34,3,4,1.5
8,0,attend,6,35,4,2,1.25
8,0,attorney,8,36,3,5,1.75
8,0,audience,8,37,1,7,5.75
8,0,audit,5,38,4,1,0.75
8,0,august,6,39,2,4,1.25
8,0,autumn,6,40,2,4,5
8,0,avoid,5,41,1,4,1.25
8,0,aware,5,42,1,4,1.25
8,0,back,4,43,0,4,1
8,0,backdrop,8,44,4,4,5.5
8,0,bad,3,45,2,1,0.5
8,0,bake,4,46,2,2,0.75
8,0,bank,4,47,2,2,0.75
8,0,barrier,7,48,2,5,5.25
8,0,basis,5,49,2,3,1
8,0,bean,4,50,1,3,1
8,0,bear,4,51,3,1,0.5
8,0,because,7,52,2,5,1.5
8,0,become,6,53,3,3,5
8,0,bee,3,54,2,1,0.5
8,0,being,5,55,2,3,1
8,0,bend,4,56,2,2,0.75
8,0,bent,4,57,3,1,0.5
8,0,bet,3,58,2,1,0.5
8,0,bicycle,7,59,1,6,5.75
8,0,biology,7,60,2,5,1.75
8,0,blanket,7,61,1,6,6.25
8,0,blast,5,62,3,2,1
8,0,blend,5,63,2,3,1
8,0,blood,5,64,2,3,1
8,0,body,4,65,1,3,1
8,0,bold,4,66,2,2,4.75
8,0,born,4,67,2,2,0.75
8,0,bounce,6,68,2,4,1.25
8,0,bread,5,69,1,4,1.25
8,0,breath,6,70,4,2,0.75
8,0,brick,5,71,2,3,4.75
8,0,briefly,7,72,3,4,1.5
8,0,broad,5,73,2,3,1
8,0,broadly,7,74,5,2,0.75
8,0,brother,7,75,3,4,5.25
8,0,brown,5,76,3,2,1
8,0,buck,4,77,1,3,1
8,0,building,8,78,2,6,2
8,0,bury,4,79,2,2,4.75
8,0,but,3,80,2,1,0.5
8,0,bye,3,81,1,2,0.75
8,0,camp,4,82,0,4,1.25
8,0,carriage,8,83,2,6,5.75
8,0,case,4,84,2,2,0.75
8,0,castle,6,85,3,3,1.25
8,0,catch,5,86,2,3,1
8,0,cattle,6,87,3,3,1
8,0,cause,5,88,2,3,5
8,0,centre,6,89,1,5,1.5
8,0,champion,8,90,1,7,2
8,0,chance,6,91,3,3,5.25
8,0,chaos,5,92,3,2,1
8,0,charge,6,93,3,3,1.25
8,0,chat,4,94,3,1,0.5
8,0,cheek,5,95,2,3,1
8,0,chef,4,96,3,1,0.5
8,0,chest,5,97,3,2,4.75
8,0,civic,5,98,1,4,1.25
8,0,class,5,99,1,4,1.25
8,0,classic,7,100,5,2,0.75
8,0,classify,8,101,6,2,4.5
8,0,cleaning,8,102,2,6,2
8,0,climb,5,103,2,3,1
8,0,clinic,6,104,3,3,1.25
8,0,clip,4,105,3,1,4.75
8,0,closure,7,106,2,5,1.75
8,0,cloth,5,107,3,2,1
8,0,clue,4,108,2,2,0.75
8,0,cocktail,8,109,1,7,6
8,0,college,7,110,2,5,2.5
8,0,coloured,8,111,3,5,4
8,0,complain,8,112,2,6,10.75
8,0,compose,7,113,4,3,2.5
8,0,comprise,8,114,4,4,4.25
8,0,computer,8,115,4,4,11.25
8,0,conclude,8,116,2,6,4
8,0,concrete,8,117,4,4,3.25
8,0,confirm,7,118,3,4,9.25
8,0,conflict,8,119,4,4,3.25
8,0,conserve,8,120,3,5,3.5
8,0,consume,7,121,4,3,8.75
8,0,consumer,8,122,7,1,1.75
8,0,contact,7,123,3,4,3
8,0,contract,8,124,4,4,3.25
8,0,contrary,8,125,6,2,2.5
8,0,convert,7,126,3,4,10
8,0,cook,4,127,2,2,1.75
8,0,cool,4,128,3,1,1.25
8,0,cop,3,129,2,1,1
8,0,cotton,6,130,2,4,2.75
8,0,covered,7,131,2,5,9.75
8,0,cow,3,132,2,1,1
8,0,crack,5,133,1,4,2.75
8,0,crazy,5,134,3,2,1.75
8,0,critical,8,135,2,6,11
8,0,critique,8,136,5,3,3
8,0,crop,4,137,2,2,2.25
8,0,crown,5,138,3,2,1.75
8,0,cult,4,139,1,3,2.25
8,0,cupboard,8,140,2,6,11.5
8,0,custom,6,141,2,4,2.75
8,0,daughter,8,142,0,8,12.75
8,0,dead,4,143,1,3,2.75
8,0,deadline,8,144,4,4,3.25
8,0,debris,6,145,2,4,11.5
8,0,decorate,8,146,2,6,4.75
8,0,defeat,6,147,2,4,3
8,0,defend,6,148,4,2,9.5
8,0,defy,4,149,3,1,1.25
8,0,denial,6,150,2,4,3
8,0,depict,6,151,2,4,3
8,0,desert,6,152,2,4,3
8,0,destroy,7,153,3,4,10.25
8,0,devise,6,154,2,4,3
8,0,die,3,155,1,2,1.75
8,0,dilemma,7,156,2,5,11.25
8,0,discard,7,157,2,5,3.75
8,0,disorder,8,158,3,5,3.75
8,0,dispose,7,159,3,4,10.25
8,0,distinct,8,160,3,5,4
8,0,district,8,161,4,4,3.5
8,0,disturb,7,162,4,3,9.75
8,0,divert,6,163,2,4,2.75
8,0,divorce,7,164,3,4,3
8,0,doctrine,8,165,1,7,11.75
8,0,donate,6,166,2,4,3
8,0,door,4,167,2,2,1.75
8,0,drain,5,168,1,4,2.75
8,0,draw,4,169,3,1,1.25
8,0,drive,5,170,2,3,8.75
8,0,drum,4,171,2,2,1.75
8,0,due,3,172,1,2,1.5
8,0,duty,4,173,2,2,1.75
8,0,dynamic,7,174,1,6,10.5
8,0,each,4,175,0,4,2.5
8,0,echo,4,176,1,3,2.25
8,0,economy,7,177,2,5,10
8,0,edge,4,178,1,3,2.25
8,0,educated,8,179,2,6,4.25
8,0,educator,8,180,6,2,2.25
8,0,embed,5,181,1,4,12
8,0,emerge,6,182,2,4,4.75
8,0,employ,6,183,2,4,3.25
8,0,endorse,7,184,1,6,11.5
8,0,energy,6,185,2,4,3
8,0,enforce,7,186,2,5,3.5
8,0,enough,6,187,2,4,9.75
8,0,ensue,5,188,2,3,2.25
8,0,entirely,8,189,2,6,4
8,0,entity,6,190,4,2,2
8,0,erupt,5,191,1,4,9.25
8,0,escalate,8,192,1,7,4.5
8,0,eternal,7,193,1,6,10.75
8,0,ethical,7,194,2,5,3.5
8,0,ethnic,6,195,3,3,2.75
8,0,exam,4,196,1,3,8.75
8,0,except,6,197,2,4,3
8,0,excess,6,198,4,2,2
8,0,expected,8,199,2,6,4.25
8,0,export,6,200,3,3,9.5
8,0,external,8,201,2,6,4.25
8,0,extra,5,202,3,2,2
8,0,extract,7,203,5,2,2
8,0,fabulous,8,204,0,8,11.5
8,0,facility,8,205,2,6,4.25
8,0,factor,6,206,3,3,10
8,0,familiar,8,207,2,6,4
8,0,fan,3,208,2,1,1
8,0,farm,4,209,2,2,1.5
8,0,favour,6,210,2,4,9.75
8,0,feature,7,211,1,6,4
8,0,feeling,7,212,2,5,3.5
8,0,figure,6,213,1,5,9.75
8,0,fill,4,214,2,2,1.75
8,0,film,4,215,3,1,1.25
8,0,filter,6,216,3,3,2.25
8,0,finish,6,217,2,4,9.75
8,0,firearm,7,218,2,5,3.5
8,0,first,5,219,3,2,1.75
8,0,fish,4,220,2,2,1.5
8,0,fishing,7,221,4,3,2.5
8,0,fit,3,222,2,1,7.5
8,0,flash,5,223,1,4,2.75
8,0,flawed,6,224,3,3,2.5
8,0,fluid,5,225,2,3,2.25
8,0,fold,4,226,1,3,2
8,0,fond,4,227,2,2,9
8,0,fool,4,228,2,2,2.25
8,0,forecast,8,229,2,6,4.5
8,0,forest,6,230,4,2,2
8,0,forge,5,231,3,2,9.25
8,0,formal,6,232,3,3,2.5
8,0,forth,5,233,3,2,2
8,0,forum,5,234,3,2,2
8,0,fossil,6,235,2,4,3
8,0,freely,6,236,1,5,11.25
8,0,from,4,237,2,2,1.75
8,0,fruit,5,238,2,3,2.25
8,0,fun,3,239,1,2,1.5
8,0,function,8,240,3,5,10.75
8,0,funny,5,241,3,2,2
8,0,gang,4,242,0,4,2.75
8,0,gas,3,243,2,1,1
8,0,gentle,6,244,1,5,10
8,0,genuine,7,245,3,4,3.25
8,0,glad,4,246,1,3,2
8,0,gorgeous,8,247,1,7,11
8,0,grain,5,248,1,4,2.75
8,0,grass,5,249,3,2,1.75
8,0,great,5,250,2,3,2.25
8,0,guard,5,251,1,4,9.25
8,0,hand,4,252,0,4,2.5
8,0,happy,5,253,2,3,2.25
8,0,harmony,7,254,2,5,3.5
8,0,hatred,6,255,2,4,10
8,0,hear,4,256,1,3,2.25
8,0,hearing,7,257,4,3,2.25
8,0,heating,7,258,3,4,9.5
8,0,heavily,7,259,3,4,3
8,0,help,4,260,2,2,1.75
8,0,helpful,7,261,4,3,2.25
8,0,here,4,262,2,2,1.5
8,0,hero,4,263,3,1,1.25
8,0,hidden,6,264,1,5,10.75
8,0,highway,7,265,2,5,3.5
8,0,history,7,266,2,5,10.5
8,0,hold,4,267,1,3,2
8,0,horizon,7,268,2,5,3.5
8,0,hostile,7,269,2,5,3.5
8,0,hurry,5,270,1,4,9.5
8,0,husband,7,271,2,5,3
8,0,if,2,272,0,2,0.75
8,0,ignore,6,273,1,5,6.25
8,0,illness,7,274,1,6,1.75
8,0,imminent,8,275,1,7,6.25
8,0,impress,7,276,2,5,1.75
8,0,in,2,277,1,1,0.5
8,0,indoor,6,278,2,4,1.25
8,0,indoors,7,279,6,1,0.5
8,0,induce,6,280,3,3,5.75
8,0,indulge,7,281,4,3,1.25
8,0,infect,6,282,2,4,1.25
8,0,initial,7,283,2,5,5.75
8,0,inmate,6,284,2,4,1.5
8,0,innocent,8,285,2,6,2
8,0,input,5,286,2,3,5.25
8,0,insect,6,287,2,4,1.5
8,0,insider,7,288,3,4,1.5
8,0,insight,7,289,4,3,1.25
8,0,insult,6,290,3,3,5.75
8,0,interact,8,291,2,6,1.75
8,0,invent,6,292,2,4,1.5
8,0,jeans,5,293,0,5,6
8,0,kidnap,6,294,0,6,1.75
8,0,kill,4,295,2,2,1
8,0,killing,7,296,4,3,5.5
8,0,label,5,297,0,5,1.5
8,0,ladder,6,298,2,4,1.25
8,0,lady,4,299,3,1,0.75
8,0,lamp,4,300,2,2,0.75
8,0,landing,7,301,2,5,5.75
8,0,landlord,8,302,4,4,1.75
8,0,language,8,303,3,5,1.75
8,0,late,4,304,2,2,5.25
8,0,lawyer,6,305,2,4,1.5
8,0,leap,4,306,1,3,1
8,0,learn,5,307,3,2,0.75
8,0,leisure,7,308,2,5,5.75
8,0,lend,4,309,2,2,0.75
8,0,less,4,310,2,2,0.75
8,0,lesson,6,311,4,2,0.75
8,0,level,5,312,2,3,1
8,0,lifetime,8,313,1,7,6.5
8,0,likewise,8,314,2,6,2
8,0,listener,8,315,2,6,6.25
8,0,literacy,8,316,2,6,1.75
8,0,loan,4,317,1,3,1
8,0,logic,5,318,2,3,5.5
8,0,logo,4,319,3,1,0.75
8,0,loom,4,320,2,2,0.75
8,0,loop,4,321,3,1,0.75
8,0,loss,4,322,2,2,0.75
8,0,lost,4,323,3,1,0.5
8,0,lower,5,324,2,3,1
8,0,lung,4,325,1,3,5.25
8,0,magazine,8,326,0,8,2.25
8,0,magical,7,327,3,4,6
8,0,major,5,328,2,3,1.25
8,0,mall,4,329,2,2,0.75
8,0,marginal,8,330,2,6,1.75
8,0,marriage,8,331,3,5,6.25
8,0,massive,7,332,2,5,1.5
8,0,mate,4,333,2,2,0.75
8,0,maths,5,334,3,2,0.75
8,0,maybe,5,335,2,3,5.5
8,0,mayor,5,336,3,2,1
8,0,me,2,337,1,1,0.5
8,0,meaning,7,338,2,5,1.5
8,0,means,5,339,4,1,0.5
8,0,measure,7,340,3,4,5.5
8,0,medical,7,341,2,5,1.75
8,0,meet,4,342,2,2,0.75
8,0,metal,5,343,2,3,1
8,0,metaphor,8,344,4,4,5.75
8,0,mile,4,345,1,3,1
8,0,military,8,346,3,5,1.75
8,0,milk,4,347,3,1,0.5
8,0,mill,4,348,3,1,0.75
8,0,miner,5,349,2,3,5.25
8,0,mining,6,350,3,3,1.25
8,0,minute,6,351,3,3,1.25
8,0,missile,7,352,2,5,1.5
8,0,mistake,7,353,3,4,5.75
8,0,mobile,6,354,1,5,1.5
8,0,modern,6,355,2,4,1.25
8,0,modest,6,356,4,2,5.5
8,0,motorist,8,357,2,6,2
8,0,mount,5,358,2,3,1
8,0,mountain,8,359,5,3,1
8,0,movement,8,360,2,6,6.5
8,0,multiply,8,361,1,7,2.25
8,0,musical,7,362,2,5,6
8,0,mutual,6,363,2,4,1.25
8,0,myself,6,364,1,5,1.5
8,0,nail,4,365,0,4,5.75
8,0,naval,5,366,2,3,1
8,0,nerve,5,367,1,4,1.25
8,0,net,3,368,2,1,0.5
8,0,nineteen,8,369,1,7,6.75
8,0,nod,3,370,1,2,0.75
8,0,nonsense,8,371,2,6,2.25
8,0,nose,4,372,2,2,5.25
8,0,now,3,373,2,1,0.5
8,0,number,6,374,1,5,1.5
8,0,nurse,5,375,2,3,1
8,0,nursery,7,376,5,2,1
8,0,nursing,7,377,4,3,6
8,0,o,1,378,0,1,0.25
8,0,obey,4,379,1,3,1
8,0,observe,7,380,2,5,1.5
8,0,obvious,7,381,2,5,6
8,0,of,2,382,1,1,0.5
8,0,offender,8,383,2,6,1.75
8,0,on,2,384,1,1,0.25
8,0,operate,7,385,1,6,6.25
8,0,oral,4,386,1,3,1
8,0,orange,6,387,3,3,1.25
8,0,our,3,388,1,2,0.75
8,0,outrage,7,389,2,5,6
8,0,over,4,390,1,3,1
8,0,oxygen,6,391,1,5,1.5
8,0,pair,4,392,0,4,5.5
8,0,parental,8,393,2,6,2
8,0,party,5,394,3,2,1
8,0,passage,7,395,2,5,6.25
8,0,passion,7,396,4,3,1.5
8,0,pension,7,397,1,6,1.75
8,0,period,6,398,2,4,6
8,0,phase,5,399,1,4,1.5
8,0,pink,4,400,1,3,1
8,0,plain,5,401,1,4,1.25
8,0,planet,6,402,3,3,5.75
8,0,plate,5,403,3,2,1
8,0,player,6,404,3,3,1.25
8,0,pleasure,8,405,2,6,2
8,0,plug,4,406,2,2,5.5
8,0,poet,4,407,1,3,1
8,0,poetry,6,408,4,2,0.75
8,0,politics,8,409,2,6,2
8,0,port,4,410,2,2,5.25
8,0,practice,8,411,1,7,2.25
8,0,preach,6,412,2,4,1.5
8,0,prepare,7,413,3,4,6
8,0,present,7,414,3,4,1.5
8,0,pretty,6,415,3,3,1.25
8,0,price,5,416,2,3,1
8,0,prison,6,417,3,3,6
8,0,prisoner,8,418,6,2,1.25
8,0,probable,8,419,2,6,2
8,0,probably,8,420,7,1,0.75
8,0,protein,7,421,3,4,5.75
8,0,province,8,422,3,5,1.75
8,0,provoke,7,423,4,3,1.25
8,0,purchase,8,424,1,7,6.75
8,0,purely,6,425,3,3,1.25
8,0,purple,6,426,3,3,1
8,0,pursue,6,427,3,3,1
8,0,qualify,7,428,0,7,6.75
8,0,queen,5,429,2,3,1
8,0,question,8,430,3,5,1.75
8,0,quietly,7,431,2,5,6
8,0,racist,6,432,0,6,1.75
8,0,radio,5,433,2,3,5.75
8,0,random,6,434,2,4,1.5
8,0,rapid,5,435,2,3,1
8,0,rare,4,436,2,2,0.75
8,0,reader,6,437,1,5,6.25
8,0,reading,7,438,4,3,1.25
8,0,real,4,439,3,1,0.5
8,0,realize,7,440,4,3,1
8,0,really,6,441,4,2,0.75
8,0,receive,7,442,2,5,6
8,0,receiver,8,443,7,1,0.75
8,0,red,3,444,2,1,0.5
8,0,refuge,6,445,2,4,1.25
8,0,register,8,446,2,6,6.25
8,0,regret,6,447,3,3,1.25
8,0,release,7,448,2,5,1.5
8,0,reliable,8,449,3,5,1.75
8,0,remember,8,450,2,6,6.5
8,0,repeated,8,451,2,6,1.75
8,0,reporter,8,452,3,5,6.25
8,0,respect,7,453,2,5,1.5
8,0,response,8,454,4,4,1.5
8,0,result,6,455,3,3,5.75
8,0,resume,6,456,4,2,1
8,0,reverse,7,457,2,5,1.5
8,0,review,6,458,3,3,1.25
8,0,rhythm,6,459,1,5,6.25
8,0,rice,4,460,1,3,1
8,0,riot,4,461,2,2,0.75
8,0,risk,4,462,2,2,1
8,0,rock,4,463,1,3,5.5
8,0,route,5,464,2,3,1.25
8,0,royal,5,465,2,3,1.25
8,0,rugby,5,466,1,4,1.25
8,0,rule,4,467,2,2,0.75
8,0,rumour,6,468,2,4,6.25
8,0,run,3,469,2,1,0.5
8,0,sad,3,470,0,3,1
8,0,sail,4,471,2,2,0.75
8,0,say,3,472,2,1,0.5
8,0,scratch,7,473,1,6,6.5
8,0,scream,6,474,3,3,1.25
8,0,sea,3,475,1,2,0.75
8,0,seize,5,476,2,3,2
8,0,seldom,6,477,2,4,10.5
8,0,self,4,478,3,1,1.25
8,0,senator,7,479,2,5,3.5
8,0,send,4,480,3,1,1.25
8,0,senior,6,481,3,3,2.5
8,0,serial,6,482,2,4,10.25
8,0,session,7,483,2,5,3.5
8,0,set,3,484,2,1,1
8,0,sex,3,485,2,1,1
8,0,shadow,6,486,1,5,11
8,0,shake,5,487,3,2,1.75
8,0,shall,5,488,3,2,1.75
8,0,shine,5,489,2,3,2.25
8,0,shock,5,490,2,3,2
8,0,shocking,8,491,5,3,9.75
8,0,shot,4,492,3,1,1.25
8,0,should,6,493,3,3,2.5
8,0,shrug,5,494,2,3,2.25
8,0,silence,7,495,1,6,11.25
8,0,silly,5,496,3,2,1.75
8,0,sincere,7,497,2,5,3.5
8,0,sing,4,498,3,1,1.25
8,0,sixty,5,499,2,3,2.25
8,0,size,4,500,2,2,1.5
8,0,skiing,6,501,1,5,10.75
8,0,slogan,6,502,1,5,3.25
8,0,slot,4,503,3,1,1.25
8,0,small,5,504,1,4,19.5
8,0,smart,5,505,3,2,1025.25
8,0,smash,5,506,3,2,1.5
8,0,soar,4,507,1,3,2
8,0,society,7,508,2,5,2.5
8,0,soft,4,509,2,2,7.75
8,0,soldier,7,510,2,5,2.5
8,0,solely,6,511,3,3,1.75
8,0,sorry,5,512,2,3,1.75
8,0,sort,4,513,3,1,1
8,0,spending,8,514,1,7,8.75
8,0,spill,5,515,2,3,2
8,0,sponsor,7,516,2,5,9
8,0,spoon,5,517,3,2,2.25
8,0,sport,5,518,3,2,2
8,0,status,6,519,1,5,2.25
8,0,steep,5,520,2,3,1.75
8,0,stiff,5,521,2,3,6.5
8,0,stress,6,522,2,4,2
8,0,strive,6,523,3,3,1.5
8,0,student,7,524,2,5,6.75
8,0,stunning,8,525,3,5,2.25
8,0,style,5,526,2,3,1.25
8,0,success,7,527,1,6,6.75
8,0,suffer,6,528,2,4,1.5
8,0,sum,3,529,2,1,0.5
8,0,summer,6,530,3,3,1.25
8,0,superior,8,531,2,6,7
8,0,supply,6,532,3,3,1.5
8,0,suppress,8,533,4,4,2.25
8,0,surge,5,534,2,3,2
8,0,survive,7,535,3,4,6.75
8,0,sweet,5,536,1,4,1.5
8,0,swing,5,537,2,3,1.25
8,0,symbol,6,538,1,5,5.25
8,0,teach,5,539,0,5,1.5
8,0,teenage,7,540,2,5,1.75
8,0,tell,4,541,2,2,1
8,0,tennis,6,542,2,4,9
8,0,terminal,8,543,2,6,4
8,0,terrain,7,544,3,4,9.5
8,0,testify,7,545,2,5,3.5
8,0,text,4,546,2,2,1.75
8,0,that,4,547,1,3,2
8,0,theatre,7,548,2,5,9.75
8,0,their,5,549,3,2,1.75
8,0,theirs,6,550,5,1,1.25
8,0,there,5,551,3,2,1.75
8,0,thick,5,552,2,3,2.25
8,0,threaten,8,553,2,6,10.25
8,0,thrive,6,554,3,3,2.5
8,0,throat,6,555,3,3,2.5
8,0,throw,5,556,4,1,1.5
8,0,timber,6,557,1,5,9.5
8,0,toll,4,558,1,3,2.25
8,0,tongue,6,559,2,4,3
8,0,tourist,7,560,2,5,3.5
8,0,toy,3,561,2,1,7.25
8,0,trace,5,562,1,4,2.75
8,0,training,8,563,3,5,3.75
8,0,transfer,8,564,3,5,10.75
8,0,trillion,8,565,2,6,4
8,0,true,4,566,2,2,1.5
8,0,trustee,7,567,3,4,10
8,0,tuesday,7,568,1,6,4
8,0,tuition,7,569,2,5,3.5
8,0,turn,4,570,2,2,1.75
8,0,turnout,7,571,4,3,9.5
8,0,twist,5,572,1,4,2.75
8,0,type,4,573,1,3,2
8,0,typical,7,574,3,4,9.5
8,0,ugly,4,575,0,4,2.5
8,0,umbrella,8,576,1,7,4.5
8,0,under,5,577,1,4,9.25
8,0,unfold,6,578,2,4,3
8,0,unit,4,579,2,2,1.75
8,0,unlike,6,580,2,4,3
8,0,upwards,7,581,1,6,10.75
8,0,us,2,582,1,1,0.75
8,0,use,3,583,2,1,1
8,0,user,4,584,3,1,1
8,0,vast,4,585,0,4,2.75
8,0,versus,6,586,1,5,9.75
8,0,very,4,587,3,1,1.25
8,0,vicious,7,588,1,6,4
8,0,violate,7,589,2,5,10.25
8,0,vitamin,7,590,2,5,3.5
8,0,volume,6,591,1,5,3.25
8,0,wall,4,592,0,4,8.75
8,0,wash,4,593,2,2,1.75
8,0,we,2,594,1,1,0.75
8,0,wear,4,595,2,2,1.5
8,0,web,3,596,2,1,0.75
8,0,website,7,597,3,4,2.75
8,0,weekly,6,598,2,4,9
8,0,well,4,599,2,2,1.75
8,0,what,4,600,1,3,2
8,0,when,4,601,2,2,1.5
8,0,whilst,6,602,2,4,9
8,0,whisper,7,603,3,4,3.25
8,0,who,3,604,2,1,1
8,0,whole,5,605,3,2,1.5
8,0,widely,6,606,1,5,3.25
8,0,winter,6,607,2,4,9.5
8,0,wise,4,608,2,2,1.5
8,0,withdraw,8,609,2,6,4
8,0,workout,7,610,1,6,10.25
8,0,worm,4,611,3,1,1.25
8,0,writer,6,612,1,5,3.25
8,0,you,3,613,0,3,2
8,0,yours,5,614,3,2,8
8,0,zone,4,615,0,4,2.75
8,1,able,4,0,0,4,2.5
8,1,abolish,7,1,2,5,9.75
8,1,abortion,8,2,3,5,3.75
8,1,about,5,3,3,2,1.75
8,1,abstract,8,4,2,6,10.5
8,1,account,7,5,1,6,4
8,1,acquire,7,6,2,5,10
8,1,act,3,7,2,1,1
8,1,addition,8,8,1,7,4.5
8,1,adhere,6,9,2,4,3
8,1,advanced,8,10,2,6,10.75
8,1,affair,6,11,1,5,3.25
8,1,afford,6,12,3,3,2.25
8,1,afraid,6,13,2,4,9
8,1,aircraft,8,14,1,7,4.5
8,1,all,3,15,1,2,1.5
8,1,alliance,8,16,3,5,9.75
8,1,alone,5,17,2,3,2.25
8,1,also,4,18,2,2,1.75
8,1,although,8,19,2,6,10.5
8,1,amid,4,20,1,3,2.25
8,1,angel,5,21,1,4,2.75
8,1,angry,5,22,3,2,1.75
8,1,answer,6,23,2,4,9.5
8,1,anything,8,24,2,6,4.25
8,1,apart,5,25,1,4,2.75
8,1,appetite,8,26,2,6,10.5
8,1,apply,5,27,3,2,2
8,1,april,5,28,2,3,2.25
8,1,arena,5,29,1,4,3
8,1,armed,5,30,2,3,8.75
8,1,array,5,31,2,3,2.25
8,1,article,7,32,2,5,3.5
8,1,asset,5,33,1,4,9.5
8,1,assign,6,34,3,3,2.5
8,1,audit,5,35,1,4,3
8,1,august,6,36,2,4,3
8,1,author,6,37,2,4,9.75
8,1,avoid,5,38,1,4,2.75
8,1,aware,5,39,1,4,2.75
8,1,away,4,40,3,1,1.25
8,1,back,4,41,0,4,9
8,1,backdrop,8,42,4,4,3
8,1,bad,3,43,2,1,1
8,1,ballot,6,44,2,4,2.75
8,1,banana,6,45,2,4,9
8,1,bare,4,46,2,2,1.75
8,1,barrier,7,47,3,4,3
8,1,because,7,48,1,6,10.5
8,1,become,6,49,3,3,2.5
8,1,before,6,50,2,4,2.75
8,1,behind,6,51,2,4,2.75
8,1,beneath,7,52,2,5,10.5
8,1,bent,4,53,3,1,1.5
8,1,beside,6,54,2,4,3
8,1,bet,3,55,2,1,1
8,1,biology,7,56,1,6,10.75
8,1,blast,5,57,1,4,2.75
8,1,blend,5,58,2,3,2.25
8,1,blessing,8,59,3,5,10.25
8,1,body,4,60,1,3,2.25
8,1,bold,4,61,2,2,1.75
8,1,bonus,5,62,2,3,2.25
8,1,booking,7,63,2,5,3.5
8,1,born,4,64,2,2,8
8,1,bread,5,65,1,4,2.75
8,1,breath,6,66,4,2,1.75
8,1,brick,5,67,2,3,2.25
8,1,briefly,7,68,3,4,9.5
8,1,broad,5,69,2,3,2.25
8,1,broadly,7,70,5,2,2
8,1,brother,7,71,3,4,3
8,1,building,8,72,1,7,11
8,1,bulk,4,73,2,2,1.75
8,1,burial,6,74,2,4,3
8,1,bury,4,75,3,1,1.25
8,1,busy,4,76,2,2,1.75
8,1,but,3,77,2,1,7.5
8,1,cabinet,7,78,0,7,4.5
8,1,captain,7,79,2,5,3.5
8,1,capture,7,80,4,3,9.5
8,1,carriage,8,81,2,6,4.25
8,1,carrot,6,82,4,2,2
8,1,cat,3,83,2,1,1
8,1,catch,5,84,3,2,8.5
8,1,cause,5,85,2,3,2.5
8,1,caution,7,86,3,4,3.25
8,1,cautious,8,87,6,2,2.25
8,1,centre,6,88,1,5,10.5
8,1,champion,8,89,1,7,4.5
8,1,chaos,5,90,3,2,1.75
8,1,charge,6,91,3,3,2.5
8,1,chat,4,92,3,1,8.25
8,1,chef,4,93,2,2,1.75
8,1,cinema,6,94,1,5,3.25
8,1,clarify,7,95,1,6,7.25
8,1,class,5,96,3,2,4.5
8,1,classic,7,97,5,2,1
8,1,climate,7,98,2,5,1.75
8,1,climb,5,99,4,1,0.75
8,1,clip,4,100,3,1,0.5
8,1,clock,5,101,2,3,5
8,1,closure,7,102,3,4,1.5
8,1,clothing,8,103,3,5,1.75
8,1,clue,4,104,2,2,0.75
8,1,coast,5,105,1,4,5.5
8,1,cocktail,8,106,2,6,2
8,1,college,7,107,2,5,1.5
8,1,colour,6,108,3,3,5.25
8,1,combine,7,109,2,5,1.5
8,1,commerce,8,110,3,5,1.75
8,1,complex,7,111,3,4,5.75
8,1,compose,7,112,4,3,1.25
8,1,comprise,8,113,4,4,1.5
8,1,computer,8,114,4,4,5.75
8,1,concrete,8,115,2,6,1.75
8,1,conflict,8,116,3,5,1.75
8,1,confuse,7,117,4,3,5.5
8,1,contact,7,118,3,4,1.5
8,1,contest,7,119,4,3,1.25
8,1,convert,7,120,3,4,1.5
8,1,cook,4,121,2,2,5.25
8,1,cool,4,122,3,1,0.75
8,1,copy,4,123,2,2,0.75
8,1,costume,7,124,2,5,1.5
8,1,cotton,6,125,2,4,1.5
8,1,council,7,126,2,5,6
8,1,covered,7,127,2,5,1.5
8,1,crack,5,128,1,4,5.5
8,1,crazy,5,129,3,2,1
8,1,cream,5,130,2,3,1.25
8,1,creation,8,131,4,4,1.5
8,1,critical,8,132,2,6,6.25
8,1,crop,4,133,2,2,0.75
8,1,crown,5,134,3,2,1
8,1,cue,3,135,1,2,0.75
8,1,cult,4,136,2,2,0.75
8,1,cure,4,137,2,2,0.75
8,1,customer,8,138,2,6,6.25
8,1,dad,3,139,0,3,1
8,1,dancer,6,140,2,4,1.25
8,1,daughter,8,141,2,6,6.25
8,1,deadly,6,142,1,5,1.5
8,1,dear,4,143,3,1,0.75
8,1,debate,6,144,2,4,5.75
8,1,debris,6,145,3,3,1.25
8,1,decorate,8,146,2,6,1.75
8,1,defeat,6,147,2,4,5.5
8,1,defy,4,148,3,1,0.75
8,1,depart,6,149,2,4,1.25
8,1,derive,6,150,2,4,1.25
8,1,desire,6,151,2,4,1.25
8,1,detail,6,152,2,4,5.75
8,1,diary,5,153,1,4,1.25
8,1,die,3,154,2,1,0.5
8,1,differ,6,155,2,4,1.25
8,1,dilemma,7,156,2,5,5.5
8,1,directly,8,157,2,6,1.75
8,1,disagree,8,158,2,6,6
8,1,disease,7,159,3,4,1.5
8,1,distance,8,160,3,5,1.75
8,1,distract,8,161,4,4,6.5
8,1,disturb,7,162,4,3,1.25
8,1,doctrine,8,163,1,7,2
8,1,dominate,8,164,2,6,6
8,1,dose,4,165,2,2,0.75
8,1,drag,4,166,1,3,1
8,1,draw,4,167,3,1,0.5
8,1,driver,6,168,2,4,5.5
8,1,drown,5,169,2,3,1
8,1,drug,4,170,2,2,0.75
8,1,drum,4,171,3,1,0.5
8,1,drunk,5,172,3,2,0.75
8,1,dynamic,7,173,1,6,6.25
8,1,early,5,174,0,5,1.5
8,1,easily,6,175,2,4,1.5
8,1,easy,4,176,3,1,0.75
8,1,eat,3,177,2,1,4.75
8,1,economy,7,178,1,6,1.75
8,1,edge,4,179,1,3,1
8,1,educated,8,180,2,6,6.25
8,1,eighteen,8,181,1,7,2
8,1,election,8,182,1,7,6.75
8,1,elevate,7,183,3,4,1.5
8,1,embed,5,184,1,4,1.25
8,1,emerge,6,185,2,4,5.75
8,1,employ,6,186,2,4,1.25
8,1,empty,5,187,3,2,1
8,1,endorse,7,188,1,6,1.75
8,1,energy,6,189,2,4,5.75
8,1,enquire,7,190,2,5,1.5
8,1,ensue,5,191,2,3,1
8,1,entire,6,192,2,4,5.75
8,1,equation,8,193,1,7,2
8,1,equip,5,194,3,2,1
8,1,era,3,195,1,2,0.75
8,1,escalate,8,196,1,7,6.75
8,1,ethic,5,197,1,4,1.25
8,1,every,5,198,1,4,5.5
8,1,evil,4,199,2,2,1
8,1,example,7,200,1,6,1.75
8,1,exotic,6,201,2,4,1.25
8,1,expected,8,202,2,6,6.5
8,1,export,6,203,3,3,1.25
8,1,exposure,8,204,4,4,1.5
8,1,external,8,205,2,6,6.25
8,1,fabulous,8,206,0,8,2.25
8,1,facility,8,207,2,6,6.5
8,1,fact,4,208,3,1,0.5
8,1,faction,7,209,4,3,1.25
8,1,factor,6,210,4,2,0.75
8,1,fame,4,211,2,2,0.75
8,1,fan,3,212,2,1,4.75
8,1,favour,6,213,2,4,1.25
8,1,feat,4,214,1,3,1
8,1,feather,7,215,4,3,1
8,1,feature,7,216,4,3,5.5
8,1,feedback,8,217,2,6,2
8,1,feel,4,218,3,1,0.75
8,1,feeling,7,219,4,3,1.25
8,1,festival,8,220,2,6,6.25
8,1,fifth,5,221,1,4,1.25
8,1,fighting,8,222,2,6,2
8,1,figure,6,223,3,3,5.75
8,1,film,4,224,2,2,0.75
8,1,finger,6,225,2,4,1.25
8,1,finish,6,226,3,3,1
8,1,fish,4,227,2,2,5.25
8,1,fit,3,228,2,1,0.5
8,1,five,4,229,2,2,0.75
8,1,flash,5,230,1,4,1.25
8,1,flawed,6,231,3,3,1.25
8,1,fleet,5,232,2,3,5.5
8,1,float,5,233,2,3,1.25
8,1,fluid,5,234,2,3,1
8,1,fold,4,235,1,3,1
8,1,fool,4,236,2,2,1
8,1,forecast,8,237,2,6,6.5
8,1,forest,6,238,4,2,1
8,1,forever,7,239,4,3,1.25
8,1,forgive,7,240,3,4,1.5
8,1,formal,6,241,3,3,5.75
8,1,format,6,242,5,1,0.75
8,1,forum,5,243,3,2,0.75
8,1,fossil,6,244,2,4,1.25
8,1,frame,5,245,1,4,5.75
8,1,fruit,5,246,2,3,1.25
8,1,fun,3,247,1,2,0.75
8,1,fund,4,248,3,1,0.5
8,1,garden,6,249,0,6,1.75
8,1,gas,3,250,2,1,0.5
8,1,generous,8,251,1,7,6.5
8,1,gentle,6,252,3,3,1.25
8,1,get,3,253,2,1,0.5
8,1,ghost,5,254,1,4,5.75
8,1,glad,4,255,1,3,1
8,1,goal,4,256,1,3,1
8,1,graduate,8,257,1,7,6.5
8,1,grand,5,258,3,2,1
8,1,grant,5,259,4,1,0.75
8,1,great,5,260,2,3,1
8,1,guard,5,261,1,4,1.25
8,1,halt,4,262,0,4,5.75
8,1,hand,4,263,2,2,0.75
8,1,harmony,7,264,2,5,1.5
8,1,hatred,6,265,2,4,1.25
8,1,hearing,7,266,1,6,6.5
8,1,heavily,7,267,3,4,1.5
8,1,hello,5,268,2,3,1
8,1,help,4,269,3,1,0.75
8,1,helpful,7,270,4,3,6
8,1,hero,4,271,2,2,0.75
8,1,hide,4,272,1,3,1
8,1,highway,7,273,2,5,1.5
8,1,hill,4,274,2,2,5.75
8,1,history,7,275,2,5,1.75
8,1,homeless,8,276,1,7,6.5
8,1,honour,6,277,2,4,1.5
8,1,hope,4,278,2,2,0.75
8,1,hostile,7,279,2,5,1.5
8,1,house,5,280,2,3,5.25
8,1,housing,7,281,4,3,1.5
8,1,husband,7,282,1,6,1.75
8,1,ignore,6,283,0,6,6.5
8,1,immense,7,284,1,6,1.75
8,1,imminent,8,285,3,5,1.75
8,1,impact,6,286,2,4,6
8,1,inclined,8,287,1,7,2
8,1,induce,6,288,2,4,6.25
8,1,innocent,8,289,2,6,2
8,1,insect,6,290,2,4,1.25
8,1,insight,7,291,3,4,6
8,1,invasion,8,292,2,6,2
8,1,invoke,6,293,3,3,1.25
8,1,jam,3,294,0,3,5.5
8,1,join,4,295,1,3,1
8,1,joint,5,296,4,1,0.5
8,1,july,4,297,1,3,1
8,1,justice,7,298,2,5,1.5
8,1,keen,4,299,0,4,9.25
8,1,kidnap,6,300,1,5,3.5
8,1,kill,4,301,2,2,1.75
8,1,killing,7,302,4,3,2.5
8,1,kind,4,303,2,2,9.5
8,1,kiss,4,304,2,2,1.75
8,1,labour,6,305,0,6,3.75
8,1,landlord,8,306,2,6,11.25
8,1,language,8,307,3,5,3.75
8,1,lately,6,308,2,4,2.75
8,1,lawsuit,7,309,2,5,10.75
8,1,lead,4,310,1,3,2
8,1,leap,4,311,3,1,1
8,1,leave,5,312,3,2,1.75
8,1,leisure,7,313,2,5,11
8,1,lend,4,314,2,2,1.5
8,1,length,6,315,3,3,2.5
8,1,lesson,6,316,2,4,2.75
8,1,let,3,317,2,1,1
8,1,level,5,318,2,3,2.25
8,1,lifetime,8,319,1,7,12
8,1,light,5,320,2,3,2.25
8,1,likewise,8,321,2,6,11.25
8,1,linger,6,322,2,4,3
8,1,listener,8,323,2,6,4
8,1,lively,6,324,2,4,10
8,1,logo,4,325,1,3,2
8,1,loom,4,326,2,2,1.75
8,1,loop,4,327,3,1,1.25
8,1,lose,4,328,2,2,1.5
8,1,lower,5,329,2,3,10
8,1,lung,4,330,1,3,2.25
8,1,magazine,8,331,0,8,5
8,1,mall,4,332,2,2,9.25
8,1,man,3,333,2,1,1
8,1,manifest,8,334,3,5,3.5
8,1,marker,6,335,2,4,2.75
8,1,massive,7,336,2,5,10.75
8,1,matter,6,337,2,4,3
8,1,maximize,8,338,2,6,4
8,1,me,2,339,1,1,0.75
8,1,means,5,340,2,3,9.5
8,1,medical,7,341,2,5,3.5
8,1,medicine,8,342,5,3,2.75
8,1,menu,4,343,2,2,1.5
8,1,metal,5,344,2,3,9.75
8,1,militant,8,345,1,7,4.5
8,1,milk,4,346,3,1,1.25
8,1,mill,4,347,3,1,1.25
8,1,mine,4,348,2,2,1.5
8,1,minimize,8,349,3,5,11
8,1,minor,5,350,3,2,1.75
8,1,minority,8,351,5,3,2.5
8,1,miracle,7,352,2,5,10.5
8,1,missile,7,353,2,5,3.5
8,1,mobile,6,354,1,5,3.25
8,1,mode,4,355,2,2,1.75
8,1,modern,6,356,4,2,9.75
8,1,monitor,7,357,2,5,3.5
8,1,monk,4,358,3,1,1.25
8,1,moral,5,359,2,3,2.25
8,1,morality,8,360,5,3,10
8,1,motorist,8,361,2,6,4
8,1,mount,5,362,2,3,2.25
8,1,mutual,6,363,1,5,11.25
8,1,nail,4,364,0,4,2.75
8,1,national,8,365,2,6,4
8,1,native,6,366,4,2,2
8,1,naval,5,367,2,3,10.25
8,1,neglect,7,368,1,6,4
8,1,nest,4,369,2,2,1.75
8,1,news,4,370,2,2,1.75
8,1,ninety,6,371,1,5,11
8,1,noble,5,372,1,4,2.75
8,1,nonsense,8,373,2,6,12
8,1,notable,7,374,2,5,3.75
8,1,nowadays,8,375,2,6,4.25
8,1,nurse,5,376,1,4,10.25
8,1,nursery,7,377,5,2,1.75
8,1,o,1,378,0,1,0.75
8,1,obey,4,379,1,3,2
8,1,observe,7,380,2,5,3.25
8,1,obtain,6,381,2,4,10.75
8,1,obvious,7,382,2,5,3.5
8,1,offering,8,383,1,7,20.75
8,1,on,2,384,1,1,716.25
8,1,open,4,385,1,3,3.25
8,1,orange,6,386,1,5,4.75
8,1,out,3,387,1,2,2.25
8,1,outrage,7,388,3,4,10.5
8,1,oven,4,389,1,3,2.25
8,1,over,4,390,3,1,1.25
8,1,overly,6,391,4,2,1.25
8,1,overseas,8,392,4,4,2
8,1,owner,5,393,1,4,7
8,1,pair,4,394,0,4,1.75
8,1,pan,3,395,2,1,0.75
8,1,pass,4,396,2,2,1.25
8,1,passion,7,397,4,3,1.75
8,1,peak,4,398,1,3,7.5
8,1,penalty,7,399,2,5,3.25
8,1,people,6,400,2,4,2.25
8,1,phase,5,401,1,4,7.25
8,1,pill,4,402,1,3,2
8,1,pink,4,403,2,2,2.5
8,1,pit,3,404,2,1,1.5
8,1,pitch,5,405,3,2,2.5
8,1,planet,6,406,1,5,11.5
8,1,plate,5,407,3,2,1.25
8,1,plunge,6,408,2,4,1.75
8,1,poet,4,409,1,3,1.25
8,1,poetry,6,410,4,2,1
8,1,pole,4,411,2,2,5.25
8,1,politics,8,412,3,5,1.75
8,1,pop,3,413,2,1,0.5
8,1,positive,8,414,2,6,1.75
8,1,poverty,7,415,2,5,5.25
8,1,powder,6,416,2,4,1.25
8,1,preach,6,417,1,5,1.5
8,1,precede,7,418,3,4,5.25
8,1,prepare,7,419,3,4,1.5
8,1,prey,4,420,3,1,0.5
8,1,priest,6,421,2,4,1.25
8,1,probably,8,422,2,6,5.5
8,1,protein,7,423,3,4,1.5
8,1,provide,7,424,3,4,3.25
8,1,province,8,425,5,3,3.5
8,1,pub,3,426,1,2,0.75
8,1,punch,5,427,2,3,1
8,1,purchase,8,428,2,6,5.5
8,1,purely,6,429,3,3,1.5
8,1,purple,6,430,3,3,2.5
8,1,pursue,6,431,3,3,2.5
8,1,qualify,7,432,0,7,10.5
8,1,queue,5,433,2,3,2.25
8,1,quietly,7,434,2,5,3.5
8,1,quote,5,435,2,3,8.25
8,1,random,6,436,0,6,3.75
8,1,range,5,437,3,2,1.75
8,1,read,4,438,1,3,2.25
8,1,readily,7,439,4,3,8.75
8,1,real,4,440,3,1,1.25
8,1,really,6,441,4,2,2
8,1,receiver,8,442,2,6,4.25
8,1,recipe,6,443,3,3,8.5
8,1,recovery,8,444,3,5,3.75
8,1,refuge,6,445,2,4,3
8,1,refugee,7,446,6,1,1.25
8,1,relaxing,8,447,2,6,10.75
8,1,release,7,448,3,4,3.25
8,1,rely,4,449,3,1,1.25
8,1,reminder,8,450,2,6,10.5
8,1,remote,6,451,3,3,2.5
8,1,repeated,8,452,2,6,4.25
8,1,report,6,453,3,3,2.5
8,1,response,8,454,2,6,10.75
8,1,resume,6,455,3,3,2.5
8,1,retreat,7,456,2,5,3.5
8,1,reverse,7,457,2,5,10.5
8,1,review,6,458,3,3,2.5
8,1,rhetoric,8,459,1,7,11
8,1,rock,4,460,1,3,2
8,1,role,4,461,2,2,1.75
8,1,royal,5,462,2,3,2.25
8,1,rule,4,463,1,3,2
8,1,rumour,6,464,2,4,9.25
8,1,runner,6,465,2,4,3
8,1,sad,3,466,0,3,2
8,1,sadly,5,467,3,2,1.5
8,1,sail,4,468,2,2,7.75
8,1,saint,5,469,3,2,1.75
8,1,sanction,8,470,2,6,4
8,1,sandwich,8,471,3,5,3.5
8,1,say,3,472,2,1,7.25
8,1,scope,5,473,1,4,3
8,1,scratch,7,474,2,5,3.5
8,1,sea,3,475,1,2,1.5
8,1,section,7,476,2,5,13.5
8,1,see,3,477,2,1,1.75
8,1,seize,5,478,2,3,2.75
8,1,seldom,6,479,2,4,3.5
8,1,self,4,480,3,1,1.5
8,1,senior,6,481,2,4,10.25
8,1,serial,6,482,2,4,3.25
8,1,session,7,483,2,5,3.75
8,1,several,7,484,2,5,10.5
8,1,sex,3,485,2,1,1.25
8,1,shade,5,486,1,4,2.75
8,1,shake,5,487,3,2,2
8,1,shaped,6,488,3,3,9.25
8,1,shine,5,489,2,3,2.25
8,1,short,5,490,2,3,2.25
8,1,shot,4,491,3,1,1.25
8,1,show,4,492,3,1,1.5
8,1,shrink,6,493,2,4,3
8,1,silent,6,494,1,5,9.25
8,1,simulate,8,495,2,6,4.25
8,1,sixty,5,496,2,3,2.25
8,1,size,4,497,2,2,8.25
8,1,skiing,6,498,1,5,3.5
8,1,sky,3,499,2,1,1
8,1,slave,5,500,1,4,2.75
8,1,slogan,6,501,2,4,9.25
8,1,slot,4,502,3,1,1.25
8,1,soccer,6,503,1,5,3.25
8,1,society,7,504,3,4,3
8,1,software,8,505,2,6,10.5
8,1,solely,6,506,2,4,2.75
8,1,sorry,5,507,2,3,2.25
8,1,spicy,5,508,1,4,8.5
8,1,spill,5,509,3,2,1.75
8,1,spoon,5,510,2,3,2.25
8,1,sport,5,511,3,2,1.75
8,1,spot,4,512,3,1,1.25
8,1,spy,3,513,2,1,1
8,1,stadium,7,514,1,6,10
8,1,stage,5,515,3,2,1.75
8,1,stark,5,516,3,2,1.75
8,1,status,6,517,3,3,2.5
8,1,steel,5,518,2,3,8.75
8,1,steep,5,519,4,1,1.25
8,1,stream,6,520,2,4,2.75
8,1,student,7,521,2,5,3.5
8,1,stupid,6,522,3,3,9
8,1,suburb,6,523,1,5,3.5
8,1,suburban,8,524,6,2,2
8,1,suddenly,8,525,2,6,10.5
8,1,suicide,7,526,2,5,3.75
8,1,sum,3,527,2,1,1
8,1,summer,6,528,3,3,2.25
8,1,summit,6,529,4,2,2
8,1,superb,6,530,2,4,9.5
8,1,superior,8,531,5,3,2.75
8,1,supply,6,532,3,3,2.5
8,1,surface,7,533,2,5,3.5
8,1,surge,5,534,3,2,8.25
8,1,survive,7,535,3,4,3
8,1,sustain,7,536,2,5,3.5
8,1,sweet,5,537,1,4,8.75
8,1,swimming,8,538,2,6,4.25
8,1,symbol,6,539,1,5,3.25
8,1,syndrome,8,540,2,6,10.5
8,1,tag,3,541,0,3,2
8,1,teenage,7,542,1,6,4
8,1,teenager,8,543,7,1,8
8,1,tenure,6,544,2,4,3
8,1,theirs,6,545,1,5,3.25
8,1,there,5,546,3,2,1.75
8,1,they,4,547,3,1,1.25
8,1,thief,5,548,2,3,8.5
8,1,thing,5,549,3,2,1.75
8,1,think,5,550,4,1,1.5
8,1,third,5,551,3,2,1.75
8,1,though,6,552,2,4,2.75
8,1,thought,7,553,6,1,1.25
8,1,thrive,6,554,2,4,9
8,1,throw,5,555,3,2,2
8,1,thursday,8,556,2,6,4.25
8,1,timber,6,557,1,5,9.5
8,1,toll,4,558,1,3,2.25
8,1,ton,3,559,2,1,1.25
8,1,tongue,6,560,3,3,2.25
8,1,total,5,561,2,3,2.25
8,1,towel,5,562,2,3,8.25
8,1,training,8,563,1,7,4.75
8,1,trillion,8,564,2,6,11
8,1,troubled,8,565,2,6,4.5
8,1,true,4,566,2,2,1.5
8,1,truly,5,567,3,2,1.75
8,1,trustee,7,568,3,4,9.25
8,1,truth,5,569,3,2,1.75
8,1,tuition,7,570,1,6,4
8,1,tunnel,6,571,2,4,9.25
8,1,turn,4,572,2,2,1.5
8,1,turnout,7,573,4,3,2.25
8,1,turnover,8,574,5,3,2.5
8,1,twenty,6,575,1,5,9.5
8,1,twist,5,576,2,3,2.25
8,1,type,4,577,1,3,2
8,1,typical,7,578,3,4,2.75
8,1,under,5,579,0,5,9.75
8,1,unfold,6,580,2,4,3
8,1,upper,5,581,1,4,2.75
8,1,upset,5,582,2,3,9.5
8,1,upwards,7,583,2,5,3.5
8,1,user,4,584,1,3,2
8,1,vehicle,7,585,0,7,10.75
8,1,versus,6,586,2,4,3
8,1,vicious,7,587,1,6,4
8,1,victim,6,588,3,3,9
8,1,want,4,589,0,4,2.5
8,1,warfare,7,590,2,5,3.5
8,1,wash,4,591,2,2,1.75
8,1,wear,4,592,1,3,9.25
8,1,weather,7,593,3,4,3.25
8,1,web,3,594,2,1,1.25
8,1,wedding,7,595,2,5,3.75
8,1,weekly,6,596,2,4,10.25
8,1,well,4,597,2,2,1.75
8,1,wet,3,598,2,1,1
8,1,what,4,599,1,3,2
8,1,wheat,5,600,2,3,2.25
8,1,when,4,601,3,1,1.25
8,1,while,5,602,2,3,9
8,1,whisper,7,603,3,4,3
8,1,who,3,604,2,1,1
8,1,wise,4,605,1,3,2
8,1,wooden,6,606,1,5,8.75
8,1,workout,7,607,2,5,1.75
8,1,worse,5,608,3,2,1
8,1,worst,5,609,4,1,0.75
8,1,writing,7,610,1,6,5.75
8,1,wrong,5,611,2,3,1
8,1,yell,4,612,0,4,1.25
8,1,you,3,613,1,2,0.75
8,1,yours,5,614,3,2,4.75
8,1,zero,4,615,0,4,1.25
8,2,abolish,7,0,0,7,5.5
8,2,above,5,1,3,2,1
8,2,absent,6,2,2,4,1.25
8,2,access,6,3,1,5,1.5
8,2,account,7,4,3,4,5.25
8,2,acquire,7,5,2,5,1.5
8,2,action,6,6,2,4,1.25
8,2,addition,8,7,1,7,6
8,2,advance,7,8,2,5,1.75
8,2,afraid,6,9,1,5,5.75
8,2,aged,4,10,1,3,1
8,2,ah,2,11,1,1,0.5
8,2,aircraft,8,12,1,7,2.75
8,2,allege,6,13,1,5,7
8,2,alone,5,14,2,3,1.25
8,2,along,5,15,4,1,0.75
8,2,also,4,16,2,2,0.75
8,2,angel,5,17,1,4,3.25
8,2,angry,5,18,3,2,3
8,2,anything,8,19,2,6,2
8,2,archive,7,20,1,6,5.75
8,2,arena,5,21,2,3,1.25
8,2,armed,5,22,2,3,1
8,2,article,7,23,2,5,1.5
8,2,assign,6,24,1,5,5.75
8,2,attach,6,25,1,5,1.5
8,2,attorney,8,26,3,5,1.75
8,2,audit,5,27,1,4,5.5
8,2,august,6,28,2,4,1.5
8,2,author,6,29,2,4,1.25
8,2,avoid,5,30,1,4,5.25
8,2,away,4,31,1,3,1
8,2,backdrop,8,32,0,8,2.25
8,2,bad,3,33,2,1,4.5
8,2,banana,6,34,2,4,1.25
8,2,bare,4,35,2,2,0.75
8,2,basis,5,36,2,3,1
8,2,beef,4,37,1,3,1
8,2,behind,6,38,2,4,5.5
8,2,being,5,39,2,3,1
8,2,bend,4,40,2,2,0.75
8,2,beneath,7,41,3,4,1.25
8,2,beside,6,42,2,4,5.25
8,2,bias,4,43,1,3,1
8,2,bicycle,7,44,2,5,1.75
8,2,big,3,45,2,1,0.5
8,2,blanket,7,46,1,6,5.75
8,2,blast,5,47,3,2,1
8,2,blessing,8,48,2,6,2
8,2,body,4,49,1,3,5
8,2,bold,4,50,2,2,0.75
8,2,bond,4,51,2,2,0.75
8,2,boring,6,52,2,4,1.25
8,2,born,4,53,3,1,0.5
8,2,bread,5,54,1,4,5.25
8,2,briefly,7,55,2,5,1.5
8,2,bring,5,56,3,2,1
8,2,broad,5,57,2,3,1
8,2,broadly,7,58,5,2,5
8,2,brother,7,59,3,4,1.5
8,2,bury,4,60,1,3,1
8,2,but,3,61,2,1,0.5
8,2,button,6,62,3,3,1
8,2,cabinet,7,63,0,7,6
8,2,captain,7,64,2,5,1.75
8,2,carriage,8,65,2,6,6.5
8,2,carrot,6,66,4,2,1
8,2,case,4,67,2,2,0.75
8,2,catch,5,68,2,3,1
8,2,cattle,6,69,3,3,1.25
8,2,caution,7,70,2,5,5.75
8,2,cautious,8,71,6,2,1.25
8,2,cent,4,72,1,3,1
8,2,centre,6,73,4,2,0.75
8,2,champion,8,74,1,7,6.25
8,2,chance,6,75,3,3,1.25
8,2,cheek,5,76,2,3,1.25
8,2,chef,4,77,3,1,0.5
8,2,chest,5,78,3,2,5
8,2,civic,5,79,1,4,1.25
8,2,claim,5,80,1,4,1.25
8,2,classic,7,81,3,4,1.5
8,2,cleaning,8,82,2,6,6.25
8,2,climate,7,83,2,5,1.75
8,2,climb,5,84,4,1,0.75
8,2,cling,5,85,3,2,1
8,2,clinic,6,86,4,2,5.25
8,2,closure,7,87,2,5,1.75
8,2,clothes,7,88,3,4,1.5
8,2,cocktail,8,89,1,7,6.25
8,2,coin,4,90,2,2,0.75
8,2,collapse,8,91,2,6,1.75
8,2,college,7,92,4,3,6
8,2,combine,7,93,2,5,4.25
8,2,common,6,94,3,3,1.5
8,2,complex,7,95,3,4,6
8,2,compose,7,96,4,3,1.5
8,2,computer,8,97,4,4,1.5
8,2,conclude,8,98,2,6,6.25
8,2,concrete,8,99,4,4,1.75
8,2,conflict,8,100,3,5,2
8,2,confuse,7,101,4,3,1.5
8,2,conserve,8,102,3,5,6.25
8,2,consume,7,103,4,3,1.25
8,2,contact,7,104,3,4,1.25
8,2,context,7,105,4,3,5.5
8,2,contrary,8,106,4,4,1.5
8,2,convert,7,107,3,4,1.25
8,2,cook,4,108,2,2,0.75
8,2,cooking,7,109,4,3,1
8,2,cool,4,110,3,1,4.75
8,2,corrupt,7,111,2,5,1.5
8,2,costume,7,112,2,5,1.5
8,2,cotton,6,113,2,4,5.5
8,2,courage,7,114,2,5,1.75
8,2,covered,7,115,2,5,1.5
8,2,crash,5,116,1,4,5.5
8,2,creation,8,117,2,6,2
8,2,creator,7,118,5,2,1
8,2,critique,8,119,2,6,6
8,2,cue,3,120,1,2,0.75
8,2,cult,4,121,2,2,0.75
8,2,custody,7,122,2,5,1.5
8,2,custom,6,123,5,1,0.75
8,2,database,8,124,0,8,6.5
8,2,date,4,125,3,1,0.5
8,2,dead,4,126,1,3,1
8,2,deadly,6,127,4,2,0.75
8,2,deck,4,128,2,2,4.75
8,2,decorate,8,129,3,5,1.75
8,2,defeat,6,130,2,4,1.25
8,2,defend,6,131,4,2,1
8,2,define,6,132,3,3,5.5
8,2,depend,6,133,2,4,1.5
8,2,depict,6,134,3,3,1.25
8,2,descend,7,135,2,5,5.75
8,2,desert,6,136,3,3,1.25
8,2,desire,6,137,3,3,1.5
8,2,destroy,7,138,3,4,1.5
8,2,devise,6,139,2,4,5.75
8,2,dialogue,8,140,1,7,2.25
8,2,die,3,141,2,1,0.75
8,2,differ,6,142,2,4,8.25
8,2,dilemma,7,143,2,5,1.75
8,2,directly,8,144,2,6,2.25
8,2,disagree,8,145,2,6,6.75
8,2,discard,7,146,3,4,1.5
8,2,disorder,8,147,3,5,1.75
8,2,disrupt,7,148,3,4,6
8,2,distance,8,149,3,5,1.75
8,2,district,8,150,4,4,1.5
8,2,divert,6,151,2,4,5.5
8,2,divorce,7,152,3,4,1.5
8,2,dominate,8,153,1,7,6.25
8,2,donate,6,154,2,4,1.5
8,2,donor,5,155,3,2,1
8,2,dose,4,156,2,2,0.75
8,2,dozen,5,157,2,3,1
8,2,drag,4,158,1,3,5.25
8,2,dramatic,8,159,3,5,1.75
8,2,dress,5,160,2,3,1
8,2,drum,4,161,2,2,0.75
8,2,drunk,5,162,3,2,0.75
8,2,duty,4,163,1,3,5.5
8,2,each,4,164,0,4,1.25
8,2,eastern,7,165,2,5,1.5
8,2,economy,7,166,1,6,6
8,2,edge,4,167,1,3,1
8,2,educated,8,168,2,6,1.75
8,2,educator,8,169,6,2,5.75
8,2,election,8,170,1,7,2
8,2,electric,8,171,5,3,1.25
8,2,element,7,172,3,4,5.75
8,2,emerge,6,173,1,5,1.5
8,2,empire,6,174,2,4,1.5
8,2,energy,6,175,1,5,7
8,2,enhance,7,176,2,5,1.75
8,2,enough,6,177,2,4,1.75
8,2,enquire,7,178,2,5,6.25
8,2,ensue,5,179,2,3,1.25
8,2,equal,5,180,1,4,1.25
8,2,equip,5,181,3,2,0.75
8,2,error,5,182,1,4,5.5
8,2,eternal,7,183,1,6,1.75
8,2,ethic,5,184,2,3,1
8,2,ethnic,6,185,3,3,5.75
8,2,evil,4,186,1,3,1
8,2,evolve,6,187,2,4,2.5
8,2,except,6,188,1,5,3.25
8,2,exclude,7,189,3,4,10
8,2,exotic,6,190,2,4,3
8,2,expected,8,191,2,6,11.75
8,2,exposure,8,192,3,5,4
8,2,extra,5,193,2,3,2.5
8,2,fabulous,8,194,0,8,12.25
8,2,fact,4,195,2,2,1.75
8,2,faith,5,196,2,3,2.25
8,2,fame,4,197,2,2,1.5
8,2,fan,3,198,2,1,1
8,2,farm,4,199,2,2,1.5
8,2,favour,6,200,2,4,10
8,2,feat,4,201,1,3,2.25
8,2,feature,7,202,4,3,2.25
8,2,feed,4,203,2,2,1.75
8,2,feedback,8,204,4,4,10
8,2,feeling,7,205,3,4,3.25
8,2,fence,5,206,2,3,2.25
8,2,final,5,207,1,4,2.75
8,2,find,4,208,3,1,8.25
8,2,finish,6,209,3,3,2.5
8,2,firework,8,210,2,6,4
8,2,five,4,211,2,2,1.5
8,2,flame,5,212,1,4,9.5
8,2,flash,5,213,3,2,1.75
8,2,flaw,4,214,3,1,1
8,2,flawed,6,215,4,2,1.75
8,2,float,5,216,2,3,2.25
8,2,flour,5,217,3,2,1.75
8,2,fold,4,218,1,3,9
8,2,follow,6,219,3,3,2.25
8,2,fond,4,220,2,2,1.75
8,2,fool,4,221,2,2,1.75
8,2,forest,6,222,2,4,9.75
8,2,forge,5,223,3,2,2
8,2,formal,6,224,3,3,2.5
8,2,format,6,225,5,1,1.25
8,2,forth,5,226,3,2,1.75
8,2,frankly,7,227,1,6,10.75
8,2,fully,5,228,1,4,2.75
8,2,function,8,229,2,6,4.25
8,2,gambling,8,230,0,8,16.25
8,2,gas,3,231,2,1,1
8,2,generous,8,232,1,7,4.5
8,2,gentle,6,233,3,3,10.25
8,2,genuine,7,234,3,4,3
8,2,ghost,5,235,1,4,2.75
8,2,golden,6,236,1,5,10.5
8,2,gorgeous,8,237,2,6,4.25
8,2,graduate,8,238,1,7,12
8,2,grand,5,239,3,2,1.75
8,2,grant,5,240,4,1,1.25
8,2,great,5,241,2,3,2.25
8,2,greatly,7,242,5,2,1.75
8,2,half,4,243,0,4,10
8,2,halt,4,244,3,1,1
8,2,hardware,8,245,2,6,4
8,2,hatred,6,246,2,4,2.75
8,2,he,2,247,1,1,0.75
8,2,hearing,7,248,2,5,10.5
8,2,heavily,7,249,3,4,3
8,2,helmet,6,250,2,4,2.75
8,2,help,4,251,3,1,1.25
8,2,helpful,7,252,4,3,9.75
8,2,hidden,6,253,1,5,3.5
8,2,himself,7,254,2,5,3.5
8,2,history,7,255,2,5,14.75
8,2,hobby,5,256,1,4,3
8,2,hockey,6,257,2,4,3
8,2,hold,4,258,2,2,9.25
8,2,holy,4,259,3,1,1.25
8,2,hook,4,260,2,2,1.75
8,2,horizon,7,261,2,5,3.5
8,2,host,4,262,2,2,1.5
8,2,hostile,7,263,4,3,9.5
8,2,hurry,5,264,1,4,2.75
8,2,husband,7,265,2,5,3.5
8,2,ideology,8,266,0,8,13
8,2,if,2,267,1,1,1
8,2,inclined,8,268,1,7,4.75
8,2,indeed,6,269,2,4,10
8,2,indoor,6,270,3,3,2.5
8,2,indoors,7,271,6,1,1.5
8,2,induce,6,272,3,3,2.5
8,2,injured,7,273,2,5,10.75
8,2,input,5,274,2,3,2.25
8,2,insider,7,275,2,5,3.5
8,2,insight,7,276,4,3,2.5
8,2,insult,6,277,3,3,10
8,2,interact,8,278,2,6,4.25
8,2,invent,6,279,2,4,3
8,2,jam,3,280,0,3,9.75
8,2,join,4,281,1,3,2.25
8,2,joint,5,282,4,1,1
8,2,justice,7,283,1,6,4
8,2,keen,4,284,0,4,9.5
8,2,kidnap,6,285,1,5,3.25
8,2,kill,4,286,2,2,1.75
8,2,killing,7,287,4,3,2.5
8,2,labour,6,288,0,6,14.75
8,2,ladder,6,289,2,4,3
8,2,lady,4,290,3,1,1.5
8,2,lamp,4,291,2,2,1.75
8,2,landing,7,292,2,5,10.75
8,2,landlord,8,293,4,4,3.25
8,2,lane,4,294,3,1,1.25
8,2,laptop,6,295,2,4,3
8,2,late,4,296,2,2,9
8,2,lately,6,297,4,2,2
8,2,lawsuit,7,298,2,5,3.5
8,2,lawyer,6,299,3,3,2.5
8,2,layout,6,300,2,4,11.25
8,2,lead,4,301,1,3,2.25
8,2,learn,5,302,3,2,1.75
8,2,leave,5,303,3,2,1.75
8,2,leisure,7,304,2,5,10.5
8,2,level,5,305,2,3,2.25
8,2,light,5,306,1,4,2.75
8,2,likewise,8,307,2,6,4
8,2,literacy,8,308,2,6,11.5
8,2,logic,5,309,1,4,2.75
8,2,lord,4,310,2,2,1.75
8,2,lose,4,311,2,2,9
8,2,loss,4,312,3,1,1.25
8,2,lost,4,313,3,1,1.25
8,2,lower,5,314,2,3,2.25
8,2,lung,4,315,1,3,2
8,2,magazine,8,316,0,8,12.75
8,2,magical,7,317,3,4,3
8,2,major,5,318,2,3,2.25
8,2,man,3,319,2,1,1
8,2,marathon,8,320,2,6,11.75
8,2,march,5,321,3,2,2
8,2,marginal,8,322,3,5,3.75
8,2,marriage,8,323,3,5,10.75
8,2,marry,5,324,4,1,1.5
8,2,matching,8,325,2,6,4
8,2,maximize,8,326,2,6,18.5
8,2,mayor,5,327,2,3,500.75
8,2,me,2,328,1,1,0.75
8,2,means,5,329,2,3,1.5
8,2,medical,7,330,2,5,2.5
8,2,medicine,8,331,5,3,8.25
8,2,meet,4,332,2,2,1.25
8,2,menu,4,333,2,2,1.25
8,2,metal,5,334,2,3,1.5
8,2,mile,4,335,1,3,1.5
8,2,militant,8,336,3,5,7.75
8,2,military,8,337,6,2,1.75
8,2,milk,4,338,3,1,0.75
8,2,mill,4,339,3,1,0.75
8,2,mine,4,340,2,2,1
8,2,minimize,8,341,3,5,8.5
8,2,miracle,7,342,2,5,5
8,2,mode,4,343,1,3,3.25
8,2,monk,4,344,2,2,2.5
8,2,morality,8,345,2,6,10.5
8,2,morning,7,346,3,4,2.5
8,2,motor,5,347,2,3,1.75
8,2,multiply,8,348,1,7,12.25
8,2,musical,7,349,2,5,2.25
8,2,national,8,350,0,8,6.25
8,2,naval,5,351,2,3,1
8,2,nerve,5,352,1,4,1.25
8,2,network,7,353,2,5,5.25
8,2,news,4,354,2,2,0.75
8,2,nineteen,8,355,1,7,2
8,2,ninety,6,356,5,1,0.75
8,2,noble,5,357,1,4,4.75
8,2,nod,3,358,2,1,0.5
8,2,nonsense,8,359,2,6,2
8,2,noon,4,360,2,2,0.75
8,2,nose,4,361,2,2,0.75
8,2,notable,7,362,2,5,7.5
8,2,notably,7,363,6,1,1.5
8,2,number,6,364,1,5,3.25
8,2,nursery,7,365,2,5,9
8,2,o,1,366,0,1,0.75
8,2,obey,4,367,1,3,2
8,2,object,6,368,2,4,2.75
8,2,obtain,6,369,2,4,8.25
8,2,offer,5,370,1,4,2.75
8,2,offering,8,371,5,3,2.5
8,2,onto,4,372,1,3,2
8,2,open,4,373,1,3,8.25
8,2,operator,8,374,3,5,3.75
8,2,optimism,8,375,2,6,4.25
8,2,or,2,376,1,1,1
8,2,oral,4,377,2,2,8
8,2,organize,8,378,2,6,4
8,2,our,3,379,1,2,1.5
8,2,over,4,380,1,3,2
8,2,overly,6,381,4,2,7.75
8,2,overseas,8,382,4,4,3.25
8,2,own,3,383,1,2,1.5
8,2,owner,5,384,3,2,1.75
8,2,oxygen,6,385,1,5,9.75
8,2,packet,6,386,0,6,3.75
8,2,palm,4,387,2,2,1.75
8,2,paper,5,388,2,3,2.25
8,2,parent,6,389,2,4,8.75
8,2,parish,6,390,3,3,2.5
8,2,partly,6,391,3,3,2.75
8,2,party,5,392,4,1,1.5
8,2,pass,4,393,2,2,1.5
8,2,passage,7,394,4,3,8.75
8,2,passing,7,395,4,3,2.5
8,2,peasant,7,396,1,6,4
8,2,person,6,397,2,4,9.25
8,2,persuade,8,398,4,4,4
8,2,petition,8,399,2,6,5
8,2,phase,5,400,1,4,8.75
8,2,pill,4,401,1,3,2.25
8,2,pilot,5,402,3,2,1.75
8,2,pitch,5,403,2,3,2.5
8,2,plain,5,404,1,4,2.75
8,2,planet,6,405,3,3,9
8,2,plate,5,406,3,2,2
8,2,player,6,407,3,3,2.5
8,2,pocket,6,408,1,5,3.25
8,2,poetry,6,409,2,4,9.5
8,2,pole,4,410,2,2,1.75
8,2,pop,3,411,2,1,1
8,2,popular,7,412,3,4,3
8,2,pose,4,413,2,2,1.75
8,2,powder,6,414,2,4,8.75
8,2,pray,4,415,1,3,2.25
8,2,preach,6,416,2,4,2.75
8,2,prefer,6,417,3,3,2.5
8,2,present,7,418,3,4,9
8,2,pretty,6,419,3,3,2.75
8,2,previous,8,420,3,5,4
8,2,price,5,421,2,3,8.75
8,2,pride,5,422,3,2,1.75
8,2,prison,6,423,3,3,2.5
8,2,probable,8,424,2,6,4.25
8,2,probably,8,425,7,1,1.75
8,2,protein,7,426,3,4,10.75
8,2,protocol,8,427,4,4,3.25
8,2,provide,7,428,3,4,3.25
8,2,provoke,7,429,4,3,9.5
8,2,pub,3,430,1,2,2.25
8,2,purchase,8,431,2,6,4.5
8,2,purely,6,432,3,3,3
8,2,purple,6,433,3,3,9
8,2,pursue,6,434,3,3,2.5
8,2,qualify,7,435,0,7,5
8,2,question,8,436,2,6,12.25
8,2,quickly,7,437,2,5,3.75
8,2,quote,5,438,2,3,2.5
8,2,racist,6,439,0,6,10.75
8,2,rain,4,440,2,2,2
8,2,receiver,8,441,1,7,11
8,2,recipe,6,442,3,3,2.5
8,2,red,3,443,2,1,1
8,2,register,8,444,2,6,4.25
8,2,relaxing,8,445,2,6,11.75
8,2,release,7,446,3,4,3.5
8,2,reliable,8,447,3,5,4
8,2,rely,4,448,3,1,1.25
8,2,reminder,8,449,2,6,10
8,2,renowned,8,450,2,6,4.25
8,2,reporter,8,451,2,6,10
8,2,respect,7,452,2,5,3.5
8,2,response,8,453,4,4,3.25
8,2,result,6,454,3,3,9.25
8,2,review,6,455,2,4,3
8,2,rhythm,6,456,1,5,3.5
8,2,rice,4,457,1,3,8
8,2,riot,4,458,2,2,1.75
8,2,risk,4,459,2,2,1.75
8,2,rock,4,460,1,3,2.25
8,2,romantic,8,461,2,6,10.25
8,2,rule,4,462,1,3,2.25
8,2,rumour,6,463,2,4,3
8,2,run,3,464,2,1,1
8,2,sad,3,465,0,3,2
8,2,sadly,5,466,3,2,7.75
8,2,sandwich,8,467,2,6,4.25
8,2,say,3,468,2,1,1
8,2,scratch,7,469,1,6,4
8,2,script,6,470,3,3,8.5
8,2,seize,5,471,1,4,2.75
8,2,self,4,472,2,2,1.75
8,2,send,4,473,2,2,1.75
8,2,serial,6,474,2,4,9
8,2,set,3,475,2,1,1
8,2,seventy,7,476,2,5,3.75
8,2,several,7,477,4,3,4
8,2,shadow,6,478,1,5,5.5
8,2,shall,5,479,3,2,1
8,2,shaped,6,480,3,3,1.25
8,2,sheet,5,481,2,3,1.25
8,2,shine,5,482,2,3,4.75
8,2,shock,5,483,2,3,1
8,2,shocking,8,484,5,3,1.25
8,2,short,5,485,3,2,1
8,2,show,4,486,3,1,0.5
8,2,shrink,6,487,2,4,1.25
8,2,silence,7,488,1,6,5.5
8,2,silly,5,489,3,2,1
8,2,sixty,5,490,2,3,1
8,2,size,4,491,2,2,0.75
8,2,skill,5,492,1,4,5
8,2,sky,3,493,2,1,0.5
8,2,small,5,494,1,4,1.25
8,2,smash,5,495,3,2,0.75
8,2,soak,4,496,1,3,4.5
8,2,soccer,6,497,2,4,1.5
8,2,society,7,498,3,4,1.5
8,2,soft,4,499,2,2,0.75
8,2,soldier,7,500,2,5,5.5
8,2,sort,4,501,2,2,1
8,2,source,6,502,2,4,1.25
8,2,span,4,503,1,3,1
8,2,spending,8,504,2,6,5.75
8,2,spicy,5,505,2,3,1
8,2,spill,5,506,3,2,1
8,2,spoil,5,507,2,3,1
8,2,sponsor,7,508,3,4,5
8,2,spoon,5,509,3,2,1
8,2,stadium,7,510,1,6,1.75
8,2,stark,5,511,3,2,1
8,2,status,6,512,3,3,5
8,2,steel,5,513,2,3,1
8,2,steep,5,514,4,1,0.5
8,2,suburb,6,515,1,5,1.5
8,2,suburban,8,516,6,2,0.75
8,2,success,7,517,2,5,5.25
8,2,sum,3,518,2,1,0.5
8,2,summer,6,519,3,3,1
8,2,superior,8,520,2,6,5.25
8,2,supply,6,521,3,3,1.25
8,2,suppress,8,522,4,4,1.75
8,2,surge,5,523,2,3,1
8,2,survive,7,524,3,4,5
8,2,sustain,7,525,2,5,1.5
8,2,symbol,6,526,1,5,1.5
8,2,t,1,527,0,1,0.25
8,2,talented,8,528,1,7,5.75
8,2,tax,3,529,2,1,0.5
8,2,teach,5,530,1,4,1.25
8,2,teenager,8,531,2,6,5.75
8,2,tell,4,532,2,2,0.75
8,2,terminal,8,533,2,6,1.75
8,2,terrain,7,534,3,4,5.5
8,2,terrible,8,535,4,4,1.5
8,2,testing,7,536,2,5,1.5
8,2,than,4,537,1,3,4.75
8,2,that,4,538,3,1,0.5
8,2,theatre,7,539,2,5,1.5
8,2,their,5,540,3,2,0.75
8,2,them,4,541,3,1,0.5
8,2,then,4,542,3,1,0.5
8,2,theology,8,543,3,5,5.25
8,2,there,5,544,3,2,0.75
8,2,thing,5,545,2,3,1
8,2,think,5,546,4,1,0.5
8,2,thinking,8,547,5,3,1
8,2,third,5,548,3,2,4.5
8,2,thought,7,549,2,5,1.75
8,2,threat,6,550,2,4,1.25
8,2,threaten,8,551,6,2,1
8,2,throw,5,552,3,2,4.5
8,2,timber,6,553,1,5,1.75
8,2,tobacco,7,554,1,6,1.75
8,2,ton,3,555,2,1,0.5
8,2,touch,5,556,2,3,5.25
8,2,tourist,7,557,3,4,1.75
8,2,towards,7,558,2,5,3.25
8,2,toy,3,559,2,1,0.75
8,2,trace,5,560,1,4,6.5
8,2,trading,7,561,3,4,1.5
8,2,training,8,562,3,5,2
8,2,transfer,8,563,3,5,6.5
8,2,tribunal,8,564,2,6,2
8,2,truly,5,565,2,3,1.25
8,2,trustee,7,566,3,4,6
8,2,truth,5,567,3,2,1
8,2,try,3,568,2,1,0.5
8,2,tunnel,6,569,1,5,1.5
8,2,turnout,7,570,2,5,5.5
8,2,turnover,8,571,5,3,1.5
8,2,twist,5,572,1,4,1.25
8,2,umbrella,8,573,0,8,6.25
8,2,under,5,574,1,4,1.5
8,2,unit,4,575,2,2,1
8,2,unless,6,576,2,4,5.25
8,2,unlikely,8,577,3,5,1.75
8,2,upwards,7,578,1,6,1.75
8,2,us,2,579,1,1,0.5
8,2,vehicle,7,580,0,7,6
8,2,very,4,581,2,2,0.75
8,2,vicious,7,582,1,6,5.75
8,2,violate,7,583,2,5,2
8,2,volume,6,584,1,5,1.5
8,2,vote,4,585,2,2,0.75
8,2,ward,4,586,0,4,5.25
8,2,warfare,7,587,3,4,2.25
8,2,warm,4,588,3,1,1
8,2,wash,4,589,2,2,1.75
8,2,we,2,590,1,1,1
8,2,weak,4,591,2,2,1.5
8,2,wear,4,592,3,1,7.75
8,2,web,3,593,2,1,1
8,2,week,4,594,2,2,1.75
8,2,well,4,595,2,2,1.75
8,2,wet,3,596,2,1,1
8,2,what,4,597,1,3,2
8,2,when,4,598,2,2,1.75
8,2,while,5,599,2,3,10.5
8,2,whilst,6,600,4,2,2.25
8,2,whisper,7,601,3,4,3.25
8,2,who,3,602,2,1,1
8,2,wide,4,603,1,3,2
8,2,widely,6,604,4,2,8.25
8,2,winner,6,605,2,4,3.75
8,2,wish,4,606,2,2,1.5
8,2,wooden,6,607,1,5,3.5
8,2,worst,5,608,2,3,9.25
8,2,writing,7,609,1,6,4.25
8,2,wrong,5,610,2,3,2.5
8,2,you,3,611,0,3,2.25
8,2,yours,5,612,3,2,8.25
8,2,yourself,8,613,5,3,2.5
8,2,zero,4,614,0,4,2.5
8,2,zone,4,615,1,3,2.25
8,3,abortion,8,0,0,8,5
8,3,about,5,1,3,2,1.75
8,3,above,5,2,3,2,2.25
8,3,absent,6,3,2,4,10
8,3,academy,7,4,1,6,4
8,3,account,7,5,2,5,10.5
8,3,accuracy,8,6,3,5,3.75
8,3,acquire,7,7,2,5,3.5
8,3,act,3,8,2,1,1
8,3,addition,8,9,1,7,11
8,3,adhere,6,10,2,4,3
8,3,advanced,8,11,2,6,10.75
8,3,afford,6,12,1,5,3.5
8,3,afraid,6,13,2,4,3
8,3,ah,2,14,1,1,0.75
8,3,aid,3,15,1,2,7.75
8,3,air,3,16,2,1,1
8,3,aircraft,8,17,3,5,3.5
8,3,alert,5,18,1,4,2.75
8,3,alien,5,19,2,3,9
8,3,alike,5,20,3,2,2
8,3,all,3,21,2,1,1
8,3,allege,6,22,3,3,2.5
8,3,alliance,8,23,3,5,3.5
8,3,allow,5,24,3,2,8.25
8,3,along,5,25,2,3,2.25
8,3,also,4,26,2,2,1.75
8,3,although,8,27,2,6,4.25
8,3,angel,5,28,1,4,9
8,3,angry,5,29,3,2,1.75
8,3,answer,6,30,2,4,3
8,3,apply,5,31,1,4,2.75
8,3,archive,7,32,1,6,10.75
8,3,arena,5,33,2,3,2.25
8,3,arrival,7,34,2,5,3.5
8,3,article,7,35,2,5,10.25
8,3,assess,6,36,1,5,3.25
8,3,asset,5,37,4,1,1.25
8,3,assign,6,38,3,3,2.5
8,3,attach,6,39,1,5,9.75
8,3,attorney,8,40,3,5,3.75
8,3,august,6,41,1,5,11.75
8,3,aware,5,42,1,4,2.75
8,3,away,4,43,3,1,1.25
8,3,bad,3,44,0,3,2
8,3,bare,4,45,2,2,1.5
8,3,barrier,7,46,3,4,9.5
8,3,basket,6,47,2,4,3
8,3,bear,4,48,1,3,2
8,3,because,7,49,2,5,10
8,3,bee,3,50,2,1,1
8,3,before,6,51,2,4,2.75
8,3,bend,4,52,2,2,1.5
8,3,beneath,7,53,3,4,3
8,3,beside,6,54,2,4,9.25
8,3,bet,3,55,2,1,1
8,3,bias,4,56,1,3,2.25
8,3,bicycle,7,57,2,5,3.5
8,3,big,3,58,2,1,1
8,3,biology,7,59,2,5,10.5
8,3,blanket,7,60,1,6,4
8,3,bleed,5,61,2,3,2.25
8,3,blend,5,62,3,2,12.25
8,3,body,4,63,1,3,2.25
8,3,booking,7,64,2,5,3.5
8,3,boring,6,65,2,4,3
8,3,brain,5,66,1,4,9.25
8,3,breath,6,67,2,4,3
8,3,briefly,7,68,2,5,3.5
8,3,bring,5,69,3,2,8.5
8,3,broadly,7,70,2,5,3.5
8,3,buck,4,71,1,3,2
8,3,bulk,4,72,2,2,1.75
8,3,burst,5,73,2,3,8.75
8,3,bus,3,74,2,1,1
8,3,bye,3,75,1,2,1.5
8,3,cabinet,7,76,0,7,4.5
8,3,calm,4,77,2,2,1.75
8,3,camp,4,78,2,2,8.25
8,3,captain,7,79,2,5,3.5
8,3,capture,7,80,4,3,2.5
8,3,carriage,8,81,2,6,10.5
8,3,carrot,6,82,4,2,2
8,3,castle,6,83,2,4,2.75
8,3,cat,3,84,2,1,1
8,3,catch,5,85,3,2,2
8,3,cattle,6,86,3,3,9.25
8,3,cause,5,87,2,3,2.25
8,3,caution,7,88,3,4,3
8,3,chaos,5,89,1,4,2.75
8,3,chat,4,90,3,1,1.25
8,3,cheek,5,91,2,3,8.75
8,3,chest,5,92,3,2,2
8,3,class,5,93,1,4,2.75
8,3,classic,7,94,5,2,1.75
8,3,classify,8,95,6,2,1.75
8,3,climate,7,96,2,5,10
8,3,cling,5,97,3,2,1.75
8,3,clip,4,98,3,1,1.25
8,3,clock,5,99,2,3,2.25
8,3,closure,7,100,3,4,9.75
8,3,cloth,5,101,3,2,1.75
8,3,clue,4,102,2,2,2
8,3,coastal,7,103,1,6,4.75
8,3,collapse,8,104,2,6,12.25
8,3,college,7,105,4,3,2.5
8,3,coloured,8,106,3,5,3.75
8,3,combine,7,107,2,5,10.5
8,3,comic,5,108,3,2,1.75
8,3,commerce,8,109,3,5,3.75
8,3,complain,8,110,3,5,10.5
8,3,comprise,8,111,4,4,3.5
8,3,computer,8,112,4,4,4
8,3,conclude,8,113,2,6,14
8,3,confirm,7,114,3,4,3.5
8,3,confuse,7,115,4,3,3
8,3,consumer,8,116,3,5,10.75
8,3,context,7,117,3,4,3.25
8,3,continue,8,118,4,4,3.25
8,3,contract,8,119,4,4,3.25
8,3,cooking,7,120,2,5,10.25
8,3,copy,4,121,2,2,1.5
8,3,corrupt,7,122,2,5,3.5
8,3,costume,7,123,2,5,10.75
8,3,cotton,6,124,2,4,2.75
8,3,courage,7,125,2,5,3.5
8,3,covered,7,126,2,5,10.25
8,3,crack,5,127,1,4,2.75
8,3,crash,5,128,3,2,1.75
8,3,creative,8,129,2,6,10.75
8,3,creator,7,130,5,2,2.25
8,3,critical,8,131,2,6,4.25
8,3,crystal,7,132,2,5,10.75
8,3,cue,3,133,1,2,1.5
8,3,cure,4,134,2,2,1.75
8,3,custody,7,135,2,5,3.5
8,3,dad,3,136,0,3,8.75
8,3,dark,4,137,2,2,1.75
8,3,data,4,138,2,2,1.75
8,3,database,8,139,4,4,3
8,3,daughter,8,140,2,6,10.75
8,3,debate,6,141,1,5,3.25
8,3,debris,6,142,3,3,2.5
8,3,decision,8,143,2,6,8.25
8,3,deck,4,144,3,1,0.75
8,3,decorate,8,145,3,5,1.75
8,3,defeat,6,146,2,4,1.25
8,3,define,6,147,3,3,5.25
8,3,defy,4,148,3,1,0.5
8,3,descend,7,149,2,5,1.75
8,3,destroy,7,150,3,4,1.5
8,3,dialogue,8,151,1,7,6.5
8,3,dilemma,7,152,2,5,1.75
8,3,dip,3,153,2,1,0.5
8,3,discard,7,154,2,5,6.25
8,3,disease,7,155,3,4,1.75
8,3,dispose,7,156,3,4,1.75
8,3,distinct,8,157,3,5,7
8,3,distract,8,158,4,4,1.75
8,3,disturb,7,159,4,3,1.25
8,3,diverse,7,160,2,5,6
8,3,divert,6,161,5,1,0.75
8,3,divorce,7,162,3,4,1.5
8,3,dog,3,163,1,2,0.75
8,3,dominate,8,164,2,6,2
8,3,donate,6,165,2,4,6
8,3,donor,5,166,3,2,1
8,3,dozen,5,167,2,3,1
8,3,dramatic,8,168,1,7,6.5
8,3,dress,5,169,2,3,1
8,3,driver,6,170,2,4,1.25
8,3,drown,5,171,2,3,1
8,3,drug,4,172,2,2,5
8,3,dry,3,173,2,1,0.5
8,3,due,3,174,1,2,0.75
8,3,dump,4,175,2,2,0.75
8,3,during,6,176,2,4,1.25
8,3,eastern,7,177,0,7,6.5
8,3,easy,4,178,3,1,0.5
8,3,echo,4,179,1,3,1
8,3,economy,7,180,2,5,1.5
8,3,edge,4,181,1,3,5.25
8,3,election,8,182,1,7,2
8,3,electric,8,183,5,3,1.5
8,3,element,7,184,3,4,6
8,3,elevate,7,185,3,4,1.5
8,3,embed,5,186,1,4,1.25
8,3,empire,6,187,2,4,6
8,3,employ,6,188,3,3,1.25
8,3,empty,5,189,3,2,1
8,3,endorse,7,190,1,6,2
8,3,energy,6,191,2,4,5.5
8,3,enrol,5,192,2,3,1
8,3,ensue,5,193,2,3,1
8,3,entity,6,194,2,4,1.25
8,3,epidemic,8,195,1,7,6.5
8,3,equal,5,196,1,4,1.25
8,3,equation,8,197,4,4,5.75
8,3,error,5,198,1,4,1.25
8,3,eternal,7,199,1,6,1.75
8,3,ethic,5,200,2,3,5.5
8,3,every,5,201,1,4,1.25
8,3,evolve,6,202,2,4,1.5
8,3,exam,4,203,1,3,1
8,3,excess,6,204,2,4,6
8,3,exert,5,205,2,3,1.25
8,3,explicit,8,206,2,6,2
8,3,exposure,8,207,3,5,6.5
8,3,external,8,208,2,6,2
8,3,extract,7,209,3,4,1.5
8,3,fabulous,8,210,0,8,9.75
8,3,faction,7,211,2,5,2
8,3,factory,7,212,4,3,7.25
8,3,fairness,8,213,2,6,2
8,3,faith,5,214,3,2,1
8,3,farm,4,215,2,2,0.75
8,3,feather,7,216,1,6,6.75
8,3,feed,4,217,2,2,0.75
8,3,feedback,8,218,4,4,1.5
8,3,feeling,7,219,3,4,5.75
8,3,fence,5,220,2,3,1.25
8,3,festival,8,221,2,6,2
8,3,fifth,5,222,1,4,6
8,3,figure,6,223,2,4,1.25
8,3,fill,4,224,2,2,0.75
8,3,filter,6,225,3,3,1
8,3,finish,6,226,2,4,3.5
8,3,fire,4,227,2,2,3.25
8,3,firearm,7,228,4,3,1.25
8,3,firework,8,229,4,4,1.25
8,3,first,5,230,3,2,0.75
8,3,flash,5,231,1,4,5.5
8,3,flaw,4,232,3,1,0.5
8,3,fleet,5,233,2,3,1
8,3,flood,5,234,2,3,1
8,3,flour,5,235,3,2,0.75
8,3,fold,4,236,1,3,5.25
8,3,forecast,8,237,2,6,2
8,3,forgive,7,238,3,4,1.5
8,3,formal,6,239,3,3,5.5
8,3,format,6,240,5,1,1
8,3,forum,5,241,3,2,0.75
8,3,frame,5,242,1,4,1.25
8,3,frankly,7,243,3,4,1.5
8,3,freeze,6,244,2,4,6.25
8,3,fun,3,245,1,2,0.75
8,3,function,8,246,3,5,1.75
8,3,fund,4,247,3,1,0.5
8,3,gambling,8,248,0,8,6.75
8,3,garden,6,249,2,4,1.5
8,3,gas,3,250,2,1,0.5
8,3,generic,7,251,1,6,6.5
8,3,gentle,6,252,3,3,1.25
8,3,genuine,7,253,3,4,1.5
8,3,get,3,254,2,1,0.5
8,3,ghost,5,255,1,4,5.75
8,3,glad,4,256,1,3,1
8,3,goal,4,257,1,3,1
8,3,golden,6,258,2,4,1.25
8,3,gorgeous,8,259,2,6,7.5
8,3,graduate,8,260,1,7,2.5
8,3,great,5,261,2,3,1.25
8,3,guard,5,262,1,4,6.75
8,3,hand,4,263,0,4,1.75
8,3,happy,5,264,2,3,1.5
8,3,harmony,7,265,2,5,7.25
8,3,he,2,266,1,1,0.5
8,3,hide,4,267,1,3,1.25
8,3,highway,7,268,2,5,2
8,3,himself,7,269,2,5,7.5
8,3,hockey,6,270,1,5,1.75
8,3,holy,4,271,2,2,1
8,3,homework,8,272,2,6,7.25
8,3,host,4,273,2,2,1
8,3,house,5,274,2,3,1.25
8,3,hungry,6,275,1,5,1.75
8,3,ideology,8,276,0,8,8.5
8,3,ignore,6,277,1,5,2
8,3,immense,7,278,1,6,7.5
8,3,imminent,8,279,3,5,2
8,3,impact,6,280,2,4,2.25
8,3,impress,7,281,3,4,8
8,3,in,2,282,1,1,0.5
8,3,increase,8,283,2,6,2.5
8,3,indulge,7,284,2,5,7.5
8,3,infect,6,285,2,4,1.5
8,3,initial,7,286,2,5,1.75
8,3,insight,7,287,2,5,6.75
8,3,interact,8,288,2,6,2.25
8,3,july,4,289,0,4,1.25
8,3,justice,7,290,2,5,6.25
8,3,keen,4,291,0,4,1.25
8,3,kidnap,6,292,1,5,1.75
8,3,kill,4,293,2,2,5.75
8,3,knock,5,294,1,4,1.25
8,3,labour,6,295,0,6,1.75
8,3,ladder,6,296,2,4,10.5
8,3,lady,4,297,3,1,854
8,3,lamp,4,298,2,2,1
8,3,lane,4,299,2,2,1
8,3,laptop,6,300,2,4,1.75
8,3,late,4,301,2,2,1
8,3,lately,6,302,4,2,1
8,3,lead,4,303,1,3,6.75
8,3,leap,4,304,3,1,0.75
8,3,learn,5,305,3,2,1
8,3,leave,5,306,3,2,1
8,3,legacy,6,307,2,4,1.75
8,3,legal,5,308,4,1,1
8,3,leisure,7,309,2,5,6.25
8,3,length,6,310,2,4,1.75
8,3,less,4,311,2,2,1
8,3,let,3,312,2,1,0.5
8,3,level,5,313,2,3,5.75
8,3,lifetime,8,314,1,7,2.75
8,3,likewise,8,315,2,6,2.75
8,3,limit,5,316,2,3,7.25
8,3,linger,6,317,2,4,2.25
8,3,listener,8,318,2,6,2.5
8,3,literacy,8,319,2,6,12.5
8,3,loop,4,320,1,3,2
8,3,lose,4,321,2,2,1.75
8,3,loss,4,322,3,1,1.5
8,3,lovely,6,323,2,4,13.5
8,3,luck,4,324,1,3,1.75
8,3,lung,4,325,2,2,1.5
8,3,man,3,326,0,3,1.25
8,3,marriage,8,327,2,6,6.25
8,3,matching,8,328,2,6,2.25
8,3,maximize,8,329,2,6,5.25
8,3,me,2,330,1,1,0.5
8,3,meaning,7,331,2,5,1.5
8,3,means,5,332,4,1,0.5
8,3,measure,7,333,3,4,1.25
8,3,medicine,8,334,2,6,5.25
8,3,metal,5,335,2,3,1.25
8,3,metaphor,8,336,4,4,1.75
8,3,militant,8,337,1,7,5.75
8,3,mill,4,338,3,1,0.75
8,3,minimize,8,339,2,6,2
8,3,minority,8,340,3,5,5.25
8,3,minute,6,341,3,3,1.25
8,3,missile,7,342,2,5,1.5
8,3,modern,6,343,1,5,5
8,3,modest,6,344,4,2,1
8,3,momentum,8,345,2,6,2
8,3,mount,5,346,2,3,5
8,3,mountain,8,347,5,3,1.5
8,3,musical,7,348,1,6,2
8,3,mystery,7,349,1,6,6.25
8,3,native,6,350,0,6,2
8,3,nerve,5,351,1,4,1.5
8,3,nest,4,352,2,2,4.75
8,3,net,3,353,2,1,1
8,3,nod,3,354,1,2,0.75
8,3,nonsense,8,355,2,6,2
8,3,noon,4,356,2,2,1
8,3,notable,7,357,2,5,5.25
8,3,notably,7,358,6,1,0.75
8,3,now,3,359,2,1,0.5
8,3,nurse,5,360,1,4,1.25
8,3,nursing,7,361,4,3,1.25
8,3,o,1,362,0,1,4.5
8,3,observe,7,363,1,6,2
8,3,observer,8,364,7,1,0.75
8,3,obtain,6,365,2,4,1.5
8,3,obvious,7,366,2,5,5.25
8,3,of,2,367,1,1,0.5
8,3,offender,8,368,2,6,1.75
8,3,offer,5,369,4,1,0.75
8,3,onto,4,370,1,3,4.5
8,3,open,4,371,1,3,1
8,3,operator,8,372,3,5,1.5
8,3,opinion,7,373,2,5,5.25
8,3,oral,4,374,1,3,1
8,3,order,5,375,2,3,1
8,3,out,3,376,1,2,0.75
8,3,outrage,7,377,3,4,1.75
8,3,over,4,378,1,3,5.25
8,3,own,3,379,1,2,0.75
8,3,oxygen,6,380,1,5,1.5
8,3,packet,6,381,0,6,5.25
8,3,pair,4,382,2,2,0.75
8,3,paper,5,383,2,3,1
8,3,parent,6,384,2,4,1.25
8,3,parental,8,385,6,2,1
8,3,pass,4,386,2,2,4
8,3,passing,7,387,4,3,1.25
8,3,passion,7,388,5,2,1
8,3,peasant,7,389,1,6,1.75
8,3,people,6,390,2,4,5
8,3,period,6,391,2,4,1.25
8,3,physics,7,392,1,6,2
8,3,pilot,5,393,1,4,5.5
8,3,pitch,5,394,2,3,1.25
8,3,planet,6,395,1,5,1.5
8,3,plunge,6,396,2,4,6
8,3,pocket,6,397,1,5,1.5
8,3,pole,4,398,2,2,1
8,3,pool,4,399,2,2,1
8,3,pop,3,400,2,1,0.5
8,3,popular,7,401,3,4,5.75
8,3,powder,6,402,2,4,1.5
8,3,preach,6,403,1,5,1.75
8,3,prefer,6,404,3,3,5.25
8,3,pretty,6,405,3,3,1.25
8,3,prevent,7,406,3,4,1.5
8,3,previous,8,407,4,4,1.5
8,3,pride,5,408,2,3,5.25
8,3,priest,6,409,3,3,1.25
8,3,princess,8,410,3,5,1.75
8,3,prisoner,8,411,3,5,5.75
8,3,probable,8,412,2,6,1.75
8,3,probably,8,413,7,1,0.75
8,3,protect,7,414,3,4,1.5
8,3,protein,7,415,5,2,5.25
8,3,protocol,8,416,4,4,1.75
8,3,province,8,417,3,5,1.75
8,3,provoke,7,418,4,3,1.25
8,3,purchase,8,419,1,7,6.25
8,3,pursue,6,420,3,3,1.25
8,3,qualify,7,421,0,7,6
8,3,question,8,422,2,6,2
8,3,quietly,7,423,2,5,5.75
8,3,quota,5,424,2,3,1.25
8,3,random,6,425,0,6,1.75
8,3,rapid,5,426,2,3,1
8,3,raw,3,427,2,1,0.5
8,3,read,4,428,1,3,5
8,3,readily,7,429,4,3,1.25
8,3,reading,7,430,5,2,1
8,3,realize,7,431,3,4,1.5
8,3,receive,7,432,2,5,5.25
8,3,receiver,8,433,7,1,1
8,3,recipe,6,434,3,3,1.25
8,3,recovery,8,435,3,5,1.75
8,3,refuge,6,436,2,4,4.75
8,3,refugee,7,437,6,1,0.75
8,3,register,8,438,2,6,1.75
8,3,regret,6,439,3,3,1
8,3,release,7,440,2,5,5.25
8,3,reliable,8,441,3,5,1.75
8,3,remains,7,442,2,5,5
8,3,remember,8,443,3,5,1.75
8,3,renowned,8,444,2,6,1.75
8,3,reporter,8,445,2,6,5.5
8,3,request,7,446,2,5,1.5
8,3,respect,7,447,2,5,5
8,3,response,8,448,4,4,1.5
8,3,result,6,449,3,3,1.25
8,3,resume,6,450,4,2,1
8,3,retreat,7,451,2,5,5.25
8,3,review,6,452,2,4,1.25
8,3,rhythm,6,453,1,5,1.5
8,3,rice,4,454,1,3,4.75
8,3,rid,3,455,2,1,0.5
8,3,rock,4,456,1,3,1
8,3,route,5,457,2,3,1.25
8,3,run,3,458,1,2,0.75
8,3,runner,6,459,3,3,1
8,3,sail,4,460,0,4,5.25
8,3,sanction,8,461,2,6,2
8,3,sandwich,8,462,3,5,5.5
8,3,say,3,463,2,1,0.5
8,3,scratch,7,464,1,6,1.75
8,3,scream,6,465,3,3,1.25
8,3,sea,3,466,1,2,0.75
8,3,see,3,467,2,1,4.75
8,3,seize,5,468,2,3,1.5
8,3,self,4,469,2,2,1
8,3,senator,7,470,2,5,2
8,3,senior,6,471,3,3,6.5
8,3,session,7,472,2,5,2
8,3,seventy,7,473,2,5,2.25
8,3,several,7,474,4,3,1.5
8,3,sex,3,475,2,1,4.5
8,3,shade,5,476,1,4,1.25
8,3,shall,5,477,3,2,1
8,3,sheet,5,478,2,3,1
8,3,shine,5,479,2,3,1.25
8,3,shock,5,480,2,3,5.5
8,3,short,5,481,3,2,1
8,3,should,6,482,3,3,1.25
8,3,shout,5,483,4,1,0.75
8,3,show,4,484,3,1,0.75
8,3,shrink,6,485,2,4,5.75
8,3,shrug,5,486,3,2,1.25
8,3,silence,7,487,1,6,1.75
8,3,silent,6,488,5,1,0.5
8,3,sincere,7,489,2,5,5.25
8,3,sing,4,490,3,1,0.5
8,3,sixty,5,491,2,3,1
8,3,skiing,6,492,1,5,1.5
8,3,slave,5,493,1,4,8.5
8,3,slogan,6,494,2,4,3.5
8,3,slot,4,495,3,1,1.25
8,3,slow,4,496,3,1,1.25
8,3,small,5,497,1,4,3
8,3,soak,4,498,1,3,8
8,3,soar,4,499,3,1,1.25
8,3,soccer,6,500,2,4,3
8,3,society,7,501,3,4,3
8,3,soft,4,502,2,2,1.5
8,3,solely,6,503,2,4,8.75
8,3,somebody,8,504,2,6,4.25
8,3,soon,4,505,2,2,1.75
8,3,sorry,5,506,2,3,2.25
8,3,sort,4,507,3,1,8
8,3,source,6,508,2,4,3
8,3,spending,8,509,1,7,4.5
8,3,spicy,5,510,2,3,8.5
8,3,spill,5,511,3,2,2
8,3,split,5,512,2,3,2.25
8,3,spoil,5,513,2,3,2.25
8,3,spot,4,514,3,1,1
8,3,stadium,7,515,1,6,10
8,3,stage,5,516,3,2,1.75
8,3,stark,5,517,3,2,1.75
8,3,station,7,518,3,4,2.75
8,3,stress,6,519,2,4,8.75
8,3,strive,6,520,3,3,2.5
8,3,stunning,8,521,2,6,4
8,3,style,5,522,2,3,8.25
8,3,suburb,6,523,1,5,3.5
8,3,suburban,8,524,6,2,2
8,3,success,7,525,2,5,3.5
8,3,sum,3,526,2,1,1
8,3,summer,6,527,3,3,9.5
8,3,supply,6,528,2,4,2.75
8,3,suppress,8,529,4,4,3
8,3,surge,5,530,2,3,8.25
8,3,survive,7,531,3,4,3
8,3,swimming,8,532,1,7,4.5
8,3,swing,5,533,3,2,1.75
8,3,teenage,7,534,0,7,10.25
8,3,tennis,6,535,2,4,3
8,3,terrain,7,536,2,5,10
8,3,terrible,8,537,4,4,3.25
8,3,testify,7,538,2,5,3.5
8,3,testing,7,539,5,2,2
8,3,that,4,540,1,3,8.25
8,3,theatre,7,541,2,5,3.5
8,3,theft,5,542,3,2,1.75
8,3,theirs,6,543,3,3,2.25
8,3,they,4,544,3,1,7.25
8,3,thief,5,545,2,3,2.25
8,3,thing,5,546,3,2,1.75
8,3,think,5,547,4,1,1.25
8,3,third,5,548,3,2,2
8,3,threaten,8,549,2,6,10.25
8,3,throw,5,550,3,2,2
8,3,thursday,8,551,2,6,4
8,3,tobacco,7,552,1,6,10
8,3,tone,4,553,2,2,1.75
8,3,total,5,554,2,3,2.5
8,3,towards,7,555,2,5,3.75
8,3,towel,5,556,3,2,8.5
8,3,trace,5,557,1,4,2.75
8,3,trading,7,558,3,4,3
8,3,transfer,8,559,3,5,9.5
8,3,tribunal,8,560,2,6,4.25
8,3,trillion,8,561,3,5,3.75
8,3,true,4,562,2,2,1.5
8,3,trust,5,563,3,2,8
8,3,trustee,7,564,5,2,2
8,3,try,3,565,2,1,1
8,3,tunnel,6,566,1,5,3.25
8,3,turn,4,567,2,2,1.75
8,3,twenty,6,568,1,5,9.5
8,3,type,4,569,1,3,2.25
8,3,ugly,4,570,0,4,2.5
8,3,under,5,571,1,4,9
8,3,unfold,6,572,2,4,3
8,3,unless,6,573,2,4,3
8,3,unlike,6,574,3,3,2.5
8,3,unlikely,8,575,6,2,8.5
8,3,up,2,576,1,1,0.75
8,3,upper,5,577,2,3,2
8,3,upset,5,578,2,3,2
8,3,used,4,579,1,3,2
8,3,user,4,580,3,1,1
8,3,valid,5,581,0,5,9.25
8,3,versus,6,582,1,5,3.5
8,3,very,4,583,3,1,1.25
8,3,vicious,7,584,1,6,10.25
8,3,victim,6,585,3,3,2.75
8,3,vitamin,7,586,2,5,3.5
8,3,vote,4,587,1,3,2
8,3,wage,4,588,0,4,8.75
8,3,wall,4,589,2,2,1.75
8,3,ward,4,590,2,2,1.75
8,3,wash,4,591,2,2,1.75
8,3,wear,4,592,1,3,2
8,3,web,3,593,2,1,7.5
8,3,wedding,7,594,2,5,3.75
8,3,well,4,595,2,2,1.75
8,3,wet,3,596,2,1,1
8,3,what,4,597,1,3,2
8,3,where,5,598,2,3,8.75
8,3,while,5,599,2,3,2.25
8,3,whisper,7,600,3,4,3.25
8,3,wholly,6,601,2,4,3
8,3,wide,4,602,1,3,8.75
8,3,widely,6,603,4,2,1.75
8,3,winner,6,604,2,4,2.75
8,3,winter,6,605,3,3,2.5
8,3,wish,4,606,2,2,1.75
8,3,wooden,6,607,1,5,9.75
8,3,worse,5,608,2,3,2.25
8,3,worst,5,609,4,1,1.25
8,3,wound,5,610,2,3,2.25
8,3,writer,6,611,1,5,9.75
8,3,wrong,5,612,2,3,2.25
8,3,year,4,613,0,4,2.5
8,3,yours,5,614,1,4,9.25
8,3,yourself,8,615,5,3,2.75
8,4,able,4,0,0,4,2.5
8,4,abolish,7,1,2,5,10.5
8,4,abortion,8,2,3,5,4
8,4,abroad,6,3,2,4,2.75
8,4,abstract,8,4,2,6,10.5
8,4,academy,7,5,1,6,4
8,4,account,7,6,2,5,10
8,4,acquire,7,7,2,5,3.5
8,4,action,6,8,2,4,2.75
8,4,advance,7,9,1,6,10.5
8,4,alert,5,10,1,4,2.75
8,4,all,3,11,2,1,1
8,4,alone,5,12,2,3,2.25
8,4,along,5,13,4,1,1.25
8,4,also,4,14,2,2,7.75
8,4,although,8,15,2,6,4
8,4,amid,4,16,1,3,2
8,4,angel,5,17,1,4,2.75
8,4,answer,6,18,2,4,10.25
8,4,anyone,6,19,2,4,3
8,4,arena,5,20,1,4,2.75
8,4,armed,5,21,2,3,8.75
8,4,arrival,7,22,2,5,3.5
8,4,athlete,7,23,1,6,4
8,4,attack,6,24,2,4,9.5
8,4,attend,6,25,3,3,2.5
8,4,attorney,8,26,3,5,3.75
8,4,audience,8,27,1,7,11.25
8,4,audit,5,28,4,1,1.25
8,4,august,6,29,2,4,2.75
8,4,author,6,30,2,4,2.75
8,4,away,4,31,1,3,8.75
8,4,back,4,32,0,4,2.75
8,4,backdrop,8,33,4,4,2.75
8,4,bad,3,34,2,1,1
8,4,banana,6,35,2,4,9.5
8,4,bank,4,36,3,1,1.25
8,4,barrier,7,37,2,5,3.75
8,4,basis,5,38,2,3,2.5
8,4,bear,4,39,1,3,8.5
8,4,because,7,40,2,5,3.5
8,4,bee,3,41,2,1,1
8,4,before,6,42,2,4,2.75
8,4,behind,6,43,2,4,9.25
8,4,bend,4,44,2,2,1.5
8,4,beneath,7,45,3,4,3
8,4,bias,4,46,1,3,2
8,4,bicycle,7,47,2,5,9.75
8,4,big,3,48,2,1,1
8,4,blast,5,49,1,4,2.75
8,4,blessing,8,50,2,6,10.5
8,4,bond,4,51,1,3,2.25
8,4,bonus,5,52,3,2,1.75
8,4,boring,6,53,2,4,3
8,4,born,4,54,3,1,1.25
8,4,brain,5,55,1,4,10.25
8,4,branch,6,56,3,3,1.75
8,4,brick,5,57,2,3,1.75
8,4,briefly,7,58,3,4,2
8,4,brother,7,59,2,5,6.75
8,4,buck,4,60,1,3,1
8,4,building,8,61,2,6,2
8,4,bulk,4,62,2,2,1
8,4,bus,3,63,2,1,4.25
8,4,button,6,64,2,4,1.25
8,4,cabin,5,65,0,5,1.5
8,4,calm,4,66,2,2,0.75
8,4,camp,4,67,2,2,4.75
8,4,carrot,6,68,2,4,1.25
8,4,case,4,69,2,2,0.75
8,4,cattle,6,70,2,4,1.25
8,4,cause,5,71,2,3,5
8,4,cautious,8,72,3,5,1.75
8,4,cent,4,73,1,3,1
8,4,centre,6,74,4,2,0.75
8,4,chaos,5,75,1,4,5.5
8,4,chat,4,76,3,1,0.75
8,4,chest,5,77,2,3,1.25
8,4,cinema,6,78,1,5,1.5
8,4,clarify,7,79,1,6,6
8,4,climb,5,80,2,3,1
8,4,cling,5,81,3,2,1
8,4,closure,7,82,2,5,1.5
8,4,cloth,5,83,3,2,4.75
8,4,clothing,8,84,5,3,1.5
8,4,clue,4,85,2,2,0.75
8,4,coast,5,86,1,4,1.25
8,4,cocktail,8,87,2,6,6
8,4,coin,4,88,2,2,0.75
8,4,collapse,8,89,2,6,1.75
8,4,college,7,90,4,3,5
8,4,combat,6,91,2,4,1.25
8,4,comic,5,92,3,2,1
8,4,commit,6,93,3,3,1
8,4,compare,7,94,3,4,5.25
8,4,complex,7,95,4,3,1.5
8,4,compose,7,96,4,3,1.25
8,4,comprise,8,97,4,4,1.5
8,4,computer,8,98,4,4,5.75
8,4,confirm,7,99,2,5,1.75
8,4,confuse,7,100,4,3,1.25
8,4,conserve,8,101,3,5,6.25
8,4,consume,7,102,4,3,1.25
8,4,contact,7,103,3,4,1.5
8,4,context,7,104,4,3,1.25
8,4,contract,8,105,4,4,5.75
8,4,convert,7,106,3,4,1.5
8,4,convict,7,107,4,3,1.25
8,4,cook,4,108,2,2,0.75
8,4,cooking,7,109,4,3,1
8,4,cool,4,110,3,1,4.75
8,4,corrupt,7,111,2,5,1.5
8,4,costume,7,112,2,5,1.5
8,4,cotton,6,113,2,4,5.25
8,4,council,7,114,2,5,1.5
8,4,courage,7,115,3,4,1.5
8,4,cow,3,116,2,1,0.5
8,4,crack,5,117,1,4,5.25
8,4,crash,5,118,3,2,1
8,4,crazy,5,119,3,2,1
8,4,cream,5,120,2,3,1
8,4,creator,7,121,4,3,1.25
8,4,crystal,7,122,2,5,6
8,4,cure,4,123,1,3,1
8,4,custody,7,124,2,5,1.5
8,4,custom,6,125,5,1,0.75
8,4,cutting,7,126,2,5,5.75
8,4,dancer,6,127,0,6,1.75
8,4,daughter,8,128,2,6,6.25
8,4,dead,4,129,1,3,1
8,4,dear,4,130,3,1,0.5
8,4,debate,6,131,2,4,1.25
8,4,debut,5,132,3,2,1
8,4,deck,4,133,2,2,5
8,4,decorate,8,134,3,5,1.75
8,4,defend,6,135,2,4,1.25
8,4,define,6,136,3,3,1
8,4,defy,4,137,3,1,4.75
8,4,delivery,8,138,2,6,2
8,4,derive,6,139,2,4,1.25
8,4,desert,6,140,2,4,6
8,4,desire,6,141,3,3,1.25
8,4,destroy,7,142,3,4,1.5
8,4,detail,6,143,2,4,1.25
8,4,devise,6,144,2,4,5.75
8,4,differ,6,145,1,5,1.5
8,4,directly,8,146,2,6,6.5
8,4,disagree,8,147,2,6,2
8,4,discard,7,148,3,4,1.5
8,4,disease,7,149,3,4,6
8,4,disorder,8,150,3,5,1.75
8,4,dispute,7,151,3,4,1.5
8,4,distance,8,152,3,5,6
8,4,disturb,7,153,4,3,1.5
8,4,divert,6,154,2,4,1.25
8,4,divorce,7,155,3,4,1.5
8,4,doctrine,8,156,1,7,6.5
8,4,drag,4,157,1,3,1
8,4,drain,5,158,3,2,1
8,4,dramatic,8,159,3,5,10
8,4,draw,4,160,3,1,1.5
8,4,dress,5,161,2,3,3
8,4,drown,5,162,2,3,3.25
8,4,dry,3,163,2,1,1.5
8,4,due,3,164,1,2,1.75
8,4,during,6,165,2,4,10.75
8,4,duty,4,166,2,2,1.5
8,4,dynamic,7,167,1,6,4
8,4,each,4,168,0,4,9.5
8,4,early,5,169,2,3,2.25
8,4,easily,6,170,2,4,2.75
8,4,east,4,171,3,1,1.25
8,4,eastern,7,172,4,3,2.5
8,4,educated,8,173,1,7,11.25
8,4,educator,8,174,6,2,2
8,4,electric,8,175,1,7,11.25
8,4,embed,5,176,1,4,2.75
8,4,emerge,6,177,2,4,3
8,4,empire,6,178,2,4,9.75
8,4,energy,6,179,1,5,3.25
8,4,enough,6,180,2,4,3
8,4,enquire,7,181,2,5,10.5
8,4,entity,6,182,2,4,3
8,4,equation,8,183,1,7,4.5
8,4,erupt,5,184,1,4,10.25
8,4,escalate,8,185,1,7,4.75
8,4,eternal,7,186,1,6,11
8,4,every,5,187,1,4,2.75
8,4,everyday,8,188,5,3,2.25
8,4,evolve,6,189,2,4,3
8,4,exam,4,190,1,3,9
8,4,example,7,191,4,3,2.5
8,4,except,6,192,2,4,3
8,4,exotic,6,193,2,4,9.75
8,4,exposure,8,194,2,6,4.25
8,4,external,8,195,2,6,4
8,4,fabulous,8,196,0,8,11.75
8,4,facility,8,197,2,6,4.25
8,4,fact,4,198,3,1,8.5
8,4,factor,6,199,4,2,2.25
8,4,familiar,8,200,2,6,4
8,4,farm,4,201,2,2,1.5
8,4,feed,4,202,1,3,2
8,4,feedback,8,203,4,4,10.5
8,4,feel,4,204,3,1,1.25
8,4,feeling,7,205,4,3,2.5
8,4,fence,5,206,2,3,2.25
8,4,fifth,5,207,1,4,9.5
8,4,figure,6,208,2,4,3
8,4,film,4,209,2,2,1.75
8,4,final,5,210,2,3,2.25
8,4,finger,6,211,3,3,10
8,4,finish,6,212,3,3,2.75
8,4,first,5,213,2,3,2.25
8,4,fish,4,214,2,2,1.5
8,4,fishing,7,215,4,3,2.5
8,4,fit,3,216,2,1,1
8,4,five,4,217,2,2,10
8,4,flame,5,218,1,4,3.5
8,4,flash,5,219,3,2,2.25
8,4,flaw,4,220,3,1,1.5
8,4,fleet,5,221,2,3,3.75
8,4,flood,5,222,2,3,11.75
8,4,follow,6,223,1,5,4
8,4,fool,4,224,2,2,2.25
8,4,forecast,8,225,2,6,12.25
8,4,forest,6,226,4,2,2.25
8,4,fork,4,227,3,1,1.25
8,4,formal,6,228,3,3,2.5
8,4,forum,5,229,3,2,2
8,4,frame,5,230,1,4,2.75
8,4,freeze,6,231,2,4,10
8,4,from,4,232,2,2,1.75
8,4,fruit,5,233,2,3,2.25
8,4,function,8,234,1,7,12
8,4,funny,5,235,3,2,1.75
8,4,furious,7,236,2,5,3.5
8,4,gang,4,237,0,4,2.5
8,4,genuine,7,238,1,6,11.5
8,4,get,3,239,2,1,1
8,4,glad,4,240,1,3,2
8,4,goal,4,241,1,3,2
8,4,goods,5,242,2,3,9.5
8,4,gorgeous,8,243,2,6,4.25
8,4,grain,5,244,1,4,2.75
8,4,grant,5,245,3,2,9.25
8,4,guard,5,246,1,4,2.75
8,4,hardly,6,247,0,6,3.75
8,4,harmful,7,248,3,4,10.25
8,4,harmony,7,249,4,3,2.75
8,4,he,2,250,1,1,0.75
8,4,hear,4,251,2,2,1.5
8,4,hearing,7,252,4,3,2.5
8,4,heating,7,253,3,4,10
8,4,hello,5,254,2,3,2.5
8,4,helmet,6,255,3,3,2.75
8,4,help,4,256,3,1,1.25
8,4,hero,4,257,2,2,1.5
8,4,hidden,6,258,1,5,10.5
8,4,highway,7,259,2,5,3.5
8,4,himself,7,260,2,5,3.5
8,4,history,7,261,2,5,10.75
8,4,hockey,6,262,1,5,3.25
8,4,hold,4,263,2,2,1.75
8,4,holy,4,264,3,1,1.25
8,4,homework,8,265,2,6,11.5
8,4,honour,6,266,2,4,3
8,4,horizon,7,267,2,5,3.5
8,4,housing,7,268,2,5,7.25
8,4,hungry,6,269,1,5,1.5
8,4,hurry,5,270,2,3,1.25
8,4,husband,7,271,2,5,7
8,4,if,2,272,0,2,0.75
8,4,imagine,7,273,1,6,2.25
8,4,immense,7,274,2,5,7.5
8,4,impact,6,275,2,4,1.75
8,4,impress,7,276,3,4,1.75
8,4,inclined,8,277,1,7,7.5
8,4,indoors,7,278,2,5,1.75
8,4,induce,6,279,3,3,1.25
8,4,indulge,7,280,4,3,5.5
8,4,initial,7,281,2,5,1.5
8,4,innocent,8,282,2,6,1.75
8,4,insect,6,283,2,4,5.75
8,4,insight,7,284,3,4,1.5
8,4,insult,6,285,3,3,1
8,4,invasion,8,286,2,6,11.25
8,4,invent,6,287,3,3,657.25
8,4,invoke,6,288,3,3,3
8,4,jeans,5,289,0,5,3.75
8,4,joint,5,290,1,4,14.5
8,4,july,4,291,1,3,5.25
8,4,keen,4,292,0,4,3.25
8,4,knock,5,293,1,4,5.75
8,4,label,5,294,0,5,9.75
8,4,lamp,4,295,2,2,1.25
8,4,landing,7,296,2,5,3
8,4,laptop,6,297,2,4,8.5
8,4,lawsuit,7,298,2,5,3.75
8,4,lawyer,6,299,3,3,2.75
8,4,layout,6,300,2,4,3
8,4,leap,4,301,1,3,7.5
8,4,learn,5,302,3,2,2
8,4,leave,5,303,3,2,2
8,4,leisure,7,304,2,5,3
8,4,length,6,305,2,4,7.25
8,4,lesson,6,306,2,4,2
8,4,lifetime,8,307,1,7,3.25
8,4,light,5,308,2,3,6.75
8,4,limit,5,309,2,3,1
8,4,listener,8,310,2,6,1.75
8,4,loan,4,311,1,3,4.25
8,4,lobby,5,312,2,3,1.25
8,4,logo,4,313,2,2,0.75
8,4,loom,4,314,2,2,0.75
8,4,lord,4,315,2,2,0.75
8,4,lost,4,316,2,2,0.75
8,4,luck,4,317,1,3,4.5
8,4,magazine,8,318,0,8,2.5
8,4,magical,7,319,3,4,5.25
8,4,major,5,320,2,3,1
8,4,mall,4,321,2,2,0.75
8,4,man,3,322,2,1,0.5
8,4,manifest,8,323,3,5,1.5
8,4,marathon,8,324,2,6,5.5
8,4,marker,6,325,3,3,1.25
8,4,marry,5,326,3,2,1
8,4,meaning,7,327,1,6,6
8,4,measure,7,328,3,4,1.75
8,4,medical,7,329,2,5,1.75
8,4,medicine,8,330,5,3,4.75
8,4,meet,4,331,2,2,0.75
8,4,metal,5,332,2,3,1
8,4,mile,4,333,1,3,1
8,4,military,8,334,3,5,1.75
8,4,miner,5,335,2,3,4.75
8,4,minimize,8,336,3,5,1.75
8,4,mining,6,337,4,2,1
8,4,minute,6,338,3,3,1.25
8,4,missile,7,339,2,5,5
8,4,mode,4,340,1,3,1
8,4,modern,6,341,4,2,1
8,4,momentum,8,342,2,6,5.5
8,4,moral,5,343,2,3,1
8,4,morality,8,344,5,3,1.25
8,4,motive,6,345,2,4,1.25
8,4,motorist,8,346,3,5,5.25
8,4,mountain,8,347,2,6,1.75
8,4,movement,8,348,2,6,5.5
8,4,musical,7,349,1,6,2
8,4,neglect,7,350,0,7,5.5
8,4,nerve,5,351,2,3,1
8,4,nest,4,352,2,2,0.75
8,4,net,3,353,2,1,0.5
8,4,network,7,354,3,4,1.5
8,4,news,4,355,2,2,4
8,4,next,4,356,2,2,0.75
8,4,nineteen,8,357,1,7,2
8,4,noble,5,358,1,4,1.25
8,4,nod,3,359,2,1,4
8,4,nonsense,8,360,2,6,2
8,4,noon,4,361,2,2,0.75
8,4,notable,7,362,2,5,5
8,4,nowadays,8,363,2,6,2
8,4,obey,4,364,0,4,1.25
8,4,object,6,365,2,4,4.75
8,4,observe,7,366,2,5,1.75
8,4,obvious,7,367,2,5,1.5
8,4,occasion,8,368,1,7,5.5
8,4,of,2,369,1,1,0.25
8,4,offering,8,370,2,6,1.75
8,4,onion,5,371,1,4,4.5
8,4,open,4,372,1,3,1
8,4,or,2,373,1,1,0.5
8,4,oral,4,374,2,2,0.75
8,4,order,5,375,2,3,1.25
8,4,ordinary,8,376,3,5,5.75
8,4,outrage,7,377,1,6,2
8,4,over,4,378,1,3,1
8,4,overseas,8,379,4,4,6
8,4,own,3,380,1,2,0.75
8,4,owner,5,381,3,2,0.75
8,4,oxygen,6,382,1,5,2
8,4,palm,4,383,0,4,5.25
8,4,pan,3,384,2,1,0.5
8,4,paper,5,385,2,3,1.25
8,4,parent,6,386,2,4,1.75
8,4,partly,6,387,3,3,1.25
8,4,party,5,388,4,1,4.5
8,4,pass,4,389,2,2,0.75
8,4,passing,7,390,4,3,1.25
8,4,payment,7,391,2,5,1.75
8,4,pension,7,392,1,6,5.25
8,4,period,6,393,2,4,1.5
8,4,person,6,394,3,3,1.25
8,4,petition,8,395,2,6,5.5
8,4,physics,7,396,1,6,2
8,4,pit,3,397,1,2,0.75
8,4,pitch,5,398,3,2,0.75
8,4,planet,6,399,1,5,5
8,4,plate,5,400,3,2,1
8,4,pleasure,8,401,2,6,2
8,4,plunge,6,402,2,4,5
8,4,pocket,6,403,1,5,1.5
8,4,poet,4,404,2,2,0.75
8,4,policy,6,405,2,4,5
8,4,pop,3,406,2,1,0.5
8,4,popular,7,407,3,4,1.5
8,4,port,4,408,2,2,0.75
8,4,positive,8,409,2,6,5.5
8,4,powder,6,410,2,4,1.5
8,4,pray,4,411,1,3,1
8,4,preach,6,412,2,4,1.25
8,4,premium,7,413,3,4,5
8,4,prepare,7,414,3,4,1.5
8,4,pretty,6,415,3,3,1
8,4,previous,8,416,3,5,5.25
8,4,prince,6,417,2,4,1.25
8,4,princess,8,418,6,2,0.75
8,4,prison,6,419,3,3,1
8,4,prisoner,8,420,6,2,1
8,4,proceed,7,421,2,5,5.5
8,4,promote,7,422,3,4,1.5
8,4,protect,7,423,3,4,1.5
8,4,protocol,8,424,4,4,5
8,4,provide,7,425,3,4,1.5
8,4,province,8,426,5,3,1.25
8,4,punch,5,427,1,4,1.25
8,4,purchase,8,428,2,6,5.25
8,4,purely,6,429,3,3,1
8,4,purple,6,430,3,3,1
8,4,quarter,7,431,0,7,5.5
8,4,queen,5,432,2,3,1
8,4,queue,5,433,3,2,1
8,4,quickly,7,434,2,5,5
8,4,quota,5,435,2,3,1
8,4,radio,5,436,0,5,1.5
8,4,rain,4,437,2,2,1
8,4,range,5,438,2,3,4.75
8,4,raw,3,439,2,1,0.5
8,4,readily,7,440,1,6,1.75
8,4,realize,7,441,3,4,1.5
8,4,really,6,442,4,2,4.5
8,4,receive,7,443,2,5,1.75
8,4,receiver,8,444,7,1,0.5
8,4,recipe,6,445,3,3,1.25
8,4,recovery,8,446,3,5,5.25
8,4,red,3,447,2,1,0.5
8,4,refuge,6,448,2,4,1.25
8,4,refugee,7,449,6,1,0.5
8,4,regret,6,450,2,4,1.25
8,4,release,7,451,2,5,5.25
8,4,rely,4,452,3,1,0.75
8,4,remains,7,453,2,5,1.5
8,4,remember,8,454,3,5,5.5
8,4,remote,6,455,3,3,1.25
8,4,renowned,8,456,2,6,1.75
8,4,repeated,8,457,2,6,5.5
8,4,request,7,458,2,5,1.75
8,4,respect,7,459,2,5,1.5
8,4,response,8,460,4,4,5.25
8,4,retreat,7,461,2,5,1.5
8,4,review,6,462,2,4,1.25
8,4,rhetoric,8,463,1,7,5.75
8,4,rhythm,6,464,2,4,1.25
8,4,risk,4,465,1,3,1
8,4,rock,4,466,1,3,4.5
8,4,romantic,8,467,2,6,2
8,4,rugby,5,468,1,4,1.25
8,4,rule,4,469,2,2,0.75
8,4,rumour,6,470,2,4,5.25
8,4,run,3,471,2,1,0.5
8,4,sadly,5,472,0,5,1.5
8,4,sail,4,473,2,2,0.75
8,4,salary,6,474,2,4,5
8,4,sanction,8,475,2,6,2
8,4,sandwich,8,476,3,5,1.75
8,4,say,3,477,2,1,4.25
8,4,scope,5,478,1,4,1.25
8,4,sea,3,479,1,2,0.75
8,4,section,7,480,2,5,1.5
8,4,see,3,481,2,1,0.5
8,4,seize,5,482,2,3,5
8,4,senior,6,483,2,4,1.5
8,4,sentence,8,484,3,5,1.75
8,4,set,3,485,2,1,0.75
8,4,several,7,486,2,5,5.75
8,4,sex,3,487,2,1,0.5
8,4,shade,5,488,1,4,1.25
8,4,shadow,6,489,4,2,1
8,4,shine,5,490,2,3,5.25
8,4,shocking,8,491,2,6,2
8,4,short,5,492,3,2,1
8,4,shot,4,493,3,1,0.75
8,4,should,6,494,3,3,1
8,4,shrink,6,495,2,4,5.5
8,4,silence,7,496,1,6,2
8,4,simulate,8,497,2,6,6
8,4,sing,4,498,2,2,1
8,4,sir,3,499,2,1,0.5
8,4,slave,5,500,1,4,1.25
8,4,small,5,501,1,4,1.75
8,4,smart,5,502,3,2,8.25
8,4,smash,5,503,3,2,2
8,4,snap,4,504,1,3,2.25
8,4,soak,4,505,1,3,2.25
8,4,soar,4,506,3,1,1.25
8,4,soccer,6,507,2,4,9.5
8,4,society,7,508,3,4,3.25
8,4,soft,4,509,2,2,1.75
8,4,software,8,510,4,4,3
8,4,soldier,7,511,2,5,9.75
8,4,solely,6,512,3,3,2.5
8,4,somebody,8,513,2,6,4
8,4,son,3,514,2,1,3.75
8,4,sorry,5,515,2,3,5.75
8,4,sort,4,516,3,1,1.25
8,4,spicy,5,517,1,4,2.75
8,4,split,5,518,2,3,2.25
8,4,spoil,5,519,2,3,8.75
8,4,spot,4,520,3,1,1.25
8,4,stadium,7,521,1,6,4
8,4,stage,5,522,3,2,1.75
8,4,stark,5,523,3,2,1.75
8,4,status,6,524,3,3,8.75
8,4,steel,5,525,2,3,2.25
8,4,steep,5,526,4,1,1.25
8,4,stiff,5,527,2,3,2.25
8,4,stream,6,528,2,4,3
8,4,strive,6,529,3,3,9
8,4,student,7,530,2,5,3.5
8,4,style,5,531,2,3,2.25
8,4,suburb,6,532,1,5,9.5
8,4,suburban,8,533,6,2,2.25
8,4,suddenly,8,534,2,6,4
8,4,sum,3,535,2,1,1
8,4,summit,6,536,3,3,8.5
8,4,superb,6,537,2,4,3
8,4,superior,8,538,5,3,2.5
8,4,sustain,7,539,2,5,3.5
8,4,symbol,6,540,1,5,9.25
8,4,tag,3,541,0,3,2
8,4,talented,8,542,2,6,4
8,4,tennis,6,543,1,5,9.5
8,4,tenure,6,544,3,3,2.5
8,4,terminal,8,545,2,6,7.25
8,4,terrain,7,546,3,4,6.5
8,4,testing,7,547,2,5,3.5
8,4,that,4,548,1,3,2
8,4,theatre,7,549,2,5,10
8,4,their,5,550,3,2,1.75
8,4,theirs,6,551,5,1,1.25
8,4,theology,8,552,3,5,3.75
8,4,think,5,553,2,3,8.5
8,4,thinking,8,554,5,3,2.75
8,4,third,5,555,3,2,1.75
8,4,thought,7,556,2,5,3.5
8,4,threaten,8,557,2,6,10.5
8,4,thursday,8,558,2,6,4
8,4,toll,4,559,1,3,2
8,4,tongue,6,560,2,4,9
8,4,tourist,7,561,2,5,3.5
8,4,towards,7,562,2,5,3.5
8,4,toy,3,563,2,1,7
8,4,trace,5,564,1,4,2.75
8,4,trading,7,565,3,4,3
8,4,transfer,8,566,3,5,10
8,4,trillion,8,567,2,6,4.25
8,4,trust,5,568,2,3,2.25
8,4,trustee,7,569,5,2,1.75
8,4,truth,5,570,3,2,8.5
8,4,try,3,571,2,1,1
8,4,tuesday,7,572,1,6,4
8,4,tuition,7,573,2,5,3.5
8,4,tunnel,6,574,2,4,9
8,4,turn,4,575,2,2,1.5
8,4,turnout,7,576,4,3,2.25
8,4,turnover,8,577,5,3,2.5
8,4,twenty,6,578,1,5,9.5
8,4,twist,5,579,2,3,2.25
8,4,ugly,4,580,0,4,2.5
8,4,under,5,581,1,4,2.75
8,4,unlikely,8,582,2,6,10.5
8,4,up,2,583,1,1,0.75
8,4,upper,5,584,2,3,2.25
8,4,upset,5,585,2,3,2.25
8,4,use,3,586,1,2,8.5
8,4,vast,4,587,0,4,2.5
8,4,vicious,7,588,1,6,4
8,4,victim,6,589,3,3,9.25
8,4,village,7,590,2,5,3.75
8,4,volume,6,591,1,5,3.25
8,4,vote,4,592,2,2,1.75
8,4,wage,4,593,0,4,9
8,4,warfare,7,594,2,5,3.5
8,4,warm,4,595,3,1,1.25
8,4,wash,4,596,2,2,1.75
8,4,we,2,597,1,1,1
8,4,weak,4,598,2,2,8
8,4,weather,7,599,3,4,3
8,4,week,4,600,2,2,1.75
8,4,weekly,6,601,4,2,1.75
8,4,well,4,602,2,2,1.75
8,4,what,4,603,1,3,8.5
8,4,wheat,5,604,2,3,2.25
8,4,whisper,7,605,2,5,3.5
8,4,who,3,606,2,1,1
8,4,whole,5,607,3,2,1.75
8,4,wide,4,608,1,3,8.5
8,4,widely,6,609,4,2,2
8,4,winter,6,610,2,4,3
8,4,wooden,6,611,1,5,3.5
8,4,worm,4,612,2,2,8.5
8,4,writing,7,613,1,6,4
8,4,wrong,5,614,2,3,2.5
8,4,yourself,8,615,0,8,12
8,5,able,4,0,0,4,2.5
8,5,about,5,1,2,3,8.25
8,5,academy,7,2,1,6,4
8,5,accent,6,3,2,4,2.75
8,5,account,7,4,3,4,5.75
8,5,accuracy,8,5,3,5,1.75
8,5,act,3,6,2,1,0.5
8,5,adhere,6,7,1,5,1.5
8,5,afraid,6,8,1,5,5.5
8,5,aged,4,9,1,3,1
8,5,aid,3,10,1,2,0.75
8,5,aircraft,8,11,2,6,5.75
8,5,alert,5,12,1,4,1.25
8,5,alien,5,13,2,3,1
8,5,alike,5,14,3,2,1
8,5,all,3,15,2,1,0.5
8,5,allege,6,16,3,3,5
8,5,alliance,8,17,3,5,1.75
8,5,alone,5,18,2,3,1
8,5,along,5,19,4,1,0.5
8,5,also,4,20,2,2,0.75
8,5,angel,5,21,1,4,5.5
8,5,answer,6,22,2,4,1.5
8,5,anyone,6,23,2,4,1.25
8,5,anything,8,24,3,5,5.75
8,5,appetite,8,25,1,7,2
8,5,apple,5,26,3,2,1
8,5,apply,5,27,4,1,0.75
8,5,april,5,28,2,3,5
8,5,arena,5,29,1,4,1.25
8,5,array,5,30,2,3,1
8,5,assess,6,31,1,5,5.75
8,5,asset,5,32,4,1,0.75
8,5,athlete,7,33,1,6,1.75
8,5,audience,8,34,1,7,6.5
8,5,audit,5,35,4,1,0.75
8,5,august,6,36,2,4,1.5
8,5,autumn,6,37,2,4,1.25
8,5,avoid,5,38,1,4,5.5
8,5,aware,5,39,1,4,1.25
8,5,away,4,40,3,1,0.5
8,5,bad,3,41,0,3,0.75
8,5,ballot,6,42,2,4,1.25
8,5,banana,6,43,2,4,5.25
8,5,bank,4,44,3,1,0.5
8,5,basis,5,45,2,3,1
8,5,bean,4,46,1,3,1
8,5,bear,4,47,3,1,0.5
8,5,because,7,48,2,5,5.75
8,5,before,6,49,2,4,1.25
8,5,behind,6,50,2,4,1.5
8,5,beneath,7,51,2,5,5.5
8,5,bent,4,52,3,1,0.75
8,5,bias,4,53,1,3,1
8,5,big,3,54,2,1,0.5
8,5,biology,7,55,2,5,1.5
8,5,blast,5,56,1,4,5.25
8,5,blood,5,57,2,3,1.25
8,5,body,4,58,1,3,1
8,5,bold,4,59,2,2,0.75
8,5,bond,4,60,2,2,4.75
8,5,bonus,5,61,3,2,1.25
8,5,booking,7,62,2,5,2
8,5,brain,5,63,1,4,1.25
8,5,bread,5,64,2,3,5.25
8,5,breast,6,65,4,2,1.25
8,5,breath,6,66,4,2,1
8,5,brick,5,67,2,3,1
8,5,bring,5,68,3,2,0.75
8,5,broadly,7,69,2,5,5.75
8,5,brother,7,70,3,4,1.75
8,5,brown,5,71,3,2,1.25
8,5,buck,4,72,1,3,1.5
8,5,bulk,4,73,2,2,1.5
8,5,busy,4,74,2,2,7.5
8,5,but,3,75,2,1,0.5
8,5,button,6,76,3,3,1.5
8,5,bye,3,77,1,2,1
8,5,cabin,5,78,0,5,1.75
8,5,calm,4,79,2,2,5.5
8,5,camp,4,80,2,2,0.75
8,5,capture,7,81,2,5,1.75
8,5,carriage,8,82,2,6,6.75
8,5,case,4,83,2,2,1
8,5,cat,3,84,2,1,0.5
8,5,cattle,6,85,3,3,1.25
8,5,chat,4,86,1,3,1
8,5,cinema,6,87,1,5,5.5
8,5,clarify,7,88,1,6,1.75
8,5,classic,7,89,3,4,1.5
8,5,climate,7,90,2,5,5.75
8,5,clip,4,91,3,1,0.75
8,5,closure,7,92,2,5,1.5
8,5,cloth,5,93,3,2,1
8,5,clothes,7,94,5,2,1
8,5,clothing,8,95,5,3,5.5
8,5,coastal,7,96,1,6,1.75
8,5,college,7,97,2,5,5.75
8,5,combat,6,98,2,4,1.25
8,5,comic,5,99,3,2,1
8,5,commit,6,100,3,3,1.25
8,5,compare,7,101,3,4,6
8,5,comprise,8,102,4,4,1.75
8,5,conclude,8,103,2,6,1.75
8,5,concrete,8,104,4,4,6.25
8,5,confuse,7,105,3,4,1.75
8,5,consumer,8,106,3,5,1.75
8,5,contact,7,107,3,4,5.25
8,5,contest,7,108,4,3,1.25
8,5,convict,7,109,3,4,1.5
8,5,cooking,7,110,2,5,1.75
8,5,cop,3,111,2,1,0.5
8,5,copy,4,112,3,1,5
8,5,corrupt,7,113,2,5,1.5
8,5,council,7,114,2,5,1.5
8,5,covered,7,115,2,5,5.75
8,5,cow,3,116,2,1,0.5
8,5,crash,5,117,1,4,1.25
8,5,cream,5,118,2,3,1
8,5,creator,7,119,4,3,5.75
8,5,critical,8,120,2,6,2
8,5,crop,4,121,2,2,0.75
8,5,cue,3,122,1,2,0.75
8,5,cult,4,123,2,2,0.75
8,5,custody,7,124,2,5,6
8,5,custom,6,125,5,1,0.75
8,5,dad,3,126,0,3,1
8,5,dancer,6,127,2,4,1.25
8,5,dark,4,128,2,2,5
8,5,data,4,129,2,2,0.75
8,5,database,8,130,4,4,1.25
8,5,deadline,8,131,1,7,4
8,5,deadly,6,132,5,1,3
8,5,dear,4,133,3,1,0.5
8,5,debate,6,134,2,4,1.25
8,5,debris,6,135,3,3,1.25
8,5,defend,6,136,2,4,1.25
8,5,defy,4,137,3,1,4.75
8,5,delivery,8,138,2,6,2
8,5,denial,6,139,2,4,1.5
8,5,depict,6,140,2,4,5.5
8,5,destroy,7,141,2,5,1.75
8,5,detail,6,142,2,4,1.25
8,5,diary,5,143,1,4,5.5
8,5,die,3,144,2,1,0.5
8,5,differ,6,145,2,4,1.25
8,5,dilemma,7,146,2,5,1.5
8,5,disagree,8,147,2,6,6.25
8,5,discard,7,148,3,4,1.5
8,5,disorder,8,149,3,5,1.75
8,5,dispute,7,150,3,4,6
8,5,distract,8,151,3,5,1.75
8,5,district,8,152,5,3,1.5
8,5,disturb,7,153,4,3,6
8,5,divert,6,154,2,4,1.5
8,5,divorce,7,155,3,4,1.5
8,5,doctrine,8,156,1,7,6.25
8,5,dominate,8,157,2,6,1.75
8,5,door,4,158,2,2,0.75
8,5,dose,4,159,2,2,0.75
8,5,drag,4,160,1,3,5.25
8,5,drain,5,161,3,2,1
8,5,dramatic,8,162,3,5,1.75
8,5,dress,5,163,2,3,1
8,5,drive,5,164,2,3,5.25
8,5,driver,6,165,5,1,0.75
8,5,drown,5,166,2,3,1.25
8,5,drug,4,167,2,2,0.75
8,5,drunk,5,168,3,2,1
8,5,dry,3,169,2,1,0.5
8,5,due,3,170,1,2,0.75
8,5,during,6,171,2,4,6.75
8,5,duty,4,172,2,2,1
8,5,easily,6,173,0,6,2.75
8,5,edge,4,174,1,3,7.25
8,5,educated,8,175,2,6,2
8,5,educator,8,176,6,2,1.25
8,5,elevate,7,177,1,6,6.75
8,5,empire,6,178,1,5,3
8,5,employ,6,179,3,3,2
8,5,energy,6,180,1,5,6.75
8,5,enhance,7,181,2,5,1.75
8,5,enquire,7,182,2,5,1.75
8,5,enrol,5,183,2,3,5.75
8,5,ensue,5,184,2,3,1.25
8,5,entire,6,185,2,4,1.5
8,5,entirely,8,186,6,2,1
8,5,equal,5,187,1,4,6.75
8,5,equip,5,188,3,2,2
8,5,era,3,189,1,2,1.25
8,5,error,5,190,2,3,1.5
8,5,erupt,5,191,2,3,1.5
8,5,escalate,8,192,1,7,7.75
8,5,eternal,7,193,1,6,2
8,5,ethic,5,194,2,3,1.25
8,5,ethical,7,195,5,2,5.75
8,5,ethnic,6,196,3,3,1.25
8,5,every,5,197,1,4,1.25
8,5,everyday,8,198,5,3,1.25
8,5,evolve,6,199,2,4,6.5
8,5,example,7,200,1,6,2.25
8,5,excess,6,201,2,4,1.5
8,5,exclude,7,202,3,4,6.25
8,5,exotic,6,203,2,4,1.5
8,5,export,6,204,2,4,1.5
8,5,exposure,8,205,4,4,6.5
8,5,extra,5,206,2,3,1
8,5,fabulous,8,207,0,8,2.25
8,5,factor,6,208,2,4,7.5
8,5,faith,5,209,2,3,2.25
8,5,favour,6,210,2,4,3
8,5,feat,4,211,1,3,2
8,5,festival,8,212,2,6,11.75
8,5,film,4,213,1,3,2.25
8,5,final,5,214,2,3,2.5
8,5,finger,6,215,3,3,9.5
8,5,firearm,7,216,2,5,3.5
8,5,firework,8,217,4,4,3.25
8,5,fish,4,218,2,2,1.5
8,5,fit,3,219,2,1,1
8,5,five,4,220,2,2,8.5
8,5,flame,5,221,1,4,2.75
8,5,float,5,222,2,3,2.25
8,5,fold,4,223,1,3,2
8,5,follow,6,224,3,3,9.5
8,5,fool,4,225,2,2,1.75
8,5,forecast,8,226,2,6,4.25
8,5,forest,6,227,4,2,2
8,5,forever,7,228,4,3,9.75
8,5,forgive,7,229,3,4,3.25
8,5,from,4,230,1,3,2
8,5,fruit,5,231,2,3,2.5
8,5,function,8,232,1,7,11.5
8,5,gambling,8,233,0,8,5
8,5,garden,6,234,2,4,10
8,5,gas,3,235,2,1,1
8,5,generic,7,236,1,6,4
8,5,genuine,7,237,3,4,10.25
8,5,get,3,238,2,1,1
8,5,ghost,5,239,1,4,2.75
8,5,goal,4,240,1,3,2.25
8,5,goods,5,241,2,3,2.25
8,5,gorgeous,8,242,2,6,11.75
8,5,graduate,8,243,1,7,4.75
8,5,grain,5,244,3,2,2
8,5,grand,5,245,3,2,9.75
8,5,grant,5,246,4,1,1.25
8,5,grass,5,247,3,2,1.75
8,5,great,5,248,2,3,2.25
8,5,greatly,7,249,5,2,1.75
8,5,guard,5,250,1,4,10
8,5,halt,4,251,0,4,2.75
8,5,hand,4,252,2,2,1.75
8,5,hardware,8,253,2,6,4
8,5,harmony,7,254,3,4,10.25
8,5,hear,4,255,1,3,2.25
8,5,heavily,7,256,3,4,3
8,5,helmet,6,257,2,4,10.25
8,5,hence,5,258,2,3,2.25
8,5,hidden,6,259,1,5,3.5
8,5,hobby,5,260,1,4,2.75
8,5,hockey,6,261,2,4,10.25
8,5,hold,4,262,2,2,1.75
8,5,hook,4,263,2,2,1.75
8,5,hope,4,264,2,2,1.75
8,5,horizon,7,265,2,5,11
8,5,host,4,266,2,2,1.75
8,5,hostile,7,267,4,3,2.5
8,5,house,5,268,2,3,2.25
8,5,ideology,8,269,0,8,12.75
8,5,ignore,6,270,1,5,3.25
8,5,illness,7,271,1,6,11.25
8,5,imagine,7,272,1,6,4
8,5,imminent,8,273,2,6,4.25
8,5,impress,7,274,2,5,10.75
8,5,inclined,8,275,1,7,4.5
8,5,indeed,6,276,2,4,10.5
8,5,indoors,7,277,3,4,3.25
8,5,induce,6,278,3,3,2.5
8,5,indulge,7,279,4,3,2.75
8,5,initial,7,280,2,5,607.5
8,5,inmate,6,281,2,4,2
8,5,innocent,8,282,2,6,3.5
8,5,input,5,283,2,3,2
8,5,invasion,8,284,2,6,9
8,5,investor,8,285,3,5,4
8,5,invoke,6,286,3,3,6.75
8,5,joint,5,287,0,5,3.5
8,5,july,4,288,1,3,2.25
8,5,keen,4,289,0,4,2.5
8,5,kidnap,6,290,1,5,9
8,5,kill,4,291,2,2,1.5
8,5,killing,7,292,4,3,2.25
8,5,kind,4,293,2,2,1.5
8,5,kiss,4,294,2,2,1.75
8,5,knock,5,295,1,4,8.5
8,5,landing,7,296,0,7,4.25
8,5,lane,4,297,3,1,1.5
8,5,language,8,298,3,5,15
8,5,late,4,299,2,2,2
8,5,lately,6,300,4,2,1.5
8,5,lawsuit,7,301,2,5,2.25
8,5,layout,6,302,2,4,6.25
8,5,lead,4,303,1,3,1
8,5,leap,4,304,3,1,0.75
8,5,learn,5,305,3,2,0.75
8,5,leave,5,306,3,2,0.75
8,5,legacy,6,307,2,4,5
8,5,length,6,308,2,4,1.5
8,5,less,4,309,2,2,0.75
8,5,lesson,6,310,4,2,0.75
8,5,let,3,311,2,1,0.5
8,5,level,5,312,2,3,4.75
8,5,likewise,8,313,1,7,2.25
8,5,listener,8,314,2,6,2
8,5,lively,6,315,2,4,5
8,5,lobby,5,316,1,4,1.25
8,5,lock,4,317,2,2,0.75
8,5,logo,4,318,2,2,0.75
8,5,loom,4,319,2,2,4.5
8,5,loop,4,320,3,1,0.75
8,5,lord,4,321,2,2,0.75
8,5,lose,4,322,2,2,0.75
8,5,lost,4,323,3,1,0.5
8,5,lower,5,324,2,3,1
8,5,magazine,8,325,0,8,6.75
8,5,major,5,326,2,3,1.25
8,5,man,3,327,2,1,0.5
8,5,march,5,328,2,3,1
8,5,marginal,8,329,3,5,5.75
8,5,marker,6,330,3,3,1.25
8,5,marriage,8,331,3,5,1.75
8,5,massive,7,332,2,5,5.25
8,5,mate,4,333,2,2,0.75
8,5,maths,5,334,3,2,0.75
8,5,maybe,5,335,2,3,1
8,5,mayor,5,336,3,2,0.75
8,5,me,2,337,1,1,0.5
8,5,medical,7,338,2,5,4.75
8,5,medicine,8,339,5,3,1.25
8,5,menu,4,340,2,2,0.75
8,5,mile,4,341,1,3,1
8,5,mine,4,342,2,2,4
8,5,minimize,8,343,3,5,1.75
8,5,mining,6,344,4,2,1
8,5,minority,8,345,3,5,1.5
8,5,minute,6,346,3,3,4.5
8,5,miracle,7,347,2,5,1.5
8,5,missile,7,348,2,5,1.5
8,5,mistake,7,349,3,4,5
8,5,mode,4,350,1,3,1
8,5,momentum,8,351,2,6,1.75
8,5,morning,7,352,2,5,5
8,5,motor,5,353,2,3,1
8,5,mountain,8,354,2,6,1.75
8,5,move,4,355,2,2,4
8,5,movement,8,356,4,4,1.5
8,5,multiply,8,357,1,7,2
8,5,musical,7,358,2,5,5.25
8,5,myself,6,359,1,5,1.75
8,5,mystery,7,360,3,4,1.5
8,5,nail,4,361,0,4,4.75
8,5,native,6,362,2,4,1.25
8,5,naval,5,363,2,3,1
8,5,neglect,7,364,1,6,5.25
8,5,nest,4,365,2,2,0.75
8,5,news,4,366,2,2,0.75
8,5,nineteen,8,367,1,7,5.5
8,5,ninety,6,368,5,1,1
8,5,nod,3,369,1,2,0.75
8,5,now,3,370,2,1,0.5
8,5,nowadays,8,371,3,5,1.5
8,5,number,6,372,1,5,4.75
8,5,o,1,373,0,1,0.25
8,5,occasion,8,374,1,7,2
8,5,of,2,375,1,1,0.5
8,5,offender,8,376,2,6,5.25
8,5,offering,8,377,4,4,1.75
8,5,onion,5,378,1,4,1.25
8,5,open,4,379,1,3,2.75
8,5,operate,7,380,3,4,3.25
8,5,or,2,381,1,1,0.5
8,5,ordinary,8,382,2,6,1.75
8,5,organize,8,383,2,6,5.5
8,5,our,3,384,1,2,0.75
8,5,outrage,7,385,2,5,1.5
8,5,oven,4,386,1,3,4.5
8,5,over,4,387,3,1,0.75
8,5,overly,6,388,4,2,1
8,5,overseas,8,389,4,4,1.25
8,5,own,3,390,1,2,0.75
8,5,packet,6,391,0,6,5.25
8,5,pan,3,392,2,1,0.5
8,5,paper,5,393,2,3,1
8,5,parent,6,394,2,4,1.25
8,5,parental,8,395,6,2,1
8,5,party,5,396,3,2,4.25
8,5,pass,4,397,2,2,0.75
8,5,passage,7,398,4,3,1
8,5,passion,7,399,4,3,1
8,5,payment,7,400,2,5,5
8,5,peasant,7,401,1,6,1.75
8,5,pension,7,402,2,5,1.5
8,5,people,6,403,2,4,5
8,5,person,6,404,2,4,1.25
8,5,persuade,8,405,4,4,1.5
8,5,petition,8,406,2,6,5.25
8,5,phase,5,407,1,4,1.25
8,5,pill,4,408,1,3,1
8,5,pilot,5,409,3,2,0.75
8,5,pink,4,410,2,2,0.75
8,5,pit,3,411,2,1,4.25
8,5,pitch,5,412,3,2,1.5
8,5,plain,5,413,1,4,2.75
8,5,planet,6,414,3,3,2.5
8,5,player,6,415,3,3,2.5
8,5,poetry,6,416,1,5,9
8,5,policy,6,417,2,4,3
8,5,politics,8,418,4,4,3.25
8,5,portray,7,419,2,5,9.25
8,5,poverty,7,420,2,5,3.5
8,5,powerful,8,421,2,6,9.75
8,5,pray,4,422,1,3,2
8,5,precede,7,423,2,5,3.5
8,5,prefer,6,424,3,3,2.5
8,5,premium,7,425,3,4,9.5
8,5,prepare,7,426,3,4,3.25
8,5,present,7,427,3,4,3
8,5,pretty,6,428,3,3,8.5
8,5,prevent,7,429,3,4,3.25
8,5,previous,8,430,4,4,3.5
8,5,prey,4,431,3,1,1.25
8,5,price,5,432,2,3,2.25
8,5,princess,8,433,3,5,9.75
8,5,probable,8,434,2,6,4
8,5,probably,8,435,7,1,1.25
8,5,proceed,7,436,3,4,8.75
8,5,provoke,7,437,3,4,3.25
8,5,purchase,8,438,1,7,4.75
8,5,pursue,6,439,3,3,8.75
8,5,quarter,7,440,0,7,4.5
8,5,question,8,441,2,6,10.5
8,5,racist,6,442,0,6,3.75
8,5,radio,5,443,2,3,2.25
8,5,random,6,444,2,4,9
8,5,range,5,445,3,2,2
8,5,rapid,5,446,2,3,2.25
8,5,rare,4,447,2,2,1.5
8,5,realize,7,448,1,6,10.25
8,5,really,6,449,4,2,2
8,5,receive,7,450,2,5,3.5
8,5,receiver,8,451,7,1,1.5
8,5,recovery,8,452,3,5,10.25
8,5,red,3,453,2,1,1
8,5,refuge,6,454,2,4,2.75
8,5,refugee,7,455,6,1,1.25
8,5,register,8,456,2,6,4
8,5,release,7,457,2,5,10.25
8,5,reliable,8,458,3,5,3.75
8,5,rely,4,459,3,1,1.25
8,5,remote,6,460,2,4,8.75
8,5,repeated,8,461,2,6,4.25
8,5,reporter,8,462,3,5,3.75
8,5,request,7,463,2,5,10
8,5,result,6,464,2,4,2.75
8,5,retreat,7,465,2,5,3.5
8,5,reverse,7,466,2,5,9.5
8,5,rhetoric,8,467,1,7,4.75
8,5,riot,4,468,1,3,8.75
8,5,risk,4,469,2,2,1.75
8,5,royal,5,470,1,4,2.75
8,5,rugby,5,471,1,4,2.75
8,5,rule,4,472,2,2,1.75
8,5,rumour,6,473,2,4,9.25
8,5,sad,3,474,0,3,2
8,5,saint,5,475,2,3,2.25
8,5,salary,6,476,2,4,2.75
8,5,sandwich,8,477,2,6,10
8,5,say,3,478,2,1,1
8,5,scale,5,479,1,4,2.75
8,5,scope,5,480,2,3,8
8,5,scratch,7,481,2,5,3.5
8,5,scream,6,482,3,3,2.5
8,5,sea,3,483,1,2,1.5
8,5,section,7,484,2,5,9.75
8,5,see,3,485,2,1,1
8,5,self,4,486,2,2,1.5
8,5,senator,7,487,2,5,3.75
8,5,send,4,488,3,1,1.25
8,5,serial,6,489,2,4,9
8,5,session,7,490,2,5,3.5
8,5,seventy,7,491,2,5,3.5
8,5,several,7,492,4,3,9.25
8,5,shake,5,493,1,4,2.75
8,5,shall,5,494,3,2,1.75
8,5,sheet,5,495,2,3,2.25
8,5,shine,5,496,2,3,2.25
8,5,shock,5,497,2,3,8.25
8,5,shout,5,498,3,2,2
8,5,show,4,499,3,1,1
8,5,shrink,6,500,2,4,2.75
8,5,silence,7,501,1,6,11.25
8,5,sir,3,502,2,1,1
8,5,sixty,5,503,2,3,2.25
8,5,skiing,6,504,1,5,3.75
8,5,skill,5,505,3,2,8.75
8,5,sky,3,506,2,1,1
8,5,snap,4,507,1,3,2.25
8,5,soar,4,508,1,3,2.25
8,5,soccer,6,509,2,4,3.25
8,5,soft,4,510,2,2,9
8,5,soldier,7,511,2,5,3.75
8,5,son,3,512,2,1,1
8,5,soon,4,513,2,2,1.75
8,5,span,4,514,1,3,2.25
8,5,spending,8,515,2,6,10.5
8,5,spicy,5,516,2,3,2.25
8,5,split,5,517,2,3,2.25
8,5,spoil,5,518,2,3,2.25
8,5,sponsor,7,519,3,4,9
8,5,spoon,5,520,3,2,2
8,5,sport,5,521,3,2,1.75
8,5,spot,4,522,3,1,1.25
8,5,squeeze,7,523,1,6,10
8,5,stadium,7,524,1,6,4
8,5,station,7,525,3,4,3
8,5,steep,5,526,2,3,8.25
8,5,stunning,8,527,2,6,4.25
8,5,success,7,528,1,6,4
8,5,suffer,6,529,2,4,9
8,5,suicide,7,530,2,5,3.5
8,5,sum,3,531,2,1,1
8,5,summer,6,532,3,3,2.25
8,5,summit,6,533,4,2,7.75
8,5,supply,6,534,2,4,3
8,5,suppress,8,535,4,4,3.25
8,5,surface,7,536,2,5,10
8,5,survive,7,537,3,4,3
8,5,sustain,7,538,2,5,3.5
8,5,sweet,5,539,1,4,2.75
8,5,swimming,8,540,2,6,10.25
8,5,swing,5,541,3,2,2
8,5,symbol,6,542,1,5,3.5
8,5,syndrome,8,543,2,6,10.75
8,5,t,1,544,0,1,0.75
8,5,tag,3,545,1,2,1.5
8,5,talented,8,546,2,6,10.25
8,5,tell,4,547,1,3,2
8,5,tenure,6,548,2,4,3
8,5,terrible,8,549,2,6,10.75
8,5,text,4,550,2,2,1.75
8,5,that,4,551,1,3,2.25
8,5,their,5,552,2,3,2.25
8,5,theirs,6,553,5,1,1.25
8,5,then,4,554,3,1,1.25
8,5,theology,8,555,3,5,10
8,5,there,5,556,3,2,2
8,5,thief,5,557,2,3,2.5
8,5,think,5,558,3,2,1.75
8,5,though,6,559,2,4,6.25
8,5,thought,7,560,6,1,2
8,5,thrive,6,561,2,4,3
8,5,thursday,8,562,2,6,4
8,5,timber,6,563,1,5,10.25
8,5,tiny,4,564,2,2,1.75
8,5,toll,4,565,1,3,2
8,5,ton,3,566,2,1,1
8,5,toy,3,567,2,1,1
8,5,trace,5,568,1,4,9.25
8,5,trading,7,569,3,4,3.25
8,5,training,8,570,3,5,4
8,5,transfer,8,571,3,5,10.5
8,5,true,4,572,2,2,1.75
8,5,truly,5,573,3,2,1.75
8,5,trustee,7,574,3,4,3
8,5,tunnel,6,575,1,5,9.25
8,5,turn,4,576,2,2,1.5
8,5,turnover,8,577,4,4,3
8,5,typical,7,578,1,6,4.25
8,5,ugly,4,579,0,4,9.25
8,5,unfold,6,580,1,5,3.5
8,5,upper,5,581,1,4,3
8,5,upset,5,582,2,3,11
8,5,upwards,7,583,2,5,3.75
8,5,use,3,584,1,2,1.75
8,5,used,4,585,3,1,0.75
8,5,versus,6,586,0,6,7
8,5,very,4,587,3,1,0.75
8,5,vicious,7,588,1,6,2
8,5,victim,6,589,3,3,1.75
8,5,village,7,590,2,5,6.5
8,5,violate,7,591,2,5,2.25
8,5,wash,4,592,0,4,1.25
8,5,we,2,593,1,1,6.75
8,5,wear,4,594,2,2,1.25
8,5,weather,7,595,3,4,3
8,5,website,7,596,2,5,2.25
8,5,wedding,7,597,2,5,7.25
8,5,weekly,6,598,2,4,1.5
8,5,well,4,599,2,2,1.25
8,5,while,5,600,1,4,1.25
8,5,whole,5,601,2,3,6.5
8,5,widely,6,602,1,5,1.5
8,5,winner,6,603,2,4,1.5
8,5,winter,6,604,3,3,7.25
8,5,wise,4,605,2,2,0.75
8,5,wish,4,606,3,1,1.25
8,5,wooden,6,607,1,5,1.75
8,5,workout,7,608,2,5,6.75
8,5,worm,4,609,3,1,0.75
8,5,worse,5,610,3,2,1
8,5,writing,7,611,1,6,2
8,5,wrong,5,612,2,3,1.25
8,5,yours,5,613,0,5,5.5
8,5,yourself,8,614,5,3,1.25
8,5,zone,4,615,0,4,1.25
8,6,abortion,8,0,0,8,2.25
8,6,about,5,1,3,2,1
8,6,absent,6,2,2,4,5.5
8,6,abstract,8,3,3,5,1.75
8,6,academy,7,4,1,6,1.75
8,6,accent,6,5,2,4,5.5
8,6,access,6,6,4,2,1.25
8,6,account,7,7,3,4,1.5
8,6,action,6,8,2,4,1.25
8,6,adhere,6,9,1,5,5.75
8,6,advance,7,10,2,5,1.75
8,6,affair,6,11,1,5,5.5
8,6,afford,6,12,3,3,1.25
8,6,afraid,6,13,2,4,1.5
8,6,agent,5,14,1,4,1.25
8,6,air,3,15,1,2,4.75
8,6,alert,5,16,1,4,1.25
8,6,alien,5,17,2,3,1
8,6,allege,6,18,2,4,1.25
8,6,alliance,8,19,3,5,6
8,6,allow,5,20,3,2,1
8,6,along,5,21,2,3,1
8,6,also,4,22,2,2,0.75
8,6,angry,5,23,1,4,5.75
8,6,answer,6,24,2,4,1.5
8,6,anything,8,25,2,6,2
8,6,appoint,7,26,1,6,6
8,6,archive,7,27,1,6,1.75
8,6,article,7,28,2,5,5.75
8,6,assess,6,29,1,5,1.5
8,6,attend,6,30,1,5,1.5
8,6,attorney,8,31,3,5,6
8,6,audit,5,32,1,4,1.25
8,6,august,6,33,2,4,1.5
8,6,author,6,34,2,4,5.5
8,6,avoid,5,35,1,4,1.25
8,6,bad,3,36,0,3,1
8,6,bake,4,37,2,2,0.75
8,6,banana,6,38,2,4,5.25
8,6,bank,4,39,3,1,0.75
8,6,barrier,7,40,2,5,1.75
8,6,bear,4,41,1,3,1
8,6,become,6,42,2,4,5.5
8,6,bee,3,43,2,1,0.5
8,6,beef,4,44,3,1,0.5
8,6,before,6,45,2,4,1.25
8,6,behind,6,46,2,4,1.25
8,6,being,5,47,2,3,5
8,6,beneath,7,48,2,5,1.5
8,6,bent,4,49,3,1,0.75
8,6,beside,6,50,2,4,1.25
8,6,blast,5,51,1,4,5
8,6,blend,5,52,2,3,1.25
8,6,bold,4,53,1,3,1
8,6,bond,4,54,2,2,0.75
8,6,booking,7,55,2,5,5.5
8,6,boring,6,56,2,4,1.5
8,6,born,4,57,3,1,0.75
8,6,bounce,6,58,2,4,1.25
8,6,bread,5,59,1,4,5.25
8,6,breast,6,60,4,2,1
8,6,brick,5,61,2,3,1
8,6,buck,4,62,1,3,1
8,6,building,8,63,2,6,6.25
8,6,bulk,4,64,2,2,1
8,6,burst,5,65,2,3,1
8,6,button,6,66,2,4,1.25
8,6,captain,7,67,0,7,6.25
8,6,capture,7,68,4,3,1.25
8,6,carriage,8,69,2,6,1.75
8,6,carrot,6,70,4,2,5
8,6,cattle,6,71,2,4,1.5
8,6,cause,5,72,2,3,1
8,6,champion,8,73,1,7,6.25
8,6,charge,6,74,3,3,1.25
8,6,chat,4,75,3,1,0.5
8,6,chef,4,76,2,2,0.75
8,6,class,5,77,1,4,1.25
8,6,cling,5,78,2,3,5.25
8,6,clip,4,79,3,1,0.75
8,6,clothes,7,80,2,5,1.5
8,6,coast,5,81,1,4,1.25
8,6,colour,6,82,2,4,5.5
8,6,coloured,8,83,6,2,1
8,6,combat,6,84,2,4,1.25
8,6,combine,7,85,4,3,1.25
8,6,comic,5,86,3,2,0.75
8,6,commerce,8,87,3,5,6
8,6,common,6,88,4,2,1.25
8,6,complex,7,89,3,4,2
8,6,compose,7,90,4,3,5.75
8,6,conclude,8,91,2,6,1.75
8,6,concrete,8,92,4,4,1.5
8,6,conflict,8,93,3,5,6.5
8,6,conserve,8,94,3,5,2.5
8,6,consist,7,95,4,3,1.25
8,6,consume,7,96,4,3,1.25
8,6,contact,7,97,3,4,6.75
8,6,contest,7,98,4,3,2
8,6,context,7,99,5,2,2.25
8,6,continue,8,100,4,4,2.5
8,6,contract,8,101,4,4,6.75
8,6,convert,7,102,3,4,1.5
8,6,cooking,7,103,2,5,1.75
8,6,cop,3,104,2,1,0.5
8,6,copy,4,105,3,1,6.25
8,6,cotton,6,106,2,4,1.75
8,6,covered,7,107,2,5,1.5
8,6,cow,3,108,2,1,0.5
8,6,crack,5,109,1,4,6
8,6,cream,5,110,2,3,1.25
8,6,creation,8,111,4,4,1.5
8,6,creative,8,112,6,2,1
8,6,creator,7,113,5,2,1
8,6,crystal,7,114,2,5,5.75
8,6,cue,3,115,1,2,0.75
8,6,cult,4,116,2,2,0.75
8,6,cure,4,117,2,2,0.75
8,6,custom,6,118,2,4,5.5
8,6,customer,8,119,6,2,1.25
8,6,cutting,7,120,2,5,1.75
8,6,dark,4,121,0,4,1.25
8,6,database,8,122,2,6,6.5
8,6,deadline,8,123,1,7,2
8,6,debate,6,124,2,4,5.5
8,6,debut,5,125,3,2,1
8,6,deck,4,126,2,2,0.75
8,6,decorate,8,127,3,5,1.75
8,6,defeat,6,128,2,4,5.75
8,6,denial,6,129,2,4,1.5
8,6,depend,6,130,2,4,1.5
8,6,depict,6,131,3,3,1.25
8,6,derive,6,132,2,4,6
8,6,desert,6,133,2,4,1.5
8,6,destroy,7,134,3,4,1.5
8,6,diary,5,135,1,4,5.75
8,6,die,3,136,2,1,0.5
8,6,differ,6,137,2,4,1.25
8,6,dip,3,138,2,1,0.5
8,6,directly,8,139,2,6,4
8,6,disagree,8,140,2,6,4
8,6,disease,7,141,3,4,1.5
8,6,dispose,7,142,3,4,5.75
8,6,disrupt,7,143,3,4,1.5
8,6,distance,8,144,3,5,1.75
8,6,distract,8,145,4,4,5.75
8,6,disturb,7,146,4,3,1.5
8,6,divert,6,147,2,4,1.5
8,6,divorce,7,148,3,4,1.5
8,6,doctrine,8,149,1,7,6.75
8,6,dominate,8,150,2,6,2
8,6,donate,6,151,2,4,5.75
8,6,donor,5,152,3,2,1
8,6,dose,4,153,2,2,0.75
8,6,drain,5,154,1,4,1.25
8,6,dramatic,8,155,3,5,6.25
8,6,dress,5,156,2,3,1.25
8,6,drive,5,157,2,3,1
8,6,driver,6,158,5,1,0.75
8,6,drown,5,159,2,3,1
8,6,drug,4,160,2,2,0.75
8,6,dry,3,161,2,1,4.75
8,6,due,3,162,1,2,0.75
8,6,dull,4,163,2,2,0.75
8,6,each,4,164,0,4,1.25
8,6,early,5,165,2,3,1.25
8,6,east,4,166,2,2,5.75
8,6,easy,4,167,3,1,1.25
8,6,economy,7,168,1,6,4
8,6,edge,4,169,1,3,2.25
8,6,educator,8,170,2,6,11.75
8,6,eighteen,8,171,1,7,4.5
8,6,element,7,172,1,6,11.25
8,6,else,4,173,2,2,1.75
8,6,empty,5,174,1,4,2.75
8,6,endorse,7,175,1,6,11
8,6,energy,6,176,2,4,3
8,6,enforce,7,177,2,5,3.5
8,6,enhance,7,178,2,5,10.25
8,6,ensue,5,179,2,3,2.5
8,6,entire,6,180,2,4,3
8,6,entity,6,181,4,2,2
8,6,equal,5,182,1,4,9.5
8,6,equation,8,183,4,4,3
8,6,era,3,184,1,2,1.5
8,6,error,5,185,2,3,2.25
8,6,erupt,5,186,2,3,2.25
8,6,escalate,8,187,1,7,11.5
8,6,escape,6,188,4,2,2
8,6,eternal,7,189,1,6,11
8,6,ethic,5,190,2,3,2.5
8,6,ethical,7,191,5,2,2
8,6,every,5,192,1,4,2.75
8,6,everyday,8,193,5,3,2.5
8,6,evolve,6,194,2,4,11.5
8,6,example,7,195,1,6,4.25
8,6,exclude,7,196,2,5,12.5
8,6,expected,8,197,2,6,4.25
8,6,explicit,8,198,3,5,4
8,6,export,6,199,3,3,12.75
8,6,facility,8,200,0,8,5.5
8,6,faction,7,201,3,4,14.25
8,6,factor,6,202,4,2,2.5
8,6,fairness,8,203,2,6,4.5
8,6,familiar,8,204,2,6,12.75
8,6,favour,6,205,2,4,3
8,6,feather,7,206,1,6,4
8,6,feature,7,207,4,3,9.25
8,6,feedback,8,208,2,6,4.25
8,6,feel,4,209,3,1,1.25
8,6,feeling,7,210,4,3,2.5
8,6,fence,5,211,2,3,2.25
8,6,festival,8,212,2,6,11
8,6,fifth,5,213,1,4,2.75
8,6,fighting,8,214,2,6,11.25
8,6,figure,6,215,3,3,2.5
8,6,fill,4,216,2,2,1.5
8,6,final,5,217,2,3,2.25
8,6,find,4,218,3,1,1
8,6,finish,6,219,3,3,9.75
8,6,firework,8,220,2,6,4.25
8,6,fit,3,221,2,1,1
8,6,five,4,222,2,2,1.75
8,6,flaw,4,223,1,3,2.25
8,6,flawed,6,224,4,2,9.25
8,6,fleet,5,225,2,3,2.25
8,6,flour,5,226,2,3,2.25
8,6,fold,4,227,1,3,2
8,6,fool,4,228,2,2,1.75
8,6,forest,6,229,2,4,10.25
8,6,forge,5,230,3,2,1.75
8,6,fork,4,231,3,1,1.25
8,6,forum,5,232,3,2,1.75
8,6,frame,5,233,1,4,2.75
8,6,freeze,6,234,2,4,9.75
8,6,from,4,235,2,2,1.5
8,6,fruit,5,236,2,3,2.25
8,6,fun,3,237,1,2,1.5
8,6,function,8,238,3,5,10.5
8,6,funny,5,239,3,2,1.75
8,6,gambling,8,240,0,8,5
8,6,gentle,6,241,1,5,10.5
8,6,ghost,5,242,1,4,2.75
8,6,glad,4,243,1,3,2
8,6,golden,6,244,1,5,10.5
8,6,grain,5,245,1,4,3
8,6,grand,5,246,3,2,1.75
8,6,grant,5,247,4,1,1.5
8,6,greatly,7,248,2,5,10.5
8,6,hand,4,249,0,4,2.5
8,6,hear,4,250,1,3,2.25
8,6,hence,5,251,2,3,2.25
8,6,here,4,252,2,2,1.75
8,6,hero,4,253,3,1,8.25
8,6,hide,4,254,1,3,2.25
8,6,hill,4,255,2,2,1.75
8,6,himself,7,256,2,5,3.5
8,6,history,7,257,2,5,10.25
8,6,hobby,5,258,1,4,3
8,6,hockey,6,259,2,4,3
8,6,hold,4,260,2,2,1.75
8,6,homeless,8,261,2,6,11
8,6,honour,6,262,2,4,2.75
8,6,hope,4,263,2,2,1.5
8,6,horizon,7,264,2,5,10.5
8,6,hostile,7,265,2,5,3.5
8,6,housing,7,266,2,5,3.5
8,6,hungry,6,267,1,5,10.25
8,6,hurry,5,268,2,3,2.25
8,6,ideology,8,269,0,8,12
8,6,illness,7,270,1,6,4
8,6,imminent,8,271,1,7,12
8,6,impact,6,272,2,4,3
8,6,impress,7,273,3,4,3.25
8,6,increase,8,274,1,7,20.5
8,6,indeed,6,275,2,4,505.75
8,6,indoor,6,276,3,3,3.5
8,6,indulge,7,277,3,4,4.5
8,6,infect,6,278,2,4,10.25
8,6,innocent,8,279,2,6,5
8,6,insect,6,280,2,4,2
8,6,insider,7,281,3,4,8
8,6,insight,7,282,4,3,2
8,6,inspire,7,283,3,4,2.25
8,6,insult,6,284,3,3,1.75
8,6,interact,8,285,2,6,7.25
8,6,investor,8,286,2,6,2.5
8,6,invoke,6,287,3,3,1.75
8,6,jam,3,288,0,3,7.25
8,6,jeans,5,289,1,4,3.75
8,6,join,4,290,1,3,2.75
8,6,justice,7,291,1,6,8.25
8,6,kidnap,6,292,0,6,2
8,6,killing,7,293,2,5,1.75
8,6,kiss,4,294,2,2,4
8,6,knock,5,295,1,4,1.25
8,6,ladder,6,296,0,6,1.75
8,6,lamp,4,297,2,2,4.25
8,6,landing,7,298,2,5,1.75
8,6,lane,4,299,3,1,0.75
8,6,laptop,6,300,2,4,1.5
8,6,late,4,301,2,2,1
8,6,lately,6,302,4,2,4.25
8,6,lawsuit,7,303,2,5,1.75
8,6,lawyer,6,304,3,3,1.25
8,6,lead,4,305,1,3,1
8,6,learn,5,306,3,2,4.25
8,6,leave,5,307,3,2,0.75
8,6,legal,5,308,2,3,1.25
8,6,less,4,309,2,2,0.75
8,6,lesson,6,310,4,2,0.75
8,6,let,3,311,2,1,0.5
8,6,likewise,8,312,1,7,5.75
8,6,linger,6,313,2,4,1.5
8,6,listener,8,314,2,6,5.5
8,6,loan,4,315,1,3,1
8,6,lobby,5,316,2,3,1
8,6,logo,4,317,2,2,0.75
8,6,loss,4,318,2,2,0.75
8,6,lovely,6,319,2,4,4.75
8,6,lung,4,320,1,3,1
8,6,mall,4,321,0,4,1.25
8,6,marathon,8,322,2,6,5.25
8,6,marginal,8,323,3,5,1.75
8,6,marker,6,324,3,3,1.25
8,6,marry,5,325,3,2,0.75
8,6,mate,4,326,2,2,4.5
8,6,matter,6,327,3,3,1.25
8,6,mayor,5,328,2,3,1
8,6,meaning,7,329,1,6,2
8,6,measure,7,330,3,4,5.25
8,6,meet,4,331,2,2,0.75
8,6,menu,4,332,2,2,0.75
8,6,metaphor,8,333,2,6,1.75
8,6,mile,4,334,1,3,4.75
8,6,military,8,335,3,5,1.75
8,6,miner,5,336,2,3,1
8,6,minimize,8,337,3,5,6
8,6,mining,6,338,4,2,1.25
8,6,minor,5,339,3,2,1
8,6,minority,8,340,5,3,1.25
8,6,minute,6,341,3,3,1.25
8,6,miracle,7,342,2,5,5.75
8,6,missile,7,343,2,5,1.75
8,6,mistake,7,344,3,4,1.5
8,6,mobile,6,345,1,5,5.5
8,6,mode,4,346,2,2,0.75
8,6,modern,6,347,4,2,1
8,6,monk,4,348,2,2,0.75
8,6,motor,5,349,2,3,1
8,6,mount,5,350,2,3,5.25
8,6,movement,8,351,2,6,2
8,6,musical,7,352,1,6,5.75
8,6,myself,6,353,1,5,1.75
8,6,national,8,354,0,8,10.25
8,6,neglect,7,355,1,6,4
8,6,nerve,5,356,2,3,2.5
8,6,net,3,357,2,1,1.25
8,6,network,7,358,3,4,9.25
8,6,news,4,359,2,2,1.75
8,6,next,4,360,2,2,1.75
8,6,nineteen,8,361,1,7,4.5
8,6,nod,3,362,1,2,7.5
8,6,nonsense,8,363,2,6,4.75
8,6,notable,7,364,2,5,3.75
8,6,notably,7,365,6,1,1.5
8,6,now,3,366,2,1,6.75
8,6,nursing,7,367,1,6,4
8,6,obey,4,368,0,4,2.5
8,6,obtain,6,369,2,4,8.75
8,6,occasion,8,370,1,7,4.75
8,6,occur,5,371,3,2,2
8,6,of,2,372,1,1,0.75
8,6,on,2,373,1,1,0.75
8,6,onion,5,374,2,3,7.75
8,6,open,4,375,1,3,2
8,6,operate,7,376,3,4,3
8,6,operator,8,377,6,2,2
8,6,optimism,8,378,2,6,9.75
8,6,or,2,379,1,1,0.75
8,6,oral,4,380,2,2,1.5
8,6,orange,6,381,3,3,2.25
8,6,order,5,382,2,3,2
8,6,organize,8,383,2,6,9.5
8,6,our,3,384,1,2,1.5
8,6,outrage,7,385,2,5,3.5
8,6,oven,4,386,1,3,7.75
8,6,over,4,387,3,1,1.25
8,6,overly,6,388,4,2,2
8,6,own,3,389,1,2,1.5
8,6,packet,6,390,0,6,3.75
8,6,palm,4,391,2,2,7.25
8,6,pan,3,392,2,1,1
8,6,parent,6,393,2,4,2.75
8,6,partly,6,394,3,3,2.25
8,6,pass,4,395,2,2,1.5
8,6,passion,7,396,4,3,8.25
8,6,payment,7,397,2,5,3.75
8,6,pension,7,398,1,6,4
8,6,people,6,399,2,4,9
8,6,petition,8,400,2,6,4
8,6,phase,5,401,1,4,2.75
8,6,pilot,5,402,1,4,8.25
8,6,pit,3,403,2,1,1
8,6,pitch,5,404,3,2,1.75
8,6,planet,6,405,1,5,3.5
8,6,plate,5,406,3,2,1.75
8,6,player,6,407,3,3,8.25
8,6,pleasure,8,408,2,6,4.25
8,6,plug,4,409,2,2,1.75
8,6,poet,4,410,1,3,7.75
8,6,poetry,6,411,4,2,2
8,6,pole,4,412,2,2,1.75
8,6,policy,6,413,3,3,2.5
8,6,politics,8,414,4,4,3.25
8,6,popular,7,415,2,5,9.25
8,6,portray,7,416,2,5,3.5
8,6,pose,4,417,2,2,1.5
8,6,powerful,8,418,2,6,9.75
8,6,practice,8,419,1,7,4.5
8,6,pray,4,420,3,1,1.25
8,6,preach,6,421,2,4,8.75
8,6,premium,7,422,3,4,3.25
8,6,prepare,7,423,3,4,3
8,6,price,5,424,2,3,2.25
8,6,priest,6,425,3,3,8.25
8,6,prince,6,426,3,3,2.5
8,6,princess,8,427,6,2,2
8,6,prison,6,428,3,3,2.5
8,6,prisoner,8,429,6,2,2
8,6,probable,8,430,2,6,9.75
8,6,protect,7,431,3,4,3.5
8,6,provide,7,432,3,4,3
8,6,provoke,7,433,4,3,8.25
8,6,pub,3,434,1,2,1.5
8,6,punch,5,435,2,3,2.25
8,6,purchase,8,436,2,6,4
8,6,pursue,6,437,3,3,8.75
8,6,quarter,7,438,0,7,4.5
8,6,queue,5,439,2,3,2.25
8,6,quota,5,440,2,3,8
8,6,quote,5,441,4,1,1.25
8,6,racist,6,442,0,6,3.75
8,6,radio,5,443,2,3,2.25
8,6,random,6,444,2,4,8.75
8,6,range,5,445,3,2,1.75
8,6,read,4,446,1,3,2
8,6,readily,7,447,4,3,2.25
8,6,real,4,448,3,1,1
8,6,realize,7,449,4,3,8.25
8,6,receive,7,450,2,5,3.5
8,6,receiver,8,451,7,1,1.25
8,6,recovery,8,452,3,5,4.25
8,6,refugee,7,453,2,5,10
8,6,regret,6,454,2,4,2.75
8,6,relaxing,8,455,2,6,9.75
8,6,release,7,456,3,4,3
8,6,rely,4,457,3,1,1.25
8,6,remains,7,458,2,5,3.75
8,6,reminder,8,459,3,5,9.5
8,6,remote,6,460,3,3,2.25
8,6,renowned,8,461,2,6,4
8,6,report,6,462,2,4,9.25
8,6,reporter,8,463,6,2,2.25
8,6,reverse,7,464,2,5,3.5
8,6,review,6,465,3,3,2.5
8,6,rhetoric,8,466,1,7,10.5
8,6,rhythm,6,467,2,4,3
8,6,rice,4,468,1,3,2
8,6,route,5,469,1,4,9
8,6,run,3,470,1,2,1.5
8,6,runner,6,471,3,3,2.25
8,6,sanction,8,472,0,8,11.25
8,6,say,3,473,2,1,1
8,6,scope,5,474,1,4,2.75
8,6,scratch,7,475,2,5,3.5
8,6,script,6,476,3,3,9
8,6,section,7,477,1,6,4
8,6,see,3,478,2,1,1
8,6,seize,5,479,2,3,2.25
8,6,seldom,6,480,2,4,8.75
8,6,senator,7,481,2,5,3.5
8,6,send,4,482,3,1,1.25
8,6,serial,6,483,2,4,2.75
8,6,set,3,484,2,1,7.5
8,6,seventy,7,485,2,5,3.5
8,6,shake,5,486,1,4,3
8,6,shall,5,487,3,2,1.75
8,6,sheet,5,488,2,3,8.25
8,6,shine,5,489,2,3,2.25
8,6,shock,5,490,2,3,2.25
8,6,shot,4,491,3,1,1.25
8,6,should,6,492,3,3,2.5
8,6,shrink,6,493,2,4,8.75
8,6,sigh,4,494,1,3,2.25
8,6,silence,7,495,2,5,3.5
8,6,silent,6,496,5,1,1.25
8,6,sing,4,497,2,2,1.75
8,6,skill,5,498,1,4,8.5
8,6,slogan,6,499,1,5,3.5
8,6,smart,5,500,1,4,2.75
8,6,soak,4,501,1,3,8.5
8,6,soccer,6,502,2,4,3.25
8,6,software,8,503,2,6,4.5
8,6,soldier,7,504,2,5,9.5
8,6,solely,6,505,3,3,2.5
8,6,soon,4,506,2,2,1.75
8,6,sorry,5,507,2,3,2.25
8,6,sort,4,508,3,1,1.25
8,6,spicy,5,509,1,4,9
8,6,spill,5,510,3,2,2
8,6,split,5,511,2,3,2.25
8,6,spoil,5,512,2,3,2.25
8,6,sponsor,7,513,3,4,9
8,6,spot,4,514,3,1,1.25
8,6,stage,5,515,1,4,2.75
8,6,steel,5,516,2,3,2.25
8,6,stiff,5,517,2,3,2.25
8,6,stream,6,518,2,4,8.75
8,6,stress,6,519,4,2,2
8,6,struggle,8,520,3,5,3.75
8,6,student,7,521,2,5,9.75
8,6,stunning,8,522,3,5,3.75
8,6,style,5,523,2,3,2.25
8,6,suburb,6,524,1,5,9.5
8,6,sum,3,525,2,1,1
8,6,summit,6,526,3,3,2.25
8,6,surge,5,527,2,3,2.25
8,6,survive,7,528,3,4,3
8,6,sustain,7,529,2,5,9.5
8,6,sweet,5,530,1,4,2.75
8,6,swimming,8,531,2,6,10.25
8,6,swing,5,532,3,2,2
8,6,tag,3,533,0,3,2
8,6,talented,8,534,2,6,4
8,6,teach,5,535,1,4,8
8,6,teenager,8,536,2,6,2.25
8,6,tent,4,537,2,2,1
8,6,terrible,8,538,2,6,5.75
8,6,theatre,7,539,1,6,1.75
8,6,their,5,540,3,2,1
8,6,them,4,541,3,1,0.75
8,6,then,4,542,3,1,0.5
8,6,theology,8,543,3,5,5.5
8,6,they,4,544,3,1,0.75
8,6,thing,5,545,2,3,1
8,6,think,5,546,4,1,0.5
8,6,thinking,8,547,5,3,1
8,6,threat,6,548,2,4,5.25
8,6,threaten,8,549,6,2,1
8,6,thrive,6,550,3,3,1
8,6,throat,6,551,3,3,1
8,6,throw,5,552,4,1,0.75
8,6,thursday,8,553,2,6,6
8,6,timber,6,554,1,5,1.5
8,6,tiny,4,555,2,2,0.75
8,6,tired,5,556,2,3,5
8,6,toll,4,557,1,3,1
8,6,ton,3,558,2,1,0.5
8,6,tone,4,559,3,1,0.5
8,6,total,5,560,2,3,1
8,6,tourist,7,561,2,5,5
8,6,towards,7,562,2,5,1.75
8,6,towel,5,563,3,2,0.75
8,6,tribunal,8,564,1,7,5.75
8,6,trust,5,565,2,3,1
8,6,try,3,566,2,1,0.5
8,6,tuesday,7,567,1,6,1.75
8,6,tuition,7,568,2,5,5.75
8,6,turn,4,569,2,2,0.75
8,6,turnout,7,570,4,3,1.25
8,6,twist,5,571,1,4,1.25
8,6,type,4,572,1,3,5
8,6,typical,7,573,3,4,1.5
8,6,ugly,4,574,0,4,1.25
8,6,umbrella,8,575,1,7,6
8,6,unfold,6,576,1,5,1.5
8,6,unit,4,577,2,2,0.75
8,6,unlikely,8,578,2,6,6
8,6,up,2,579,1,1,0.5
8,6,upset,5,580,2,3,1
8,6,upwards,7,581,2,5,1.5
8,6,us,2,582,1,1,4.25
8,6,use,3,583,2,1,0.5
8,6,user,4,584,3,1,0.5
8,6,utterly,7,585,1,6,1.75
8,6,valid,5,586,0,5,1.75
8,6,vast,4,587,2,2,4.75
8,6,very,4,588,1,3,1
8,6,vicious,7,589,1,6,1.75
8,6,village,7,590,2,5,5.5
8,6,wage,4,591,0,4,1.25
8,6,wall,4,592,2,2,0.75
8,6,want,4,593,2,2,0.75
8,6,warm,4,594,2,2,0.75
8,6,wash,4,595,2,2,4.75
8,6,we,2,596,1,1,0.5
8,6,weak,4,597,2,2,0.75
8,6,wear,4,598,3,1,0.5
8,6,website,7,599,2,5,1.5
8,6,what,4,600,1,3,1
8,6,wheat,5,601,2,3,5
8,6,where,5,602,3,2,1
8,6,whisper,7,603,2,5,1.75
8,6,who,3,604,2,1,0.5
8,6,whole,5,605,3,2,0.75
8,6,wholly,6,606,4,2,5.25
8,6,widely,6,607,1,5,1.75
8,6,winner,6,608,2,4,1.25
8,6,wooden,6,609,1,5,5.75
8,6,worse,5,610,2,3,1.25
8,6,worst,5,611,4,1,0.75
8,6,year,4,612,0,4,1.25
8,6,yell,4,613,2,2,0.75
8,6,you,3,614,1,2,4.75
8,6,zone,4,615,0,4,1.25
8,7,able,4,0,0,4,1
8,7,abolish,7,1,2,5,5.25
8,7,abroad,6,2,2,4,1.25
8,7,academy,7,3,1,6,1.75
8,7,account,7,4,2,5,5.25
8,7,accuracy,8,5,3,5,1.75
8,7,acquire,7,6,2,5,5.25
8,7,act,3,7,2,1,0.5
8,7,adult,5,8,1,4,1.25
8,7,affair,6,9,1,5,1.5
8,7,afford,6,10,3,3,5.25
8,7,afraid,6,11,2,4,1.5
8,7,agent,5,12,1,4,1.25
8,7,aid,3,13,1,2,0.75
8,7,air,3,14,2,1,0.5
8,7,aircraft,8,15,3,5,5.75
8,7,alert,5,16,1,4,1.5
8,7,alien,5,17,2,3,1
8,7,alike,5,18,3,2,1
8,7,all,3,19,2,1,4.25
8,7,alliance,8,20,3,5,1.75
8,7,alone,5,21,2,3,1
8,7,along,5,22,4,1,0.5
8,7,also,4,23,2,2,0.75
8,7,although,8,24,2,6,6
8,7,amid,4,25,1,3,1
8,7,angel,5,26,1,4,1.25
8,7,angry,5,27,3,2,1
8,7,answer,6,28,2,4,5.5
8,7,apply,5,29,1,4,1.25
8,7,april,5,30,2,3,1.25
8,7,archive,7,31,1,6,5.75
8,7,armed,5,32,2,3,1
8,7,arrival,7,33,2,5,1.5
8,7,article,7,34,2,5,5.5
8,7,assess,6,35,1,5,1.5
8,7,assign,6,36,3,3,1.25
8,7,athlete,7,37,1,6,5.75
8,7,attach,6,38,2,4,1.5
8,7,attend,6,39,3,3,1.25
8,7,audit,5,40,1,4,5.5
8,7,away,4,41,1,3,1
8,7,back,4,42,0,4,1.25
8,7,backdrop,8,43,4,4,1.25
8,7,bare,4,44,2,2,5
8,7,bear,4,45,1,3,1
8,7,because,7,46,2,5,1.5
8,7,behind,6,47,2,4,1.25
8,7,being,5,48,2,3,5.5
8,7,bend,4,49,2,2,1
8,7,beneath,7,50,3,4,1.5
8,7,beside,6,51,2,4,1.5
8,7,bet,3,52,2,1,0.5
8,7,bicycle,7,53,1,6,6
8,7,big,3,54,2,1,0.5
8,7,biology,7,55,2,5,1.5
8,7,blast,5,56,1,4,5.25
8,7,blood,5,57,2,3,1.25
8,7,bond,4,58,1,3,1
8,7,bonus,5,59,3,2,0.75
8,7,boring,6,60,2,4,5.5
8,7,brain,5,61,1,4,1.25
8,7,branch,6,62,3,3,1.25
8,7,breast,6,63,2,4,1.25
8,7,brick,5,64,2,3,5.5
8,7,briefly,7,65,3,4,1.5
8,7,broad,5,66,2,3,1
8,7,broadly,7,67,5,2,0.75
8,7,brother,7,68,3,4,5.25
8,7,brown,5,69,3,2,1
8,7,building,8,70,1,7,2
8,7,bulk,4,71,2,2,0.75
8,7,burial,6,72,2,4,5.25
8,7,burst,5,73,3,2,1
8,7,bus,3,74,2,1,0.5
8,7,but,3,75,2,1,0.5
8,7,button,6,76,3,3,1
8,7,cabin,5,77,0,5,5.75
8,7,camp,4,78,2,2,0.75
8,7,captain,7,79,2,5,1.5
8,7,capture,7,80,4,3,1.25
8,7,carrot,6,81,2,4,5.75
8,7,case,4,82,2,2,0.75
8,7,cautious,8,83,2,6,2
8,7,cent,4,84,1,3,1
8,7,chat,4,85,1,3,5.25
8,7,cheek,5,86,2,3,1
8,7,cinema,6,87,1,5,1.5
8,7,clarify,7,88,1,6,5.75
8,7,class,5,89,3,2,1
8,7,classify,8,90,5,3,1.5
8,7,cleaning,8,91,2,6,6
8,7,climb,5,92,2,3,1
8,7,cling,5,93,3,2,1
8,7,close,5,94,2,3,1
8,7,closure,7,95,4,3,1
8,7,cloth,5,96,3,2,5
8,7,clothing,8,97,5,3,1.5
8,7,clue,4,98,2,2,0.75
8,7,coastal,7,99,1,6,1.75
8,7,coin,4,100,2,2,5
8,7,college,7,101,2,5,1.75
8,7,coloured,8,102,3,5,2
8,7,commerce,8,103,2,6,6
8,7,common,6,104,4,2,1.25
8,7,complain,8,105,3,5,1.75
8,7,complex,7,106,5,2,1.25
8,7,concrete,8,107,2,6,6.5
8,7,confirm,7,108,3,4,2
8,7,conserve,8,109,3,5,1.75
8,7,consume,7,110,4,3,5.75
8,7,contact,7,111,3,4,1.75
8,7,contest,7,112,4,3,1.25
8,7,context,7,113,5,2,1.25
8,7,convert,7,114,3,4,6
8,7,cooking,7,115,2,5,1.75
8,7,cool,4,116,3,1,0.75
8,7,copy,4,117,2,2,0.75
8,7,corrupt,7,118,2,5,5.75
8,7,cotton,6,119,2,4,1.25
8,7,council,7,120,2,5,1.5
8,7,covered,7,121,2,5,6
8,7,crack,5,122,1,4,1.25
8,7,crash,5,123,3,2,1
8,7,crazy,5,124,3,2,0.75
8,7,cream,5,125,2,3,5.5
8,7,creative,8,126,4,4,2
8,7,creator,7,127,5,2,1.25
8,7,critique,8,128,2,6,2
8,7,crop,4,129,2,2,5.25
8,7,cue,3,130,1,2,0.75
8,7,cult,4,131,2,2,0.75
8,7,cupboard,8,132,2,6,2
8,7,cure,4,133,2,2,1
8,7,custom,6,134,2,4,5.75
8,7,cutting,7,135,2,5,1.75
8,7,dad,3,136,0,3,1
8,7,dancer,6,137,2,4,5.75
8,7,dark,4,138,2,2,0.75
8,7,database,8,139,2,6,2
8,7,date,4,140,3,1,0.75
8,7,daughter,8,141,2,6,7.25
8,7,deadly,6,142,1,5,3.5
8,7,dear,4,143,3,1,1.25
8,7,decorate,8,144,2,6,11.25
8,7,define,6,145,2,4,2.75
8,7,defy,4,146,3,1,1.25
8,7,delivery,8,147,2,6,4
8,7,depend,6,148,2,4,10.75
8,7,descend,7,149,2,5,3.75
8,7,desert,6,150,3,3,2.5
8,7,desire,6,151,3,3,10.75
8,7,detail,6,152,2,4,3
8,7,devise,6,153,2,4,3.25
8,7,dialogue,8,154,1,7,11.5
8,7,dip,3,155,2,1,1
8,7,directly,8,156,2,6,4
8,7,disagree,8,157,2,6,10.75
8,7,dispose,7,158,3,4,3
8,7,disrupt,7,159,3,4,3.25
8,7,distract,8,160,3,5,11.25
8,7,district,8,161,5,3,3
8,7,disturb,7,162,4,3,3
8,7,diverse,7,163,2,5,3.5
8,7,donor,5,164,1,4,11
8,7,drag,4,165,1,3,2.25
8,7,draw,4,166,3,1,1.25
8,7,dress,5,167,2,3,2.5
8,7,driver,6,168,2,4,10.5
8,7,drown,5,169,2,3,2.5
8,7,drunk,5,170,2,3,2.5
8,7,dry,3,171,2,1,1
8,7,due,3,172,1,2,1.75
8,7,dull,4,173,2,2,1.75
8,7,dump,4,174,2,2,9
8,7,during,6,175,2,4,3
8,7,easily,6,176,0,6,3.75
8,7,educated,8,177,1,7,12
8,7,eighteen,8,178,1,7,5
8,7,election,8,179,1,7,13.25
8,7,electric,8,180,5,3,2.75
8,7,element,7,181,3,4,3.25
8,7,elevate,7,182,3,4,10.5
8,7,else,4,183,2,2,1.75
8,7,embed,5,184,1,4,3
8,7,emerge,6,185,2,4,3.25
8,7,endorse,7,186,1,6,11
8,7,enforce,7,187,2,5,3.5
8,7,enough,6,188,2,4,10
8,7,enquire,7,189,2,5,3.75
8,7,ensue,5,190,2,3,2.25
8,7,entity,6,191,2,4,3
8,7,equation,8,192,1,7,11.75
8,7,era,3,193,1,2,1.5
8,7,error,5,194,2,3,2.25
8,7,eternal,7,195,1,6,12
8,7,ethic,5,196,2,3,2.5
8,7,ethnic,6,197,3,3,2.75
8,7,every,5,198,1,4,2.75
8,7,evil,4,199,2,2,9.25
8,7,evolve,6,200,2,4,3.25
8,7,exam,4,201,1,3,2.25
8,7,example,7,202,4,3,2.5
8,7,excess,6,203,2,4,12
8,7,expected,8,204,2,6,5.25
8,7,explicit,8,205,3,5,16
8,7,fabulous,8,206,0,8,6
8,7,facility,8,207,2,6,12.25
8,7,factory,7,208,3,4,3.25
8,7,faith,5,209,2,3,2.25
8,7,fan,3,210,2,1,1
8,7,feat,4,211,1,3,2.25
8,7,feather,7,212,4,3,9.5
8,7,feedback,8,213,2,6,4.25
8,7,figure,6,214,1,5,3.25
8,7,fill,4,215,2,2,8.75
8,7,filter,6,216,3,3,2.5
8,7,find,4,217,2,2,1.5
8,7,finger,6,218,3,3,2.5
8,7,finish,6,219,3,3,2.5
8,7,fire,4,220,2,2,8.5
8,7,fish,4,221,2,2,1.75
8,7,fishing,7,222,4,3,2.25
8,7,fit,3,223,2,1,1
8,7,five,4,224,2,2,1.5
8,7,flame,5,225,1,4,2.75
8,7,flaw,4,226,3,1,8
8,7,float,5,227,2,3,2.25
8,7,flood,5,228,3,2,1.75
8,7,flour,5,229,3,2,1.75
8,7,fluid,5,230,2,3,2.25
8,7,fond,4,231,1,3,9
8,7,fool,4,232,2,2,1.75
8,7,forecast,8,233,2,6,4
8,7,forest,6,234,4,2,2
8,7,forgive,7,235,3,4,10
8,7,fork,4,236,3,1,1.25
8,7,formal,6,237,3,3,2.5
8,7,format,6,238,5,1,1.25
8,7,forth,5,239,3,2,1.75
8,7,frame,5,240,1,4,2.75
8,7,freeze,6,241,2,4,10.25
8,7,fun,3,242,1,2,1.5
8,7,fund,4,243,3,1,1
8,7,gambling,8,244,0,8,12.25
8,7,gas,3,245,2,1,1
8,7,generic,7,246,1,6,4
8,7,ghost,5,247,1,4,2.75
8,7,glad,4,248,1,3,9
8,7,goal,4,249,1,3,2
8,7,golden,6,250,2,4,3
8,7,goods,5,251,2,3,2.25
8,7,grain,5,252,1,4,10
8,7,grand,5,253,3,2,2
8,7,grant,5,254,4,1,1.5
8,7,great,5,255,2,3,2.25
8,7,greatly,7,256,5,2,1.75
8,7,guard,5,257,1,4,9.75
8,7,half,4,258,0,4,2.5
8,7,halt,4,259,3,1,1
8,7,hardware,8,260,2,6,4
8,7,harmony,7,261,3,4,10
8,7,hatred,6,262,2,4,2.75
8,7,he,2,263,1,1,0.75
8,7,hearing,7,264,2,5,3.5
8,7,help,4,265,2,2,8.75
8,7,hence,5,266,2,3,2.5
8,7,here,4,267,2,2,1.5
8,7,hidden,6,268,1,5,3.25
8,7,hide,4,269,3,1,1.25
8,7,himself,7,270,2,5,10.5
8,7,history,7,271,2,5,3.5
8,7,holy,4,272,1,3,2.25
8,7,homeless,8,273,2,6,11.75
8,7,homework,8,274,4,4,3.25
8,7,honour,6,275,2,4,2.75
8,7,hook,4,276,2,2,9.25
8,7,horizon,7,277,2,5,3.75
8,7,hungry,6,278,1,5,3.5
8,7,husband,7,279,2,5,10.5
8,7,ideology,8,280,0,8,5
8,7,ignore,6,281,1,5,17.75
8,7,imminent,8,282,1,7,411.75
8,7,impress,7,283,2,5,2.75
8,7,in,2,284,1,1,0.5
8,7,inclined,8,285,2,6,11.5
8,7,indoor,6,286,2,4,3.75
8,7,induce,6,287,3,3,2.75
8,7,indulge,7,288,4,3,7.5
8,7,inmate,6,289,2,4,2
8,7,input,5,290,2,3,1.5
8,7,insider,7,291,2,5,2.25
8,7,insight,7,292,4,3,9.25
8,7,inspire,7,293,3,4,3.5
8,7,interact,8,294,2,6,3.25
8,7,invent,6,295,2,4,8.5
8,7,invoke,6,296,3,3,1.75
8,7,justice,7,297,0,7,2.75
8,7,keen,4,298,0,4,10
8,7,kill,4,299,1,3,1.25
8,7,killing,7,300,4,3,1.25
8,7,ladder,6,301,0,6,5.75
8,7,lamp,4,302,2,2,1
8,7,landing,7,303,2,5,1.75
8,7,landlord,8,304,4,4,1.5
8,7,laptop,6,305,2,4,5.25
8,7,lawsuit,7,306,2,5,1.75
8,7,layout,6,307,2,4,1.5
8,7,leave,5,308,1,4,5
8,7,leisure,7,309,2,5,1.75
8,7,lend,4,310,2,2,0.75
8,7,length,6,311,3,3,1.25
8,7,level,5,312,2,3,5
8,7,lifetime,8,313,1,7,2.25
8,7,literacy,8,314,2,6,5.75
8,7,lively,6,315,2,4,1.5
8,7,loan,4,316,1,3,1
8,7,logic,5,317,2,3,1
8,7,loom,4,318,2,2,4.75
8,7,lower,5,319,2,3,1.25
8,7,magazine,8,320,0,8,2.25
8,7,magical,7,321,3,4,5.25
8,7,major,5,322,2,3,1
8,7,mall,4,323,2,2,0.75
8,7,man,3,324,2,1,0.5
8,7,manner,6,325,3,3,1
8,7,march,5,326,2,3,4.75
8,7,marriage,8,327,3,5,2
8,7,matching,8,328,2,6,1.75
8,7,mate,4,329,3,1,0.5
8,7,maybe,5,330,2,3,5
8,7,measure,7,331,1,6,1.75
8,7,menu,4,332,2,2,1
8,7,mile,4,333,1,3,4.75
8,7,military,8,334,3,5,2
8,7,milk,4,335,3,1,0.75
8,7,mill,4,336,3,1,0.75
8,7,mining,6,337,2,4,1.25
8,7,minority,8,338,3,5,5.75
8,7,mistake,7,339,2,5,1.75
8,7,mobile,6,340,1,5,1.5
8,7,monitor,7,341,2,5,5.75
8,7,monk,4,342,3,1,1.25
8,7,moral,5,343,2,3,2.25
8,7,motive,6,344,2,4,2.75
8,7,motorist,8,345,3,5,9.25
8,7,mountain,8,346,2,6,4.5
8,7,movement,8,347,2,6,10
8,7,multiply,8,348,1,7,4.5
8,7,musical,7,349,2,5,9.25
8,7,myself,6,350,1,5,3.25
8,7,mystery,7,351,3,4,3
8,7,native,6,352,0,6,9.5
8,7,neglect,7,353,1,6,4
8,7,nerve,5,354,2,3,2.25
8,7,nineteen,8,355,1,7,10.5
8,7,noble,5,356,1,4,2.75
8,7,nod,3,357,2,1,1
8,7,nonsense,8,358,2,6,9.75
8,7,nose,4,359,2,2,1.75
8,7,now,3,360,2,1,1
8,7,number,6,361,1,5,3.25
8,7,nurse,5,362,2,3,8
8,7,nursery,7,363,5,2,2.25
8,7,o,1,364,0,1,0.75
8,7,observe,7,365,1,6,3.75
8,7,obvious,7,366,2,5,9
8,7,occasion,8,367,1,7,4.75
8,7,of,2,368,1,1,0.75
8,7,offender,8,369,2,6,9.75
8,7,onion,5,370,1,4,2.75
8,7,onto,4,371,2,2,1.75
8,7,open,4,372,1,3,2
8,7,operator,8,373,3,5,9
8,7,orange,6,374,1,5,3.5
8,7,organize,8,375,2,6,4.25
8,7,our,3,376,1,2,7
8,7,over,4,377,1,3,2.25
8,7,owner,5,378,1,4,2.75
8,7,palm,4,379,0,4,2.5
8,7,pan,3,380,2,1,6.75
8,7,parish,6,381,2,4,3
8,7,partly,6,382,3,3,2.5
8,7,passage,7,383,2,5,3.5
8,7,pathway,7,384,2,5,9.25
8,7,peak,4,385,1,3,2.25
8,7,pension,7,386,2,5,3.5
8,7,period,6,387,2,4,8.25
8,7,person,6,388,3,3,2.5
8,7,persuade,8,389,4,4,3.25
8,7,physics,7,390,1,6,9.5
8,7,pill,4,391,1,3,2
8,7,pilot,5,392,3,2,1.75
8,7,pink,4,393,2,2,1.75
8,7,pitch,5,394,2,3,2.25
8,7,plain,5,395,1,4,8.5
8,7,planet,6,396,3,3,2.5
8,7,plate,5,397,3,2,1.75
8,7,player,6,398,3,3,2.25
8,7,pleasure,8,399,2,6,9.75
8,7,plunge,6,400,2,4,3
8,7,poetry,6,401,1,5,3.25
8,7,policy,6,402,2,4,9.5
8,7,port,4,403,2,2,1.5
8,7,poverty,7,404,2,5,3.75
8,7,powder,6,405,2,4,8.75
8,7,powerful,8,406,3,5,4
8,7,practice,8,407,1,7,4.75
8,7,pray,4,408,3,1,1.25
8,7,preach,6,409,2,4,8.75
8,7,precede,7,410,3,4,3
8,7,premium,7,411,3,4,3
8,7,present,7,412,3,4,8.75
8,7,priest,6,413,2,4,3
8,7,princess,8,414,3,5,3.75
8,7,probable,8,415,2,6,9.75
8,7,probably,8,416,7,1,1.75
8,7,proceed,7,417,3,4,3
8,7,promote,7,418,3,4,3
8,7,protect,7,419,3,4,8.75
8,7,protocol,8,420,4,4,3.25
8,7,provide,7,421,3,4,3
8,7,province,8,422,5,3,8.5
8,7,purchase,8,423,1,7,4.5
8,7,pursue,6,424,3,3,2.5
8,7,quarter,7,425,0,7,10.25
8,7,queen,5,426,2,3,2.25
8,7,question,8,427,3,5,3.75
8,7,queue,5,428,3,2,7.75
8,7,quickly,7,429,2,5,3.75
8,7,quota,5,430,2,3,2.25
8,7,racist,6,431,0,6,9.5
8,7,rain,4,432,2,2,1.75
8,7,range,5,433,2,3,2.25
8,7,rare,4,434,2,2,1.5
8,7,raw,3,435,2,1,1
8,7,read,4,436,1,3,2
8,7,readily,7,437,4,3,8.5
8,7,reading,7,438,5,2,2.25
8,7,real,4,439,3,1,1.25
8,7,realize,7,440,4,3,2.5
8,7,red,3,441,2,1,1
8,7,refuge,6,442,2,4,8.5
8,7,register,8,443,2,6,4.25
8,7,relaxing,8,444,2,6,4
8,7,release,7,445,3,4,9.25
8,7,remains,7,446,2,5,3.5
8,7,remember,8,447,3,5,3.5
8,7,reminder,8,448,3,5,9.25
8,7,remote,6,449,3,3,2.25
8,7,renowned,8,450,2,6,4
8,7,rental,6,451,3,3,8.25
8,7,report,6,452,2,4,2.75
8,7,reporter,8,453,6,2,2
8,7,request,7,454,2,5,9.25
8,7,respect,7,455,2,5,3.5
8,7,retreat,7,456,2,5,3.5
8,7,reverse,7,457,2,5,9.25
8,7,review,6,458,3,3,2.5
8,7,rhetoric,8,459,1,7,4.5
8,7,rice,4,460,1,3,8
8,7,rid,3,461,2,1,1
8,7,riot,4,462,2,2,2
8,7,risk,4,463,2,2,1.75
8,7,rugby,5,464,1,4,2.75
8,7,run,3,465,2,1,1
8,7,saint,5,466,0,5,9
8,7,sandwich,8,467,2,6,4.25
8,7,say,3,468,2,1,1
8,7,scratch,7,469,1,6,9.75
8,7,scream,6,470,3,3,2.5
8,7,script,6,471,3,3,2.5
8,7,sea,3,472,1,2,1.5
8,7,section,7,473,2,5,9.5
8,7,see,3,474,2,1,1
8,7,self,4,475,2,2,1.5
8,7,senator,7,476,2,5,3.5
8,7,send,4,477,3,1,1
8,7,sentence,8,478,3,5,9.5
8,7,serial,6,479,2,4,3
8,7,session,7,480,2,5,3.5
8,7,set,3,481,2,1,1
8,7,several,7,482,2,5,9.5
8,7,shade,5,483,1,4,2.75
8,7,shake,5,484,3,2,1.75
8,7,shall,5,485,3,2,1.75
8,7,shaped,6,486,3,3,8.25
8,7,sheet,5,487,2,3,2.25
8,7,shock,5,488,2,3,2.25
8,7,shocking,8,489,5,3,2.5
8,7,shop,4,490,3,1,1.25
8,7,short,5,491,3,2,8.25
8,7,shot,4,492,3,1,1.25
8,7,should,6,493,3,3,2.5
8,7,shout,5,494,4,1,1.25
8,7,shrink,6,495,2,4,2.75
8,7,shrug,5,496,3,2,1.75
8,7,silent,6,497,1,5,9.25
8,7,silly,5,498,3,2,1.75
8,7,sing,4,499,2,2,1.75
8,7,sir,3,500,2,1,1
8,7,size,4,501,2,2,1.5
8,7,skiing,6,502,1,5,9.25
8,7,skill,5,503,3,2,2
8,7,sky,3,504,2,1,1
8,7,slave,5,505,1,4,2.75
8,7,slogan,6,506,2,4,9
8,7,slow,4,507,3,1,1.25
8,7,small,5,508,1,4,2.75
8,7,smash,5,509,3,2,1.75
8,7,society,7,510,1,6,9.75
8,7,software,8,511,2,6,4.25
8,7,solely,6,512,2,4,3
8,7,somebody,8,513,2,6,10.25
8,7,soon,4,514,2,2,1.75
8,7,sorry,5,515,2,3,2.5
8,7,span,4,516,1,3,2.25
8,7,spending,8,517,2,6,10
8,7,spicy,5,518,2,3,2.25
8,7,split,5,519,2,3,2.25
8,7,spot,4,520,2,2,1.25
8,7,spy,3,521,2,1,0.5
8,7,stadium,7,522,1,6,5.75
8,7,status,6,523,3,3,1.25
8,7,steep,5,524,2,3,1.25
8,7,stream,6,525,2,4,5
8,7,strive,6,526,3,3,1.25
8,7,stunning,8,527,2,6,1.75
8,7,suburban,8,528,1,7,5.75
8,7,suffer,6,529,2,4,1.5
8,7,summer,6,530,2,4,1.25
8,7,summit,6,531,4,2,4.75
8,7,superb,6,532,2,4,1.25
8,7,supply,6,533,3,3,1.25
8,7,surge,5,534,2,3,1
8,7,survive,7,535,3,4,5.25
8,7,sweet,5,536,1,4,1.25
8,7,swing,5,537,2,3,1.25
8,7,symbol,6,538,1,5,1.5
8,7,t,1,539,0,1,4
8,7,talented,8,540,1,7,2
8,7,teenage,7,541,1,6,5.75
8,7,teenager,8,542,7,1,1.25
8,7,tennis,6,543,2,4,1.5
8,7,tent,4,544,3,1,0.75
8,7,tenure,6,545,3,3,1
8,7,terminal,8,546,2,6,5.5
8,7,terrain,7,547,3,4,1.5
8,7,terrible,8,548,4,4,1.75
8,7,testify,7,549,2,5,5.75
8,7,testing,7,550,5,2,1
8,7,than,4,551,1,3,1
8,7,theatre,7,552,2,5,1.75
8,7,their,5,553,3,2,5
8,7,theirs,6,554,5,1,1
8,7,there,5,555,3,2,1
8,7,they,4,556,3,1,0.5
8,7,thief,5,557,2,3,1
8,7,thin,4,558,3,1,0.5
8,7,thing,5,559,4,1,0.5
8,7,thinking,8,560,4,4,6
8,7,thought,7,561,2,5,2
8,7,thrive,6,562,2,4,1.25
8,7,thursday,8,563,2,6,5.75
8,7,timber,6,564,1,5,1.5
8,7,tired,5,565,2,3,1
8,7,tomato,6,566,1,5,5.25
8,7,total,5,567,2,3,1.25
8,7,towel,5,568,2,3,1
8,7,training,8,569,1,7,5.75
8,7,transfer,8,570,3,5,1.75
8,7,tribunal,8,571,2,6,1.75
8,7,true,4,572,2,2,4.5
8,7,try,3,573,2,1,0.5
8,7,tunnel,6,574,1,5,1.5
8,7,turnout,7,575,2,5,1.5
8,7,twenty,6,576,1,5,5.5
8,7,twist,5,577,2,3,1
8,7,unfold,6,578,0,6,1.5
8,7,unlike,6,579,2,4,5.25
8,7,unlikely,8,580,6,2,1.25
8,7,upper,5,581,1,4,1.25
8,7,upset,5,582,2,3,1
8,7,use,3,583,1,2,0.75
8,7,user,4,584,3,1,4.5
8,7,valid,5,585,0,5,1.5
8,7,vast,4,586,2,2,0.75
8,7,vehicle,7,587,1,6,5.5
8,7,versus,6,588,2,4,1.5
8,7,very,4,589,3,1,0.75
8,7,vicious,7,590,1,6,1.75
8,7,victim,6,591,3,3,5
8,7,violate,7,592,2,5,1.5
8,7,vitamin,7,593,2,5,1.5
8,7,volume,6,594,1,5,5.5
8,7,vote,4,595,2,2,0.75
8,7,want,4,596,0,4,1.25
8,7,warfare,7,597,2,5,5.5
8,7,wear,4,598,1,3,1
8,7,weather,7,599,3,4,1.5
8,7,website,7,600,2,5,1.5
8,7,wedding,7,601,2,5,5.5
8,7,wet,3,602,2,1,0.5
8,7,what,4,603,1,3,1
8,7,wheat,5,604,2,3,1
8,7,when,4,605,3,1,0.5
8,7,whilst,6,606,2,4,5.5
8,7,whisper,7,607,3,4,1.5
8,7,whole,5,608,2,3,1
8,7,wholly,6,609,4,2,0.75
8,7,withdraw,8,610,1,7,6
8,7,writing,7,611,1,6,1.75
8,7,wrong,5,612,2,3,5
8,7,you,3,613,0,3,1
8,7,yourself,8,614,3,5,1.5
8,7,zone,4,615,0,4,1
8,8,ability,7,0,0,7,2
8,8,able,4,1,2,2,0.75
8,8,abolish,7,2,2,5,5.75
8,8,abortion,8,3,3,5,1.75
8,8,about,5,4,3,2,1
8,8,absent,6,5,2,4,1.25
8,8,abstract,8,6,3,5,5.75
8,8,accent,6,7,1,5,1.5
8,8,act,3,8,2,1,0.5
8,8,action,6,9,3,3,5
8,8,addition,8,10,1,7,2.25
8,8,adult,5,11,2,3,1.25
8,8,affair,6,12,1,5,6
8,8,afford,6,13,3,3,1.25
8,8,aid,3,14,1,2,0.75
8,8,alert,5,15,1,4,1.25
8,8,alien,5,16,2,3,5
8,8,allege,6,17,2,4,1.5
8,8,along,5,18,2,3,1
8,8,although,8,19,2,6,1.75
8,8,angel,5,20,1,4,5.25
8,8,angry,5,21,3,2,0.75
8,8,answer,6,22,2,4,1.25
8,8,anyone,6,23,2,4,5.5
8,8,anything,8,24,3,5,2
8,8,apart,5,25,1,4,1.25
8,8,apply,5,26,2,3,1
8,8,appoint,7,27,3,4,6
8,8,archive,7,28,1,6,2
8,8,armed,5,29,2,3,1.25
8,8,article,7,30,2,5,6
8,8,assign,6,31,1,5,1.5
8,8,attack,6,32,1,5,5.5
8,8,attorney,8,33,3,5,1.75
8,8,audience,8,34,1,7,2
8,8,audit,5,35,4,1,0.75
8,8,awkward,7,36,1,6,5.75
8,8,backdrop,8,37,0,8,2.25
8,8,banana,6,38,2,4,5.5
8,8,basket,6,39,2,4,1.25
8,8,bee,3,40,1,2,0.75
8,8,beef,4,41,3,1,0.5
8,8,behind,6,42,2,4,5.25
8,8,being,5,43,2,3,1
8,8,beneath,7,44,2,5,1.5
8,8,bent,4,45,3,1,0.5
8,8,beside,6,46,2,4,5.25
8,8,bicycle,7,47,1,6,1.75
8,8,big,3,48,2,1,0.5
8,8,biology,7,49,2,5,1.5
8,8,blast,5,50,1,4,5
8,8,blessing,8,51,2,6,1.75
8,8,blood,5,52,2,3,1
8,8,bold,4,53,1,3,5
8,8,bonus,5,54,2,3,1.25
8,8,born,4,55,2,2,0.75
8,8,bounce,6,56,2,4,1.25
8,8,branch,6,57,1,5,5.5
8,8,breast,6,58,2,4,1.25
8,8,breath,6,59,4,2,1
8,8,briefly,7,60,2,5,5.5
8,8,broad,5,61,2,3,1
8,8,broadly,7,62,5,2,0.75
8,8,buck,4,63,1,3,1
8,8,building,8,64,2,6,6
8,8,bulk,4,65,2,2,0.75
8,8,bury,4,66,2,2,0.75
8,8,bus,3,67,2,1,0.25
8,8,busy,4,68,3,1,0.5
8,8,cabin,5,69,0,5,1.5
8,8,calm,4,70,2,2,4.75
8,8,camp,4,71,2,2,0.75
8,8,capture,7,72,2,5,1.5
8,8,carrot,6,73,2,4,1.25
8,8,cat,3,74,2,1,0.5
8,8,catch,5,75,3,2,5.5
8,8,cattle,6,76,3,3,1.25
8,8,cautious,8,77,2,6,1.75
8,8,cent,4,78,1,3,5
8,8,centre,6,79,4,2,1
8,8,champion,8,80,1,7,2
8,8,chance,6,81,3,3,1
8,8,chat,4,82,3,1,4.75
8,8,cheek,5,83,2,3,1
8,8,chef,4,84,3,1,0.5
8,8,clarify,7,85,1,6,1.75
8,8,cleaning,8,86,2,6,6.25
8,8,clock,5,87,2,3,1
8,8,close,5,88,3,2,1
8,8,closure,7,89,4,3,1.25
8,8,cloth,5,90,3,2,0.75
8,8,clothes,7,91,5,2,5.25
8,8,clothing,8,92,5,3,1.5
8,8,clue,4,93,2,2,0.75
8,8,coast,5,94,1,4,1.25
8,8,coastal,7,95,5,2,0.75
8,8,coin,4,96,2,2,5
8,8,college,7,97,2,5,1.75
8,8,combat,6,98,2,4,1.25
8,8,combine,7,99,4,3,1.25
8,8,commerce,8,100,3,5,6
8,8,common,6,101,4,2,1
8,8,complex,7,102,3,4,1.5
8,8,compose,7,103,4,3,5.5
8,8,concrete,8,104,2,6,2
8,8,conflict,8,105,3,5,1.75
8,8,confuse,7,106,4,3,6
8,8,consume,7,107,3,4,1.5
8,8,contact,7,108,3,4,1.25
8,8,contest,7,109,4,3,1.25
8,8,context,7,110,5,2,5.25
8,8,continue,8,111,4,4,1.5
8,8,contract,8,112,4,4,2
8,8,contrary,8,113,6,2,1.25
8,8,convert,7,114,3,4,5.75
8,8,copy,4,115,2,2,0.75
8,8,corrupt,7,116,2,5,1.5
8,8,costume,7,117,2,5,3
8,8,courage,7,118,2,5,10.5
8,8,crazy,5,119,1,4,2.75
8,8,cream,5,120,2,3,2.25
8,8,creative,8,121,4,4,9.75
8,8,critical,8,122,2,6,4
8,8,critique,8,123,5,3,2.5
8,8,crop,4,124,2,2,1.5
8,8,crystal,7,125,2,5,10.25
8,8,cue,3,126,1,2,1.5
8,8,cure,4,127,2,2,1.75
8,8,custody,7,128,2,5,10
8,8,custom,6,129,5,1,1.5
8,8,cutting,7,130,2,5,3.5
8,8,dancer,6,131,0,6,3.75
8,8,date,4,132,2,2,8.25
8,8,daughter,8,133,2,6,4
8,8,dead,4,134,1,3,2.25
8,8,deadline,8,135,4,4,10
8,8,dear,4,136,3,1,1.25
8,8,debate,6,137,2,4,2.75
8,8,debris,6,138,3,3,2.5
8,8,deck,4,139,2,2,1.5
8,8,defeat,6,140,2,4,9.5
8,8,defend,6,141,4,2,2
8,8,depart,6,142,2,4,2.75
8,8,depend,6,143,3,3,2.25
8,8,descend,7,144,2,5,10.25
8,8,descent,7,145,6,1,1.75
8,8,desire,6,146,3,3,2.5
8,8,detail,6,147,2,4,2.75
8,8,devise,6,148,2,4,9.75
8,8,dialogue,8,149,1,7,4.5
8,8,diary,5,150,3,2,1.75
8,8,differ,6,151,2,4,9.5
8,8,dilemma,7,152,2,5,3.5
8,8,directly,8,153,2,6,4
8,8,discard,7,154,2,5,10.25
8,8,disorder,8,155,3,5,3.75
8,8,dispute,7,156,3,4,3
8,8,distinct,8,157,3,5,10.5
8,8,distract,8,158,4,4,3.25
8,8,district,8,159,5,3,2.75
8,8,divorce,7,160,2,5,10
8,8,dog,3,161,1,2,1.5
8,8,dominate,8,162,2,6,4.25
8,8,door,4,163,2,2,1.75
8,8,dose,4,164,2,2,8.25
8,8,dozen,5,165,2,3,2.25
8,8,drag,4,166,1,3,2
8,8,dramatic,8,167,3,5,3.75
8,8,driver,6,168,2,4,9.75
8,8,drug,4,169,2,2,1.5
8,8,dry,3,170,2,1,1
8,8,due,3,171,1,2,1.5
8,8,dull,4,172,2,2,1.5
8,8,duty,4,173,2,2,1.5
8,8,dynamic,7,174,1,6,11.25
8,8,east,4,175,0,4,2.5
8,8,easy,4,176,3,1,1
8,8,echo,4,177,1,3,2
8,8,economy,7,178,2,5,10.25
8,8,educated,8,179,1,7,4.5
8,8,election,8,180,1,7,11.5
8,8,electric,8,181,5,3,2.75
8,8,emerge,6,182,1,5,3.5
8,8,empire,6,183,2,4,10.25
8,8,employ,6,184,3,3,2.5
8,8,empty,5,185,3,2,1.75
8,8,energy,6,186,1,5,3.25
8,8,enhance,7,187,2,5,10.5
8,8,enough,6,188,2,4,3
8,8,enquire,7,189,2,5,3.5
8,8,enrol,5,190,2,3,10
8,8,entirely,8,191,2,6,4
8,8,equal,5,192,1,4,2.75
8,8,equation,8,193,4,4,10.5
8,8,equip,5,194,3,2,1.75
8,8,ethic,5,195,1,4,2.75
8,8,ethical,7,196,5,2,1.75
8,8,everyday,8,197,1,7,11.75
8,8,evil,4,198,2,2,1.75
8,8,evolve,6,199,2,4,3
8,8,expected,8,200,1,7,11.75
8,8,export,6,201,3,3,2.5
8,8,exposure,8,202,4,4,3.25
8,8,extract,7,203,2,5,10.75
8,8,fabulous,8,204,0,8,5
8,8,facility,8,205,2,6,15.5
8,8,faction,7,206,3,4,3
8,8,factory,7,207,4,3,2.75
8,8,fairness,8,208,2,6,11
8,8,faith,5,209,3,2,1.75
8,8,fame,4,210,2,2,1.5
8,8,fan,3,211,2,1,1
8,8,farm,4,212,2,2,1.5
8,8,feat,4,213,1,3,2
8,8,feather,7,214,4,3,9.5
8,8,feature,7,215,4,3,2.5
8,8,feedback,8,216,2,6,4
8,8,fence,5,217,2,3,9
8,8,fighting,8,218,1,7,4.5
8,8,figure,6,219,3,3,2.5
8,8,fill,4,220,2,2,1.75
8,8,film,4,221,3,1,8.25
8,8,firework,8,222,2,6,4.75
8,8,first,5,223,3,2,1.75
8,8,fish,4,224,2,2,1.75
8,8,fishing,7,225,4,3,10.75
8,8,fit,3,226,2,1,1
8,8,five,4,227,2,2,2
8,8,flaw,4,228,1,3,2
8,8,flawed,6,229,4,2,1.75
8,8,fleet,5,230,2,3,2.25
8,8,float,5,231,2,3,10
8,8,flood,5,232,3,2,2
8,8,fluid,5,233,2,3,2.25
8,8,fold,4,234,1,3,2
8,8,fond,4,235,2,2,1.75
8,8,fool,4,236,2,2,9.75
8,8,forever,7,237,2,5,3.5
8,8,forge,5,238,3,2,1.75
8,8,fork,4,239,3,1,1.25
8,8,forth,5,240,3,2,1.75
8,8,forum,5,241,3,2,1.75
8,8,freely,6,242,1,5,10.25
8,8,freeze,6,243,4,2,2
8,8,fruit,5,244,2,3,2.25
8,8,fully,5,245,1,4,2.75
8,8,fund,4,246,2,2,8.75
8,8,gambling,8,247,0,8,5
8,8,generous,8,248,1,7,11.75
8,8,gentle,6,249,3,3,2.5
8,8,genuine,7,250,3,4,3
8,8,get,3,251,2,1,1
8,8,ghost,5,252,1,4,9.75
8,8,glad,4,253,1,3,2
8,8,goal,4,254,1,3,2
8,8,golden,6,255,2,4,2.75
8,8,goods,5,256,2,3,9.5
8,8,gorgeous,8,257,2,6,4.25
8,8,graduate,8,258,1,7,11.5
8,8,grant,5,259,3,2,1.75
8,8,great,5,260,2,3,2.25
8,8,greatly,7,261,5,2,1.75
8,8,guard,5,262,1,4,3
8,8,halt,4,263,0,4,10.5
8,8,happy,5,264,2,3,2.25
8,8,harmful,7,265,2,5,3.5
8,8,hearing,7,266,1,6,490
8,8,heating,7,267,3,4,3.75
8,8,helmet,6,268,2,4,3.5
8,8,hence,5,269,2,3,2.75
8,8,here,4,270,2,2,2
8,8,himself,7,271,1,6,18.25
8,8,history,7,272,2,5,9.25
8,8,hobby,5,273,1,4,13.5
8,8,hold,4,274,2,2,3
8,8,homeless,8,275,2,6,6
8,8,honour,6,276,2,4,7
8,8,hook,4,277,2,2,12
8,8,horizon,7,278,2,5,6
8,8,host,4,279,2,2,2.25
8,8,house,5,280,2,3,3.25
8,8,housing,7,281,4,3,13.5
8,8,if,2,282,0,2,2.25
8,8,illness,7,283,1,6,7.5
8,8,induce,6,284,1,5,15.25
8,8,indulge,7,285,4,3,3.5
8,8,injured,7,286,2,5,4.5
8,8,insect,6,287,2,4,3
8,8,insider,7,288,3,4,10.75
8,8,inspire,7,289,3,4,4.5
8,8,investor,8,290,2,6,13.25
8,8,invoke,6,291,3,3,2.5
8,8,join,4,292,0,4,2.75
8,8,kidnap,6,293,0,6,4
8,8,kill,4,294,2,2,8
8,8,labour,6,295,0,6,3.75
8,8,ladder,6,296,2,4,3
8,8,lamp,4,297,2,2,7.5
8,8,language,8,298,2,6,4.25
8,8,lawyer,6,299,2,4,2.75
8,8,lead,4,300,1,3,2.25
8,8,leap,4,301,3,1,7
8,8,legacy,6,302,2,4,2.75
8,8,length,6,303,2,4,2.75
8,8,less,4,304,2,2,1.5
8,8,let,3,305,2,1,1
8,8,lifetime,8,306,1,7,10.5
8,8,light,5,307,2,3,2.25
8,8,likewise,8,308,2,6,10.25
8,8,limit,5,309,2,3,2.25
8,8,linger,6,310,2,4,2.75
8,8,lock,4,311,1,3,2
8,8,logic,5,312,2,3,8.25
8,8,loop,4,313,2,2,1.75
8,8,lord,4,314,2,2,1.5
8,8,lost,4,315,2,2,1.5
8,8,lower,5,316,2,3,2.25
8,8,lung,4,317,1,3,2
8,8,magazine,8,318,0,8,15
8,8,magical,7,319,3,4,3
8,8,mall,4,320,2,2,1.75
8,8,man,3,321,2,1,7
8,8,manifest,8,322,3,5,3.5
8,8,manner,6,323,3,3,2.5
8,8,marathon,8,324,2,6,10.75
8,8,march,5,325,3,2,1.75
8,8,marginal,8,326,3,5,3.75
8,8,marker,6,327,3,3,2.5
8,8,marriage,8,328,3,5,10.25
8,8,marry,5,329,4,1,1.5
8,8,massive,7,330,2,5,3.75
8,8,matter,6,331,2,4,1.75
8,8,meaning,7,332,1,6,6
8,8,means,5,333,4,1,0.75
8,8,measure,7,334,3,4,1.5
8,8,medical,7,335,2,5,5.25
8,8,menu,4,336,2,2,0.75
8,8,metaphor,8,337,2,6,1.75
8,8,milk,4,338,1,3,1
8,8,mill,4,339,3,1,4.5
8,8,mine,4,340,2,2,0.75
8,8,miner,5,341,4,1,0.5
8,8,minimize,8,342,3,5,1.75
8,8,minute,6,343,3,3,1.25
8,8,miracle,7,344,2,5,5.25
8,8,mobile,6,345,1,5,1.5
8,8,motorist,8,346,2,6,5.25
8,8,mount,5,347,2,3,1
8,8,move,4,348,2,2,0.75
8,8,multiply,8,349,1,7,2
8,8,musical,7,350,2,5,5.25
8,8,myself,6,351,1,5,1.5
8,8,mystery,7,352,3,4,1.5
8,8,neglect,7,353,0,7,5.75
8,8,nerve,5,354,2,3,1.25
8,8,network,7,355,2,5,6
8,8,next,4,356,2,2,0.75
8,8,ninety,6,357,1,5,1.5
8,8,noon,4,358,1,3,1
8,8,nose,4,359,2,2,5
8,8,now,3,360,2,1,0.75
8,8,number,6,361,1,5,1.5
8,8,observer,8,362,0,8,6.75
8,8,obtain,6,363,2,4,1.5
8,8,occasion,8,364,1,7,3.5
8,8,offender,8,365,1,7,5.75
8,8,offer,5,366,4,1,0.75
8,8,onion,5,367,1,4,1.25
8,8,onto,4,368,2,2,0.75
8,8,operator,8,369,1,7,5.75
8,8,opinion,7,370,2,5,1.75
8,8,optimism,8,371,2,6,6
8,8,oral,4,372,1,3,1
8,8,orange,6,373,3,3,1.25
8,8,ordinary,8,374,2,6,5.75
8,8,organize,8,375,2,6,2
8,8,out,3,376,1,2,0.75
8,8,outrage,7,377,3,4,3.5
8,8,oven,4,378,1,3,3.25
8,8,own,3,379,1,2,0.75
8,8,owner,5,380,3,2,0.75
8,8,oxygen,6,381,1,5,1.5
8,8,palm,4,382,0,4,5.25
8,8,pan,3,383,2,1,0.5
8,8,paper,5,384,2,3,1
8,8,parent,6,385,2,4,1.25
8,8,parish,6,386,3,3,5
8,8,peak,4,387,1,3,1
8,8,peasant,7,388,3,4,1.25
8,8,pension,7,389,2,5,1.5
8,8,people,6,390,2,4,5
8,8,period,6,391,2,4,1.5
8,8,persuade,8,392,3,5,1.75
8,8,physics,7,393,1,6,5.5
8,8,pilot,5,394,1,4,1.25
8,8,pink,4,395,2,2,0.75
8,8,pit,3,396,2,1,0.5
8,8,plain,5,397,1,4,4.75
8,8,plate,5,398,3,2,1
8,8,player,6,399,3,3,1.25
8,8,plunge,6,400,2,4,1.5
8,8,pocket,6,401,1,5,5.25
8,8,poet,4,402,2,2,0.75
8,8,poetry,6,403,4,2,1
8,8,pole,4,404,2,2,0.75
8,8,politics,8,405,3,5,5
8,8,pop,3,406,2,1,0.5
8,8,popular,7,407,3,4,1.25
8,8,port,4,408,2,2,0.75
8,8,pose,4,409,2,2,0.75
8,8,positive,8,410,3,5,5.5
8,8,poverty,7,411,2,5,1.75
8,8,practice,8,412,1,7,2.25
8,8,preach,6,413,2,4,5.5
8,8,precede,7,414,3,4,1.5
8,8,prepare,7,415,3,4,1.5
8,8,prey,4,416,3,1,0.75
8,8,priest,6,417,2,4,5
8,8,probable,8,418,2,6,2
8,8,protein,7,419,3,4,1.5
8,8,pub,3,420,1,2,4.5
8,8,purchase,8,421,2,6,2
8,8,purple,6,422,3,3,1.25
8,8,pursue,6,423,3,3,4.75
8,8,queen,5,424,0,5,1.5
8,8,quickly,7,425,2,5,1.75
8,8,radio,5,426,0,5,5.5
8,8,rain,4,427,2,2,1
8,8,random,6,428,2,4,1.5
8,8,rapid,5,429,2,3,1.25
8,8,rare,4,430,2,2,1
8,8,raw,3,431,2,1,4
8,8,reader,6,432,1,5,1.5
8,8,reading,7,433,4,3,1.25
8,8,real,4,434,3,1,0.75
8,8,realize,7,435,4,3,1.25
8,8,really,6,436,4,2,6
8,8,receiver,8,437,2,6,4
8,8,recipe,6,438,3,3,2.5
8,8,recovery,8,439,3,5,10
8,8,red,3,440,2,1,1
8,8,refuge,6,441,2,4,3
8,8,register,8,442,2,6,4
8,8,regret,6,443,3,3,8.5
8,8,reliable,8,444,2,6,4
8,8,remains,7,445,2,5,3.5
8,8,remember,8,446,3,5,9.75
8,8,rental,6,447,2,4,3
8,8,report,6,448,2,4,2.75
8,8,reporter,8,449,6,2,8.5
8,8,respect,7,450,2,5,3.5
8,8,response,8,451,4,4,3.25
8,8,retreat,7,452,2,5,10.25
8,8,rhetoric,8,453,1,7,4.75
8,8,rid,3,454,1,2,1.5
8,8,role,4,455,1,3,8.25
8,8,royal,5,456,2,3,2.5
8,8,rule,4,457,1,3,2.25
8,8,run,3,458,2,1,1.25
8,8,runner,6,459,3,3,2.5
8,8,sandwich,8,460,0,8,11.25
8,8,scale,5,461,1,4,2.75
8,8,scream,6,462,2,4,3
8,8,script,6,463,3,3,8.75
8,8,sea,3,464,1,2,1.5
8,8,seize,5,465,2,3,2.25
8,8,send,4,466,2,2,1.75
8,8,seventy,7,467,2,5,9.5
8,8,sex,3,468,2,1,1
8,8,shade,5,469,1,4,2.75
8,8,shadow,6,470,4,2,1.75
8,8,shall,5,471,3,2,1.75
8,8,shaped,6,472,3,3,8.75
8,8,shocking,8,473,2,6,4
8,8,shop,4,474,3,1,1.25
8,8,short,5,475,3,2,1.75
8,8,shot,4,476,3,1,1
8,8,show,4,477,3,1,1
8,8,shrink,6,478,2,4,8.5
8,8,shrug,5,479,3,2,1.75
8,8,sigh,4,480,1,3,2
8,8,silent,6,481,2,4,2.75
8,8,silly,5,482,3,2,1.75
8,8,simulate,8,483,2,6,10
8,8,sincere,7,484,2,5,3.5
8,8,sir,3,485,2,1,1
8,8,sixty,5,486,2,3,8
8,8,skill,5,487,1,4,2.75
8,8,slave,5,488,1,4,2.75
8,8,sleep,5,489,2,3,2.25
8,8,slow,4,490,2,2,7.5
8,8,small,5,491,1,4,2.75
8,8,smash,5,492,3,2,2
8,8,snap,4,493,1,3,2.25
8,8,soak,4,494,1,3,2
8,8,soar,4,495,3,1,7.5
8,8,society,7,496,2,5,3.75
8,8,soft,4,497,2,2,1.75
8,8,somebody,8,498,2,6,10.25
8,8,soon,4,499,2,2,1.75
8,8,sorry,5,500,2,3,2.25
8,8,source,6,501,2,4,2.75
8,8,spending,8,502,1,7,10.75
8,8,spite,5,503,2,3,2.25
8,8,split,5,504,2,3,2.25
8,8,spoon,5,505,2,3,2.25
8,8,sport,5,506,3,2,8
8,8,spy,3,507,2,1,1
8,8,squeeze,7,508,1,6,4
8,8,stage,5,509,1,4,2.75
8,8,stark,5,510,3,2,7.75
8,8,station,7,511,3,4,3.25
8,8,status,6,512,4,2,2
8,8,steep,5,513,2,3,2.25
8,8,stiff,5,514,2,3,2.25
8,8,stress,6,515,2,4,9.25
8,8,strive,6,516,3,3,2.5
8,8,student,7,517,2,5,3.5
8,8,suburban,8,518,1,7,11
8,8,suddenly,8,519,2,6,4
8,8,suffer,6,520,2,4,9.25
8,8,sum,3,521,2,1,1
8,8,summer,6,522,3,3,2.25
8,8,superior,8,523,2,6,4
8,8,surface,7,524,2,5,9.75
8,8,sustain,7,525,2,5,3.5
8,8,swimming,8,526,1,7,10.75
8,8,symbol,6,527,1,5,3.25
8,8,t,1,528,0,1,0.75
8,8,tag,3,529,1,2,1.5
8,8,teenage,7,530,1,6,10
8,8,teenager,8,531,7,1,1.75
8,8,tell,4,532,2,2,1.75
8,8,tent,4,533,2,2,1.75
8,8,terrain,7,534,2,5,3.5
8,8,terrible,8,535,4,4,9.5
8,8,testify,7,536,2,5,3.5
8,8,testing,7,537,5,2,2.25
8,8,than,4,538,1,3,2.25
8,8,theatre,7,539,2,5,10.25
8,8,theft,5,540,3,2,1.75
8,8,theirs,6,541,3,3,2.5
8,8,they,4,542,3,1,1.25
8,8,thin,4,543,2,2,1.5
8,8,thing,5,544,4,1,1
8,8,think,5,545,4,1,7.25
8,8,third,5,546,3,2,1.75
8,8,though,6,547,2,4,3
8,8,threaten,8,548,2,6,4
8,8,thursday,8,549,2,6,10.25
8,8,timber,6,550,1,5,3.25
8,8,tired,5,551,2,3,2.25
8,8,toll,4,552,1,3,8.75
8,8,ton,3,553,2,1,1
8,8,total,5,554,2,3,2.25
8,8,towards,7,555,2,5,3.5
8,8,towel,5,556,3,2,7.75
8,8,toy,3,557,2,1,1
8,8,trace,5,558,1,4,1.75
8,8,training,8,559,3,5,2
8,8,transfer,8,560,3,5,5.75
8,8,tribunal,8,561,2,6,1.75
8,8,trillion,8,562,3,5,1.75
8,8,troubled,8,563,2,6,5.75
8,8,trust,5,564,2,3,1
8,8,trustee,7,565,5,2,0.75
8,8,try,3,566,2,1,0.5
8,8,tuesday,7,567,1,6,5.5
8,8,tuition,7,568,2,5,1.75
8,8,turn,4,569,2,2,0.75
8,8,turnover,8,570,4,4,5.25
8,8,typical,7,571,1,6,1.75
8,8,under,5,572,0,5,1.5
8,8,unit,4,573,2,2,4.75
8,8,unless,6,574,2,4,1.25
8,8,up,2,575,1,1,0.25
8,8,upper,5,576,2,3,1
8,8,upset,5,577,2,3,1
8,8,us,2,578,1,1,4.25
8,8,used,4,579,2,2,0.75
8,8,utterly,7,580,1,6,1.75
8,8,vehicle,7,581,0,7,5.75
8,8,versus,6,582,2,4,1.25
8,8,very,4,583,3,1,0.75
8,8,vicious,7,584,1,6,1.75
8,8,victim,6,585,3,3,5.25
8,8,village,7,586,2,5,1.75
8,8,violate,7,587,2,5,1.5
8,8,vitamin,7,588,2,5,5.5
8,8,wage,4,589,0,4,1.25
8,8,ward,4,590,2,2,0.75
8,8,wash,4,591,2,2,0.75
8,8,weak,4,592,1,3,5
8,8,wear,4,593,3,1,0.75
8,8,weather,7,594,3,4,1.5
8,8,web,3,595,2,1,0.5
8,8,website,7,596,3,4,1.25
8,8,wedding,7,597,2,5,5.5
8,8,weekly,6,598,2,4,1.5
8,8,wheat,5,599,1,4,1.5
8,8,where,5,600,3,2,1
8,8,whisper,7,601,2,5,5.5
8,8,who,3,602,2,1,0.5
8,8,whole,5,603,3,2,0.75
8,8,widely,6,604,1,5,1.5
8,8,wish,4,605,2,2,4.75
8,8,workout,7,606,1,6,1.75
8,8,worse,5,607,3,2,1
8,8,worst,5,608,4,1,0.75
8,8,wound,5,609,2,3,4.75
8,8,writer,6,610,1,5,1.5
8,8,writing,7,611,4,3,1.25
8,8,wrong,5,612,2,3,1.25
8,8,you,3,613,0,3,4.75
8,8,zero,4,614,0,4,1.25
8,8,zone,4,615,1,3,1
8,9,ability,7,0,0,7,5.75
8,9,abolish,7,1,2,5,1.5
8,9,above,5,2,3,2,1
8,9,abroad,6,3,2,4,5.25
8,9,abstract,8,4,2,6,1.75
8,9,academy,7,5,1,6,1.75
8,9,accent,6,6,2,4,5.25
8,9,access,6,7,4,2,1
8,9,account,7,8,3,4,1.5
8,9,action,6,9,2,4,5
8,9,adhere,6,10,1,5,1.5
8,9,advance,7,11,2,5,1.75
8,9,advanced,8,12,7,1,0.75
8,9,affair,6,13,1,5,5.25
8,9,afford,6,14,3,3,1.25
8,9,afraid,6,15,2,4,1.5
8,9,agent,5,16,1,4,5.25
8,9,ah,2,17,1,1,0.5
8,9,air,3,18,1,2,0.75
8,9,aircraft,8,19,3,5,1.5
8,9,alert,5,20,1,4,1.25
8,9,alien,5,21,2,3,5.25
8,9,all,3,22,2,1,0.5
8,9,allege,6,23,3,3,1
8,9,alliance,8,24,3,5,1.75
8,9,alone,5,25,2,3,5.25
8,9,also,4,26,2,2,1
8,9,amid,4,27,1,3,1
8,9,angry,5,28,1,4,1.25
8,9,answer,6,29,2,4,5.25
8,9,anyone,6,30,2,4,1.5
8,9,anything,8,31,3,5,1.75
8,9,appetite,8,32,1,7,6.25
8,9,apply,5,33,3,2,1
8,9,arena,5,34,1,4,1.25
8,9,armed,5,35,2,3,1
8,9,array,5,36,2,3,5.25
8,9,article,7,37,2,5,1.75
8,9,asset,5,38,1,4,1.25
8,9,athlete,7,39,1,6,6.25
8,9,attach,6,40,2,4,1.5
8,9,attempt,7,41,3,4,1.5
8,9,attend,6,42,4,2,1.25
8,9,attorney,8,43,3,5,5.75
8,9,audit,5,44,1,4,1.25
8,9,august,6,45,2,4,1.25
8,9,awkward,7,46,1,6,6
8,9,ballot,6,47,0,6,1.75
8,9,banana,6,48,2,4,5.5
8,9,bank,4,49,3,1,0.5
8,9,bare,4,50,2,2,0.75
8,9,basket,6,51,2,4,1.25
8,9,bean,4,52,1,3,1
8,9,bear,4,53,3,1,0.5
8,9,because,7,54,2,5,5.5
8,9,become,6,55,3,3,1.25
8,9,beef,4,56,2,2,0.75
8,9,bend,4,57,2,2,0.75
8,9,beside,6,58,2,4,5.5
8,9,bias,4,59,1,3,1
8,9,big,3,60,2,1,0.5
8,9,biology,7,61,2,5,1.75
8,9,blast,5,62,1,4,5.25
8,9,blessing,8,63,2,6,2
8,9,blood,5,64,2,3,1
8,9,bonus,5,65,1,4,5.5
8,9,brain,5,66,1,4,1.25
8,9,branch,6,67,3,3,1.25
8,9,breast,6,68,2,4,1.25
8,9,broad,5,69,2,3,5.25
8,9,broadly,7,70,5,2,1
8,9,brother,7,71,3,4,1.5
8,9,buck,4,72,1,3,1
8,9,building,8,73,2,6,6
8,9,burial,6,74,2,4,1.25
8,9,burst,5,75,3,2,1
8,9,bury,4,76,3,1,0.5
8,9,button,6,77,2,4,5.25
8,9,cabin,5,78,0,5,1.5
8,9,cabinet,7,79,5,2,0.75
8,9,captain,7,80,2,5,1.75
8,9,capture,7,81,4,3,5.25
8,9,case,4,82,2,2,0.75
8,9,cause,5,83,2,3,1
8,9,caution,7,84,3,4,1.5
8,9,cautious,8,85,6,2,5.25
8,9,cent,4,86,1,3,1
8,9,chance,6,87,1,5,1.5
8,9,chaos,5,88,3,2,1
8,9,chat,4,89,3,1,0.5
8,9,chef,4,90,2,2,5
8,9,chest,5,91,3,2,1
8,9,civic,5,92,1,4,1.25
8,9,clarify,7,93,1,6,1.75
8,9,classify,8,94,3,5,6
8,9,climate,7,95,2,5,1.5
8,9,cling,5,96,3,2,1
8,9,clock,5,97,2,3,5.75
8,9,cloth,5,98,3,2,1
8,9,clothes,7,99,5,2,1
8,9,clothing,8,100,5,3,1.25
8,9,clue,4,101,2,2,1
8,9,college,7,102,1,6,6
8,9,coloured,8,103,3,5,1.75
8,9,combat,6,104,2,4,1.25
8,9,combine,7,105,4,3,6.25
8,9,comic,5,106,3,2,2
8,9,commerce,8,107,3,5,3.5
8,9,commit,6,108,4,2,1.25
8,9,compare,7,109,3,4,6.5
8,9,complain,8,110,4,4,3.25
8,9,compose,7,111,4,3,2.75
8,9,comprise,8,112,4,4,3
8,9,concrete,8,113,2,6,6.5
8,9,confuse,7,114,3,4,1.5
8,9,consist,7,115,3,4,1.5
8,9,consumer,8,116,4,4,5.75
8,9,contract,8,117,3,5,1.75
8,9,convert,7,118,3,4,1.25
8,9,convict,7,119,4,3,5.25
8,9,cook,4,120,2,2,0.75
8,9,cooking,7,121,4,3,1
8,9,cop,3,122,2,1,0.5
8,9,copy,4,123,3,1,0.5
8,9,corrupt,7,124,2,5,1.5
8,9,council,7,125,2,5,5.75
8,9,covered,7,126,2,5,1.5
8,9,creative,8,127,1,7,6.5
8,9,creator,7,128,5,2,1
8,9,critical,8,129,2,6,2
8,9,critique,8,130,5,3,5.75
8,9,crystal,7,131,2,5,1.75
8,9,cue,3,132,1,2,0.75
8,9,cult,4,133,2,2,0.75
8,9,custody,7,134,2,5,6
8,9,custom,6,135,5,1,1
8,9,dancer,6,136,0,6,1.75
8,9,dark,4,137,2,2,0.75
8,9,data,4,138,2,2,0.75
8,9,dead,4,139,1,3,5.25
8,9,deadline,8,140,4,4,1.75
8,9,dear,4,141,3,1,0.75
8,9,debate,6,142,2,4,1.25
8,9,debris,6,143,3,3,5.25
8,9,debut,5,144,3,2,1
8,9,deck,4,145,2,2,0.75
8,9,decorate,8,146,3,5,1.75
8,9,defeat,6,147,2,4,5.5
8,9,delivery,8,148,2,6,2
8,9,depart,6,149,2,4,1.25
8,9,derive,6,150,2,4,5.75
8,9,descent,7,151,2,5,1.75
8,9,desert,6,152,3,3,1.75
8,9,desire,6,153,3,3,2.5
8,9,detail,6,154,2,4,9.75
8,9,dialogue,8,155,1,7,4.5
8,9,die,3,156,2,1,1
8,9,differ,6,157,2,4,9.75
8,9,dilemma,7,158,2,5,3.5
8,9,dip,3,159,2,1,1
8,9,disagree,8,160,2,6,4.25
8,9,discard,7,161,3,4,10
8,9,disease,7,162,3,4,3
8,9,dispose,7,163,3,4,3
8,9,dispute,7,164,4,3,9.75
8,9,disrupt,7,165,3,4,3.25
8,9,distance,8,166,3,5,3.75
8,9,distinct,8,167,4,4,10
8,9,district,8,168,4,4,3.5
8,9,disturb,7,169,4,3,2.75
8,9,doctrine,8,170,1,7,12
8,9,dog,3,171,2,1,1
8,9,dominate,8,172,2,6,5
8,9,donate,6,173,2,4,5.75
8,9,dozen,5,174,2,3,11
8,9,dramatic,8,175,1,7,5
8,9,drown,5,176,2,3,2.5
8,9,drug,4,177,2,2,9.5
8,9,due,3,178,1,2,1.5
8,9,dull,4,179,2,2,1.75
8,9,early,5,180,0,5,3.25
8,9,easily,6,181,2,4,10
8,9,easy,4,182,3,1,1.25
8,9,eat,3,183,2,1,1
8,9,echo,4,184,1,3,2
8,9,educator,8,185,1,7,4.5
8,9,eighteen,8,186,1,7,11.75
8,9,else,4,187,1,3,2.25
8,9,empire,6,188,1,5,10.75
8,9,empty,5,189,3,2,2
8,9,endorse,7,190,1,6,4
8,9,enhance,7,191,2,5,3.5
8,9,enough,6,192,2,4,10.25
8,9,enquire,7,193,2,5,3.5
8,9,enrol,5,194,2,3,2.5
8,9,ensue,5,195,2,3,9.5
8,9,entirely,8,196,2,6,4.5
8,9,equation,8,197,1,7,11.5
8,9,era,3,198,1,2,1.5
8,9,erupt,5,199,2,3,2.25
8,9,escalate,8,200,1,7,4.5
8,9,eternal,7,201,1,6,10.75
8,9,ethic,5,202,2,3,2.5
8,9,everyday,8,203,1,7,11.75
8,9,evil,4,204,2,2,1.75
8,9,evolve,6,205,2,4,3
8,9,exclude,7,206,1,6,10.75
8,9,exert,5,207,2,3,2.25
8,9,exotic,6,208,2,4,3
8,9,extra,5,209,2,3,2.25
8,9,extract,7,210,5,2,2.25
8,9,facility,8,211,0,8,12.25
8,9,fact,4,212,3,1,1.25
8,9,factory,7,213,4,3,2.5
8,9,fairness,8,214,2,6,11.25
8,9,faith,5,215,3,2,1.75
8,9,familiar,8,216,2,6,4
8,9,fan,3,217,2,1,1
8,9,feat,4,218,1,3,9
8,9,feature,7,219,4,3,2.25
8,9,feed,4,220,2,2,1.75
8,9,feedback,8,221,4,4,3
8,9,feel,4,222,3,1,1.25
8,9,feeling,7,223,4,3,9.5
8,9,fence,5,224,2,3,2.25
8,9,festival,8,225,2,6,4
8,9,fifth,5,226,1,4,9.5
8,9,fill,4,227,2,2,1.75
8,9,final,5,228,2,3,2.25
8,9,finger,6,229,3,3,2.5
8,9,finish,6,230,3,3,2.5
8,9,first,5,231,2,3,9.5
8,9,fish,4,232,2,2,1.75
8,9,fishing,7,233,4,3,2.25
8,9,fit,3,234,2,1,1
8,9,flame,5,235,1,4,2.75
8,9,flawed,6,236,3,3,9.25
8,9,float,5,237,2,3,2.25
8,9,flood,5,238,3,2,1.75
8,9,fluid,5,239,2,3,2.25
8,9,fold,4,240,1,3,2
8,9,forecast,8,241,2,6,11.25
8,9,forest,6,242,4,2,2
8,9,forgive,7,243,3,4,3
8,9,fork,4,244,3,1,1.25
8,9,formal,6,245,3,3,9.75
8,9,fossil,6,246,2,4,3
8,9,frankly,7,247,1,6,3.75
8,9,freeze,6,248,2,4,10
8,9,fully,5,249,1,4,2.75
8,9,fun,3,250,2,1,1
8,9,function,8,251,3,5,3.5
8,9,gambling,8,252,0,8,12.75
8,9,gas,3,253,2,1,1.25
8,9,generous,8,254,1,7,13
8,9,ghost,5,255,1,4,3.25
8,9,gorgeous,8,256,1,7,5
8,9,graduate,8,257,1,7,7.75
8,9,grain,5,258,3,2,1
8,9,grand,5,259,3,2,1
8,9,grant,5,260,4,1,0.75
8,9,great,5,261,2,3,5.25
8,9,greatly,7,262,5,2,1.25
8,9,half,4,263,0,4,1.25
8,9,hand,4,264,2,2,0.75
8,9,happy,5,265,2,3,1
8,9,hardly,6,266,2,4,525.5
8,9,hardware,8,267,4,4,4.5
8,9,harmony,7,268,3,4,6
8,9,hatred,6,269,2,4,5.75
8,9,hearing,7,270,1,6,18.75
8,9,hello,5,271,2,3,5
8,9,helmet,6,272,3,3,4.75
8,9,hero,4,273,2,2,3.25
8,9,hill,4,274,1,3,14.75
8,9,himself,7,275,2,5,7.5
8,9,history,7,276,2,5,6.75
8,9,hockey,6,277,1,5,15
8,9,holy,4,278,2,2,3.25
8,9,hope,4,279,2,2,3.25
8,9,horizon,7,280,2,5,7
8,9,hostile,7,281,2,5,15
8,9,house,5,282,2,3,4
8,9,hungry,6,283,1,5,4.5
8,9,hurry,5,284,2,3,18
8,9,husband,7,285,2,5,4
8,9,ideology,8,286,0,8,11
8,9,ignore,6,287,1,5,3.25
8,9,illness,7,288,1,6,4
8,9,immense,7,289,1,6,10.25
8,9,imminent,8,290,3,5,3.75
8,9,in,2,291,1,1,0.75
8,9,indoor,6,292,2,4,8.75
8,9,induce,6,293,3,3,2.5
8,9,initial,7,294,2,5,3.5
8,9,injured,7,295,2,5,9.25
8,9,innocent,8,296,2,6,4.25
8,9,input,5,297,2,3,2
8,9,insect,6,298,2,4,5.75
8,9,insider,7,299,3,4,1.75
8,9,insight,7,300,4,3,1.5
8,9,inspire,7,301,3,4,1.5
8,9,insult,6,302,3,3,5.25
8,9,invasion,8,303,2,6,2
8,9,investor,8,304,3,5,3
8,9,invoke,6,305,3,3,6.75
8,9,jam,3,306,0,3,1
8,9,join,4,307,1,3,1.25
8,9,joint,5,308,4,1,0.75
8,9,july,4,309,1,3,1
8,9,justice,7,310,2,5,5.75
8,9,keen,4,311,0,4,1.25
8,9,kidnap,6,312,1,5,1.75
8,9,kill,4,313,2,2,5
8,9,killing,7,314,4,3,1.5
8,9,kind,4,315,2,2,1
8,9,knock,5,316,1,4,1.25
8,9,lady,4,317,0,4,5
8,9,landing,7,318,2,5,1.75
8,9,lately,6,319,2,4,1.5
8,9,lead,4,320,1,3,1
8,9,leisure,7,321,2,5,5.75
8,9,less,4,322,2,2,0.75
8,9,level,5,323,2,3,1.25
8,9,light,5,324,1,4,1.25
8,9,likewise,8,325,2,6,6
8,9,limit,5,326,2,3,1.25
8,9,lively,6,327,2,4,1.5
8,9,loan,4,328,1,3,4.75
8,9,logic,5,329,2,3,1
8,9,logo,4,330,3,1,0.75
8,9,lose,4,331,2,2,0.75
8,9,loss,4,332,3,1,0.75
8,9,luck,4,333,1,3,1
8,9,lung,4,334,2,2,4.25
8,9,man,3,335,0,3,0.75
8,9,marathon,8,336,2,6,2
8,9,marginal,8,337,3,5,5.5
8,9,marker,6,338,3,3,1.25
8,9,marry,5,339,3,2,1
8,9,mate,4,340,2,2,0.75
8,9,maths,5,341,3,2,0.75
8,9,maximize,8,342,2,6,5.5
8,9,mayor,5,343,2,3,1
8,9,me,2,344,1,1,0.5
8,9,medical,7,345,2,5,1.5
8,9,meet,4,346,2,2,4
8,9,militant,8,347,1,7,2
8,9,milk,4,348,3,1,0.5
8,9,mine,4,349,2,2,0.75
8,9,mining,6,350,3,3,4.5
8,9,minor,5,351,3,2,1
8,9,minority,8,352,5,3,1.25
8,9,miracle,7,353,2,5,1.5
8,9,missile,7,354,2,5,5
8,9,mistake,7,355,3,4,1.5
8,9,mode,4,356,1,3,1
8,9,modern,6,357,4,2,0.75
8,9,modest,6,358,4,2,4
8,9,momentum,8,359,2,6,2
8,9,monitor,7,360,2,5,1.5
8,9,monk,4,361,3,1,0.5
8,9,morality,8,362,2,6,5.25
8,9,morning,7,363,3,4,1.5
8,9,motive,6,364,2,4,1.25
8,9,motor,5,365,3,2,4.5
8,9,motorist,8,366,5,3,1.25
8,9,mount,5,367,2,3,1
8,9,movement,8,368,2,6,1.75
8,9,myself,6,369,1,5,5.25
8,9,nail,4,370,0,4,1.25
8,9,native,6,371,2,4,1.5
8,9,nerve,5,372,1,4,4.75
8,9,nest,4,373,2,2,0.75
8,9,net,3,374,2,1,0.5
8,9,news,4,375,2,2,0.75
8,9,next,4,376,2,2,0.75
8,9,nod,3,377,1,2,0.75
8,9,noon,4,378,2,2,4.25
8,9,notable,7,379,2,5,1.75
8,9,notably,7,380,6,1,0.75
8,9,now,3,381,2,1,0.5
8,9,nowadays,8,382,3,5,5.25
8,9,number,6,383,1,5,1.5
8,9,nurse,5,384,2,3,1
8,9,nursery,7,385,5,2,1
8,9,nursing,7,386,4,3,1.25
8,9,o,1,387,0,1,3.75
8,9,obey,4,388,1,3,1
8,9,object,6,389,2,4,1.25
8,9,obtain,6,390,2,4,1.5
8,9,obvious,7,391,2,5,5
8,9,of,2,392,1,1,0.5
8,9,offering,8,393,2,6,1.75
8,9,on,2,394,1,1,0.25
8,9,ongoing,7,395,2,5,5.5
8,9,onion,5,396,2,3,1.25
8,9,operator,8,397,1,7,2
8,9,opinion,7,398,2,5,5.25
8,9,optimism,8,399,2,6,1.75
8,9,ordinary,8,400,1,7,5.5
8,9,organize,8,401,2,6,1.75
8,9,our,3,402,1,2,0.75
8,9,out,3,403,2,1,0.5
8,9,outrage,7,404,3,4,5.25
8,9,own,3,405,1,2,0.75
8,9,oxygen,6,406,1,5,1.5
8,9,pan,3,407,0,3,4.5
8,9,parent,6,408,2,4,1.5
8,9,parental,8,409,6,2,1
8,9,passage,7,410,2,5,1.5
8,9,passion,7,411,4,3,5
8,9,pathway,7,412,2,5,1.75
8,9,penalty,7,413,1,6,1.75
8,9,pension,7,414,3,4,5.25
8,9,people,6,415,2,4,1.25
8,9,period,6,416,2,4,1.25
8,9,persuade,8,417,3,5,5.75
8,9,pill,4,418,1,3,1
8,9,pink,4,419,2,2,1
8,9,planet,6,420,1,5,1.5
8,9,plate,5,421,3,2,4.5
8,9,plunge,6,422,2,4,1.5
8,9,pocket,6,423,1,5,1.5
8,9,poet,4,424,2,2,0.75
8,9,politics,8,425,2,6,5.75
8,9,pool,4,426,2,2,0.75
8,9,portray,7,427,2,5,1.5
8,9,pose,4,428,2,2,0.75
8,9,powerful,8,429,2,6,5.5
8,9,pray,4,430,1,3,1
8,9,precede,7,431,2,5,5
8,9,present,7,432,3,4,1.5
8,9,prey,4,433,3,1,0.5
8,9,price,5,434,2,3,1
8,9,pride,5,435,3,2,0.75
8,9,prince,6,436,3,3,1
8,9,probably,8,437,2,6,3.75
8,9,protect,7,438,3,4,1.5
8,9,protein,7,439,5,2,1
8,9,provide,7,440,3,4,5
8,9,province,8,441,5,3,1.25
8,9,pub,3,442,1,2,1
8,9,punch,5,443,2,3,1.25
8,9,purchase,8,444,2,6,5.5
8,9,purple,6,445,3,3,1.25
8,9,pursue,6,446,3,3,1.25
8,9,queen,5,447,0,5,5
8,9,quota,5,448,2,3,1.25
8,9,racist,6,449,0,6,1.75
8,9,random,6,450,2,4,5.25
8,9,range,5,451,3,2,1
8,9,rapid,5,452,2,3,1
8,9,rare,4,453,2,2,0.75
8,9,raw,3,454,2,1,0.5
8,9,real,4,455,1,3,1
8,9,really,6,456,4,2,5.5
8,9,receiver,8,457,2,6,2.25
8,9,refuge,6,458,2,4,2
8,9,register,8,459,2,6,6
8,9,release,7,460,2,5,1.75
8,9,reliable,8,461,3,5,1.75
8,9,rely,4,462,3,1,4.5
8,9,remains,7,463,2,5,1.75
8,9,rental,6,464,2,4,1.25
8,9,repeated,8,465,2,6,5.75
8,9,report,6,466,3,3,1.25
8,9,reporter,8,467,6,2,1
8,9,request,7,468,2,5,1.5
8,9,respect,7,469,2,5,5.25
8,9,response,8,470,4,4,1.5
8,9,resume,6,471,3,3,1
8,9,rice,4,472,1,3,1
8,9,rid,3,473,2,1,4
8,9,risk,4,474,2,2,0.75
8,9,role,4,475,1,3,1
8,9,rumour,6,476,1,5,1.5
8,9,run,3,477,2,1,0.5
8,9,salary,6,478,0,6,5.5
8,9,sandwich,8,479,2,6,1.75
8,9,say,3,480,2,1,0.5
8,9,scope,5,481,1,4,4.75
8,9,scratch,7,482,2,5,1.75
8,9,scream,6,483,3,3,1.25
8,9,see,3,484,1,2,0.75
8,9,seldom,6,485,2,4,5
8,9,send,4,486,2,2,0.75
8,9,senior,6,487,3,3,1
8,9,session,7,488,2,5,1.5
8,9,seventy,7,489,2,5,5.5
8,9,several,7,490,4,3,1.5
8,9,sex,3,491,2,1,0.5
8,9,shade,5,492,1,4,1.25
8,9,shadow,6,493,4,2,4.75
8,9,shake,5,494,3,2,1
8,9,shall,5,495,3,2,0.75
8,9,shaped,6,496,3,3,1
8,9,shine,5,497,2,3,1
8,9,shock,5,498,2,3,5
8,9,shocking,8,499,5,3,1.5
8,9,shop,4,500,3,1,0.75
8,9,shout,5,501,3,2,1
8,9,sigh,4,502,1,3,1
8,9,silent,6,503,2,4,5
8,9,silly,5,504,3,2,1
8,9,simulate,8,505,2,6,2
8,9,sing,4,506,2,2,0.75
8,9,sixty,5,507,2,3,4.75
8,9,skiing,6,508,1,5,1.5
8,9,slave,5,509,1,4,1.25
8,9,slogan,6,510,2,4,1.25
8,9,smart,5,511,1,4,5
8,9,snap,4,512,1,3,1
8,9,soak,4,513,1,3,1
8,9,soar,4,514,3,1,0.5
8,9,soccer,6,515,2,4,5
8,9,soldier,7,516,2,5,1.75
8,9,solely,6,517,3,3,1.25
8,9,son,3,518,2,1,0.5
8,9,spending,8,519,1,7,5.75
8,9,spicy,5,520,2,3,1
8,9,spill,5,521,3,2,1
8,9,spite,5,522,3,2,1
8,9,split,5,523,2,3,5
8,9,spot,4,524,2,2,0.75
8,9,spy,3,525,2,1,0.5
8,9,squeeze,7,526,1,6,1.75
8,9,stage,5,527,1,4,7
8,9,steep,5,528,2,3,2.5
8,9,stiff,5,529,2,3,2.25
8,9,strive,6,530,2,4,3
8,9,struggle,8,531,3,5,14.25
8,9,suburban,8,532,1,7,4.75
8,9,success,7,533,2,5,10
8,9,suddenly,8,534,2,6,4
8,9,suicide,7,535,2,5,3.5
8,9,sum,3,536,2,1,1
8,9,summer,6,537,3,3,8.5
8,9,superb,6,538,2,4,2.75
8,9,suppress,8,539,3,5,3.75
8,9,surface,7,540,2,5,9.5
8,9,surge,5,541,3,2,1.75
8,9,sustain,7,542,2,5,3.5
8,9,sweet,5,543,1,4,8.75
8,9,syndrome,8,544,1,7,4.5
8,9,tag,3,545,0,3,2
8,9,tax,3,546,2,1,1
8,9,terminal,8,547,1,7,11
8,9,terrain,7,548,3,4,3
8,9,terrible,8,549,4,4,3.25
8,9,testify,7,550,2,5,10
8,9,testing,7,551,5,2,2
8,9,than,4,552,1,3,2
8,9,that,4,553,3,1,1
8,9,theatre,7,554,2,5,9.5
8,9,theft,5,555,3,2,1.75
8,9,their,5,556,3,2,1.75
8,9,them,4,557,3,1,1.25
8,9,then,4,558,3,1,1
8,9,thick,5,559,2,3,2.25
8,9,thief,5,560,3,2,1.75
8,9,thing,5,561,3,2,8.5
8,9,threat,6,562,2,4,2.75
8,9,throat,6,563,3,3,2.5
8,9,thursday,8,564,2,6,12
8,9,tobacco,7,565,1,6,4.25
8,9,toll,4,566,2,2,1.75
8,9,tomato,6,567,2,4,3
8,9,ton,3,568,2,1,7.75
8,9,total,5,569,2,3,2.25
8,9,tourist,7,570,2,5,3.5
8,9,towards,7,571,2,5,10.5
8,9,towel,5,572,3,2,2
8,9,training,8,573,1,7,5.25
8,9,tribunal,8,574,2,6,11
8,9,true,4,575,2,2,1.75
8,9,truly,5,576,3,2,2
8,9,trust,5,577,3,2,1.75
8,9,trustee,7,578,5,2,2
8,9,tuesday,7,579,1,6,10.5
8,9,turn,4,580,2,2,1.75
8,9,twist,5,581,1,4,2.75
8,9,type,4,582,1,3,2
8,9,unless,6,583,0,6,10.25
8,9,unlike,6,584,3,3,2.5
8,9,upwards,7,585,1,6,4
8,9,us,2,586,1,1,7
8,9,use,3,587,2,1,1
8,9,used,4,588,3,1,1
8,9,user,4,589,3,1,1
8,9,valid,5,590,0,5,3.25
8,9,very,4,591,1,3,2
8,9,vicious,7,592,1,6,10.25
8,9,victim,6,593,3,3,2.5
8,9,village,7,594,2,5,3.75
8,9,weak,4,595,0,4,9.25
8,9,wear,4,596,3,1,1
8,9,wedding,7,597,2,5,3.5
8,9,well,4,598,2,2,1.75
8,9,wet,3,599,2,1,1
8,9,what,4,600,1,3,8.25
8,9,wheat,5,601,2,3,2.25
8,9,when,4,602,3,1,1.25
8,9,while,5,603,2,3,2.25
8,9,whilst,6,604,4,2,1.75
8,9,whisper,7,605,3,4,9.25
8,9,whole,5,606,2,3,2.25
8,9,winter,6,607,1,5,3.5
8,9,withdraw,8,608,2,6,10.25
8,9,wooden,6,609,1,5,3.25
8,9,worse,5,610,2,3,2.25
8,9,writer,6,611,1,5,9.75
8,9,writing,7,612,4,3,2.75
8,9,wrong,5,613,2,3,2.25
8,9,you,3,614,0,3,2
8,9,yourself,8,615,3,5,14.25
9,0,ability,7,0,0,7,4.5
9,0,able,4,1,2,2,9
9,0,abortion,8,2,2,6,5.25
9,0,abstract,8,3,2,6,5.25
9,0,academy,7,4,1,6,12.25
9,0,accent,6,5,2,4,3.25
9,0,access,6,6,4,2,2.25
9,0,according,9,7,3,6,11
9,0,account,7,8,4,3,2.75
9,0,action,6,9,2,4,2.75
9,0,addition,8,10,1,7,11.5
9,0,advanced,8,11,2,6,4.25
9,0,advertise,9,12,3,6,11
9,0,afford,6,13,1,5,3.25
9,0,ah,2,14,1,1,0.75
9,0,aircraft,8,15,1,7,11
9,0,alignment,9,16,1,8,5.25
9,0,all,3,17,2,1,1
9,0,allegedly,9,18,3,6,11
9,0,alone,5,19,2,3,2.25
9,0,also,4,20,2,2,1.5
9,0,ambitious,9,21,1,8,11.5
9,0,amid,4,22,2,2,1.75
9,0,angry,5,23,1,4,2.75
9,0,answer,6,24,2,4,9.75
9,0,anything,8,25,2,6,4.25
9,0,appoint,7,26,1,6,4
9,0,april,5,27,2,3,9.25
9,0,arena,5,28,1,4,2.75
9,0,array,5,29,2,3,2.25
9,0,arrival,7,30,3,4,3
9,0,asset,5,31,1,4,9.25
9,0,attach,6,32,1,5,3.25
9,0,audience,8,33,1,7,11
9,0,august,6,34,2,4,3
9,0,authority,9,35,2,7,4.75
9,0,avoid,5,36,1,4,9.5
9,0,away,4,37,1,3,2.25
9,0,awkward,7,38,2,5,3.5
9,0,back,4,39,0,4,9
9,0,bad,3,40,2,1,1
9,0,ballot,6,41,2,4,2.75
9,0,basis,5,42,2,3,2.25
9,0,basket,6,43,3,3,2.25
9,0,bear,4,44,1,3,9.25
9,0,beginning,9,45,2,7,5.5
9,0,being,5,46,2,3,2.5
9,0,beneath,7,47,2,5,13.25
9,0,beside,6,48,2,4,5.75
9,0,bet,3,49,2,1,2
9,0,bias,4,50,1,3,8
9,0,bicycle,7,51,2,5,16.75
9,0,big,3,52,2,1,1.75
9,0,biology,7,53,2,5,6.5
9,0,body,4,54,1,3,2.75
9,0,bold,4,55,2,2,10.5
9,0,bond,4,56,2,2,1.75
9,0,bonus,5,57,3,2,1.75
9,0,born,4,58,2,2,1.5
9,0,bounce,6,59,2,4,3
9,0,brain,5,60,1,4,10.75
9,0,branch,6,61,3,3,2.5
9,0,brick,5,62,2,3,2.25
9,0,briefly,7,63,3,4,3.25
9,0,brilliant,9,64,3,6,11.75
9,0,bring,5,65,3,2,1.25
9,0,broad,5,66,2,3,1.25
9,0,broadband,9,67,5,4,3.75
9,0,broadly,7,68,5,2,3.5
9,0,building,8,69,1,7,2.25
9,0,burst,5,70,2,3,1.25
9,0,bye,3,71,1,2,5.25
9,0,capture,7,72,0,7,2
9,0,case,4,73,2,2,1
9,0,cattle,6,74,2,4,5.25
9,0,caution,7,75,2,5,1.75
9,0,cent,4,76,1,3,1
9,0,champion,8,77,1,7,6.25
9,0,charge,6,78,3,3,1.25
9,0,cigarette,9,79,1,8,2.5
9,0,cinema,6,80,2,4,5.5
9,0,class,5,81,1,4,1.25
9,0,classical,9,82,5,4,1.5
9,0,classify,8,83,6,2,1
9,0,cleaning,8,84,2,6,6
9,0,cling,5,85,2,3,1
9,0,clock,5,86,2,3,1
9,0,close,5,87,3,2,5
9,0,cloth,5,88,3,2,1
9,0,clothes,7,89,5,2,1
9,0,clue,4,90,2,2,0.75
9,0,coalition,9,91,1,8,6.5
9,0,coast,5,92,3,2,1
9,0,coastal,7,93,5,2,1
9,0,coin,4,94,2,2,0.75
9,0,collapse,8,95,2,6,1.75
9,0,college,7,96,4,3,5.75
9,0,collision,9,97,4,5,2
9,0,combat,6,98,2,4,1.25
9,0,communist,9,99,3,6,6.5
9,0,complaint,9,100,3,6,2
9,0,complex,7,101,5,2,1
9,0,compose,7,102,4,3,5.5
9,0,comprise,8,103,4,4,1.5
9,0,computer,8,104,4,4,1.5
9,0,concerned,9,105,2,7,6.5
9,0,concrete,8,106,4,4,1.5
9,0,confident,9,107,3,6,2
9,0,conflict,8,108,4,4,5.75
9,0,confusion,9,109,4,5,1.75
9,0,consist,7,110,3,4,1.5
9,0,consume,7,111,4,3,5.5
9,0,consumer,8,112,7,1,1
9,0,contact,7,113,3,4,1.5
9,0,container,9,114,5,4,1.5
9,0,contest,7,115,4,3,5.5
9,0,context,7,116,5,2,1.25
9,0,continue,8,117,4,4,1.5
9,0,contrary,8,118,4,4,1.5
9,0,convict,7,119,3,4,5.75
9,0,cook,4,120,2,2,0.75
9,0,cooperate,9,121,3,6,2
9,0,cotton,6,122,2,4,1.25
9,0,countless,9,123,2,7,6.75
9,0,courage,7,124,3,4,1.5
9,0,covered,7,125,2,5,5.75
9,0,crazy,5,126,1,4,1.25
9,0,cream,5,127,2,3,1
9,0,creative,8,128,4,4,1.5
9,0,creator,7,129,5,2,5.5
9,0,critical,8,130,2,6,2
9,0,criticism,9,131,6,3,1.5
9,0,crop,4,132,2,2,0.75
9,0,crystal,7,133,2,5,6.25
9,0,cue,3,134,1,2,0.75
9,0,custody,7,135,2,5,1.5
9,0,customer,8,136,5,3,5.75
9,0,cutting,7,137,2,5,1.75
9,0,dancer,6,138,0,6,1.75
9,0,dark,4,139,2,2,5
9,0,database,8,140,2,6,2
9,0,dead,4,141,1,3,1
9,0,deadline,8,142,4,4,5.5
9,0,dear,4,143,3,1,0.5
9,0,debris,6,144,2,4,1.25
9,0,decision,8,145,2,6,1.75
9,0,deck,4,146,3,1,0.5
9,0,delivery,8,147,2,6,6.25
9,0,depend,6,148,2,4,1.25
9,0,dependent,9,149,6,3,1.25
9,0,depict,6,150,3,3,5.5
9,0,derive,6,151,2,4,1.25
9,0,detail,6,152,2,4,1.25
9,0,detection,9,153,3,6,6.5
9,0,devise,6,154,2,4,1.5
9,0,dialogue,8,155,1,7,2
9,0,diary,5,156,3,2,5.5
9,0,differ,6,157,2,4,1.5
9,0,different,9,158,6,3,1.25
9,0,dilemma,7,159,2,5,6.25
9,0,dip,3,160,2,1,4.75
9,0,directly,8,161,2,6,4
9,0,discharge,9,162,2,7,11.75
9,0,disease,7,163,3,4,3.25
9,0,dispose,7,164,3,4,3
9,0,disrupt,7,165,3,4,3
9,0,distance,8,166,3,5,11.25
9,0,distinct,8,167,4,4,4
9,0,district,8,168,4,4,5.25
9,0,diversity,9,169,2,7,15.5
9,0,divert,6,170,5,1,1.5
9,0,divorce,7,171,3,4,3.25
9,0,donate,6,172,1,5,11.75
9,0,donor,5,173,3,2,1.75
9,0,dose,4,174,2,2,2.75
9,0,dozen,5,175,2,3,2.25
9,0,drain,5,176,1,4,2.75
9,0,draw,4,177,3,1,8.25
9,0,dress,5,178,2,3,2.25
9,0,drug,4,179,2,2,1.5
9,0,drunk,5,180,3,2,1.75
9,0,dry,3,181,2,1,1
9,0,dull,4,182,1,3,2
9,0,duty,4,183,2,2,8.5
9,0,early,5,184,0,5,3.5
9,0,east,4,185,2,2,1.75
9,0,eastern,7,186,4,3,2.5
9,0,easy,4,187,3,1,1.25
9,0,economics,9,188,1,8,12
9,0,editorial,9,189,1,8,12
9,0,educated,8,190,2,6,4.25
9,0,education,9,191,6,3,2.75
9,0,eighteen,8,192,1,7,12
9,0,elaborate,9,193,1,8,5
9,0,empty,5,194,1,4,10
9,0,encourage,9,195,1,8,5.25
9,0,endorse,7,196,2,5,10.75
9,0,energy,6,197,2,4,3
9,0,enforce,7,198,2,5,3.5
9,0,enhance,7,199,2,5,10.25
9,0,enquire,7,200,2,5,3.5
9,0,ensue,5,201,2,3,2.25
9,0,entire,6,202,2,4,9.75
9,0,entirely,8,203,6,2,2.75
9,0,entity,6,204,4,2,2.25
9,0,epidemic,8,205,1,7,4.5
9,0,equal,5,206,1,4,10.25
9,0,equip,5,207,3,2,2
9,0,era,3,208,1,2,1.5
9,0,error,5,209,2,3,2.25
9,0,erupt,5,210,2,3,2.25
9,0,eternal,7,211,1,6,11
9,0,ethical,7,212,2,5,3.75
9,0,ethnic,6,213,3,3,2.5
9,0,every,5,214,1,4,9.75
9,0,everybody,9,215,5,4,3
9,0,evolution,9,216,2,7,12
9,0,exam,4,217,1,3,2.25
9,0,exclude,7,218,2,5,3.5
9,0,exert,5,219,2,3,2.25
9,0,exotic,6,220,2,4,9.75
9,0,expect,6,221,2,4,3
9,0,explosion,9,222,3,6,4.5
9,0,export,6,223,3,3,9.5
9,0,exposure,8,224,4,4,3.25
9,0,extra,5,225,2,3,2.25
9,0,extract,7,226,5,2,2
9,0,fabulous,8,227,0,8,12.25
9,0,fact,4,228,2,2,1.75
9,0,factory,7,229,4,3,2.5
9,0,fairness,8,230,2,6,11.25
9,0,faith,5,231,3,2,2
9,0,fame,4,232,2,2,1.5
9,0,favourite,9,233,2,7,11.75
9,0,feat,4,234,1,3,2.25
9,0,feather,7,235,4,3,2.25
9,0,feed,4,236,2,2,1.5
9,0,feeling,7,237,3,4,3
9,0,fighting,8,238,1,7,11.5
9,0,fire,4,239,2,2,1.75
9,0,firearm,7,240,4,3,2.5
9,0,first,5,241,3,2,1.75
9,0,fishing,7,242,2,5,10.75
9,0,fit,3,243,2,1,1
9,0,five,4,244,2,2,1.5
9,0,float,5,245,1,4,2.75
9,0,follow,6,246,1,5,10.75
9,0,fond,4,247,2,2,1.75
9,0,forest,6,248,2,4,3
9,0,forgive,7,249,3,4,3
9,0,formal,6,250,3,3,16.75
9,0,forth,5,251,3,2,390
9,0,forum,5,252,3,2,1.25
9,0,fossil,6,253,2,4,2.25
9,0,frame,5,254,1,4,2.25
9,0,franchise,9,255,3,6,10.25
9,0,frankly,7,256,4,3,3.5
9,0,freely,6,257,2,4,2.5
9,0,freeze,6,258,4,2,1.75
9,0,from,4,259,2,2,6
9,0,fully,5,260,1,4,1.75
9,0,fun,3,261,2,1,0.75
9,0,fund,4,262,3,1,1
9,0,gambling,8,263,0,8,8.25
9,0,gang,4,264,2,2,1.5
9,0,garden,6,265,2,4,2.75
9,0,generic,7,266,1,6,7
9,0,generous,8,267,5,3,3.5
9,0,gentleman,9,268,3,6,4.25
9,0,ghost,5,269,1,4,10.5
9,0,glad,4,270,1,3,1.5
9,0,goal,4,271,1,3,1.25
9,0,golden,6,272,2,4,1.75
9,0,gorgeous,8,273,2,6,6
9,0,grand,5,274,1,4,1.5
9,0,grant,5,275,4,1,0.75
9,0,great,5,276,2,3,1.25
9,0,greatly,7,277,5,2,1
9,0,guideline,9,278,1,8,6
9,0,half,4,279,0,4,1.25
9,0,halt,4,280,3,1,0.5
9,0,hand,4,281,2,2,4.25
9,0,happy,5,282,2,3,1
9,0,hardly,6,283,2,4,1.25
9,0,hardware,8,284,4,4,1.5
9,0,harmony,7,285,3,4,5
9,0,hatred,6,286,2,4,1.25
9,0,he,2,287,1,1,0.5
9,0,hear,4,288,2,2,0.75
9,0,heating,7,289,3,4,4.75
9,0,hello,5,290,2,3,1
9,0,helmet,6,291,3,3,1.25
9,0,helpful,7,292,3,4,1.5
9,0,hence,5,293,2,3,4.25
9,0,hero,4,294,2,2,0.75
9,0,hidden,6,295,1,5,1.5
9,0,highway,7,296,2,5,1.5
9,0,hill,4,297,2,2,4.25
9,0,himself,7,298,2,5,1.5
9,0,historian,9,299,2,7,2
9,0,history,7,300,6,1,4.25
9,0,hobby,5,301,1,4,1.25
9,0,holy,4,302,2,2,0.75
9,0,homeless,8,303,2,6,1.75
9,0,homework,8,304,4,4,5
9,0,hope,4,305,2,2,0.75
9,0,hopefully,9,306,4,5,1.5
9,0,hostile,7,307,2,5,8.5
9,0,house,5,308,2,3,2.25
9,0,hungry,6,309,1,5,3.25
9,0,husband,7,310,2,5,9
9,0,ideology,8,311,0,8,5
9,0,if,2,312,1,1,1
9,0,illness,7,313,1,6,9.5
9,0,impact,6,314,1,5,3.25
9,0,in,2,315,1,1,0.75
9,0,incentive,9,316,2,7,10.5
9,0,inclined,8,317,3,5,3.75
9,0,including,9,318,4,5,4
9,0,increase,8,319,3,5,9.5
9,0,indeed,6,320,2,4,3.25
9,0,indicator,9,321,3,6,4.25
9,0,indoors,7,322,3,4,9.5
9,0,induce,6,323,3,3,2.5
9,0,infect,6,324,2,4,3
9,0,infection,9,325,6,3,9
9,0,inflation,9,326,3,6,4.75
9,0,innocent,8,327,2,6,4.5
9,0,input,5,328,2,3,8.5
9,0,inspire,7,329,2,5,3.75
9,0,instantly,9,330,3,6,4.5
9,0,intensity,9,331,2,7,11.25
9,0,interact,8,332,4,4,3.5
9,0,interrupt,9,333,5,4,10.75
9,0,introduce,9,334,3,6,4.5
9,0,invasion,8,335,2,6,4.25
9,0,invisible,9,336,3,6,11.75
9,0,jam,3,337,0,3,2
9,0,jeans,5,338,1,4,2.75
9,0,joint,5,339,1,4,9
9,0,july,4,340,1,3,2.25
9,0,kill,4,341,0,4,2.5
9,0,kiss,4,342,2,2,1.75
9,0,knock,5,343,1,4,9
9,0,knowledge,9,344,3,6,4.25
9,0,label,5,345,0,5,3.25
9,0,labour,6,346,3,3,8.5
9,0,lady,4,347,2,2,1.5
9,0,lamp,4,348,2,2,1.5
9,0,landing,7,349,2,5,3.5
9,0,landlord,8,350,4,4,9
9,0,lane,4,351,3,1,1.25
9,0,language,8,352,3,5,3.5
9,0,late,4,353,2,2,1.5
9,0,lately,6,354,4,2,1.75
9,0,lawyer,6,355,2,4,9
9,0,leap,4,356,1,3,2.25
9,0,learn,5,357,3,2,1.75
9,0,leave,5,358,3,2,1.75
9,0,lend,4,359,2,2,1.5
9,0,length,6,360,3,3,7.75
9,0,level,5,361,2,3,2.5
9,0,lifetime,8,362,1,7,4.5
9,0,light,5,363,2,3,8.25
9,0,likewise,8,364,2,6,4
9,0,limit,5,365,2,3,2.25
9,0,linger,6,366,2,4,8.75
9,0,loan,4,367,1,3,2.25
9,0,logic,5,368,2,3,2.25
9,0,loom,4,369,2,2,1.75
9,0,loop,4,370,3,1,1.25
9,0,lose,4,371,2,2,2
9,0,lost,4,372,3,1,7.75
9,0,lower,5,373,2,3,2.5
9,0,magazine,8,374,0,8,6.75
9,0,magical,7,375,3,4,9.25
9,0,magnitude,9,376,3,6,4.25
9,0,manifest,8,377,2,6,10
9,0,marathon,8,378,2,6,4.25
9,0,march,5,379,3,2,1.75
9,0,marketing,9,380,3,6,11
9,0,marriage,8,381,3,5,3.75
9,0,massive,7,382,2,5,3.5
9,0,matter,6,383,2,4,8.75
9,0,maximize,8,384,2,6,4
9,0,maybe,5,385,2,3,2.25
9,0,me,2,386,1,1,0.75
9,0,measure,7,387,2,5,9.25
9,0,mechanism,9,388,2,7,4.75
9,0,medicine,8,389,2,6,10
9,0,menu,4,390,2,2,1.75
9,0,metal,5,391,2,3,2.25
9,0,migration,9,392,1,8,10.75
9,0,mile,4,393,2,2,1.5
9,0,military,8,394,3,5,3.5
9,0,mine,4,395,2,2,1.5
9,0,miner,5,396,4,1,1.25
9,0,mining,6,397,3,3,8.75
9,0,minority,8,398,3,5,3.75
9,0,miracle,7,399,2,5,3.5
9,0,missile,7,400,2,5,9.25
9,0,mistake,7,401,3,4,3.25
9,0,mobile,6,402,1,5,3.5
9,0,modern,6,403,2,4,8.75
9,0,monitor,7,404,2,5,3.5
9,0,monk,4,405,3,1,1.25
9,0,moral,5,406,2,3,2.25
9,0,morning,7,407,3,4,9.25
9,0,motorist,8,408,2,6,4
9,0,mount,5,409,2,3,2.25
9,0,movement,8,410,2,6,10.25
9,0,musical,7,411,1,6,4
9,0,neglect,7,412,0,7,10.25
9,0,nerve,5,413,2,3,2.25
9,0,network,7,414,2,5,3.5
9,0,next,4,415,2,2,1.75
9,0,nineteen,8,416,1,7,11
9,0,noble,5,417,1,4,2.75
9,0,nod,3,418,2,1,1
9,0,nonsense,8,419,2,6,10
9,0,noon,4,420,2,2,1.75
9,0,nose,4,421,2,2,1.75
9,0,now,3,422,2,1,1
9,0,nowadays,8,423,3,5,9.25
9,0,number,6,424,1,5,3.5
9,0,nurse,5,425,2,3,2.5
9,0,o,1,426,0,1,0.75
9,0,obsession,9,427,1,8,11
9,0,obtain,6,428,2,4,3
9,0,obvious,7,429,2,5,3.5
9,0,occur,5,430,1,4,9
9,0,of,2,431,1,1,0.75
9,0,ongoing,7,432,1,6,4
9,0,open,4,433,1,3,8
9,0,operator,8,434,3,5,3.75
9,0,or,2,435,1,1,0.75
9,0,orchestra,9,436,2,7,4.5
9,0,our,3,437,1,2,7.75
9,0,outrage,7,438,2,5,3.5
9,0,oven,4,439,1,3,2.25
9,0,overseas,8,440,3,5,9.5
9,0,own,3,441,1,2,1.5
9,0,owner,5,442,3,2,1.5
9,0,pair,4,443,0,4,2.5
9,0,paper,5,444,2,3,2.25
9,0,partly,6,445,2,4,9.25
9,0,party,5,446,4,1,1.25
9,0,passage,7,447,2,5,3.5
9,0,passing,7,448,4,3,2.5
9,0,passion,7,449,5,2,8
9,0,pathway,7,450,2,5,3.5
9,0,peasant,7,451,1,6,4
9,0,period,6,452,2,4,9.5
9,0,permanent,9,453,3,6,4.25
9,0,physics,7,454,1,6,9.75
9,0,pill,4,455,1,3,2
9,0,pilot,5,456,3,2,1.75
9,0,pitch,5,457,2,3,2.25
9,0,plain,5,458,1,4,2.75
9,0,plunge,6,459,2,4,8.75
9,0,poet,4,460,1,3,2
9,0,poisonous,9,461,2,7,4.5
9,0,policeman,9,462,2,7,10.75
9,0,policy,6,463,5,1,1.5
9,0,port,4,464,2,2,1.75
9,0,pose,4,465,2,2,1.5
9,0,potential,9,466,2,7,10.75
9,0,poverty,7,467,2,5,2.25
9,0,powerful,8,468,2,6,5.75
9,0,practice,8,469,1,7,2
9,0,pray,4,470,3,1,0.75
9,0,precision,9,471,2,7,5.75
9,0,prefer,6,472,3,3,1.25
9,0,premium,7,473,3,4,1.5
9,0,prepare,7,474,3,4,5.25
9,0,present,7,475,3,4,1.5
9,0,pretty,6,476,3,3,1
9,0,prevent,7,477,3,4,1.25
9,0,previous,8,478,4,4,5.5
9,0,price,5,479,2,3,1
9,0,primarily,9,480,3,6,2
9,0,prison,6,481,3,3,5
9,0,probably,8,482,2,6,1.75
9,0,protein,7,483,3,4,1.5
9,0,protocol,8,484,4,4,5.25
9,0,provide,7,485,3,4,1.25
9,0,purely,6,486,1,5,1.5
9,0,purple,6,487,3,3,5
9,0,pursue,6,488,3,3,1
9,0,qualify,7,489,0,7,2
9,0,queen,5,490,2,3,4.75
9,0,question,8,491,3,5,1.75
9,0,queue,5,492,3,2,1
9,0,quietly,7,493,2,5,1.5
9,0,quota,5,494,2,3,5
9,0,racist,6,495,0,6,1.75
9,0,radio,5,496,2,3,1.25
9,0,range,5,497,2,3,5
9,0,rare,4,498,2,2,0.75
9,0,raw,3,499,2,1,0.5
9,0,reader,6,500,1,5,1.5
9,0,readily,7,501,4,3,1
9,0,reading,7,502,5,2,4.75
9,0,real,4,503,3,1,0.5
9,0,realize,7,504,4,3,1.25
9,0,rebellion,9,505,2,7,2
9,0,receiver,8,506,2,6,5.75
9,0,recession,9,507,4,5,1.75
9,0,recipe,6,508,3,3,1.25
9,0,red,3,509,2,1,0.5
9,0,register,8,510,2,6,5.75
9,0,reinforce,9,511,2,7,2.25
9,0,relaxing,8,512,2,6,5.75
9,0,release,7,513,3,4,1.5
9,0,remains,7,514,2,5,5.25
9,0,remember,8,515,3,5,1.75
9,0,reminder,8,516,3,5,1.75
9,0,renowned,8,517,2,6,5.75
9,0,rental,6,518,3,3,1.25
9,0,repeated,8,519,2,6,1.75
9,0,report,6,520,3,3,5
9,0,reproduce,9,521,3,6,2
9,0,request,7,522,2,5,1.5
9,0,response,8,523,2,6,5.75
9,0,restraint,9,524,3,6,2
9,0,result,6,525,3,3,5
9,0,resume,6,526,4,2,1
9,0,review,6,527,2,4,1.25
9,0,rice,4,528,1,3,0.75
9,0,rid,3,529,2,1,0.5
9,0,riot,4,530,2,2,0.75
9,0,risk,4,531,2,2,4.75
9,0,rock,4,532,1,3,1
9,0,route,5,533,2,3,1
9,0,royal,5,534,2,3,1
9,0,rugby,5,535,1,4,5.25
9,0,rumour,6,536,2,4,1.5
9,0,run,3,537,2,1,0.5
9,0,runner,6,538,3,3,1.25
9,0,sail,4,539,0,4,1.25
9,0,saint,5,540,3,2,5
9,0,sanction,8,541,2,6,1.75
9,0,sandwich,8,542,3,5,1.75
9,0,scope,5,543,1,4,5.25
9,0,scratch,7,544,2,5,1.75
9,0,scream,6,545,3,3,1.25
9,0,screening,9,546,4,5,5.75
9,0,script,6,547,3,3,1.25
9,0,sculpture,9,548,2,7,2
9,0,sea,3,549,1,2,4.75
9,0,section,7,550,2,5,1.75
9,0,seize,5,551,2,3,1
9,0,self,4,552,2,2,0.75
9,0,senator,7,553,2,5,5.75
9,0,sensation,9,554,3,6,2.25
9,0,sensitive,9,555,4,5,6.75
9,0,sentence,8,556,3,5,2
9,0,serial,6,557,2,4,1.5
9,0,seventeen,9,558,2,7,6.5
9,0,seventy,7,559,6,1,1
9,0,several,7,560,4,3,1.25
9,0,shine,5,561,1,4,1.25
9,0,shot,4,562,2,2,0.75
9,0,shrug,5,563,2,3,5
9,0,sigh,4,564,1,3,1
9,0,silence,7,565,2,5,2
9,0,simulate,8,566,2,6,6.5
9,0,sir,3,567,2,1,0.5
9,0,sixty,5,568,2,3,1
9,0,skiing,6,569,1,5,1.5
9,0,skill,5,570,3,2,5
9,0,sky,3,571,2,1,0.5
9,0,slot,4,572,1,3,1
9,0,smash,5,573,1,4,1.25
9,0,soar,4,574,1,3,1
9,0,soccer,6,575,2,4,5.25
9,0,socialist,9,576,3,6,2
9,0,soft,4,577,2,2,0.75
9,0,software,8,578,4,4,5.5
9,0,solely,6,579,2,4,1.5
9,0,solicitor,9,580,3,6,2
9,0,somebody,8,581,2,6,6
9,0,source,6,582,2,4,1.5
9,0,spicy,5,583,1,4,1.25
9,0,spill,5,584,3,2,1
9,0,split,5,585,2,3,5.25
9,0,sponsor,7,586,2,5,2
9,0,spot,4,587,3,1,0.75
9,0,stadium,7,588,1,6,6
9,0,stage,5,589,3,2,1
9,0,steel,5,590,2,3,1
9,0,stream,6,591,2,4,1.25
9,0,struggle,8,592,3,5,5.75
9,0,student,7,593,2,5,1.5
9,0,suburb,6,594,1,5,1.5
9,0,suffer,6,595,2,4,5.5
9,0,sum,3,596,2,1,0.5
9,0,summit,6,597,3,3,1
9,0,superb,6,598,2,4,1.25
9,0,supply,6,599,3,3,5
9,0,supporter,9,600,4,5,2.25
9,0,suppress,8,601,4,4,1.75
9,0,surface,7,602,2,5,6
9,0,surge,5,603,3,2,0.75
9,0,sustain,7,604,2,5,1.5
9,0,swimming,8,605,1,7,6
9,0,symbol,6,606,1,5,1.75
9,0,syndrome,8,607,2,6,2
9,0,t,1,608,0,1,0.25
9,0,tag,3,609,1,2,4.75
9,0,talented,8,610,2,6,2
9,0,tax,3,611,2,1,0.5
9,0,teach,5,612,1,4,1.25
9,0,technical,9,613,2,7,6.25
9,0,tell,4,614,2,2,0.75
9,0,tennis,6,615,2,4,1.5
9,0,tenure,6,616,3,3,5
9,0,terminal,8,617,2,6,2
9,0,terrain,7,618,3,4,1.5
9,0,terrible,8,619,4,4,5.75
9,0,terrorist,9,620,4,5,2
9,0,testify,7,621,2,5,1.75
9,0,text,4,622,2,2,5
9,0,that,4,623,1,3,1
9,0,theirs,6,624,2,4,1.5
9,0,them,4,625,3,1,0.75
9,0,theology,8,626,3,5,5.5
9,0,there,5,627,3,2,1
9,0,thin,4,628,2,2,0.75
9,0,think,5,629,4,1,0.5
9,0,third,5,630,3,2,0.75
9,0,thought,7,631,2,5,1.5
9,0,thrive,6,632,2,4,5.5
9,0,throw,5,633,3,2,1
9,0,thursday,8,634,2,6,2
9,0,tobacco,7,635,1,6,6.75
9,0,tongue,6,636,2,4,1.5
9,0,total,5,637,2,3,1.25
9,0,touch,5,638,2,3,6.25
9,0,tourist,7,639,3,4,1.75
9,0,towards,7,640,2,5,1.75
9,0,toy,3,641,2,1,0.5
9,0,tribunal,8,642,1,7,7
9,0,true,4,643,2,2,1
9,0,trust,5,644,3,2,1.25
9,0,try,3,645,2,1,0.75
9,0,tuesday,7,646,1,6,6.75
9,0,tuition,7,647,2,5,2
9,0,turn,4,648,2,2,1
9,0,twenty,6,649,1,5,6.5
9,0,type,4,650,1,3,1
9,0,typical,7,651,3,4,1.5
9,0,ugly,4,652,0,4,1.25
9,0,umbrella,8,653,1,7,7.5
9,0,unfold,6,654,1,5,2
9,0,unlike,6,655,2,4,6
9,0,unlikely,8,656,6,2,1.5
9,0,upper,5,657,1,4,1.25
9,0,upset,5,658,2,3,1.25
9,0,us,2,659,1,1,0.5
9,0,use,3,660,2,1,0.5
9,0,used,4,661,3,1,0.5
9,0,valid,5,662,0,5,6
9,0,versus,6,663,1,5,1.5
9,0,very,4,664,3,1,0.75
9,0,violation,9,665,1,8,6.5
9,0,vitamin,7,666,2,5,1.75
9,0,vote,4,667,1,3,1.25
9,0,wall,4,668,0,4,9
9,0,want,4,669,2,2,1.75
9,0,wash,4,670,2,2,1.75
9,0,weak,4,671,1,3,2
9,0,wear,4,672,3,1,1
9,0,weather,7,673,3,4,9.5
9,0,web,3,674,2,1,1
9,0,website,7,675,3,4,3
9,0,wedding,7,676,2,5,3.5
9,0,wet,3,677,2,1,1
9,0,what,4,678,1,3,9
9,0,when,4,679,2,2,1.75
9,0,where,5,680,3,2,1.75
9,0,whilst,6,681,2,4,2.75
9,0,who,3,682,2,1,1
9,0,wholly,6,683,3,3,9.25
9,0,wide,4,684,1,3,2
9,0,winter,6,685,2,4,2.75
9,0,wish,4,686,2,2,1.75
9,0,wooden,6,687,1,5,10
9,0,workout,7,688,2,5,3.75
9,0,worldwide,9,689,3,6,4.25
9,0,worm,4,690,3,1,7.75
9,0,worse,5,691,3,2,1.75
9,0,wrong,5,692,1,4,2.75
9,0,year,4,693,0,4,2.5
9,0,yours,5,694,1,4,9.75
9,0,zone,4,695,0,4,2.5
9,1,ability,7,0,0,7,11.25
9,1,above,5,1,2,3,2.25
9,1,abroad,6,2,2,4,2.75
9,1,absent,6,3,2,4,2.75
9,1,abstract,8,4,3,5,11.5
9,1,accent,6,5,1,5,3.5
9,1,according,9,6,3,6,15.75
9,1,account,7,7,4,3,2.75
9,1,act,3,8,2,1,1
9,1,action,6,9,3,3,2.25
9,1,adhere,6,10,1,5,10.5
9,1,admission,9,11,2,7,4.75
9,1,adult,5,12,2,3,2.25
9,1,advertise,9,13,2,7,11.75
9,1,affair,6,14,1,5,3.25
9,1,affection,9,15,3,6,11.5
9,1,afford,6,16,3,3,2.25
9,1,afraid,6,17,2,4,3
9,1,aid,3,18,1,2,1.5
9,1,air,3,19,2,1,1
9,1,aircraft,8,20,3,5,10.75
9,1,alert,5,21,1,4,2.75
9,1,alignment,9,22,2,7,12.25
9,1,alliance,8,23,2,6,5.25
9,1,allow,5,24,3,2,2
9,1,alone,5,25,2,3,2.25
9,1,along,5,26,4,1,1.25
9,1,also,4,27,2,2,8.25
9,1,although,8,28,2,6,4
9,1,ambitious,9,29,1,8,12.25
9,1,amid,4,30,2,2,1.75
9,1,angel,5,31,1,4,2.75
9,1,anything,8,32,2,6,11.5
9,1,apart,5,33,1,4,2.75
9,1,apple,5,34,2,3,2.25
9,1,archive,7,35,1,6,4
9,1,armed,5,36,2,3,9.25
9,1,arrival,7,37,2,5,3.5
9,1,asset,5,38,1,4,3
9,1,attach,6,39,1,5,11
9,1,attack,6,40,5,1,1.5
9,1,attempt,7,41,3,4,3
9,1,attend,6,42,4,2,2.5
9,1,attribute,9,43,3,6,12.5
9,1,authority,9,44,1,8,5.25
9,1,avoid,5,45,1,4,10.75
9,1,aware,5,46,1,4,2.75
9,1,back,4,47,0,4,2.75
9,1,backdrop,8,48,4,4,2.75
9,1,ballot,6,49,2,4,10.5
9,1,banana,6,50,2,4,2.75
9,1,barrier,7,51,2,5,3.5
9,1,basis,5,52,2,3,9.5
9,1,bear,4,53,1,3,2
9,1,because,7,54,2,5,3.5
9,1,bee,3,55,2,1,1
9,1,beef,4,56,3,1,1
9,1,being,5,57,2,3,9
9,1,bend,4,58,2,2,2
9,1,beneath,7,59,3,4,3
9,1,bent,4,60,3,1,1.25
9,1,bet,3,61,2,1,1
9,1,bias,4,62,1,3,2
9,1,bicycle,7,63,2,5,10.25
9,1,biology,7,64,2,5,3.5
9,1,blast,5,65,1,4,10
9,1,bleed,5,66,2,3,2.25
9,1,blend,5,67,3,2,1.75
9,1,body,4,68,1,3,2
9,1,bonus,5,69,2,3,2.25
9,1,booking,7,70,2,5,10.25
9,1,boring,6,71,2,4,3
9,1,bounce,6,72,2,4,3
9,1,brain,5,73,1,4,9.75
9,1,bread,5,74,2,3,2.25
9,1,breath,6,75,4,2,2
9,1,briefly,7,76,2,5,3.5
9,1,brilliant,9,77,3,6,11.25
9,1,broad,5,78,2,3,2.25
9,1,broadcast,9,79,5,4,3.25
9,1,broadly,7,80,5,2,1.75
9,1,brother,7,81,3,4,9.75
9,1,brown,5,82,3,2,1.75
9,1,burst,5,83,1,4,2.75
9,1,bury,4,84,3,1,1.25
9,1,bus,3,85,2,1,1
9,1,busy,4,86,3,1,1
9,1,cabin,5,87,0,5,10
9,1,cabinet,7,88,5,2,1.75
9,1,calm,4,89,2,2,1.75
9,1,capture,7,90,2,5,10.25
9,1,carrot,6,91,2,4,3
9,1,case,4,92,2,2,1.5
9,1,castle,6,93,3,3,2.5
9,1,cat,3,94,2,1,1
9,1,catch,5,95,3,2,1.5
9,1,cattle,6,96,3,3,9.5
9,1,caution,7,97,2,5,3.5
9,1,cautious,8,98,6,2,2
9,1,charge,6,99,1,5,10.25
9,1,chat,4,100,3,1,1
9,1,cinema,6,101,1,5,3.25
9,1,civic,5,102,2,3,2.5
9,1,class,5,103,1,4,9.75
9,1,cleaning,8,104,2,6,4.25
9,1,clinic,6,105,2,4,3
9,1,clip,4,106,3,1,1.25
9,1,clock,5,107,2,3,9.5
9,1,clothing,8,108,3,5,4
9,1,clue,4,109,2,2,1.75
9,1,coast,5,110,1,4,2.75
9,1,coastal,7,111,5,2,9.25
9,1,cocktail,8,112,2,6,4.25
9,1,cognitive,9,113,2,7,12
9,1,collapse,8,114,2,6,4.25
9,1,college,7,115,4,3,2.5
9,1,collision,9,116,4,5,11.5
9,1,combat,6,117,2,4,3
9,1,commander,9,118,3,6,4.25
9,1,commerce,8,119,4,4,10.5
9,1,commit,6,120,4,2,2
9,1,comprise,8,121,3,5,3.5
9,1,computer,8,122,4,4,3.25
9,1,concerned,9,123,2,7,11.75
9,1,conclude,8,124,4,4,3.25
9,1,concrete,8,125,4,4,10.25
9,1,confirm,7,126,3,4,3.25
9,1,confuse,7,127,4,3,2.5
9,1,conserve,8,128,3,5,3.5
9,1,construct,9,129,4,5,11
9,1,consumer,8,130,4,4,3.5
9,1,container,9,131,3,6,9.25
9,1,contender,9,132,4,5,1.75
9,1,contest,7,133,5,2,1
9,1,continue,8,134,4,4,1.5
9,1,contract,8,135,4,4,9.75
9,1,contrary,8,136,6,2,175.25
9,1,convict,7,137,3,4,4.25
9,1,cool,4,138,2,2,1.25
9,1,council,7,139,2,5,2.25
9,1,covered,7,140,2,5,7.5
9,1,crack,5,141,1,4,1.75
9,1,crazy,5,142,3,2,1.5
9,1,creator,7,143,2,5,6.75
9,1,criterion,9,144,2,7,4
9,1,cue,3,145,1,2,1.25
9,1,cupboard,8,146,2,6,7.5
9,1,curiosity,9,147,2,7,3.75
9,1,custody,7,148,2,5,7
9,1,custom,6,149,5,1,2.25
9,1,cutting,7,150,2,5,3
9,1,dad,3,151,0,3,1.25
9,1,dancer,6,152,2,4,7.5
9,1,dark,4,153,2,2,1.25
9,1,data,4,154,2,2,1
9,1,date,4,155,3,1,0.75
9,1,daughter,8,156,2,6,2.5
9,1,dead,4,157,1,3,9.75
9,1,deadly,6,158,4,2,1.25
9,1,decision,8,159,2,6,2.5
9,1,decorate,8,160,3,5,9.75
9,1,dedicated,9,161,2,7,2.5
9,1,defensive,9,162,2,7,5.25
9,1,define,6,163,3,3,1.25
9,1,defy,4,164,3,1,0.75
9,1,dependent,9,165,2,7,2.25
9,1,depict,6,166,3,3,5
9,1,derive,6,167,2,4,1.5
9,1,descent,7,168,2,5,1.5
9,1,desert,6,169,3,3,4.5
9,1,desire,6,170,3,3,1.5
9,1,destroy,7,171,3,4,1.5
9,1,detection,9,172,2,7,5.75
9,1,diary,5,173,1,4,1.25
9,1,die,3,174,2,1,0.5
9,1,different,9,175,2,7,2.25
9,1,dilemma,7,176,2,5,5
9,1,dimension,9,177,2,7,2.25
9,1,dip,3,178,2,1,0.5
9,1,direction,9,179,2,7,5.75
9,1,directory,9,180,6,3,1.5
9,1,disagree,8,181,2,6,5.25
9,1,discard,7,182,3,4,1.5
9,1,discharge,9,183,4,5,1.75
9,1,dispose,7,184,3,4,5
9,1,district,8,185,3,5,2
9,1,disturb,7,186,4,3,1.25
9,1,diverse,7,187,2,5,1.5
9,1,divert,6,188,5,1,4.25
9,1,divorce,7,189,3,4,1.5
9,1,dog,3,190,1,2,0.75
9,1,dominance,9,191,2,7,5.75
9,1,dominate,8,192,6,2,1.25
9,1,donate,6,193,2,4,1.25
9,1,dose,4,194,2,2,0.75
9,1,drag,4,195,1,3,1
9,1,drain,5,196,3,2,4.25
9,1,dramatic,8,197,3,5,1.75
9,1,draw,4,198,3,1,0.5
9,1,dress,5,199,2,3,1
9,1,drive,5,200,2,3,1
9,1,driver,6,201,5,1,4.25
9,1,drug,4,202,2,2,1
9,1,dull,4,203,1,3,1
9,1,duty,4,204,2,2,0.75
9,1,easy,4,205,0,4,1.25
9,1,eat,3,206,2,1,0.5
9,1,economics,9,207,1,8,6
9,1,educator,8,208,1,7,5.75
9,1,eighteen,8,209,1,7,2
9,1,elaborate,9,210,1,8,6
9,1,election,8,211,2,6,2.25
9,1,electoral,9,212,5,4,1.75
9,1,element,7,213,3,4,5.25
9,1,embed,5,214,1,4,1.25
9,1,emphasize,9,215,2,7,2.25
9,1,empty,5,216,3,2,4.5
9,1,energy,6,217,1,5,1.5
9,1,enough,6,218,2,4,1.25
9,1,enrol,5,219,2,3,4.25
9,1,entirely,8,220,2,6,2
9,1,equation,8,221,1,7,2
9,1,era,3,222,1,2,4
9,1,error,5,223,2,3,1
9,1,erupt,5,224,2,3,1
9,1,eternal,7,225,1,6,5
9,1,ethical,7,226,2,5,1.75
9,1,ethnic,6,227,3,3,1.25
9,1,everyday,8,228,1,7,5.25
9,1,except,6,229,1,5,1.5
9,1,exclude,7,230,3,4,1.5
9,1,exert,5,231,2,3,4.25
9,1,exotic,6,232,2,4,1.5
9,1,explosion,9,233,2,7,2.25
9,1,export,6,234,3,3,4.5
9,1,exposure,8,235,4,4,1.75
9,1,facility,8,236,0,8,2.25
9,1,factory,7,237,3,4,4.75
9,1,fairness,8,238,2,6,2
9,1,faith,5,239,3,2,1
9,1,familiar,8,240,2,6,5.5
9,1,farm,4,241,2,2,0.75
9,1,feat,4,242,1,3,1
9,1,feather,7,243,4,3,1
9,1,feature,7,244,4,3,4.25
9,1,feed,4,245,2,2,0.75
9,1,feel,4,246,3,1,0.5
9,1,fence,5,247,2,3,1
9,1,fifth,5,248,1,4,1.25
9,1,fighting,8,249,2,6,7
9,1,fill,4,250,2,2,1.75
9,1,fire,4,251,2,2,1.75
9,1,firework,8,252,4,4,3
9,1,first,5,253,3,2,7.25
9,1,fishing,7,254,2,5,3.5
9,1,fit,3,255,2,1,1
9,1,five,4,256,2,2,1.5
9,1,flame,5,257,1,4,2.75
9,1,flash,5,258,3,2,7
9,1,flaw,4,259,3,1,1
9,1,flawed,6,260,4,2,1.75
9,1,fleet,5,261,2,3,2.25
9,1,float,5,262,2,3,2.25
9,1,flour,5,263,3,2,1.75
9,1,follow,6,264,1,5,9
9,1,following,9,265,6,3,2.75
9,1,fool,4,266,2,2,1.75
9,1,forever,7,267,2,5,9
9,1,forge,5,268,3,2,2
9,1,fork,4,269,3,1,1.25
9,1,format,6,270,3,3,2.5
9,1,forth,5,271,3,2,2
9,1,forum,5,272,3,2,2
9,1,fossil,6,273,2,4,8.75
9,1,framework,9,274,1,8,5
9,1,franchise,9,275,3,6,9.75
9,1,frankly,7,276,4,3,2.75
9,1,freely,6,277,2,4,2.75
9,1,freeze,6,278,4,2,2
9,1,fruit,5,279,2,3,8
9,1,fun,3,280,1,2,1.5
9,1,funny,5,281,3,2,1.75
9,1,furious,7,282,2,5,3.5
9,1,gambling,8,283,0,8,10.25
9,1,gang,4,284,2,2,1.75
9,1,gas,3,285,2,1,1
9,1,genuine,7,286,1,6,4
9,1,glad,4,287,1,3,7.75
9,1,goal,4,288,1,3,2
9,1,golden,6,289,2,4,2.75
9,1,goods,5,290,2,3,2.25
9,1,gorgeous,8,291,2,6,10.25
9,1,graduate,8,292,1,7,4.5
9,1,grand,5,293,3,2,7.25
9,1,greatly,7,294,2,5,3.5
9,1,half,4,295,0,4,2.5
9,1,halt,4,296,3,1,1
9,1,happy,5,297,2,3,7.5
9,1,hardware,8,298,2,6,4
9,1,harmony,7,299,3,4,3
9,1,hatred,6,300,2,4,8.25
9,1,hear,4,301,1,3,2.25
9,1,hearing,7,302,4,3,2.25
9,1,heating,7,303,3,4,3
9,1,heavily,7,304,3,4,8.25
9,1,hello,5,305,2,3,2.25
9,1,help,4,306,3,1,1.25
9,1,here,4,307,2,2,1.5
9,1,hidden,6,308,1,5,3.25
9,1,hide,4,309,3,1,6.5
9,1,highway,7,310,2,5,3.5
9,1,hill,4,311,2,2,1.5
9,1,himself,7,312,2,5,3.5
9,1,historian,9,313,2,7,10.5
9,1,history,7,314,6,1,1.5
9,1,hobby,5,315,1,4,3
9,1,hockey,6,316,2,4,8.25
9,1,hold,4,317,2,2,1.5
9,1,homeless,8,318,2,6,4
9,1,homework,8,319,4,4,8.5
9,1,horizon,7,320,2,5,3.75
9,1,hostility,9,321,2,7,4.75
9,1,house,5,322,2,3,7.75
9,1,hurry,5,323,1,4,2.75
9,1,husband,7,324,2,5,3.5
9,1,ideology,8,325,0,8,10.75
9,1,if,2,326,1,1,1
9,1,illness,7,327,1,6,4
9,1,immigrant,9,328,1,8,10.75
9,1,impact,6,329,2,4,3
9,1,impress,7,330,3,4,9.25
9,1,incentive,9,331,1,8,5.25
9,1,inclined,8,332,3,5,9.75
9,1,increase,8,333,3,5,3.75
9,1,indeed,6,334,2,4,3
9,1,indicator,9,335,3,6,9.75
9,1,indoors,7,336,3,4,3
9,1,induce,6,337,3,3,2.25
9,1,infect,6,338,2,4,2.75
9,1,infection,9,339,6,3,8.25
9,1,injured,7,340,2,5,3.5
9,1,innocent,8,341,2,6,9.5
9,1,insider,7,342,2,5,3.5
9,1,insight,7,343,4,3,2.75
9,1,instantly,9,344,3,6,11.5
9,1,investor,8,345,2,6,4
9,1,invoke,6,346,3,3,2.75
9,1,isolation,9,347,1,8,11.25
9,1,jam,3,348,0,3,2
9,1,jeans,5,349,1,4,2.75
9,1,joint,5,350,1,4,8.5
9,1,kind,4,351,0,4,2.5
9,1,kiss,4,352,2,2,1.75
9,1,knock,5,353,1,4,3
9,1,knowledge,9,354,3,6,10.5
9,1,lady,4,355,0,4,2.5
9,1,landlord,8,356,2,6,10
9,1,laptop,6,357,2,4,3
9,1,late,4,358,2,2,1.5
9,1,layout,6,359,2,4,2.75
9,1,leap,4,360,1,3,7.75
9,1,legacy,6,361,2,4,3
9,1,legal,5,362,4,1,1.25
9,1,leisure,7,363,2,5,3.5
9,1,length,6,364,2,4,9
9,1,less,4,365,2,2,1.75
9,1,lesson,6,366,4,2,1.75
9,1,level,5,367,2,3,2.25
9,1,lifetime,8,368,1,7,10.25
9,1,likewise,8,369,2,6,4
9,1,linger,6,370,2,4,2.75
9,1,lively,6,371,2,4,8.75
9,1,loan,4,372,1,3,2.25
9,1,lobby,5,373,2,3,2.25
9,1,lock,4,374,2,2,1.75
9,1,loop,4,375,2,2,1.75
9,1,lord,4,376,2,2,7.5
9,1,loss,4,377,2,2,1.75
9,1,lost,4,378,3,1,1.25
9,1,lower,5,379,2,3,2.25
9,1,luck,4,380,1,3,2.25
9,1,lung,4,381,2,2,1.75
9,1,magazine,8,382,0,8,11.25
9,1,magical,7,383,3,4,3
9,1,major,5,384,2,3,8.25
9,1,manifest,8,385,2,6,4.25
9,1,marathon,8,386,2,6,4
9,1,march,5,387,3,2,8
9,1,marginal,8,388,3,5,3.75
9,1,marketing,9,389,3,6,4.25
9,1,marriage,8,390,3,5,9.5
9,1,massive,7,391,2,5,3.5
9,1,mate,4,392,2,2,1.5
9,1,maths,5,393,3,2,1.75
9,1,matter,6,394,3,3,8.25
9,1,me,2,395,1,1,1
9,1,meaning,7,396,2,5,3.5
9,1,means,5,397,4,1,1.25
9,1,mechanism,9,398,2,7,10.25
9,1,medical,7,399,2,5,3.5
9,1,medicine,8,400,5,3,2.5
9,1,meet,4,401,2,2,1.75
9,1,militant,8,402,1,7,10.25
9,1,mill,4,403,3,1,1.25
9,1,mine,4,404,2,2,1.75
9,1,miner,5,405,4,1,1
9,1,mining,6,406,3,3,2.25
9,1,minority,8,407,3,5,9.5
9,1,mobile,6,408,1,5,3.5
9,1,modern,6,409,2,4,9
9,1,modest,6,410,4,2,2.25
9,1,momentum,8,411,2,6,4
9,1,monitor,7,412,2,5,3.5
9,1,monk,4,413,3,1,7.5
9,1,moral,5,414,2,3,2.25
9,1,morning,7,415,3,4,3.25
9,1,motor,5,416,2,3,2.25
9,1,mountain,8,417,2,6,9.75
9,1,movement,8,418,2,6,4
9,1,multiply,8,419,1,7,10.5
9,1,mutual,6,420,2,4,3
9,1,mystery,7,421,1,6,4
9,1,nail,4,422,0,4,5.75
9,1,native,6,423,2,4,1.5
9,1,necessity,9,424,1,8,6
9,1,neglect,7,425,2,5,1.75
9,1,nest,4,426,2,2,0.75
9,1,network,7,427,2,5,5.5
9,1,news,4,428,2,2,1
9,1,nineteen,8,429,1,7,2
9,1,noble,5,430,1,4,1.25
9,1,noon,4,431,2,2,4.5
9,1,nose,4,432,2,2,0.75
9,1,notable,7,433,2,5,1.5
9,1,nowadays,8,434,2,6,5.5
9,1,nursery,7,435,1,6,1.75
9,1,nutrition,9,436,2,7,5.75
9,1,o,1,437,0,1,0.25
9,1,obey,4,438,1,3,1
9,1,observe,7,439,2,5,1.5
9,1,occur,5,440,1,4,4.75
9,1,offender,8,441,1,7,2
9,1,offering,8,442,4,4,1.5
9,1,on,2,443,1,1,0.25
9,1,ongoing,7,444,2,5,5.25
9,1,open,4,445,1,3,1
9,1,operate,7,446,3,4,1.25
9,1,optimism,8,447,2,6,5.5
9,1,or,2,448,1,1,0.5
9,1,oral,4,449,2,2,0.75
9,1,orange,6,450,3,3,1
9,1,order,5,451,2,3,1
9,1,out,3,452,1,2,4.25
9,1,over,4,453,1,3,1
9,1,owner,5,454,1,4,1.25
9,1,oxygen,6,455,1,5,1.5
9,1,pair,4,456,0,4,4.75
9,1,paper,5,457,2,3,1
9,1,parish,6,458,2,4,1.25
9,1,partly,6,459,3,3,4.75
9,1,party,5,460,4,1,0.75
9,1,passage,7,461,2,5,1.5
9,1,passing,7,462,4,3,1.25
9,1,passion,7,463,5,2,1
9,1,peasant,7,464,1,6,5.75
9,1,pension,7,465,2,5,1.5
9,1,person,6,466,2,4,1.5
9,1,persuade,8,467,4,4,5.25
9,1,phase,5,468,1,4,1.25
9,1,physics,7,469,2,5,1.75
9,1,pill,4,470,1,3,4.75
9,1,pilot,5,471,3,2,1
9,1,pit,3,472,2,1,0.5
9,1,placement,9,473,1,8,2.25
9,1,plain,5,474,3,2,4.75
9,1,player,6,475,3,3,1.25
9,1,pleasure,8,476,2,6,2
9,1,pocket,6,477,1,5,5.25
9,1,poetry,6,478,2,4,1.25
9,1,pole,4,479,2,2,0.75
9,1,policy,6,480,3,3,1
9,1,pool,4,481,2,2,0.75
9,1,popular,7,482,2,5,5.25
9,1,poverty,7,483,2,5,1.5
9,1,powder,6,484,2,4,5.25
9,1,pray,4,485,1,3,1
9,1,precede,7,486,2,5,1.75
9,1,precision,9,487,4,5,1.75
9,1,prefer,6,488,3,3,5
9,1,prepare,7,489,3,4,1.5
9,1,prevent,7,490,3,4,1.25
9,1,priest,6,491,2,4,5
9,1,primarily,9,492,3,6,2
9,1,prison,6,493,3,3,1.25
9,1,prisoner,8,494,6,2,1
9,1,privilege,9,495,3,6,5.75
9,1,probably,8,496,2,6,2
9,1,promote,7,497,3,4,5.5
9,1,promotion,9,498,6,3,1.5
9,1,protect,7,499,3,4,1.5
9,1,protein,7,500,5,2,1
9,1,provide,7,501,3,4,5.25
9,1,provision,9,502,5,4,1.75
9,1,punch,5,503,1,4,1.25
9,1,purchase,8,504,2,6,5.75
9,1,purely,6,505,3,3,1.25
9,1,purple,6,506,3,3,1.25
9,1,pursue,6,507,3,3,1.25
9,1,qualify,7,508,0,7,6
9,1,question,8,509,2,6,1.75
9,1,queue,5,510,3,2,1
9,1,quickly,7,511,2,5,5.25
9,1,quietly,7,512,3,4,1.5
9,1,quota,5,513,2,3,1
9,1,random,6,514,0,6,5.5
9,1,range,5,515,3,2,0.75
9,1,rapid,5,516,2,3,1
9,1,rare,4,517,2,2,0.75
9,1,readily,7,518,1,6,5.25
9,1,reading,7,519,5,2,1
9,1,realize,7,520,3,4,1.25
9,1,really,6,521,4,2,1
9,1,receiver,8,522,2,6,5.75
9,1,recipe,6,523,3,3,1
9,1,recipient,9,524,5,4,1.5
9,1,refuge,6,525,2,4,7
9,1,regulator,9,526,2,7,4.75
9,1,reinforce,9,527,2,7,10.75
9,1,reliable,8,528,2,6,4
9,1,remains,7,529,2,5,3.5
9,1,remote,6,530,3,3,9.5
9,1,renowned,8,531,2,6,4
9,1,report,6,532,2,4,2.75
9,1,request,7,533,2,5,10
9,1,restraint,9,534,2,7,4.75
9,1,resume,6,535,3,3,2.5
9,1,rhetoric,8,536,1,7,11
9,1,rice,4,537,1,3,2.25
9,1,rid,3,538,2,1,1
9,1,risk,4,539,2,2,1.5
9,1,rock,4,540,1,3,8.25
9,1,role,4,541,2,2,1.75
9,1,romantic,8,542,2,6,4
9,1,rugby,5,543,1,4,9
9,1,rule,4,544,2,2,1.75
9,1,rumour,6,545,2,4,2.75
9,1,run,3,546,2,1,1
9,1,sad,3,547,0,3,2
9,1,sail,4,548,2,2,1.5
9,1,sanction,8,549,2,6,10.5
9,1,say,3,550,2,1,1
9,1,scale,5,551,1,4,2.75
9,1,screening,9,552,2,7,11.25
9,1,script,6,553,3,3,2.5
9,1,sea,3,554,1,2,1.5
9,1,self,4,555,2,2,1.75
9,1,serial,6,556,2,4,9.5
9,1,session,7,557,2,5,3.5
9,1,seventeen,9,558,2,7,11.25
9,1,shade,5,559,1,4,2.75
9,1,shake,5,560,3,2,1.75
9,1,shall,5,561,3,2,1.75
9,1,shaped,6,562,3,3,2.25
9,1,sheet,5,563,2,3,8.5
9,1,should,6,564,2,4,3
9,1,shout,5,565,4,1,1.25
9,1,show,4,566,3,1,1.25
9,1,simulate,8,567,1,7,10.75
9,1,sincere,7,568,2,5,3.5
9,1,situation,9,569,2,7,4.75
9,1,sixty,5,570,2,3,1318.25
9,1,size,4,571,2,2,0.75
9,1,sky,3,572,1,2,0.75
9,1,slogan,6,573,1,5,1.75
9,1,slot,4,574,3,1,0.75
9,1,smart,5,575,1,4,7.25
9,1,smash,5,576,3,2,1.25
9,1,soak,4,577,1,3,1.25
9,1,soar,4,578,3,1,0.75
9,1,socialist,9,579,2,7,7.25
9,1,soft,4,580,2,2,1
9,1,solely,6,581,2,4,1.75
9,1,somewhere,9,582,2,7,7.25
9,1,sorry,5,583,2,3,1.25
9,1,source,6,584,2,4,1.75
9,1,span,4,585,1,3,1.25
9,1,spill,5,586,2,3,1.25
9,1,spoil,5,587,2,3,6
9,1,spoon,5,588,3,2,1
9,1,sport,5,589,3,2,1.25
9,1,spot,4,590,3,1,0.75
9,1,spy,3,591,2,1,0.5
9,1,squeeze,7,592,1,6,6.75
9,1,stadium,7,593,1,6,2.25
9,1,stage,5,594,3,2,1.25
9,1,station,7,595,3,4,6.25
9,1,status,6,596,4,2,1.25
9,1,steep,5,597,2,3,1.25
9,1,stimulate,9,598,2,7,2.5
9,1,stream,6,599,2,4,6
9,1,stunning,8,600,2,6,2.25
9,1,stupid,6,601,3,3,1.5
9,1,style,5,602,2,3,5.75
9,1,suburb,6,603,1,5,2
9,1,suddenly,8,604,2,6,2.25
9,1,suffer,6,605,2,4,6
9,1,suffering,9,606,6,3,1.5
9,1,suicide,7,607,2,5,1.5
9,1,sum,3,608,2,1,0.5
9,1,summer,6,609,3,3,5
9,1,superior,8,610,2,6,2
9,1,suppress,8,611,3,5,1.75
9,1,surrender,9,612,2,7,6
9,1,sustain,7,613,2,5,1.5
9,1,swimming,8,614,1,7,6.25
9,1,t,1,615,0,1,0.5
9,1,tag,3,616,1,2,0.75
9,1,teach,5,617,1,4,1.25
9,1,technique,9,618,2,7,6.25
9,1,teenager,8,619,2,6,2
9,1,tent,4,620,2,2,0.75
9,1,tenure,6,621,3,3,5.25
9,1,terrain,7,622,2,5,1.75
9,1,terrible,8,623,4,4,1.5
9,1,testing,7,624,2,5,6
9,1,text,4,625,2,2,0.75
9,1,that,4,626,1,3,1
9,1,their,5,627,2,3,1
9,1,them,4,628,3,1,0.5
9,1,then,4,629,3,1,0.5
9,1,theology,8,630,3,5,5.75
9,1,there,5,631,3,2,1
9,1,thick,5,632,2,3,1
9,1,thief,5,633,3,2,0.75
9,1,thin,4,634,3,1,0.5
9,1,thing,5,635,4,1,4.75
9,1,think,5,636,4,1,0.75
9,1,thinking,8,637,5,3,1.25
9,1,thought,7,638,2,5,1.5
9,1,threat,6,639,2,4,5.5
9,1,threaten,8,640,6,2,1.25
9,1,thrive,6,641,3,3,1.25
9,1,throat,6,642,3,3,1.25
9,1,throw,5,643,4,1,0.75
9,1,timber,6,644,1,5,5.75
9,1,tired,5,645,2,3,1.25
9,1,tone,4,646,1,3,1.25
9,1,total,5,647,2,3,1.25
9,1,tourist,7,648,2,5,5.75
9,1,toy,3,649,2,1,0.5
9,1,trading,7,650,1,6,1.75
9,1,transfer,8,651,3,5,5.75
9,1,true,4,652,2,2,0.75
9,1,trust,5,653,3,2,1
9,1,truth,5,654,3,2,0.75
9,1,try,3,655,2,1,0.5
9,1,tuesday,7,656,1,6,3.5
9,1,tunnel,6,657,2,4,3.5
9,1,turn,4,658,2,2,0.75
9,1,turnover,8,659,4,4,1.25
9,1,twenty,6,660,1,5,5.5
9,1,typical,7,661,1,6,1.75
9,1,typically,9,662,7,2,0.75
9,1,umbrella,8,663,0,8,6.25
9,1,under,5,664,1,4,1.25
9,1,up,2,665,1,1,0.5
9,1,used,4,666,1,3,1
9,1,user,4,667,3,1,0.5
9,1,variation,9,668,0,9,6.5
9,1,vehicle,7,669,1,6,6
9,1,versus,6,670,2,4,1.5
9,1,very,4,671,3,1,0.75
9,1,village,7,672,1,6,1.75
9,1,violation,9,673,2,7,6.25
9,1,volume,6,674,1,5,1.5
9,1,wage,4,675,0,4,5.75
9,1,want,4,676,2,2,0.75
9,1,warehouse,9,677,2,7,2
9,1,warfare,7,678,3,4,5.75
9,1,weather,7,679,1,6,2
9,1,web,3,680,2,1,0.5
9,1,website,7,681,3,4,1.5
9,1,wedding,7,682,2,5,6.25
9,1,weekly,6,683,2,4,1.5
9,1,wheat,5,684,1,4,1.25
9,1,while,5,685,2,3,5.5
9,1,whilst,6,686,4,2,1
9,1,whole,5,687,2,3,1
9,1,winner,6,688,1,5,1.5
9,1,winter,6,689,3,3,5.25
9,1,workout,7,690,1,6,1.75
9,1,writing,7,691,1,6,1.75
9,1,wrong,5,692,2,3,5.75
9,1,yell,4,693,0,4,1.25
9,1,you,3,694,1,2,0.75
9,1,yourself,8,695,3,5,1.75
9,2,able,4,0,0,4,1.25
9,2,above,5,1,2,3,1
9,2,abroad,6,2,2,4,1.25
9,2,abstract,8,3,2,6,6
9,2,academy,7,4,1,6,1.75
9,2,accent,6,5,2,4,5.75
9,2,access,6,6,4,2,1
9,2,according,9,7,3,6,2
9,2,account,7,8,4,3,1.25
9,2,acquire,7,9,2,5,5.75
9,2,act,3,10,2,1,0.5
9,2,addition,8,11,1,7,2
9,2,advance,7,12,2,5,5.75
9,2,advanced,8,13,7,1,0.75
9,2,affair,6,14,1,5,1.5
9,2,afraid,6,15,2,4,5.5
9,2,aged,4,16,1,3,1
9,2,ah,2,17,1,1,0.5
9,2,air,3,18,1,2,0.75
9,2,alien,5,19,1,4,1.25
9,2,all,3,20,2,1,0.5
9,2,allege,6,21,3,3,5.5
9,2,alliance,8,22,3,5,2
9,2,alone,5,23,2,3,1
9,2,also,4,24,2,2,1
9,2,although,8,25,2,6,6.5
9,2,ambitious,9,26,1,8,2.25
9,2,amid,4,27,2,2,5
9,2,angel,5,28,1,4,1.25
9,2,angry,5,29,3,2,1
9,2,anyone,6,30,2,4,1.25
9,2,apply,5,31,1,4,5.5
9,2,appoint,7,32,3,4,1.5
9,2,april,5,33,2,3,1
9,2,arena,5,34,1,4,1.25
9,2,array,5,35,2,3,5.5
9,2,athlete,7,36,1,6,1.75
9,2,attack,6,37,2,4,1.5
9,2,attempt,7,38,3,4,6
9,2,attribute,9,39,3,6,2
9,2,august,6,40,1,5,1.5
9,2,author,6,41,2,4,5.5
9,2,authority,9,42,6,3,1.25
9,2,aware,5,43,1,4,1.25
9,2,awkward,7,44,2,5,5.75
9,2,backdrop,8,45,0,8,2.25
9,2,backwards,9,46,4,5,6.25
9,2,bank,4,47,2,2,0.75
9,2,basis,5,48,2,3,1
9,2,basket,6,49,3,3,1
9,2,bean,4,50,1,3,1
9,2,bear,4,51,3,1,5.25
9,2,bee,3,52,2,1,0.5
9,2,beef,4,53,3,1,0.5
9,2,before,6,54,2,4,1.25
9,2,behind,6,55,2,4,1.25
9,2,being,5,56,2,3,5.25
9,2,beside,6,57,2,4,1.5
9,2,bet,3,58,2,1,0.5
9,2,big,3,59,1,2,0.75
9,2,biology,7,60,2,5,1.75
9,2,blanket,7,61,1,6,6.25
9,2,blast,5,62,3,2,1
9,2,blend,5,63,2,3,1.25
9,2,body,4,64,1,3,1
9,2,bold,4,65,2,2,5
9,2,brain,5,66,1,4,1.25
9,2,branch,6,67,3,3,1.25
9,2,breast,6,68,2,4,1.25
9,2,brick,5,69,2,3,5.5
9,2,briefly,7,70,3,4,1.5
9,2,bring,5,71,3,2,0.75
9,2,broad,5,72,2,3,1
9,2,broadcast,9,73,5,4,6.25
9,2,brown,5,74,3,2,1
9,2,building,8,75,1,7,3.25
9,2,bulk,4,76,2,2,1.75
9,2,bus,3,77,2,1,8.5
9,2,busy,4,78,3,1,1.25
9,2,but,3,79,2,1,1
9,2,cabin,5,80,0,5,3.25
9,2,cabinet,7,81,5,2,1.75
9,2,calm,4,82,2,2,1.75
9,2,camp,4,83,2,2,8.5
9,2,captain,7,84,2,5,3.5
9,2,capture,7,85,4,3,2.5
9,2,case,4,86,2,2,1.5
9,2,champion,8,87,1,7,11.5
9,2,chaos,5,88,3,2,1.75
9,2,chat,4,89,3,1,1.25
9,2,cheek,5,90,2,3,2.25
9,2,chef,4,91,3,1,1
9,2,cinema,6,92,1,5,10.25
9,2,civic,5,93,2,3,2.5
9,2,claim,5,94,1,4,3.25
9,2,clarify,7,95,3,4,19.75
9,2,class,5,96,3,2,3.5
9,2,classical,9,97,5,4,5
9,2,clinic,6,98,2,4,3
9,2,clock,5,99,2,3,9.75
9,2,close,5,100,3,2,2
9,2,cloth,5,101,3,2,2
9,2,clothes,7,102,5,2,2
9,2,clue,4,103,2,2,1.75
9,2,coastal,7,104,1,6,12.5
9,2,coin,4,105,2,2,1.75
9,2,collision,9,106,2,7,4.75
9,2,coloured,8,107,3,5,11.5
9,2,columnist,9,108,3,6,4.5
9,2,combat,6,109,2,4,3
9,2,combine,7,110,4,3,9.5
9,2,comic,5,111,3,2,1.75
9,2,commander,9,112,3,6,4.25
9,2,commit,6,113,4,2,2
9,2,common,6,114,4,2,2
9,2,communist,9,115,4,5,11.25
9,2,complain,8,116,3,5,4
9,2,complaint,9,117,8,1,1.75
9,2,complex,7,118,5,2,2.25
9,2,compose,7,119,4,3,10.5
9,2,comprise,8,120,4,4,3.25
9,2,concerned,9,121,2,7,5
9,2,concrete,8,122,4,4,10.5
9,2,confuse,7,123,3,4,3
9,2,construct,9,124,3,6,12.25
9,2,contact,7,125,3,4,3
9,2,container,9,126,5,4,3.5
9,2,contest,7,127,4,3,2.75
9,2,context,7,128,5,2,9.75
9,2,contrary,8,129,4,4,3.25
9,2,convict,7,130,3,4,3
9,2,cook,4,131,2,2,1.5
9,2,cop,3,132,2,1,1
9,2,correlate,9,133,2,7,11.75
9,2,corrupt,7,134,4,3,2.5
9,2,costume,7,135,2,5,3.5
9,2,cotton,6,136,2,4,10
9,2,cow,3,137,2,1,1
9,2,crash,5,138,1,4,2.75
9,2,crazy,5,139,3,2,1.75
9,2,cream,5,140,2,3,9.5
9,2,creative,8,141,4,4,3.25
9,2,criticism,9,142,2,7,4.75
9,2,critique,8,143,5,3,9.75
9,2,crop,4,144,2,2,1.5
9,2,crystal,7,145,2,5,3.5
9,2,cupboard,8,146,1,7,11.75
9,2,curiosity,9,147,2,7,4.75
9,2,customer,8,148,2,6,11.5
9,2,dad,3,149,0,3,2
9,2,data,4,150,2,2,1.75
9,2,database,8,151,4,4,3
9,2,date,4,152,3,1,1
9,2,dead,4,153,1,3,9.25
9,2,deadline,8,154,4,4,3.5
9,2,debris,6,155,2,4,3
9,2,decision,8,156,2,6,12
9,2,deck,4,157,3,1,1.25
9,2,decorate,8,158,3,5,3.75
9,2,defeat,6,159,2,4,3
9,2,defend,6,160,4,2,2
9,2,define,6,161,3,3,9.5
9,2,defy,4,162,3,1,1.25
9,2,delivery,8,163,2,6,4
9,2,denial,6,164,2,4,2.75
9,2,dependent,9,165,2,7,12
9,2,depict,6,166,3,3,2.5
9,2,derive,6,167,2,4,10
9,2,descend,7,168,2,5,3.75
9,2,descent,7,169,6,1,1.5
9,2,desire,6,170,3,3,2.5
9,2,desperate,9,171,3,6,12.25
9,2,destroy,7,172,3,4,3.25
9,2,devise,6,173,2,4,3
9,2,dialogue,8,174,1,7,12.5
9,2,differ,6,175,2,4,3
9,2,dimension,9,176,2,7,15.25
9,2,direction,9,177,2,7,6.75
9,2,directory,9,178,6,3,3.25
9,2,disagree,8,179,2,6,12
9,2,discard,7,180,3,4,3
9,2,discourse,9,181,4,5,4
9,2,disorder,8,182,3,5,11.25
9,2,dispose,7,183,3,4,3
9,2,distinct,8,184,3,5,3.5
9,2,distract,8,185,4,4,10.5
9,2,doctrine,8,186,1,7,4.5
9,2,dog,3,187,2,1,1
9,2,dominance,9,188,2,7,12.25
9,2,donate,6,189,2,4,2.75
9,2,dramatic,8,190,1,7,12.25
9,2,dress,5,191,2,3,2.25
9,2,drug,4,192,2,2,1.75
9,2,dull,4,193,1,3,2
9,2,dynamic,7,194,1,6,11.25
9,2,each,4,195,0,4,2.5
9,2,eastern,7,196,2,5,3.5
9,2,eat,3,197,2,1,1
9,2,echo,4,198,1,3,10.25
9,2,economy,7,199,2,5,3.75
9,2,editorial,9,200,1,8,12.75
9,2,educator,8,201,2,6,4.25
9,2,electoral,9,202,1,8,12.5
9,2,electric,8,203,5,3,2.75
9,2,element,7,204,3,4,3
9,2,emerge,6,205,1,5,11
9,2,emphasize,9,206,2,7,4.75
9,2,empire,6,207,3,3,2.5
9,2,encourage,9,208,1,8,12.5
9,2,energy,6,209,2,4,3
9,2,enforce,7,210,2,5,10.75
9,2,enquire,7,211,2,5,3.75
9,2,entirely,8,212,2,6,4
9,2,entity,6,213,4,2,9.5
9,2,equation,8,214,1,7,4.75
9,2,equip,5,215,3,2,1.75
9,2,error,5,216,1,4,2.75
9,2,eternal,7,217,1,6,12
9,2,ethical,7,218,2,5,3.5
9,2,every,5,219,1,4,7.5
9,2,everyday,8,220,5,3,1.5
9,2,exam,4,221,1,3,1
9,2,excess,6,222,2,4,1.25
9,2,exclude,7,223,3,4,6
9,2,exert,5,224,2,3,1
9,2,exotic,6,225,2,4,1.25
9,2,explicit,8,226,2,6,6.5
9,2,exposure,8,227,3,5,2
9,2,extra,5,228,2,3,1
9,2,extract,7,229,5,2,0.75
9,2,faith,5,230,0,5,6.5
9,2,familiar,8,231,2,6,2
9,2,fan,3,232,2,1,0.5
9,2,farm,4,233,2,2,0.75
9,2,favourite,9,234,2,7,7.25
9,2,feat,4,235,1,3,1.25
9,2,feed,4,236,2,2,1.25
9,2,feedback,8,237,4,4,9
9,2,feel,4,238,3,1,0.75
9,2,fifth,5,239,1,4,1.5
9,2,film,4,240,2,2,1
9,2,filter,6,241,3,3,1.5
9,2,finger,6,242,2,4,7.25
9,2,finish,6,243,3,3,1.5
9,2,firearm,7,244,2,5,1.75
9,2,firework,8,245,4,4,6.75
9,2,first,5,246,3,2,1
9,2,fishing,7,247,2,5,1.75
9,2,flame,5,248,1,4,1.25
9,2,flaw,4,249,3,1,0.5
9,2,flawed,6,250,4,2,5.75
9,2,float,5,251,2,3,1
9,2,fluid,5,252,2,3,1
9,2,follow,6,253,1,5,1.5
9,2,following,9,254,6,3,6.5
9,2,fond,4,255,2,2,0.75
9,2,fool,4,256,2,2,0.75
9,2,forever,7,257,2,5,1.5
9,2,forge,5,258,3,2,0.75
9,2,formulate,9,259,3,6,6.75
9,2,framework,9,260,1,8,2.25
9,2,freely,6,261,2,4,6.5
9,2,fully,5,262,1,4,1.25
9,2,fun,3,263,2,1,0.5
9,2,function,8,264,3,5,6.5
9,2,funny,5,265,3,2,1
9,2,gambling,8,266,0,8,2.25
9,2,gang,4,267,2,2,0.75
9,2,garden,6,268,2,4,6.5
9,2,gathering,9,269,2,7,2.25
9,2,generous,8,270,1,7,8.25
9,2,gentle,6,271,3,3,1.25
9,2,glad,4,272,1,3,1
9,2,goal,4,273,1,3,1
9,2,goods,5,274,2,3,6.5
9,2,gorgeous,8,275,2,6,2.25
9,2,gradually,9,276,1,8,7.5
9,2,graduate,8,277,6,2,1.25
9,2,grant,5,278,3,2,0.75
9,2,great,5,279,2,3,1
9,2,guideline,9,280,1,8,7.75
9,2,half,4,281,0,4,1.25
9,2,hand,4,282,2,2,0.75
9,2,hatred,6,283,2,4,7
9,2,he,2,284,1,1,0.5
9,2,hearing,7,285,2,5,1.75
9,2,heating,7,286,3,4,1.5
9,2,helpful,7,287,2,5,6.5
9,2,hero,4,288,2,2,0.75
9,2,historian,9,289,1,8,2.5
9,2,history,7,290,6,1,0.75
9,2,hockey,6,291,1,5,6.75
9,2,homework,8,292,2,6,2
9,2,hook,4,293,2,2,0.75
9,2,hope,4,294,2,2,6
9,2,host,4,295,2,2,0.75
9,2,house,5,296,2,3,1
9,2,housing,7,297,4,3,1.25
9,2,hungry,6,298,1,5,11
9,2,husband,7,299,2,5,672
9,2,ideology,8,300,0,8,6.5
9,2,if,2,301,1,1,1.75
9,2,illness,7,302,1,6,16.75
9,2,immense,7,303,1,6,5.5
9,2,imminent,8,304,3,5,15
9,2,impress,7,305,2,5,8
9,2,in,2,306,1,1,2.5
9,2,incentive,9,307,2,7,17.25
9,2,incidence,9,308,3,6,11.75
9,2,including,9,309,3,6,11.75
9,2,increase,8,310,3,5,21.75
9,2,indoor,6,311,2,4,6
9,2,indoors,7,312,6,1,3
9,2,induce,6,313,3,3,5.5
9,2,indulge,7,314,4,3,19.5
9,2,infect,6,315,2,4,4
9,2,initial,7,316,2,5,5
9,2,injured,7,317,2,5,21.25
9,2,insight,7,318,2,5,3.75
9,2,inspire,7,319,3,4,3.25
9,2,intensity,9,320,2,7,11.25
9,2,interface,9,321,4,5,4.25
9,2,interview,9,322,5,4,10.25
9,2,investor,8,323,2,6,4.25
9,2,invisible,9,324,3,6,4.5
9,2,invoke,6,325,3,3,9
9,2,isolation,9,326,1,8,5.25
9,2,join,4,327,0,4,9
9,2,joint,5,328,4,1,1.25
9,2,keen,4,329,0,4,2.5
9,2,kidnap,6,330,1,5,3.5
9,2,kill,4,331,2,2,2
9,2,killing,7,332,4,3,8.75
9,2,kind,4,333,2,2,1.75
9,2,kiss,4,334,2,2,1.75
9,2,knock,5,335,1,4,2.75
9,2,knowledge,9,336,3,6,10
9,2,label,5,337,0,5,3.25
9,2,labour,6,338,3,3,2.5
9,2,ladder,6,339,2,4,9
9,2,lady,4,340,3,1,1.25
9,2,lamp,4,341,2,2,1.5
9,2,landing,7,342,2,5,3.5
9,2,landlord,8,343,4,4,9.25
9,2,lane,4,344,3,1,1.25
9,2,language,8,345,3,5,3.75
9,2,laptop,6,346,2,4,2.75
9,2,late,4,347,2,2,2
9,2,layout,6,348,2,4,9
9,2,legal,5,349,1,4,2.75
9,2,lend,4,350,2,2,1.75
9,2,let,3,351,2,1,1
9,2,level,5,352,2,3,2.25
9,2,lifetime,8,353,1,7,10.5
9,2,light,5,354,2,3,2.25
9,2,likewise,8,355,2,6,9.75
9,2,limit,5,356,2,3,1.5
9,2,listener,8,357,2,6,2.75
9,2,literacy,8,358,2,6,5.75
9,2,lobby,5,359,1,4,1.25
9,2,logic,5,360,2,3,1
9,2,loss,4,361,2,2,0.75
9,2,lovely,6,362,2,4,4.75
9,2,lower,5,363,2,3,1
9,2,magazine,8,364,0,8,5.75
9,2,magical,7,365,3,4,1.25
9,2,magnitude,9,366,3,6,1.75
9,2,man,3,367,2,1,0.5
9,2,march,5,368,2,3,4.5
9,2,marker,6,369,3,3,1.25
9,2,marketing,9,370,5,4,1.5
9,2,massive,7,371,2,5,1.5
9,2,matching,8,372,2,6,6
9,2,matter,6,373,3,3,1.25
9,2,mayor,5,374,2,3,1
9,2,meaning,7,375,1,6,5.5
9,2,mechanism,9,376,2,7,2
9,2,medicine,8,377,2,6,5.25
9,2,meet,4,378,2,2,0.75
9,2,menu,4,379,2,2,0.75
9,2,metal,5,380,2,3,1
9,2,metaphor,8,381,4,4,5
9,2,mile,4,382,1,3,1
9,2,militant,8,383,3,5,1.75
9,2,military,8,384,6,2,1
9,2,minimize,8,385,2,6,5.25
9,2,mining,6,386,4,2,1
9,2,minor,5,387,3,2,1
9,2,minute,6,388,3,3,1
9,2,miracle,7,389,2,5,5.5
9,2,missile,7,390,2,5,1.75
9,2,mistake,7,391,3,4,1.5
9,2,mobile,6,392,1,5,5
9,2,monitor,7,393,2,5,1.75
9,2,monk,4,394,3,1,0.75
9,2,morality,8,395,2,6,6.25
9,2,motorist,8,396,2,6,2.75
9,2,mount,5,397,2,3,1.25
9,2,myself,6,398,1,5,5.75
9,2,nail,4,399,0,4,1.25
9,2,national,8,400,2,6,2
9,2,native,6,401,4,2,4.5
9,2,necessity,9,402,1,8,2.5
9,2,neglect,7,403,2,5,1.75
9,2,nerve,5,404,2,3,4.5
9,2,next,4,405,2,2,0.75
9,2,ninety,6,406,1,5,1.5
9,2,noble,5,407,1,4,4.75
9,2,nonsense,8,408,2,6,2
9,2,notable,7,409,2,5,1.75
9,2,notably,7,410,6,1,0.75
9,2,now,3,411,2,1,4
9,2,number,6,412,1,5,1.5
9,2,nursery,7,413,2,5,1.75
9,2,nursing,7,414,4,3,1.5
9,2,obey,4,415,0,4,4.75
9,2,object,6,416,2,4,1.25
9,2,observe,7,417,2,5,1.75
9,2,observer,8,418,7,1,4.25
9,2,obsession,9,419,4,5,1.75
9,2,obvious,7,420,2,5,1.5
9,2,occasion,8,421,1,7,5.75
9,2,offender,8,422,1,7,2
9,2,onto,4,423,1,3,4.25
9,2,open,4,424,1,3,1
9,2,operate,7,425,3,4,1.25
9,2,operator,8,426,6,2,1
9,2,opinion,7,427,2,5,5
9,2,order,5,428,1,4,1.25
9,2,ordinary,8,429,3,5,1.75
9,2,our,3,430,1,2,0.75
9,2,out,3,431,2,1,0.5
9,2,oven,4,432,1,3,4.5
9,2,owner,5,433,1,4,1.25
9,2,packet,6,434,0,6,1.5
9,2,pair,4,435,2,2,4.5
9,2,paper,5,436,2,3,1
9,2,parental,8,437,2,6,1.75
9,2,parish,6,438,3,3,1.25
9,2,party,5,439,3,2,4.75
9,2,pass,4,440,2,2,0.75
9,2,passage,7,441,4,3,1
9,2,passion,7,442,4,3,1
9,2,payment,7,443,2,5,5.25
9,2,penalty,7,444,1,6,1.75
9,2,pension,7,445,3,4,1.5
9,2,period,6,446,2,4,5
9,2,permanent,9,447,3,6,2.25
9,2,person,6,448,3,3,1.25
9,2,persuade,8,449,4,4,5.25
9,2,petition,8,450,2,6,2
9,2,phase,5,451,1,4,1.25
9,2,pit,3,452,1,2,0.75
9,2,pitch,5,453,3,2,4.75
9,2,placement,9,454,1,8,2.25
9,2,plate,5,455,3,2,0.75
9,2,player,6,456,3,3,4.75
9,2,plunge,6,457,2,4,1.25
9,2,poetry,6,458,1,5,1.5
9,2,poisonous,9,459,2,7,5.75
9,2,policeman,9,460,2,7,2
9,2,politics,8,461,4,4,5.25
9,2,port,4,462,2,2,0.75
9,2,portray,7,463,4,3,1
9,2,positive,8,464,2,6,1.75
9,2,potential,9,465,2,7,6
9,2,poverty,7,466,2,5,1.5
9,2,preach,6,467,1,5,5.25
9,2,precede,7,468,3,4,1.5
9,2,precision,9,469,4,5,1.75
9,2,prefer,6,470,3,3,4.75
9,2,premium,7,471,3,4,1.25
9,2,pretty,6,472,3,3,1
9,2,prevent,7,473,3,4,1.25
9,2,pride,5,474,2,3,4.75
9,2,priest,6,475,3,3,1.25
9,2,primarily,9,476,3,6,2
9,2,prisoner,8,477,3,5,5.25
9,2,privilege,9,478,3,6,2
9,2,protect,7,479,2,5,1.5
9,2,protein,7,480,5,2,5
9,2,provide,7,481,3,4,1.5
9,2,province,8,482,5,3,1.25
9,2,provoke,7,483,4,3,1.25
9,2,quarter,7,484,0,7,6.5
9,2,quietly,7,485,2,5,1.75
9,2,quota,5,486,2,3,1.25
9,2,random,6,487,0,6,5.75
9,2,rapid,5,488,2,3,1.25
9,2,rare,4,489,2,2,1
9,2,read,4,490,1,3,4.75
9,2,reader,6,491,4,2,1.25
9,2,readily,7,492,4,3,1.5
9,2,reading,7,493,5,2,1.25
9,2,real,4,494,3,1,0.5
9,2,realize,7,495,4,3,1
9,2,rebellion,9,496,2,7,6.5
9,2,receive,7,497,2,5,1.75
9,2,receiver,8,498,7,1,0.75
9,2,recession,9,499,4,5,5.5
9,2,red,3,500,2,1,0.5
9,2,refugee,7,501,2,5,1.5
9,2,regret,6,502,2,4,1.25
9,2,regularly,9,503,3,6,5.75
9,2,reinforce,9,504,2,7,2.25
9,2,relaxing,8,505,2,6,6.75
9,2,reliable,8,506,3,5,2
9,2,rely,4,507,3,1,0.75
9,2,remember,8,508,2,6,6
9,2,remote,6,509,3,3,1.25
9,2,repeated,8,510,2,6,1.75
9,2,report,6,511,3,3,5.25
9,2,reporter,8,512,6,2,1.25
9,2,reproduce,9,513,3,6,2
9,2,request,7,514,2,5,5.75
9,2,retreat,7,515,2,5,1.75
9,2,review,6,516,2,4,1.5
9,2,rhetoric,8,517,1,7,6
9,2,rid,3,518,1,2,0.75
9,2,risk,4,519,2,2,0.75
9,2,role,4,520,1,3,1
9,2,romantic,8,521,2,6,5.75
9,2,royal,5,522,2,3,1
9,2,rugby,5,523,1,4,1.25
9,2,runner,6,524,2,4,5.5
9,2,sad,3,525,0,3,1
9,2,sail,4,526,2,2,0.75
9,2,sanction,8,527,2,6,1.75
9,2,sandwich,8,528,3,5,5.5
9,2,scratch,7,529,1,6,1.75
9,2,script,6,530,3,3,1.25
9,2,sea,3,531,1,2,4.75
9,2,seize,5,532,2,3,1
9,2,self,4,533,2,2,0.75
9,2,sensation,9,534,2,7,2
9,2,sentence,8,535,3,5,5.75
9,2,set,3,536,2,1,0.5
9,2,several,7,537,2,5,1.5
9,2,sex,3,538,2,1,0.5
9,2,shade,5,539,1,4,5
9,2,shake,5,540,3,2,0.75
9,2,sheet,5,541,2,3,1
9,2,shocking,8,542,2,6,2
9,2,shop,4,543,3,1,4.5
9,2,short,5,544,3,2,1
9,2,shot,4,545,3,1,0.75
9,2,should,6,546,3,3,1.25
9,2,show,4,547,3,1,0.5
9,2,shrink,6,548,2,4,1.25
9,2,sigh,4,549,1,3,5
9,2,silence,7,550,2,5,1.75
9,2,silent,6,551,5,1,0.75
9,2,silly,5,552,3,2,1
9,2,simulate,8,553,2,6,5.75
9,2,sing,4,554,2,2,0.75
9,2,sixty,5,555,2,3,1
9,2,skill,5,556,1,4,1.25
9,2,sleep,5,557,1,4,5.25
9,2,slogan,6,558,2,4,1.5
9,2,slow,4,559,3,1,0.75
9,2,smart,5,560,1,4,1.25
9,2,soak,4,561,1,3,8.5
9,2,society,7,562,2,5,3.5
9,2,software,8,563,2,6,4
9,2,soldier,7,564,2,5,10.25
9,2,solely,6,565,3,3,2.5
9,2,somebody,8,566,2,6,4
9,2,somewhere,9,567,4,5,10.5
9,2,son,3,568,2,1,1
9,2,soon,4,569,2,2,1.75
9,2,source,6,570,2,4,3
9,2,speculate,9,571,1,8,12
9,2,spending,8,572,3,5,3.75
9,2,spite,5,573,2,3,2.25
9,2,split,5,574,2,3,9
9,2,sponsor,7,575,2,5,3.5
9,2,sport,5,576,3,2,1.75
9,2,spy,3,577,2,1,1
9,2,squeeze,7,578,1,6,10.5
9,2,stadium,7,579,1,6,4
9,2,stage,5,580,3,2,2.25
9,2,statement,9,581,3,6,11.25
9,2,station,7,582,4,3,2.75
9,2,status,6,583,4,2,2.25
9,2,steel,5,584,2,3,2.25
9,2,steep,5,585,4,1,1.25
9,2,stress,6,586,2,4,10
9,2,stupid,6,587,2,4,3
9,2,suburb,6,588,1,5,3.25
9,2,suburban,8,589,6,2,9
9,2,suffer,6,590,2,4,3
9,2,suffering,9,591,6,3,2.5
9,2,suicide,7,592,2,5,3.5
9,2,sum,3,593,2,1,7.75
9,2,summer,6,594,3,3,2.5
9,2,superb,6,595,2,4,2.75
9,2,supply,6,596,3,3,2.5
9,2,surface,7,597,2,5,10
9,2,surge,5,598,3,2,1.75
9,2,surrender,9,599,3,6,4.25
9,2,swimming,8,600,1,7,11.25
9,2,swing,5,601,3,2,1.75
9,2,symbol,6,602,1,5,3.25
9,2,syndrome,8,603,2,6,14.75
9,2,t,1,604,0,1,0.75
9,2,tag,3,605,1,2,1.5
9,2,tax,3,606,2,1,1
9,2,technical,9,607,1,8,11.25
9,2,technique,9,608,6,3,2.75
9,2,teenage,7,609,2,5,3.5
9,2,tell,4,610,2,2,1.75
9,2,tennis,6,611,2,4,9.25
9,2,tenure,6,612,3,3,2.75
9,2,terminal,8,613,2,6,4.5
9,2,terrain,7,614,3,4,9.75
9,2,terrible,8,615,4,4,3.25
9,2,testify,7,616,2,5,3.5
9,2,than,4,617,1,3,9
9,2,that,4,618,3,1,1.25
9,2,theatre,7,619,2,5,3.5
9,2,theft,5,620,3,2,1.75
9,2,their,5,621,3,2,1.75
9,2,theirs,6,622,5,1,1.25
9,2,them,4,623,3,1,1
9,2,then,4,624,3,1,7.5
9,2,theology,8,625,3,5,3.75
9,2,there,5,626,3,2,1.75
9,2,they,4,627,3,1,1
9,2,thief,5,628,2,3,2.25
9,2,think,5,629,3,2,8.25
9,2,thinking,8,630,5,3,2.75
9,2,third,5,631,3,2,1.75
9,2,threat,6,632,2,4,2.75
9,2,threaten,8,633,6,2,2
9,2,thrive,6,634,3,3,8.75
9,2,throat,6,635,3,3,2.25
9,2,thursday,8,636,2,6,4.25
9,2,timber,6,637,1,5,10
9,2,tiny,4,638,2,2,1.75
9,2,tobacco,7,639,1,6,4
9,2,tone,4,640,2,2,1.75
9,2,tongue,6,641,3,3,9
9,2,tourist,7,642,2,5,3.5
9,2,towards,7,643,2,5,3.5
9,2,towel,5,644,3,2,2
9,2,trace,5,645,1,4,9.25
9,2,trading,7,646,3,4,3
9,2,tradition,9,647,5,4,3.25
9,2,training,8,648,3,5,10
9,2,trillion,8,649,2,6,4
9,2,trust,5,650,2,3,2.25
9,2,try,3,651,2,1,1
9,2,tuition,7,652,1,6,10.25
9,2,turn,4,653,2,2,1.75
9,2,turnover,8,654,4,4,3
9,2,twist,5,655,1,4,9.5
9,2,type,4,656,1,3,2
9,2,ugly,4,657,0,4,2.5
9,2,umbrella,8,658,1,7,11.25
9,2,under,5,659,1,4,2.75
9,2,unlike,6,660,2,4,3
9,2,unlikely,8,661,6,2,2
9,2,upwards,7,662,1,6,10.5
9,2,use,3,663,1,2,1.5
9,2,utterly,7,664,1,6,13.75
9,2,vehicle,7,665,0,7,5
9,2,very,4,666,2,2,2
9,2,victim,6,667,1,5,11
9,2,violation,9,668,2,7,5.5
9,2,volume,6,669,1,5,3.25
9,2,voluntary,9,670,4,5,11.75
9,2,vote,4,671,2,2,1.75
9,2,want,4,672,0,4,2.75
9,2,ward,4,673,2,2,1.75
9,2,warfare,7,674,3,4,9.75
9,2,wash,4,675,2,2,1.75
9,2,we,2,676,1,1,0.75
9,2,weak,4,677,2,2,1.5
9,2,wear,4,678,3,1,1
9,2,website,7,679,2,5,9.75
9,2,week,4,680,2,2,1.5
9,2,weekly,6,681,4,2,1.75
9,2,wet,3,682,2,1,1
9,2,what,4,683,1,3,2
9,2,whisper,7,684,2,5,10.25
9,2,wholly,6,685,2,4,2.75
9,2,wide,4,686,1,3,2.25
9,2,winner,6,687,2,4,3
9,2,winter,6,688,3,3,9.25
9,2,wise,4,689,2,2,1.75
9,2,wish,4,690,3,1,1
9,2,wound,5,691,1,4,2.75
9,2,writing,7,692,1,6,11.75
9,2,wrong,5,693,2,3,2.5
9,2,yesterday,9,694,0,9,5.75
9,2,zero,4,695,0,4,9.5
9,3,ability,7,0,0,7,4.25
9,3,able,4,1,2,2,8.25
9,3,abolish,7,2,2,5,3.5
9,3,about,5,3,3,2,1.75
9,3,above,5,4,3,2,1.75
9,3,abroad,6,5,2,4,9.75
9,3,absent,6,6,2,4,3
9,3,academy,7,7,1,6,4
9,3,accent,6,8,2,4,10
9,3,access,6,9,4,2,2
9,3,accuracy,8,10,3,5,3.75
9,3,acquire,7,11,2,5,3.5
9,3,act,3,12,2,1,7.5
9,3,addition,8,13,1,7,4.75
9,3,adhere,6,14,2,4,3
9,3,adult,5,15,2,3,9
9,3,advance,7,16,2,5,3.5
9,3,advertise,9,17,3,6,4.25
9,3,affair,6,18,1,5,10.25
9,3,afraid,6,19,2,4,3
9,3,aged,4,20,1,3,2
9,3,agent,5,21,3,2,1.75
9,3,ah,2,22,1,1,7.75
9,3,aid,3,23,1,2,1.5
9,3,air,3,24,2,1,1
9,3,aircraft,8,25,3,5,3.5
9,3,alike,5,26,1,4,2.75
9,3,all,3,27,2,1,8
9,3,allegedly,9,28,3,6,4.25
9,3,alliance,8,29,3,5,3.5
9,3,also,4,30,2,2,5.5
9,3,amid,4,31,1,3,1
9,3,angel,5,32,1,4,1.25
9,3,apple,5,33,1,4,1.25
9,3,appoint,7,34,3,4,5.75
9,3,april,5,35,2,3,1.25
9,3,arena,5,36,1,4,1.25
9,3,armed,5,37,2,3,1
9,3,array,5,38,2,3,5.5
9,3,assign,6,39,1,5,1.5
9,3,attach,6,40,1,5,1.5
9,3,attempt,7,41,3,4,5.75
9,3,attorney,8,42,3,5,1.75
9,3,attribute,9,43,3,6,2
9,3,audience,8,44,1,7,6.5
9,3,authority,9,45,2,7,2.25
9,3,autumn,6,46,3,3,5.75
9,3,avoid,5,47,1,4,1.25
9,3,away,4,48,1,3,1
9,3,awkward,7,49,2,5,6.25
9,3,bad,3,50,0,3,1
9,3,bake,4,51,2,2,0.75
9,3,banana,6,52,2,4,1.25
9,3,bank,4,53,3,1,0.5
9,3,bare,4,54,2,2,0.75
9,3,basket,6,55,2,4,5.5
9,3,become,6,56,1,5,1.5
9,3,beef,4,57,2,2,0.75
9,3,before,6,58,2,4,5.75
9,3,beginning,9,59,2,7,2.25
9,3,behind,6,60,2,4,1.25
9,3,beneath,7,61,2,5,6
9,3,bias,4,62,1,3,1
9,3,bicycle,7,63,2,5,1.75
9,3,big,3,64,2,1,0.5
9,3,biology,7,65,2,5,5.75
9,3,bleed,5,66,1,4,1.25
9,3,blood,5,67,2,3,1
9,3,bold,4,68,1,3,5.5
9,3,boring,6,69,2,4,1.5
9,3,brain,5,70,1,4,1.25
9,3,breath,6,71,2,4,1.25
9,3,briefly,7,72,2,5,6
9,3,bring,5,73,3,2,1
9,3,broadband,9,74,2,7,7
9,3,bus,3,75,1,2,1
9,3,busy,4,76,3,1,0.5
9,3,but,3,77,2,1,0.5
9,3,button,6,78,3,3,1
9,3,cabin,5,79,0,5,1.5
9,3,cabinet,7,80,5,2,5.25
9,3,calm,4,81,2,2,0.75
9,3,capture,7,82,2,5,1.5
9,3,castle,6,83,2,4,1.5
9,3,cat,3,84,2,1,0.5
9,3,cause,5,85,2,3,5.5
9,3,caution,7,86,3,4,1.5
9,3,cautious,8,87,6,2,1
9,3,cent,4,88,1,3,1
9,3,charge,6,89,1,5,5.75
9,3,chef,4,90,2,2,0.75
9,3,chest,5,91,3,2,1
9,3,cinema,6,92,1,5,1.5
9,3,civic,5,93,2,3,5.5
9,3,claim,5,94,1,4,1.25
9,3,class,5,95,3,2,1
9,3,classic,7,96,5,2,1
9,3,classical,9,97,7,2,1
9,3,cleaning,8,98,2,6,6.25
9,3,climb,5,99,2,3,1
9,3,cling,5,100,3,2,0.75
9,3,clinic,6,101,4,2,1
9,3,close,5,102,2,3,5.25
9,3,cloth,5,103,3,2,1
9,3,clothing,8,104,5,3,1.25
9,3,coalition,9,105,1,8,7
9,3,coast,5,106,3,2,1
9,3,coastal,7,107,5,2,1
9,3,cocktail,8,108,2,6,2
9,3,coin,4,109,2,2,0.75
9,3,college,7,110,2,5,6.25
9,3,colour,6,111,3,3,1.25
9,3,coloured,8,112,6,2,1
9,3,combat,6,113,2,4,5.75
9,3,comic,5,114,3,2,1
9,3,common,6,115,3,3,1.25
9,3,communist,9,116,4,5,1.75
9,3,compare,7,117,3,4,6
9,3,complaint,9,118,4,5,2
9,3,complex,7,119,5,2,1.25
9,3,computer,8,120,4,4,1.5
9,3,concerned,9,121,2,7,6.75
9,3,concrete,8,122,4,4,1.75
9,3,conflict,8,123,3,5,6
9,3,confuse,7,124,4,3,1.25
9,3,consensus,9,125,3,6,2
9,3,consume,7,126,4,3,1.25
9,3,contact,7,127,3,4,6
9,3,container,9,128,5,4,1.75
9,3,contest,7,129,4,3,1.25
9,3,convert,7,130,3,4,6
9,3,cooking,7,131,2,5,1.75
9,3,cooperate,9,132,3,6,2
9,3,copy,4,133,2,2,5.25
9,3,corrupt,7,134,2,5,1.75
9,3,cotton,6,135,2,4,1.25
9,3,council,7,136,2,5,6
9,3,countless,9,137,4,5,2
9,3,courage,7,138,3,4,1.5
9,3,cow,3,139,2,1,0.5
9,3,crack,5,140,1,4,6
9,3,crazy,5,141,3,2,1
9,3,creation,8,142,2,6,2.25
9,3,creative,8,143,6,2,1.25
9,3,creator,7,144,5,2,5.5
9,3,critical,8,145,2,6,2
9,3,criticism,9,146,6,3,1.25
9,3,critique,8,147,5,3,1.25
9,3,crop,4,148,2,2,5
9,3,cue,3,149,1,2,0.75
9,3,cure,4,150,2,2,0.75
9,3,custody,7,151,2,5,1.5
9,3,custom,6,152,5,1,0.75
9,3,customer,8,153,6,2,1
9,3,dad,3,154,0,3,5.25
9,3,dark,4,155,2,2,0.75
9,3,database,8,156,2,6,1.75
9,3,date,4,157,3,1,0.5
9,3,deadly,6,158,1,5,5.75
9,3,debate,6,159,2,4,1.25
9,3,decorate,8,160,2,6,1.75
9,3,defeat,6,161,2,4,6
9,3,defensive,9,162,4,5,1.75
9,3,depart,6,163,2,4,1.25
9,3,depend,6,164,3,3,5.75
9,3,derive,6,165,2,4,1.5
9,3,descend,7,166,2,5,1.75
9,3,desert,6,167,3,3,10
9,3,desire,6,168,3,3,262.25
9,3,desperate,9,169,3,6,5.75
9,3,destroy,7,170,3,4,5
9,3,devise,6,171,2,4,14.25
9,3,diary,5,172,1,4,3.75
9,3,differ,6,173,2,4,3.75
9,3,dilemma,7,174,2,5,12.25
9,3,dip,3,175,2,1,1.25
9,3,direction,9,176,2,7,5.75
9,3,directly,8,177,6,2,2.75
9,3,directory,9,178,6,3,12.75
9,3,disagree,8,179,2,6,8.5
9,3,discard,7,180,3,4,4
9,3,dispose,7,181,3,4,12.25
9,3,dispute,7,182,4,3,3.5
9,3,disrupt,7,183,3,4,4
9,3,distance,8,184,3,5,16.25
9,3,distract,8,185,4,4,5.25
9,3,disturb,7,186,4,3,3.5
9,3,diversity,9,187,2,7,24.25
9,3,divert,6,188,5,1,2
9,3,dominance,9,189,1,8,6.5
9,3,drain,5,190,1,4,8.5
9,3,dramatic,8,191,3,5,4
9,3,draw,4,192,3,1,1.25
9,3,drive,5,193,2,3,2.5
9,3,driver,6,194,5,1,1.25
9,3,drug,4,195,2,2,1.75
9,3,drum,4,196,3,1,7.75
9,3,during,6,197,1,5,4
9,3,dynamic,7,198,1,6,4.25
9,3,each,4,199,0,4,8.25
9,3,easy,4,200,2,2,1.75
9,3,eat,3,201,2,1,1
9,3,echo,4,202,1,3,2.25
9,3,economics,9,203,2,7,10.5
9,3,educated,8,204,1,7,4.5
9,3,education,9,205,6,3,2.5
9,3,eighteen,8,206,1,7,11
9,3,election,8,207,1,7,5.25
9,3,electoral,9,208,5,4,9.25
9,3,element,7,209,3,4,3.25
9,3,elevate,7,210,3,4,3
9,3,else,4,211,2,2,1.75
9,3,emerge,6,212,1,5,9
9,3,emotional,9,213,2,7,4.75
9,3,emphasize,9,214,2,7,10.75
9,3,empire,6,215,3,3,2.5
9,3,employ,6,216,3,3,2.5
9,3,empty,5,217,3,2,2.25
9,3,encourage,9,218,1,8,11.25
9,3,endorse,7,219,2,5,3.5
9,3,enquire,7,220,2,5,9.5
9,3,entirely,8,221,2,6,4
9,3,equal,5,222,1,4,8.25
9,3,era,3,223,1,2,1.5
9,3,erupt,5,224,2,3,2.25
9,3,essential,9,225,1,8,5.25
9,3,ethnic,6,226,1,5,8.5
9,3,everybody,9,227,1,8,5
9,3,everyday,8,228,5,3,8
9,3,evil,4,229,2,2,1.75
9,3,evolution,9,230,2,7,4.75
9,3,evolve,6,231,4,2,2
9,3,exam,4,232,1,3,7.5
9,3,example,7,233,4,3,2.25
9,3,exotic,6,234,2,4,3
9,3,expected,8,235,2,6,9.5
9,3,explosion,9,236,3,6,4.25
9,3,external,8,237,2,6,9.5
9,3,fabulous,8,238,0,8,5
9,3,facility,8,239,2,6,9.25
9,3,fact,4,240,3,1,1.25
9,3,faith,5,241,2,3,2.25
9,3,fame,4,242,2,2,1.5
9,3,favourite,9,243,2,7,9.75
9,3,feat,4,244,1,3,2.25
9,3,feature,7,245,4,3,2.5
9,3,feeling,7,246,2,5,3.5
9,3,festival,8,247,2,6,9.25
9,3,fifth,5,248,1,4,2.75
9,3,fighting,8,249,2,6,9.5
9,3,figure,6,250,3,3,2.75
9,3,fill,4,251,2,2,1.75
9,3,final,5,252,2,3,2.25
9,3,find,4,253,3,1,1.25
9,3,firearm,7,254,2,5,9
9,3,first,5,255,3,2,2
9,3,fit,3,256,2,1,1
9,3,flame,5,257,1,4,2.75
9,3,flash,5,258,3,2,1.75
9,3,flour,5,259,2,3,7.5
9,3,fold,4,260,1,3,2.25
9,3,follow,6,261,3,3,2.5
9,3,fool,4,262,2,2,1.75
9,3,forever,7,263,2,5,3.5
9,3,forgive,7,264,3,4,8.5
9,3,formal,6,265,3,3,2.75
9,3,formulate,9,266,4,5,4.25
9,3,fossil,6,267,2,4,8.25
9,3,freely,6,268,1,5,3.25
9,3,freeze,6,269,4,2,2
9,3,from,4,270,2,2,1.75
9,3,fruit,5,271,2,3,7.5
9,3,fully,5,272,1,4,2.75
9,3,fun,3,273,2,1,1.25
9,3,gambling,8,274,0,8,10.5
9,3,gas,3,275,2,1,1
9,3,gathering,9,276,2,7,4.75
9,3,generic,7,277,1,6,9.5
9,3,generous,8,278,5,3,2.75
9,3,genuine,7,279,3,4,3
9,3,get,3,280,2,1,1
9,3,glad,4,281,1,3,2
9,3,goal,4,282,1,3,7.5
9,3,gorgeous,8,283,2,6,4.25
9,3,grain,5,284,1,4,2.75
9,3,grand,5,285,3,2,7.5
9,3,guard,5,286,1,4,2.75
9,3,half,4,287,0,4,2.5
9,3,halt,4,288,3,1,1
9,3,hardly,6,289,2,4,2.75
9,3,harmful,7,290,3,4,8.5
9,3,harmony,7,291,4,3,2.5
9,3,he,2,292,1,1,0.75
9,3,hearing,7,293,2,5,3.5
9,3,hello,5,294,2,3,7.75
9,3,help,4,295,3,1,1.25
9,3,helpful,7,296,4,3,2.5
9,3,hence,5,297,2,3,2.25
9,3,here,4,298,2,2,1.5
9,3,hidden,6,299,1,5,9.25
9,3,hierarchy,9,300,2,7,3
9,3,himself,7,301,2,5,5
9,3,historian,9,302,2,7,2.25
9,3,history,7,303,6,1,0.75
9,3,hobby,5,304,1,4,4.25
9,3,hold,4,305,2,2,0.75
9,3,holy,4,306,3,1,0.5
9,3,homeless,8,307,2,6,1.75
9,3,homework,8,308,4,4,1.5
9,3,hook,4,309,2,2,4
9,3,hope,4,310,2,2,0.75
9,3,hostility,9,311,2,7,2
9,3,house,5,312,2,3,4.25
9,3,housing,7,313,4,3,1.5
9,3,hungry,6,314,1,5,1.5
9,3,hurry,5,315,2,3,1
9,3,if,2,316,0,2,4
9,3,ignore,6,317,1,5,1.5
9,3,imagine,7,318,1,6,1.75
9,3,immense,7,319,2,5,5
9,3,imminent,8,320,3,5,1.75
9,3,impact,6,321,2,4,1.25
9,3,impress,7,322,3,4,5
9,3,inclined,8,323,1,7,2
9,3,including,9,324,4,5,5.25
9,3,indicator,9,325,2,7,2
9,3,indoor,6,326,3,3,1.25
9,3,inflation,9,327,2,7,5.5
9,3,initial,7,328,2,5,1.5
9,3,innocent,8,329,2,6,5.5
9,3,input,5,330,2,3,1.25
9,3,insider,7,331,2,5,1.5
9,3,insight,7,332,4,3,1.25
9,3,instantly,9,333,3,6,5.5
9,3,interact,8,334,2,6,1.75
9,3,interface,9,335,5,4,5
9,3,interpret,9,336,5,4,1.5
9,3,interview,9,337,5,4,1.5
9,3,introduce,9,338,3,6,5.25
9,3,invasion,8,339,2,6,1.75
9,3,invent,6,340,3,3,1
9,3,invoke,6,341,3,3,4.5
9,3,jam,3,342,0,3,1
9,3,jeans,5,343,1,4,1.25
9,3,july,4,344,1,3,1
9,3,justice,7,345,2,5,5
9,3,killing,7,346,0,7,2
9,3,label,5,347,0,5,4.75
9,3,labour,6,348,3,3,1.25
9,3,ladder,6,349,2,4,1.25
9,3,landing,7,350,2,5,1.5
9,3,laptop,6,351,2,4,5
9,3,layout,6,352,2,4,1.25
9,3,lead,4,353,1,3,1
9,3,leave,5,354,3,2,0.75
9,3,legal,5,355,2,3,4.5
9,3,leisure,7,356,2,5,1.5
9,3,lend,4,357,2,2,0.75
9,3,length,6,358,3,3,1
9,3,less,4,359,2,2,4
9,3,let,3,360,2,1,0.5
9,3,lifetime,8,361,1,7,2
9,3,light,5,362,2,3,1
9,3,linger,6,363,2,4,4.75
9,3,listener,8,364,2,6,2
9,3,literacy,8,365,2,6,5.25
9,3,lively,6,366,2,4,1.5
9,3,loan,4,367,1,3,1.25
9,3,lobby,5,368,2,3,1
9,3,logic,5,369,2,3,1
9,3,loom,4,370,2,2,4.25
9,3,loop,4,371,3,1,0.75
9,3,loss,4,372,2,2,0.75
9,3,luck,4,373,1,3,1
9,3,lung,4,374,2,2,0.75
9,3,magical,7,375,0,7,5.5
9,3,major,5,376,2,3,1
9,3,manner,6,377,2,4,1.25
9,3,marry,5,378,2,3,4.5
9,3,matching,8,379,2,6,2
9,3,maths,5,380,3,2,0.75
9,3,maximize,8,381,2,6,5.25
9,3,maybe,5,382,2,3,1
9,3,mayor,5,383,3,2,1
9,3,measure,7,384,1,6,1.75
9,3,mechanism,9,385,2,7,5.75
9,3,metal,5,386,2,3,1
9,3,militant,8,387,1,7,5.75
9,3,military,8,388,6,2,1
9,3,mill,4,389,3,1,0.5
9,3,mine,4,390,2,2,0.75
9,3,miner,5,391,4,1,0.5
9,3,minimize,8,392,3,5,1.5
9,3,minority,8,393,3,5,5
9,3,miracle,7,394,2,5,1.5
9,3,missile,7,395,2,5,5.25
9,3,mistake,7,396,3,4,1.5
9,3,mobile,6,397,1,5,1.5
9,3,modest,6,398,2,4,4.75
9,3,momentum,8,399,2,6,2
9,3,monitor,7,400,2,5,1.5
9,3,morality,8,401,2,6,5.25
9,3,morning,7,402,3,4,1.5
9,3,motorist,8,403,2,6,7.25
9,3,mount,5,404,2,3,2.5
9,3,move,4,405,2,2,1.75
9,3,movement,8,406,4,4,3
9,3,musical,7,407,1,6,9.75
9,3,nail,4,408,0,4,2.75
9,3,native,6,409,2,4,3
9,3,naturally,9,410,3,6,10
9,3,necessity,9,411,1,8,5.25
9,3,news,4,412,2,2,1.75
9,3,nod,3,413,1,2,7.5
9,3,nonsense,8,414,2,6,4.25
9,3,notably,7,415,2,5,3.5
9,3,now,3,416,2,1,1
9,3,number,6,417,1,5,9.25
9,3,nurse,5,418,2,3,2.25
9,3,nursery,7,419,5,2,2
9,3,nursing,7,420,4,3,2.5
9,3,nutrition,9,421,2,7,11
9,3,obey,4,422,0,4,2.5
9,3,obsession,9,423,2,7,11
9,3,obtain,6,424,2,4,3
9,3,occasion,8,425,1,7,10.5
9,3,occur,5,426,3,2,2
9,3,of,2,427,1,1,0.75
9,3,offender,8,428,2,6,4
9,3,offer,5,429,4,1,1.25
9,3,on,2,430,1,1,0.75
9,3,onion,5,431,2,3,8.25
9,3,onto,4,432,2,2,1.75
9,3,operate,7,433,1,6,4
9,3,opinion,7,434,2,5,9.5
9,3,optimism,8,435,2,6,4.25
9,3,oral,4,436,1,3,2.25
9,3,ordinary,8,437,2,6,10.25
9,3,organize,8,438,2,6,4.25
9,3,our,3,439,1,2,1.5
9,3,outrage,7,440,2,5,9.5
9,3,over,4,441,1,3,2.25
9,3,overly,6,442,4,2,1.75
9,3,overseas,8,443,4,4,3
9,3,owner,5,444,1,4,8.75
9,3,oxygen,6,445,1,5,3.5
9,3,packet,6,446,0,6,3.75
9,3,pair,4,447,2,2,7.5
9,3,palm,4,448,2,2,1.5
9,3,pan,3,449,2,1,1
9,3,paper,5,450,2,3,2.25
9,3,parameter,9,451,2,7,11.75
9,3,parental,8,452,3,5,3.75
9,3,parish,6,453,3,3,2.5
9,3,partly,6,454,3,3,2.5
9,3,pass,4,455,2,2,7.5
9,3,passion,7,456,4,3,2.5
9,3,pathway,7,457,2,5,3.5
9,3,peasant,7,458,1,6,9.75
9,3,penalty,7,459,2,5,3.5
9,3,pension,7,460,3,4,3.25
9,3,period,6,461,2,4,9
9,3,petition,8,462,2,6,4
9,3,phase,5,463,1,4,2.75
9,3,physics,7,464,2,5,9.5
9,3,pit,3,465,1,2,1.5
9,3,planet,6,466,1,5,3.25
9,3,player,6,467,3,3,2.5
9,3,pleasure,8,468,2,6,10
9,3,plug,4,469,2,2,1.75
9,3,poetry,6,470,1,5,3.5
9,3,poisonous,9,471,2,7,11
9,3,pole,4,472,2,2,1.5
9,3,politics,8,473,3,5,3.75
9,3,port,4,474,2,2,8
9,3,potential,9,475,2,7,4.75
9,3,poverty,7,476,2,5,3.5
9,3,powder,6,477,2,4,8.75
9,3,powerful,8,478,3,5,3.75
9,3,practice,8,479,1,7,11.25
9,3,pray,4,480,3,1,1.25
9,3,precision,9,481,2,7,4.75
9,3,present,7,482,3,4,9.25
9,3,president,9,483,4,5,4
9,3,price,5,484,2,3,2.25
9,3,pride,5,485,3,2,1.75
9,3,priest,6,486,3,3,8.25
9,3,primarily,9,487,3,6,4.25
9,3,prison,6,488,3,3,2.25
9,3,pronounce,9,489,2,7,10.5
9,3,protocol,8,490,3,5,3.75
9,3,provision,9,491,3,6,10.5
9,3,provoke,7,492,4,3,2.75
9,3,pub,3,493,1,2,1.5
9,3,punch,5,494,2,3,2.25
9,3,purple,6,495,2,4,2.75
9,3,pursue,6,496,3,3,9
9,3,qualify,7,497,0,7,4.5
9,3,queen,5,498,2,3,2.25
9,3,queue,5,499,3,2,8
9,3,quietly,7,500,2,5,5
9,3,racist,6,501,0,6,4
9,3,random,6,502,2,4,9
9,3,range,5,503,3,2,1.75
9,3,rare,4,504,2,2,1.75
9,3,raw,3,505,2,1,1
9,3,readily,7,506,1,6,4
9,3,reading,7,507,5,2,8.25
9,3,realize,7,508,3,4,3
9,3,really,6,509,4,2,2
9,3,rebellion,9,510,2,7,8.25
9,3,recession,9,511,2,7,2.25
9,3,recipe,6,512,3,3,1.25
9,3,regret,6,513,2,4,5
9,3,regulator,9,514,3,6,2
9,3,reinforce,9,515,2,7,5.75
9,3,release,7,516,2,5,1.5
9,3,reliable,8,517,3,5,1.75
9,3,rely,4,518,3,1,0.75
9,3,remains,7,519,2,5,5.75
9,3,remote,6,520,3,3,1.25
9,3,renowned,8,521,2,6,1.75
9,3,reporter,8,522,2,6,5.75
9,3,represent,9,523,3,6,2
9,3,reproduce,9,524,4,5,5.5
9,3,respect,7,525,2,5,1.5
9,3,response,8,526,4,4,1.5
9,3,restraint,9,527,3,6,5.75
9,3,result,6,528,3,3,1.25
9,3,rhetoric,8,529,1,7,5.75
9,3,rhythm,6,530,2,4,1.5
9,3,rice,4,531,1,3,1
9,3,rid,3,532,2,1,0.5
9,3,romantic,8,533,1,7,6
9,3,route,5,534,2,3,1.25
9,3,rugby,5,535,1,4,1.25
9,3,rumour,6,536,2,4,1.25
9,3,runner,6,537,2,4,5.25
9,3,sail,4,538,0,4,1.25
9,3,sanction,8,539,2,6,6
9,3,sandwich,8,540,3,5,1.75
9,3,scope,5,541,1,4,1.25
9,3,scratch,7,542,2,5,5.75
9,3,scream,6,543,3,3,1.25
9,3,script,6,544,3,3,1.25
9,3,sculpture,9,545,2,7,6.25
9,3,sea,3,546,1,2,0.75
9,3,see,3,547,2,1,0.5
9,3,seize,5,548,2,3,1
9,3,self,4,549,2,2,0.75
9,3,senator,7,550,2,5,1.5
9,3,senior,6,551,3,3,5.25
9,3,sensation,9,552,3,6,2.25
9,3,session,7,553,2,5,5.5
9,3,set,3,554,2,1,0.5
9,3,seventeen,9,555,2,7,2.25
9,3,seventy,7,556,6,1,0.75
9,3,several,7,557,4,3,1.25
9,3,shade,5,558,1,4,5
9,3,shadow,6,559,4,2,1
9,3,shake,5,560,3,2,0.75
9,3,shop,4,561,2,2,0.75
9,3,short,5,562,3,2,1
9,3,shot,4,563,3,1,0.75
9,3,should,6,564,3,3,5.25
9,3,shout,5,565,4,1,0.75
9,3,silence,7,566,1,6,1.75
9,3,simulate,8,567,2,6,5.75
9,3,sky,3,568,1,2,0.75
9,3,sleep,5,569,1,4,1.25
9,3,slogan,6,570,2,4,1.25
9,3,slow,4,571,3,1,0.75
9,3,small,5,572,1,4,5.25
9,3,smash,5,573,3,2,1
9,3,soar,4,574,1,3,1
9,3,soccer,6,575,2,4,1.25
9,3,society,7,576,3,4,5.5
9,3,solely,6,577,2,4,1.25
9,3,solicitor,9,578,3,6,2
9,3,somebody,8,579,2,6,5.75
9,3,somewhere,9,580,4,5,1.75
9,3,son,3,581,2,1,0.5
9,3,soon,4,582,2,2,4.75
9,3,sorry,5,583,2,3,1.25
9,3,sort,4,584,3,1,0.5
9,3,source,6,585,2,4,1.25
9,3,span,4,586,1,3,1
9,3,spill,5,587,2,3,5
9,3,split,5,588,2,3,1
9,3,spoil,5,589,2,3,1
9,3,sport,5,590,3,2,1
9,3,spot,4,591,3,1,0.5
9,3,stabilize,9,592,1,8,6.5
9,3,stadium,7,593,3,4,1.75
9,3,statement,9,594,3,6,6
9,3,status,6,595,4,2,1
9,3,stimulate,9,596,2,7,2
9,3,stream,6,597,2,4,5.25
9,3,stress,6,598,4,2,1
9,3,structure,9,599,3,6,2
9,3,struggle,8,600,4,4,1.75
9,3,stupid,6,601,2,4,6.25
9,3,style,5,602,2,3,1
9,3,suburb,6,603,1,5,1.5
9,3,suburban,8,604,6,2,1
9,3,suffering,9,605,2,7,6.75
9,3,suicide,7,606,2,5,1.75
9,3,summit,6,607,2,4,5.5
9,3,supporter,9,608,2,7,2.25
9,3,surge,5,609,2,3,1
9,3,sustain,7,610,2,5,12.5
9,3,swing,5,611,1,4,3.5
9,3,symbol,6,612,1,5,3.5
9,3,syndrome,8,613,2,6,12.25
9,3,tax,3,614,0,3,2
9,3,teach,5,615,1,4,2.75
9,3,technique,9,616,2,7,12.5
9,3,teenager,8,617,2,6,4.25
9,3,terminal,8,618,2,6,11.5
9,3,testify,7,619,2,5,4
9,3,text,4,620,2,2,1.75
9,3,than,4,621,1,3,9.25
9,3,that,4,622,3,1,1
9,3,theatre,7,623,2,5,3.75
9,3,their,5,624,3,2,1.75
9,3,theirs,6,625,5,1,1.5
9,3,them,4,626,3,1,1.25
9,3,therefore,9,627,3,6,10.5
9,3,thinking,8,628,2,6,4
9,3,thought,7,629,2,5,10
9,3,threat,6,630,2,4,2.75
9,3,threshold,9,631,4,5,4
9,3,thrive,6,632,3,3,2.75
9,3,throat,6,633,3,3,9.75
9,3,throw,5,634,4,1,1.25
9,3,thursday,8,635,2,6,4
9,3,tired,5,636,1,4,2.75
9,3,toll,4,637,1,3,9
9,3,tone,4,638,2,2,1.75
9,3,tongue,6,639,3,3,2.5
9,3,tourist,7,640,2,5,3.75
9,3,towel,5,641,2,3,8.75
9,3,training,8,642,1,7,4.5
9,3,transfer,8,643,3,5,10.75
9,3,transform,9,644,6,3,3.25
9,3,tribunal,8,645,2,6,4.25
9,3,trust,5,646,2,3,2.25
9,3,tuition,7,647,1,6,10.5
9,3,turnout,7,648,2,5,3.5
9,3,typical,7,649,1,6,10.75
9,3,ugly,4,650,0,4,2.75
9,3,under,5,651,1,4,2.75
9,3,unless,6,652,2,4,9.5
9,3,unlikely,8,653,3,5,3.75
9,3,up,2,654,1,1,0.75
9,3,upwards,7,655,2,5,3.5
9,3,us,2,656,1,1,7.5
9,3,use,3,657,2,1,1
9,3,used,4,658,3,1,1
9,3,user,4,659,3,1,1
9,3,utterly,7,660,1,6,3.75
9,3,violate,7,661,0,7,11
9,3,vitamin,7,662,2,5,3.5
9,3,wage,4,663,0,4,2.5
9,3,wall,4,664,2,2,11.75
9,3,ward,4,665,2,2,4.25
9,3,warm,4,666,3,1,1469.75
9,3,we,2,667,1,1,0.5
9,3,wear,4,668,2,2,1
9,3,web,3,669,2,1,0.5
9,3,weekly,6,670,2,4,1.5
9,3,well,4,671,2,2,1
9,3,wet,3,672,2,1,0.5
9,3,wheat,5,673,1,4,7.5
9,3,when,4,674,3,1,1
9,3,where,5,675,3,2,1.25
9,3,while,5,676,2,3,1.5
9,3,whisper,7,677,3,4,2
9,3,wide,4,678,1,3,6.5
9,3,widely,6,679,4,2,1
9,3,winner,6,680,2,4,1.75
9,3,wise,4,681,2,2,1
9,3,wish,4,682,3,1,0.75
9,3,wooden,6,683,1,5,7
9,3,workout,7,684,2,5,3
9,3,worldwide,9,685,3,6,8.5
9,3,worm,4,686,3,1,1.25
9,3,worse,5,687,3,2,1.75
9,3,writer,6,688,1,5,2.25
9,3,year,4,689,0,4,1.25
9,3,yell,4,690,2,2,6.25
9,3,you,3,691,1,2,1.25
9,3,yours,5,692,3,2,1
9,3,yourself,8,693,5,3,1.5
9,3,zero,4,694,0,4,1.5
9,3,zone,4,695,1,3,6
9,4,ability,7,0,0,7,2.75
9,4,able,4,1,2,2,3.5
9,4,abolish,7,2,2,5,4.5
9,4,abortion,8,3,3,5,2.25
9,4,above,5,4,3,2,1
9,4,abroad,6,5,2,4,6.5
9,4,absent,6,6,2,4,1.5
9,4,access,6,7,1,5,1.75
9,4,according,9,8,3,6,7.25
9,4,acquire,7,9,2,5,1.75
9,4,act,3,10,2,1,0.5
9,4,action,6,11,3,3,1.25
9,4,addition,8,12,1,7,7
9,4,adult,5,13,2,3,1.25
9,4,advertise,9,14,2,7,6.5
9,4,affair,6,15,1,5,1.5
9,4,afford,6,16,3,3,1.25
9,4,ah,2,17,1,1,0.5
9,4,alignment,9,18,1,8,7
9,4,allegedly,9,19,2,7,7
9,4,also,4,20,2,2,0.75
9,4,ambitious,9,21,1,8,2.25
9,4,amid,4,22,2,2,1
9,4,angel,5,23,1,4,5.5
9,4,angry,5,24,3,2,1
9,4,answer,6,25,2,4,1.5
9,4,anyone,6,26,2,4,1.25
9,4,anything,8,27,3,5,6.25
9,4,apart,5,28,1,4,1.25
9,4,appoint,7,29,2,5,1.75
9,4,april,5,30,2,3,5.5
9,4,arbitrary,9,31,1,8,2.5
9,4,arena,5,32,2,3,5.5
9,4,armed,5,33,2,3,1
9,4,article,7,34,2,5,1.5
9,4,assign,6,35,1,5,1.5
9,4,attach,6,36,1,5,5.75
9,4,attempt,7,37,3,4,1.5
9,4,attribute,9,38,3,6,6.25
9,4,audience,8,39,1,7,2
9,4,audit,5,40,4,1,0.75
9,4,august,6,41,2,4,1.25
9,4,author,6,42,2,4,5.5
9,4,avoid,5,43,1,4,1.25
9,4,away,4,44,1,3,1
9,4,awkward,7,45,2,5,6
9,4,backdrop,8,46,0,8,2.25
9,4,bad,3,47,2,1,0.5
9,4,bake,4,48,2,2,0.75
9,4,barrier,7,49,2,5,5.75
9,4,basis,5,50,2,3,1
9,4,bear,4,51,1,3,1
9,4,because,7,52,2,5,6.25
9,4,before,6,53,2,4,1.25
9,4,behind,6,54,2,4,1.25
9,4,being,5,55,2,3,5.25
9,4,beneath,7,56,2,5,1.5
9,4,bent,4,57,3,1,0.75
9,4,beside,6,58,2,4,1.25
9,4,bet,3,59,2,1,0.5
9,4,bicycle,7,60,1,6,5.75
9,4,blanket,7,61,1,6,1.75
9,4,blood,5,62,2,3,1
9,4,bond,4,63,1,3,5.25
9,4,boring,6,64,2,4,1.5
9,4,brain,5,65,1,4,1.25
9,4,bread,5,66,2,3,1
9,4,breast,6,67,4,2,5.75
9,4,brick,5,68,2,3,2.25
9,4,broad,5,69,2,3,2.25
9,4,broadcast,9,70,5,4,3
9,4,broadly,7,71,5,2,8.75
9,4,brother,7,72,3,4,3.25
9,4,burial,6,73,1,5,3.25
9,4,burst,5,74,3,2,1.75
9,4,but,3,75,2,1,1
9,4,calm,4,76,0,4,9.5
9,4,camp,4,77,2,2,1.75
9,4,capture,7,78,2,5,3.5
9,4,case,4,79,2,2,1.5
9,4,castle,6,80,3,3,9.5
9,4,cat,3,81,2,1,1
9,4,catch,5,82,3,2,1.75
9,4,cattle,6,83,3,3,2.25
9,4,cause,5,84,2,3,2.25
9,4,cent,4,85,1,3,10.25
9,4,centre,6,86,4,2,1.75
9,4,champion,8,87,1,7,5
9,4,chance,6,88,3,3,4
9,4,cheek,5,89,2,3,10.25
9,4,chest,5,90,3,2,2
9,4,cigarette,9,91,1,8,5.5
9,4,clarify,7,92,1,6,11.25
9,4,class,5,93,3,2,2
9,4,classic,7,94,5,2,2
9,4,classical,9,95,7,2,2
9,4,cleaning,8,96,2,6,11
9,4,climate,7,97,2,5,3.5
9,4,clue,4,98,2,2,1.75
9,4,coastal,7,99,1,6,11.25
9,4,collision,9,100,2,7,4.75
9,4,colour,6,101,3,3,2.5
9,4,columnist,9,102,3,6,11.5
9,4,combat,6,103,2,4,3
9,4,combine,7,104,4,3,2.5
9,4,commander,9,105,3,6,11.5
9,4,compare,7,106,3,4,3
9,4,complex,7,107,4,3,2.75
9,4,concerned,9,108,2,7,12.25
9,4,conclude,8,109,4,4,3.25
9,4,concrete,8,110,4,4,3.25
9,4,confirm,7,111,3,4,10
9,4,confuse,7,112,4,3,2.5
9,4,confusion,9,113,6,3,2.75
9,4,conserve,8,114,3,5,11.5
9,4,consumer,8,115,4,4,3.25
9,4,contact,7,116,3,4,3
9,4,contest,7,117,4,3,2.5
9,4,cook,4,118,2,2,8.5
9,4,cooperate,9,119,3,6,4.25
9,4,correlate,9,120,2,7,11.5
9,4,corrupt,7,121,4,3,2.75
9,4,costume,7,122,2,5,3.5
9,4,cotton,6,123,2,4,2.75
9,4,courage,7,124,2,5,10.75
9,4,covered,7,125,2,5,3.5
9,4,crack,5,126,1,4,2.75
9,4,crazy,5,127,3,2,9
9,4,cream,5,128,2,3,2.25
9,4,creative,8,129,4,4,3.25
9,4,creator,7,130,5,2,2
9,4,crown,5,131,2,3,9.5
9,4,cure,4,132,1,3,2.25
9,4,curiosity,9,133,3,6,4.25
9,4,custody,7,134,2,5,10.5
9,4,cutting,7,135,2,5,3.5
9,4,dark,4,136,0,4,2.5
9,4,data,4,137,2,2,1.75
9,4,database,8,138,4,4,10.5
9,4,daughter,8,139,2,6,4
9,4,dear,4,140,1,3,2
9,4,debris,6,141,2,4,10.25
9,4,decision,8,142,2,6,4.25
9,4,deck,4,143,3,1,1.25
9,4,define,6,144,2,4,3
9,4,defy,4,145,3,1,8.5
9,4,delivery,8,146,2,6,4.25
9,4,denial,6,147,2,4,3
9,4,depict,6,148,2,4,10.25
9,4,derive,6,149,2,4,2.75
9,4,descent,7,150,2,5,3.75
9,4,desire,6,151,3,3,2.5
9,4,desperate,9,152,3,6,11.5
9,4,destroy,7,153,3,4,3
9,4,detail,6,154,2,4,10
9,4,devise,6,155,2,4,3
9,4,dialogue,8,156,1,7,4.5
9,4,diary,5,157,3,2,1.75
9,4,die,3,158,2,1,8.5
9,4,differ,6,159,2,4,2.75
9,4,dilemma,7,160,2,5,3.5
9,4,dimension,9,161,2,7,12.25
9,4,dip,3,162,2,1,1
9,4,directly,8,163,2,6,4
9,4,disagree,8,164,2,6,11.25
9,4,discard,7,165,3,4,3
9,4,discourse,9,166,4,5,4
9,4,dispose,7,167,3,4,10.75
9,4,dispute,7,168,4,3,2.25
9,4,distract,8,169,3,5,2.25
9,4,district,8,170,5,3,1.75
9,4,diverse,7,171,2,5,9.5
9,4,dominance,9,172,1,8,3
9,4,donate,6,173,2,4,6.5
9,4,dose,4,174,2,2,0.75
9,4,dozen,5,175,2,3,1
9,4,drain,5,176,1,4,1.25
9,4,dress,5,177,2,3,6
9,4,drive,5,178,2,3,1
9,4,drown,5,179,2,3,1
9,4,drunk,5,180,2,3,1
9,4,dry,3,181,2,1,0.5
9,4,dump,4,182,1,3,6
9,4,duty,4,183,2,2,0.75
9,4,easily,6,184,0,6,2.5
9,4,east,4,185,3,1,1.25
9,4,eastern,7,186,4,3,6.5
9,4,echo,4,187,1,3,1
9,4,economics,9,188,2,7,2.25
9,4,edge,4,189,1,3,1
9,4,editorial,9,190,2,7,6.75
9,4,educated,8,191,2,6,1.75
9,4,education,9,192,6,3,6.25
9,4,elaborate,9,193,1,8,2.5
9,4,element,7,194,2,5,6.25
9,4,embed,5,195,1,4,1.25
9,4,emerge,6,196,2,4,1.25
9,4,employ,6,197,2,4,6.25
9,4,endorse,7,198,1,6,1.75
9,4,enforce,7,199,2,5,1.75
9,4,enhance,7,200,2,5,6.25
9,4,enquire,7,201,2,5,1.75
9,4,enrol,5,202,2,3,1
9,4,ensue,5,203,2,3,5.5
9,4,entity,6,204,2,4,1.25
9,4,equip,5,205,1,4,1.25
9,4,erupt,5,206,1,4,1.25
9,4,escalate,8,207,1,7,6.75
9,4,eternal,7,208,1,6,1.75
9,4,ethical,7,209,2,5,6.5
9,4,ethnic,6,210,3,3,1.25
9,4,evil,4,211,1,3,1
9,4,exam,4,212,1,3,1
9,4,example,7,213,4,3,6
9,4,excess,6,214,2,4,1.5
9,4,exclude,7,215,3,4,1.5
9,4,expect,6,216,2,4,6
9,4,explicit,8,217,3,5,2
9,4,explosion,9,218,4,5,2
9,4,export,6,219,3,3,1.25
9,4,external,8,220,2,6,7
9,4,extremely,9,221,3,6,2.25
9,4,fabulous,8,222,0,8,7.25
9,4,facility,8,223,2,6,2
9,4,fact,4,224,3,1,0.75
9,4,factory,7,225,4,3,6
9,4,fairness,8,226,2,6,1.75
9,4,faith,5,227,3,2,1
9,4,fame,4,228,2,2,0.75
9,4,familiar,8,229,3,5,6.5
9,4,fan,3,230,2,1,0.5
9,4,feather,7,231,1,6,1.75
9,4,feature,7,232,4,3,5.75
9,4,feel,4,233,2,2,0.75
9,4,feeling,7,234,4,3,1.25
9,4,fifth,5,235,1,4,1.25
9,4,fighting,8,236,2,6,6.75
9,4,figure,6,237,3,3,1.25
9,4,fill,4,238,2,2,0.75
9,4,film,4,239,3,1,0.5
9,4,find,4,240,2,2,0.75
9,4,finish,6,241,3,3,5.75
9,4,firearm,7,242,2,5,1.75
9,4,first,5,243,3,2,1
9,4,fish,4,244,2,2,0.75
9,4,fishing,7,245,4,3,1
9,4,fit,3,246,2,1,5.25
9,4,five,4,247,2,2,0.75
9,4,flaw,4,248,1,3,1
9,4,flawed,6,249,4,2,0.75
9,4,float,5,250,2,3,1
9,4,fluid,5,251,2,3,1
9,4,follow,6,252,1,5,6.5
9,4,fond,4,253,2,2,1
9,4,fool,4,254,2,2,0.75
9,4,forgive,7,255,2,5,6.5
9,4,fork,4,256,3,1,0.75
9,4,formal,6,257,3,3,1.25
9,4,forth,5,258,3,2,1
9,4,forum,5,259,3,2,1
9,4,frankly,7,260,1,6,7
9,4,fruit,5,261,2,3,1
9,4,fun,3,262,1,2,0.75
9,4,function,8,263,3,5,1.5
9,4,funny,5,264,3,2,0.75
9,4,furious,7,265,2,5,6.5
9,4,gambling,8,266,0,8,2.25
9,4,gas,3,267,2,1,5.5
9,4,generic,7,268,1,6,1.75
9,4,generous,8,269,5,3,1.25
9,4,gentleman,9,270,3,6,6.75
9,4,genuine,7,271,3,4,1.5
9,4,get,3,272,2,1,0.5
9,4,glad,4,273,1,3,1
9,4,goal,4,274,1,3,1
9,4,goods,5,275,2,3,6.5
9,4,gradually,9,276,1,8,2.25
9,4,grain,5,277,3,2,1
9,4,grand,5,278,3,2,5.5
9,4,grant,5,279,4,1,0.75
9,4,grass,5,280,3,2,0.75
9,4,great,5,281,2,3,1
9,4,greatly,7,282,5,2,0.75
9,4,half,4,283,0,4,1.25
9,4,happy,5,284,2,3,6
9,4,hardware,8,285,2,6,2
9,4,hatred,6,286,2,4,1.25
9,4,hear,4,287,1,3,6
9,4,helpful,7,288,2,5,1.75
9,4,hero,4,289,2,2,0.75
9,4,hierarchy,9,290,1,8,7.5
9,4,historian,9,291,2,7,2.25
9,4,history,7,292,6,1,1
9,4,hockey,6,293,1,5,6.5
9,4,holy,4,294,2,2,1
9,4,homeless,8,295,2,6,1.75
9,4,honour,6,296,2,4,6.25
9,4,hook,4,297,2,2,0.75
9,4,hope,4,298,2,2,0.75
9,4,hopefully,9,299,4,5,1.5
9,4,host,4,300,2,2,0.75
9,4,hostile,7,301,4,3,6.25
9,4,hostility,9,302,6,3,1.5
9,4,hurry,5,303,1,4,1.25
9,4,husband,7,304,2,5,6.75
9,4,ideology,8,305,0,8,2.25
9,4,if,2,306,1,1,0.5
9,4,ignore,6,307,1,5,6.5
9,4,illness,7,308,1,6,1.75
9,4,imminent,8,309,1,7,7.25
9,4,incentive,9,310,1,8,2.5
9,4,including,9,311,3,6,7.25
9,4,increase,8,312,3,5,1.75
9,4,indeed,6,313,2,4,1.25
9,4,indoor,6,314,3,3,6.25
9,4,induce,6,315,3,3,1.25
9,4,initial,7,316,2,5,1.75
9,4,injured,7,317,2,5,1.5
9,4,instantly,9,318,2,7,7.5
9,4,insult,6,319,3,3,1.25
9,4,interact,8,320,2,6,7.25
9,4,interrupt,9,321,5,4,1.75
9,4,interview,9,322,5,4,1.75
9,4,introduce,9,323,3,6,7.75
9,4,invoke,6,324,2,4,1.5
9,4,isolation,9,325,1,8,8.5
9,4,jeans,5,326,0,5,1.5
9,4,join,4,327,1,3,1
9,4,july,4,328,1,3,1
9,4,justice,7,329,2,5,7
9,4,kidnap,6,330,0,6,1.75
9,4,kind,4,331,2,2,0.75
9,4,kiss,4,332,2,2,5.75
9,4,knowledge,9,333,1,8,2.5
9,4,label,5,334,0,5,1.5
9,4,lamp,4,335,2,2,12.25
9,4,landlord,8,336,2,6,963.25
9,4,lane,4,337,3,1,1.5
9,4,lawsuit,7,338,2,5,3.5
9,4,lawyer,6,339,3,3,10
9,4,lead,4,340,1,3,2.5
9,4,leap,4,341,3,1,1.25
9,4,leave,5,342,3,2,2
9,4,legal,5,343,2,3,2.5
9,4,leisure,7,344,2,5,9.25
9,4,lend,4,345,2,2,1.75
9,4,level,5,346,2,3,3.25
9,4,lifetime,8,347,1,7,5.25
9,4,limit,5,348,2,3,7.25
9,4,linger,6,349,2,4,2.75
9,4,literacy,8,350,2,6,4.75
9,4,loan,4,351,1,3,7.25
9,4,loom,4,352,2,2,2.25
9,4,loop,4,353,3,1,1.75
9,4,lose,4,354,2,2,2.25
9,4,loss,4,355,3,1,1.5
9,4,lost,4,356,3,1,1.5
9,4,luck,4,357,1,3,3
9,4,lung,4,358,2,2,11
9,4,magical,7,359,0,7,5.75
9,4,man,3,360,2,1,1.5
9,4,manifest,8,361,3,5,16.5
9,4,manner,6,362,3,3,2.25
9,4,marriage,8,363,2,6,2.75
9,4,massive,7,364,2,5,9
9,4,matter,6,365,2,4,1.75
9,4,maximize,8,366,2,6,2.5
9,4,meaning,7,367,1,6,6
9,4,measure,7,368,3,4,1.5
9,4,menu,4,369,2,2,1
9,4,migration,9,370,1,8,6.25
9,4,mile,4,371,2,2,0.75
9,4,militant,8,372,3,5,1.75
9,4,milk,4,373,3,1,0.5
9,4,mine,4,374,2,2,4.5
9,4,minimize,8,375,3,5,1.75
9,4,minor,5,376,3,2,1
9,4,minority,8,377,5,3,1.25
9,4,minute,6,378,3,3,4.75
9,4,miracle,7,379,2,5,1.75
9,4,missile,7,380,2,5,1.5
9,4,mistake,7,381,3,4,5
9,4,mobile,6,382,1,5,1.5
9,4,modern,6,383,2,4,1.25
9,4,modest,6,384,4,2,1
9,4,momentum,8,385,2,6,5.75
9,4,monitor,7,386,2,5,1.75
9,4,monk,4,387,3,1,0.75
9,4,moral,5,388,2,3,5
9,4,morality,8,389,5,3,1.75
9,4,morning,7,390,3,4,1.75
9,4,motor,5,391,2,3,1.25
9,4,motorist,8,392,5,3,1.25
9,4,mount,5,393,2,3,5
9,4,movement,8,394,2,6,2
9,4,multiply,8,395,1,7,5.75
9,4,nail,4,396,0,4,1.25
9,4,necessity,9,397,1,8,6
9,4,nest,4,398,2,2,0.75
9,4,news,4,399,2,2,1
9,4,next,4,400,2,2,1
9,4,nineteen,8,401,1,7,5.5
9,4,nod,3,402,1,2,0.75
9,4,nose,4,403,2,2,0.75
9,4,now,3,404,2,1,0.5
9,4,nowadays,8,405,3,5,1.5
9,4,nurse,5,406,1,4,4.75
9,4,nursery,7,407,5,2,1.25
9,4,nutrition,9,408,2,7,2.25
9,4,obey,4,409,0,4,6.25
9,4,obsession,9,410,2,7,2.25
9,4,obtain,6,411,2,4,1.25
9,4,occasion,8,412,1,7,6.75
9,4,occur,5,413,3,2,1
9,4,offer,5,414,1,4,1.25
9,4,offering,8,415,5,3,5.5
9,4,on,2,416,1,1,0.5
9,4,onion,5,417,2,3,1
9,4,onto,4,418,2,2,0.75
9,4,open,4,419,1,3,1
9,4,operate,7,420,3,4,5.5
9,4,operator,8,421,6,2,1.5
9,4,opinion,7,422,2,5,1.75
9,4,optimism,8,423,2,6,2
9,4,order,5,424,1,4,5.5
9,4,oven,4,425,1,3,1
9,4,over,4,426,3,1,0.5
9,4,overly,6,427,4,2,0.75
9,4,overnight,9,428,4,5,6
9,4,overseas,8,429,4,4,1.75
9,4,owner,5,430,1,4,1.25
9,4,oxygen,6,431,1,5,5.75
9,4,palm,4,432,0,4,1.25
9,4,paper,5,433,2,3,1
9,4,parent,6,434,2,4,1.25
9,4,parish,6,435,3,3,5.5
9,4,partly,6,436,3,3,1.25
9,4,pass,4,437,2,2,0.75
9,4,passing,7,438,4,3,1.5
9,4,passion,7,439,5,2,1
9,4,peak,4,440,1,3,5.25
9,4,peasant,7,441,3,4,1.5
9,4,penalty,7,442,2,5,1.5
9,4,pension,7,443,3,4,5.5
9,4,people,6,444,2,4,2.5
9,4,period,6,445,2,4,3.25
9,4,petition,8,446,2,6,10.5
9,4,physics,7,447,1,6,4
9,4,pill,4,448,1,3,2
9,4,pink,4,449,2,2,1.75
9,4,placement,9,450,1,8,13.5
9,4,plate,5,451,3,2,2
9,4,player,6,452,3,3,2.5
9,4,pleasure,8,453,2,6,10.25
9,4,plug,4,454,2,2,1.75
9,4,pocket,6,455,1,5,3.5
9,4,poet,4,456,2,2,5.25
9,4,pole,4,457,2,2,5.75
9,4,policeman,9,458,3,6,5.5
9,4,policy,6,459,5,1,1.5
9,4,politics,8,460,4,4,3.75
9,4,pool,4,461,2,2,8.25
9,4,port,4,462,2,2,1.75
9,4,portray,7,463,4,3,2.5
9,4,pose,4,464,2,2,1.5
9,4,powder,6,465,2,4,2.75
9,4,powerful,8,466,3,5,10
9,4,preach,6,467,1,5,3.5
9,4,precede,7,468,3,4,3
9,4,precision,9,469,4,5,10.25
9,4,prefer,6,470,3,3,2.25
9,4,premium,7,471,3,4,3
9,4,previous,8,472,3,5,9.5
9,4,prey,4,473,3,1,1.25
9,4,price,5,474,2,3,2.25
9,4,priest,6,475,3,3,2.25
9,4,prince,6,476,3,3,8.25
9,4,princess,8,477,6,2,2.5
9,4,prisoner,8,478,3,5,3.5
9,4,probable,8,479,2,6,4.25
9,4,probably,8,480,7,1,9
9,4,provision,9,481,3,6,4.25
9,4,pub,3,482,1,2,1.5
9,4,punch,5,483,2,3,2.25
9,4,purchase,8,484,2,6,10.25
9,4,purple,6,485,3,3,2.5
9,4,pursue,6,486,3,3,2.5
9,4,qualify,7,487,0,7,10.75
9,4,queen,5,488,2,3,2.25
9,4,queue,5,489,3,2,2
9,4,quickly,7,490,2,5,9.75
9,4,quota,5,491,2,3,2.5
9,4,quote,5,492,4,1,1.25
9,4,rapid,5,493,0,5,3.25
9,4,rare,4,494,2,2,1.75
9,4,read,4,495,1,3,8.25
9,4,readily,7,496,4,3,2.5
9,4,real,4,497,3,1,1.25
9,4,realize,7,498,4,3,2.5
9,4,rebellion,9,499,2,7,11.25
9,4,receive,7,500,2,5,3.5
9,4,receiver,8,501,7,1,1.25
9,4,recipe,6,502,3,3,2.5
9,4,recipient,9,503,5,4,9.5
9,4,recovery,8,504,3,5,3.75
9,4,red,3,505,2,1,1
9,4,refuge,6,506,2,4,3
9,4,regularly,9,507,2,7,11
9,4,regulator,9,508,6,3,3
9,4,relaxing,8,509,2,6,10.25
9,4,release,7,510,3,4,3
9,4,rely,4,511,3,1,1.25
9,4,remember,8,512,2,6,4.25
9,4,remote,6,513,3,3,8.75
9,4,rental,6,514,2,4,3
9,4,repeated,8,515,2,6,4
9,4,report,6,516,3,3,9
9,4,represent,9,517,3,6,4.5
9,4,restraint,9,518,2,7,11
9,4,result,6,519,3,3,2.5
9,4,resume,6,520,4,2,2
9,4,review,6,521,2,4,3
9,4,rhetoric,8,522,1,7,10.75
9,4,rhythm,6,523,2,4,3
9,4,riot,4,524,1,3,2.25
9,4,risk,4,525,2,2,1.75
9,4,route,5,526,1,4,9.25
9,4,rugby,5,527,1,4,2.75
9,4,run,3,528,2,1,1.25
9,4,runner,6,529,3,3,2.25
9,4,sad,3,530,0,3,2
9,4,sail,4,531,2,2,8
9,4,sanction,8,532,2,6,4
9,4,sandwich,8,533,3,5,3.75
9,4,scale,5,534,1,4,10.25
9,4,scope,5,535,2,3,2.5
9,4,scream,6,536,2,4,3.25
9,4,screening,9,537,4,5,10
9,4,script,6,538,3,3,2.5
9,4,sculpture,9,539,2,7,5
9,4,section,7,540,1,6,14
9,4,seize,5,541,2,3,2.25
9,4,self,4,542,2,2,1.75
9,4,serial,6,543,2,4,10
9,4,set,3,544,2,1,1.75
9,4,seventeen,9,545,2,7,7
9,4,seventy,7,546,6,1,1.75
9,4,several,7,547,4,3,5.5
9,4,sex,3,548,2,1,1
9,4,shade,5,549,1,4,9.5
9,4,shadow,6,550,4,2,1.75
9,4,shake,5,551,3,2,1.75
9,4,shall,5,552,3,2,1.75
9,4,shaped,6,553,3,3,2.5
9,4,shine,5,554,2,3,8.5
9,4,shocking,8,555,2,6,4.25
9,4,shot,4,556,3,1,1.25
9,4,shout,5,557,3,2,2
9,4,shrink,6,558,2,4,9
9,4,shrug,5,559,3,2,2
9,4,silence,7,560,1,6,4
9,4,silent,6,561,5,1,1.25
9,4,simulate,8,562,2,6,10.25
9,4,sincere,7,563,2,5,3.5
9,4,sir,3,564,2,1,1
9,4,sixty,5,565,2,3,2.25
9,4,skiing,6,566,1,5,9.5
9,4,skill,5,567,3,2,1.75
9,4,sky,3,568,2,1,1
9,4,sleep,5,569,1,4,2.75
9,4,slogan,6,570,2,4,9
9,4,slot,4,571,3,1,1.25
9,4,snap,4,572,1,3,2
9,4,soak,4,573,1,3,2
9,4,soar,4,574,3,1,1
9,4,society,7,575,2,5,10
9,4,software,8,576,2,6,4.25
9,4,soldier,7,577,2,5,3.75
9,4,solely,6,578,3,3,9
9,4,sort,4,579,2,2,1.75
9,4,source,6,580,2,4,3
9,4,span,4,581,1,3,2
9,4,speculate,9,582,2,7,11
9,4,spending,8,583,3,5,3.75
9,4,spill,5,584,2,3,2.25
9,4,spoil,5,585,2,3,8.5
9,4,sponsor,7,586,3,4,3
9,4,spot,4,587,3,1,1.25
9,4,spy,3,588,2,1,1
9,4,stadium,7,589,1,6,10.25
9,4,statement,9,590,3,6,4.5
9,4,station,7,591,4,3,3.25
9,4,steep,5,592,2,3,3
9,4,stiff,5,593,2,3,10.25
9,4,stress,6,594,2,4,3
9,4,strive,6,595,3,3,2.5
9,4,struggle,8,596,3,5,11
9,4,student,7,597,2,5,3.75
9,4,stunning,8,598,3,5,3.75
9,4,style,5,599,2,3,8.75
9,4,suddenly,8,600,1,7,5
9,4,suffer,6,601,2,4,3.25
9,4,suffering,9,602,6,3,9.25
9,4,suicide,7,603,2,5,3.5
9,4,summer,6,604,2,4,2.75
9,4,superior,8,605,2,6,10.5
9,4,supply,6,606,3,3,2.5
9,4,surface,7,607,2,5,3.5
9,4,sweet,5,608,1,4,7.5
9,4,swing,5,609,2,3,1.25
9,4,teach,5,610,0,5,1.5
9,4,technique,9,611,2,7,6.5
9,4,teenage,7,612,2,5,1.75
9,4,teenager,8,613,7,1,0.75
9,4,tennis,6,614,2,4,1.5
9,4,tenure,6,615,3,3,5.75
9,4,terminal,8,616,2,6,2
9,4,terrain,7,617,3,4,1.5
9,4,terrorist,9,618,4,5,7
9,4,testify,7,619,2,5,1.75
9,4,testing,7,620,5,2,1
9,4,text,4,621,2,2,1
9,4,than,4,622,1,3,5.5
9,4,theatre,7,623,2,5,2.25
9,4,theft,5,624,3,2,1
9,4,theirs,6,625,3,3,1.25
9,4,then,4,626,3,1,5.5
9,4,there,5,627,3,2,2
9,4,therefore,9,628,5,4,1.75
9,4,they,4,629,3,1,0.75
9,4,thinking,8,630,2,6,6.25
9,4,third,5,631,3,2,1
9,4,though,6,632,2,4,1.5
9,4,threshold,9,633,2,7,2.25
9,4,thursday,8,634,2,6,6.25
9,4,timber,6,635,1,5,1.5
9,4,tone,4,636,1,3,5.5
9,4,tongue,6,637,3,3,1.25
9,4,total,5,638,2,3,1.25
9,4,touch,5,639,2,3,1
9,4,towards,7,640,2,5,5.5
9,4,towel,5,641,3,2,1
9,4,tradition,9,642,1,8,2.25
9,4,transfer,8,643,3,5,6.25
9,4,troubled,8,644,2,6,2
9,4,truly,5,645,2,3,1
9,4,trustee,7,646,3,4,6
9,4,truth,5,647,3,2,1
9,4,try,3,648,2,1,0.5
9,4,tuesday,7,649,1,6,1.75
9,4,turnout,7,650,2,5,5.75
9,4,twenty,6,651,1,5,1.5
9,4,twist,5,652,2,3,1
9,4,typical,7,653,1,6,6
9,4,typically,9,654,7,2,1.25
9,4,umbrella,8,655,0,8,2.25
9,4,unless,6,656,1,5,5.75
9,4,up,2,657,1,1,0.5
9,4,upwards,7,658,2,5,1.5
9,4,used,4,659,1,3,3
9,4,user,4,660,3,1,0.75
9,4,versus,6,661,0,6,1.75
9,4,very,4,662,3,1,0.5
9,4,vitamin,7,663,1,6,5.75
9,4,volume,6,664,1,5,1.75
9,4,voluntary,9,665,4,5,2
9,4,vote,4,666,2,2,1
9,4,wage,4,667,0,4,5.75
9,4,wall,4,668,2,2,0.75
9,4,ward,4,669,2,2,0.75
9,4,warehouse,9,670,3,6,2
9,4,warfare,7,671,3,4,5.75
9,4,wash,4,672,2,2,0.75
9,4,we,2,673,1,1,0.5
9,4,web,3,674,2,1,0.5
9,4,well,4,675,2,2,0.75
9,4,when,4,676,1,3,1
9,4,while,5,677,2,3,5.25
9,4,whisper,7,678,3,4,1.5
9,4,whole,5,679,2,3,1
9,4,wholly,6,680,4,2,1
9,4,wide,4,681,1,3,5
9,4,winner,6,682,2,4,1.5
9,4,winter,6,683,3,3,1.25
9,4,wise,4,684,2,2,0.75
9,4,wish,4,685,3,1,0.5
9,4,withdraw,8,686,2,6,6
9,4,worldwide,9,687,1,8,2.25
9,4,wound,5,688,2,3,5.25
9,4,writing,7,689,1,6,1.75
9,4,wrong,5,690,2,3,1
9,4,yell,4,691,0,4,5.25
9,4,yesterday,9,692,2,7,2.25
9,4,yours,5,693,1,4,1.25
9,4,yourself,8,694,5,3,5.5
9,4,zone,4,695,0,4,1.25
9,5,ability,7,0,0,7,6
9,5,abortion,8,1,2,6,2
9,5,about,5,2,3,2,1
9,5,accent,6,3,1,5,5.5
9,5,access,6,4,4,2,1
9,5,account,7,5,3,4,1.25
9,5,acquire,7,6,2,5,1.5
9,5,adhere,6,7,1,5,5.75
9,5,advanced,8,8,2,6,2
9,5,affection,9,9,1,8,6.5
9,5,afford,6,10,3,3,1.25
9,5,aged,4,11,1,3,1
9,5,air,3,12,1,2,0.5
9,5,aircraft,8,13,3,5,6.25
9,5,alien,5,14,1,4,1.25
9,5,alignment,9,15,3,6,6.25
9,5,allegedly,9,16,2,7,2.25
9,5,alliance,8,17,3,5,1.75
9,5,alone,5,18,2,3,5.5
9,5,along,5,19,4,1,0.75
9,5,also,4,20,2,2,0.75
9,5,ambitious,9,21,1,8,2.5
9,5,angel,5,22,1,4,5.5
9,5,angry,5,23,3,2,1
9,5,anyone,6,24,2,4,1.25
9,5,anything,8,25,3,5,6.25
9,5,apple,5,26,1,4,1.25
9,5,archive,7,27,1,6,1.75
9,5,arena,5,28,2,3,5.25
9,5,array,5,29,2,3,1.25
9,5,article,7,30,2,5,1.5
9,5,assess,6,31,1,5,1.5
9,5,assign,6,32,3,3,5.5
9,5,athlete,7,33,1,6,1.75
9,5,attach,6,34,2,4,1.5
9,5,attend,6,35,3,3,5.5
9,5,attribute,9,36,3,6,2
9,5,authority,9,37,1,8,6.5
9,5,avoid,5,38,1,4,1.25
9,5,aware,5,39,1,4,1.25
9,5,backdrop,8,40,0,8,7
9,5,backwards,9,41,4,5,2
9,5,bad,3,42,2,1,0.5
9,5,ballot,6,43,2,4,6.5
9,5,banana,6,44,2,4,1.5
9,5,bank,4,45,3,1,0.75
9,5,bare,4,46,2,2,0.75
9,5,basis,5,47,2,3,1
9,5,basket,6,48,3,3,6
9,5,bean,4,49,1,3,1
9,5,because,7,50,2,5,1.5
9,5,become,6,51,3,3,1.25
9,5,bee,3,52,2,1,5
9,5,before,6,53,2,4,1.5
9,5,behind,6,54,2,4,1.5
9,5,being,5,55,2,3,1
9,5,beneath,7,56,2,5,5.75
9,5,beside,6,57,2,4,1.5
9,5,bicycle,7,58,1,6,1.75
9,5,big,3,59,2,1,4.75
9,5,biology,7,60,2,5,1.75
9,5,blast,5,61,1,4,1.25
9,5,bleed,5,62,2,3,1
9,5,blend,5,63,3,2,5.25
9,5,blessing,8,64,3,5,1.75
9,5,blood,5,65,2,3,1
9,5,body,4,66,1,3,1
9,5,bond,4,67,2,2,6
9,5,bonus,5,68,3,2,1.25
9,5,booking,7,69,2,5,1.75
9,5,born,4,70,2,2,0.75
9,5,brain,5,71,1,4,6
9,5,breath,6,72,2,4,1.25
9,5,brick,5,73,2,3,1
9,5,brilliant,9,74,3,6,2
9,5,broadband,9,75,2,7,6.5
9,5,broadcast,9,76,5,4,1.5
9,5,broadly,7,77,5,2,1
9,5,brown,5,78,3,2,5.25
9,5,buck,4,79,1,3,1
9,5,building,8,80,2,6,1.75
9,5,bulk,4,81,2,2,0.75
9,5,burial,6,82,2,4,5.5
9,5,burst,5,83,3,2,1
9,5,but,3,84,2,1,0.5
9,5,cabin,5,85,0,5,1.5
9,5,cabinet,7,86,5,2,0.75
9,5,captain,7,87,2,5,6.25
9,5,carriage,8,88,2,6,2.25
9,5,case,4,89,2,2,0.75
9,5,castle,6,90,3,3,5.5
9,5,catch,5,91,2,3,1.25
9,5,cause,5,92,2,3,1
9,5,cautious,8,93,3,5,1.75
9,5,centre,6,94,1,5,7.5
9,5,champion,8,95,1,7,2.5
9,5,chance,6,96,3,3,6
9,5,chaos,5,97,3,2,1
9,5,cheek,5,98,2,3,1
9,5,clarify,7,99,1,6,1.75
9,5,classic,7,100,3,4,6.25
9,5,classical,9,101,7,2,1
9,5,classify,8,102,6,2,1
9,5,cleaning,8,103,2,6,1.75
9,5,climate,7,104,2,5,9.5
9,5,climb,5,105,4,1,1.25
9,5,cling,5,106,3,2,1.75
9,5,clip,4,107,3,1,1.25
9,5,close,5,108,2,3,2.25
9,5,coastal,7,109,1,6,11
9,5,cocktail,8,110,2,6,4
9,5,cognitive,9,111,2,7,12
9,5,coin,4,112,2,2,1.5
9,5,collapse,8,113,2,6,4.25
9,5,combat,6,114,2,4,10
9,5,comic,5,115,3,2,2
9,5,commerce,8,116,3,5,3.75
9,5,compare,7,117,3,4,3
9,5,complaint,9,118,4,5,11.25
9,5,concerned,9,119,2,7,4.75
9,5,concrete,8,120,4,4,10.5
9,5,consensus,9,121,3,6,4.25
9,5,conserve,8,122,5,3,2.75
9,5,consist,7,123,4,3,9.75
9,5,construct,9,124,4,5,4
9,5,consumer,8,125,4,4,3
9,5,contact,7,126,3,4,10
9,5,contest,7,127,4,3,2.5
9,5,continue,8,128,4,4,3.25
9,5,convert,7,129,3,4,3
9,5,convict,7,130,4,3,9.75
9,5,cool,4,131,2,2,1.5
9,5,correlate,9,132,2,7,4.75
9,5,costume,7,133,2,5,12.5
9,5,cotton,6,134,2,4,3.5
9,5,council,7,135,2,5,4.25
9,5,covered,7,136,2,5,12.75
9,5,crazy,5,137,1,4,3.25
9,5,creation,8,138,2,6,4.25
9,5,creative,8,139,6,2,10
9,5,creator,7,140,5,2,2.5
9,5,crystal,7,141,2,5,3.5
9,5,cult,4,142,1,3,2
9,5,dark,4,143,0,4,9.75
9,5,data,4,144,2,2,1.75
9,5,daughter,8,145,2,6,4.25
9,5,dear,4,146,1,3,2.25
9,5,debate,6,147,2,4,10.25
9,5,debut,5,148,3,2,2
9,5,decision,8,149,2,6,4.25
9,5,dedicated,9,150,2,7,12
9,5,defend,6,151,2,4,3
9,5,defy,4,152,3,1,1.25
9,5,delivery,8,153,2,6,11.75
9,5,denial,6,154,2,4,3
9,5,depart,6,155,2,4,2.75
9,5,depend,6,156,3,3,2.5
9,5,dependent,9,157,6,3,10.5
9,5,derive,6,158,2,4,3
9,5,descend,7,159,2,5,3.5
9,5,desire,6,160,3,3,10
9,5,destroy,7,161,3,4,3.25
9,5,detection,9,162,2,7,5.25
9,5,diary,5,163,1,4,10
9,5,die,3,164,2,1,1
9,5,differ,6,165,2,4,2.75
9,5,different,9,166,6,3,2.5
9,5,dimension,9,167,2,7,15.75
9,5,dip,3,168,2,1,1
9,5,direction,9,169,2,7,4.75
9,5,directly,8,170,6,2,9.5
9,5,directory,9,171,6,3,3.25
9,5,disease,7,172,2,5,3.5
9,5,disorder,8,173,3,5,3.75
9,5,distance,8,174,3,5,10.75
9,5,distract,8,175,4,4,3.25
9,5,disturb,7,176,4,3,2.5
9,5,diverse,7,177,2,5,10.5
9,5,divorce,7,178,3,4,3.25
9,5,dog,3,179,1,2,1.5
9,5,dominance,9,180,2,7,24
9,5,dominate,8,181,6,2,309.25
9,5,dozen,5,182,2,3,1.5
9,5,drag,4,183,1,3,1.25
9,5,dramatic,8,184,3,5,2.25
9,5,driver,6,185,2,4,8
9,5,drown,5,186,2,3,2.5
9,5,drug,4,187,2,2,1
9,5,dry,3,188,2,1,0.75
9,5,due,3,189,1,2,1
9,5,dump,4,190,2,2,1.75
9,5,dynamic,7,191,1,6,13.5
9,5,easily,6,192,0,6,6.75
9,5,east,4,193,3,1,2
9,5,eastern,7,194,4,3,12.75
9,5,echo,4,195,1,3,3
9,5,economy,7,196,2,5,4
9,5,edge,4,197,1,3,10.25
9,5,editorial,9,198,2,7,8
9,5,education,9,199,2,7,17
9,5,election,8,200,1,7,6.25
9,5,electoral,9,201,5,4,4.5
9,5,embed,5,202,1,4,19.5
9,5,empire,6,203,2,4,3.25
9,5,encourage,9,204,1,8,23
9,5,enquire,7,205,2,5,4.5
9,5,ensue,5,206,2,3,2.5
9,5,entity,6,207,2,4,3.5
9,5,epidemic,8,208,1,7,10.75
9,5,era,3,209,1,2,1.5
9,5,error,5,210,2,3,2.5
9,5,eternal,7,211,1,6,10
9,5,ethical,7,212,2,5,5.25
9,5,everybody,9,213,1,8,13.5
9,5,everyday,8,214,5,3,2.75
9,5,evil,4,215,2,2,1.75
9,5,evolve,6,216,2,4,3.25
9,5,exam,4,217,1,3,8
9,5,example,7,218,4,3,2.5
9,5,except,6,219,2,4,2.75
9,5,exert,5,220,2,3,2.25
9,5,explicit,8,221,2,6,10.25
9,5,explosion,9,222,4,5,4
9,5,external,8,223,2,6,10.25
9,5,extra,5,224,3,2,1.75
9,5,extract,7,225,5,2,2
9,5,fabulous,8,226,0,8,5
9,5,facility,8,227,2,6,10.25
9,5,fact,4,228,3,1,1.25
9,5,faction,7,229,4,3,3
9,5,faith,5,230,2,3,2.5
9,5,fame,4,231,2,2,7.5
9,5,familiar,8,232,3,5,3.75
9,5,farm,4,233,2,2,1.75
9,5,feature,7,234,1,6,10
9,5,feeling,7,235,2,5,3.5
9,5,festival,8,236,2,6,4
9,5,fifth,5,237,1,4,8.25
9,5,film,4,238,2,2,1.75
9,5,final,5,239,2,3,2.25
9,5,finger,6,240,3,3,2.5
9,5,fire,4,241,2,2,1.75
9,5,firearm,7,242,4,3,8.5
9,5,firework,8,243,4,4,3.5
9,5,first,5,244,3,2,2
9,5,five,4,245,2,2,1.75
9,5,flash,5,246,1,4,8.75
9,5,flaw,4,247,3,1,1.25
9,5,flawed,6,248,4,2,1.75
9,5,fleet,5,249,2,3,2.25
9,5,float,5,250,2,3,2.25
9,5,flood,5,251,3,2,1.75
9,5,flour,5,252,3,2,8
9,5,follow,6,253,1,5,3.5
9,5,following,9,254,6,3,2.75
9,5,fond,4,255,2,2,1.75
9,5,forecast,8,256,2,6,9.75
9,5,formal,6,257,3,3,2.5
9,5,format,6,258,5,1,1.5
9,5,forth,5,259,3,2,1.75
9,5,frame,5,260,1,4,8
9,5,framework,9,261,5,4,3.25
9,5,franchise,9,262,3,6,4.25
9,5,freely,6,263,2,4,8.5
9,5,freeze,6,264,4,2,2
9,5,from,4,265,2,2,1.75
9,5,fruit,5,266,2,3,2.25
9,5,fully,5,267,1,4,2.75
9,5,function,8,268,2,6,9.5
9,5,fund,4,269,3,1,1.25
9,5,gambling,8,270,0,8,5
9,5,gang,4,271,2,2,7.5
9,5,generous,8,272,1,7,4.5
9,5,get,3,273,2,1,1.25
9,5,ghost,5,274,1,4,8
9,5,goal,4,275,1,3,2.25
9,5,golden,6,276,2,4,3
9,5,gradually,9,277,1,8,10.5
9,5,grand,5,278,3,2,2
9,5,greatly,7,279,2,5,3.5
9,5,half,4,280,0,4,2.5
9,5,happy,5,281,2,3,7.75
9,5,hardly,6,282,2,4,2.75
9,5,hardware,8,283,4,4,3.25
9,5,harmful,7,284,3,4,8.5
9,5,he,2,285,1,1,0.75
9,5,hearing,7,286,2,5,3.5
9,5,heating,7,287,3,4,3
9,5,heavily,7,288,3,4,8.75
9,5,hello,5,289,2,3,2.25
9,5,here,4,290,2,2,1.5
9,5,hidden,6,291,1,5,3.25
9,5,hierarchy,9,292,2,7,10.5
9,5,hill,4,293,2,2,1.75
9,5,himself,7,294,2,5,3.5
9,5,historian,9,295,2,7,10.5
9,5,history,7,296,6,1,1.5
9,5,hockey,6,297,1,5,3.5
9,5,homeless,8,298,2,6,10.25
9,5,homework,8,299,4,4,3.25
9,5,honour,6,300,2,4,2.75
9,5,hook,4,301,2,2,7
9,5,hostile,7,302,2,5,3.5
9,5,hostility,9,303,6,3,2.75
9,5,house,5,304,2,3,2.25
9,5,housing,7,305,4,3,8.75
9,5,hungry,6,306,1,5,3.25
9,5,hurry,5,307,2,3,2.25
9,5,husband,7,308,2,5,9
9,5,ideology,8,309,0,8,5
9,5,illness,7,310,1,6,9.75
9,5,imagine,7,311,1,6,4
9,5,impact,6,312,2,4,3
9,5,impress,7,313,3,4,8.75
9,5,in,2,314,1,1,1
9,5,incidence,9,315,2,7,5
9,5,including,9,316,3,6,11.75
9,5,increase,8,317,3,5,3.75
9,5,indeed,6,318,2,4,3
9,5,indicator,9,319,3,6,10.5
9,5,induce,6,320,3,3,2.5
9,5,indulge,7,321,4,3,2.75
9,5,inflation,9,322,2,7,10.75
9,5,initial,7,323,2,5,3.5
9,5,injured,7,324,2,5,3.5
9,5,inmate,6,325,2,4,8.5
9,5,input,5,326,2,3,2.25
9,5,insider,7,327,2,5,3.75
9,5,insult,6,328,3,3,8.25
9,5,intensity,9,329,2,7,4.75
9,5,intention,9,330,5,4,3.25
9,5,interact,8,331,4,4,8.75
9,5,interface,9,332,5,4,3.25
9,5,interpret,9,333,5,4,3.5
9,5,interrupt,9,334,5,4,9.5
9,5,interview,9,335,5,4,3.25
9,5,invent,6,336,2,4,2.75
9,5,invisible,9,337,3,6,9.75
9,5,invoke,6,338,3,3,1.5
9,5,isolation,9,339,1,8,2.75
9,5,jam,3,340,0,3,4.5
9,5,jeans,5,341,1,4,1.25
9,5,july,4,342,1,3,1
9,5,justice,7,343,2,5,5.25
9,5,keen,4,344,0,4,1.25
9,5,kind,4,345,1,3,1
9,5,kiss,4,346,2,2,1
9,5,lady,4,347,0,4,4.5
9,5,landlord,8,348,2,6,2.25
9,5,lane,4,349,3,1,0.75
9,5,language,8,350,3,5,2
9,5,laptop,6,351,2,4,5
9,5,late,4,352,2,2,1
9,5,lawyer,6,353,2,4,1.5
9,5,layout,6,354,2,4,1.25
9,5,leap,4,355,1,3,4.75
9,5,leisure,7,356,2,5,1.75
9,5,lend,4,357,2,2,0.75
9,5,length,6,358,3,3,1.25
9,5,lesson,6,359,2,4,5
9,5,let,3,360,2,1,0.5
9,5,lifetime,8,361,1,7,2
9,5,light,5,362,2,3,4.75
9,5,likewise,8,363,2,6,2
9,5,linger,6,364,2,4,1.25
9,5,listener,8,365,2,6,5.5
9,5,literacy,8,366,2,6,1.75
9,5,lively,6,367,2,4,1.25
9,5,loan,4,368,1,3,4.75
9,5,lobby,5,369,2,3,1
9,5,logic,5,370,2,3,1
9,5,loop,4,371,2,2,0.75
9,5,lord,4,372,2,2,0.75
9,5,lose,4,373,2,2,4.25
9,5,lost,4,374,3,1,0.75
9,5,lovely,6,375,2,4,1.25
9,5,lower,5,376,2,3,1
9,5,luck,4,377,1,3,1
9,5,magazine,8,378,0,8,5.75
9,5,magical,7,379,3,4,1.25
9,5,mall,4,380,2,2,0.75
9,5,marketing,9,381,2,7,5.75
9,5,marriage,8,382,3,5,1.75
9,5,massive,7,383,2,5,5
9,5,matching,8,384,2,6,1.75
9,5,mate,4,385,3,1,0.5
9,5,maximize,8,386,2,6,5.5
9,5,mayor,5,387,2,3,1
9,5,me,2,388,1,1,0.5
9,5,measure,7,389,2,5,1.5
9,5,mechanism,9,390,2,7,5.75
9,5,medicine,8,391,2,6,1.75
9,5,menu,4,392,2,2,0.75
9,5,metal,5,393,2,3,4.75
9,5,metaphor,8,394,4,4,1.5
9,5,mile,4,395,1,3,1
9,5,militant,8,396,3,5,6.75
9,5,mill,4,397,3,1,1
9,5,minor,5,398,2,3,2
9,5,minute,6,399,3,3,1.5
9,5,missile,7,400,2,5,6.75
9,5,mistake,7,401,3,4,1.75
9,5,modern,6,402,1,5,1.75
9,5,modest,6,403,4,2,1
9,5,monitor,7,404,2,5,6.25
9,5,moral,5,405,2,3,1
9,5,morality,8,406,5,3,1.25
9,5,motor,5,407,2,3,1
9,5,mount,5,408,2,3,5
9,5,musical,7,409,1,6,1.75
9,5,mutual,6,410,2,4,1.5
9,5,myself,6,411,1,5,5.75
9,5,nail,4,412,0,4,1.25
9,5,national,8,413,2,6,2
9,5,necessity,9,414,1,8,6
9,5,neglect,7,415,2,5,1.75
9,5,nerve,5,416,2,3,4.75
9,5,nest,4,417,2,2,0.75
9,5,net,3,418,2,1,0.5
9,5,news,4,419,2,2,0.75
9,5,next,4,420,2,2,0.75
9,5,nineteen,8,421,1,7,5.75
9,5,ninety,6,422,5,1,0.75
9,5,noble,5,423,1,4,1.25
9,5,nose,4,424,2,2,0.75
9,5,notably,7,425,2,5,5.5
9,5,now,3,426,2,1,0.5
9,5,nowadays,8,427,3,5,1.75
9,5,number,6,428,1,5,1.5
9,5,nutrition,9,429,2,7,6
9,5,o,1,430,0,1,0.25
9,5,obey,4,431,1,3,1
9,5,object,6,432,2,4,5
9,5,observer,8,433,2,6,1.75
9,5,obsession,9,434,4,5,1.75
9,5,obtain,6,435,2,4,5
9,5,obvious,7,436,2,5,1.5
9,5,occasion,8,437,1,7,6
9,5,occur,5,438,3,2,1
9,5,offer,5,439,1,4,1.25
9,5,offering,8,440,5,3,1
9,5,on,2,441,1,1,0.25
9,5,ongoing,7,442,2,5,5.25
9,5,open,4,443,1,3,1
9,5,opinion,7,444,2,5,1.5
9,5,ordinary,8,445,1,7,5.75
9,5,our,3,446,1,2,0.75
9,5,out,3,447,2,1,0.5
9,5,outrage,7,448,3,4,1.25
9,5,own,3,449,1,2,0.75
9,5,owner,5,450,3,2,4.5
9,5,oxygen,6,451,1,5,1.5
9,5,pair,4,452,0,4,1
9,5,parish,6,453,2,4,5.25
9,5,partly,6,454,3,3,1.25
9,5,party,5,455,4,1,0.75
9,5,pass,4,456,2,2,0.75
9,5,passage,7,457,4,3,1
9,5,passion,7,458,4,3,1
9,5,payment,7,459,2,5,5.25
9,5,penalty,7,460,1,6,1.75
9,5,pension,7,461,3,4,5.5
9,5,permanent,9,462,2,7,2.25
9,5,persuade,8,463,3,5,1.75
9,5,petition,8,464,2,6,5.75
9,5,pill,4,465,1,3,1
9,5,pilot,5,466,3,2,0.75
9,5,pink,4,467,2,2,0.75
9,5,pitch,5,468,2,3,4.75
9,5,plain,5,469,1,4,1.25
9,5,planet,6,470,3,3,1
9,5,player,6,471,3,3,1
9,5,plug,4,472,2,2,4.5
9,5,poet,4,473,1,3,1
9,5,poetry,6,474,4,2,0.75
9,5,poisonous,9,475,2,7,2
9,5,policy,6,476,2,4,4.75
9,5,positive,8,477,2,6,1.75
9,5,potential,9,478,2,7,6
9,5,powerful,8,479,2,6,1.75
9,5,practice,8,480,1,7,5.75
9,5,pray,4,481,3,1,0.5
9,5,preach,6,482,2,4,1.5
9,5,precede,7,483,3,4,1.25
9,5,prefer,6,484,3,3,5
9,5,premium,7,485,3,4,1.5
9,5,prepare,7,486,3,4,1.25
9,5,president,9,487,3,6,5.75
9,5,prey,4,488,3,1,0.75
9,5,priest,6,489,2,4,1.25
9,5,primarily,9,490,3,6,2
9,5,princess,8,491,3,5,5.5
9,5,prison,6,492,3,3,1
9,5,prisoner,8,493,6,2,0.75
9,5,probable,8,494,2,6,5.5
9,5,provoke,7,495,3,4,1.5
9,5,punch,5,496,1,4,1.25
9,5,purely,6,497,2,4,3.25
9,5,qualify,7,498,0,7,4
9,5,quarter,7,499,3,4,1.5
9,5,queue,5,500,2,3,4.75
9,5,quickly,7,501,2,5,1.5
9,5,quietly,7,502,3,4,1.25
9,5,quote,5,503,2,3,1
9,5,radio,5,504,0,5,5.25
9,5,rain,4,505,2,2,0.75
9,5,random,6,506,2,4,1.25
9,5,range,5,507,3,2,0.75
9,5,rapid,5,508,2,3,4.5
9,5,rare,4,509,2,2,0.75
9,5,raw,3,510,2,1,0.5
9,5,read,4,511,1,3,0.75
9,5,reader,6,512,4,2,0.75
9,5,readily,7,513,4,3,1
9,5,real,4,514,3,1,4.25
9,5,receiver,8,515,2,6,1.75
9,5,recession,9,516,4,5,2
9,5,recovery,8,517,3,5,5.75
9,5,refuge,6,518,2,4,1.25
9,5,register,8,519,2,6,1.75
9,5,regret,6,520,3,3,5
9,5,reinforce,9,521,2,7,2
9,5,rental,6,522,2,4,5
9,5,reproduce,9,523,2,7,2.25
9,5,response,8,524,2,6,1.75
9,5,restraint,9,525,3,6,5.75
9,5,rice,4,526,1,3,1
9,5,riot,4,527,2,2,0.75
9,5,risk,4,528,2,2,0.75
9,5,romantic,8,529,1,7,6
9,5,rule,4,530,1,3,1
9,5,salary,6,531,0,6,6
9,5,sanction,8,532,2,6,2.25
9,5,say,3,533,2,1,0.5
9,5,scale,5,534,1,4,1.25
9,5,scope,5,535,2,3,5
9,5,scream,6,536,2,4,1.25
9,5,section,7,537,1,6,1.75
9,5,see,3,538,2,1,0.5
9,5,seldom,6,539,2,4,5
9,5,self,4,540,3,1,0.5
9,5,send,4,541,2,2,0.75
9,5,sensation,9,542,3,6,2
9,5,sensitive,9,543,4,5,6
9,5,sentence,8,544,3,5,1.75
9,5,session,7,545,2,5,5.5
9,5,set,3,546,2,1,0.5
9,5,seventeen,9,547,2,7,2
9,5,seventy,7,548,6,1,1
9,5,sex,3,549,2,1,1
9,5,shall,5,550,1,4,8.75
9,5,shaped,6,551,3,3,2.5
9,5,shine,5,552,2,3,2.25
9,5,shocking,8,553,2,6,10.25
9,5,short,5,554,3,2,2
9,5,should,6,555,3,3,2.5
9,5,shout,5,556,4,1,1.25
9,5,show,4,557,3,1,1
9,5,shrink,6,558,2,4,2.75
9,5,shrug,5,559,3,2,2
9,5,sigh,4,560,1,3,8.75
9,5,silence,7,561,2,5,3.5
9,5,sincere,7,562,2,5,3.75
9,5,sing,4,563,3,1,8
9,5,sir,3,564,2,1,1
9,5,situation,9,565,2,7,5
9,5,size,4,566,2,2,1.5
9,5,skiing,6,567,1,5,9.5
9,5,skill,5,568,3,2,1.75
9,5,sky,3,569,2,1,1
9,5,slave,5,570,1,4,2.75
9,5,sleep,5,571,2,3,2.25
9,5,slogan,6,572,2,4,9.25
9,5,small,5,573,1,4,2.75
9,5,smart,5,574,3,2,1.75
9,5,snap,4,575,1,3,2
9,5,soak,4,576,1,3,8.5
9,5,socialist,9,577,2,7,5
9,5,soldier,7,578,2,5,3.5
9,5,somewhere,9,579,2,7,11.25
9,5,son,3,580,2,1,1
9,5,soon,4,581,2,2,1.5
9,5,sorry,5,582,2,3,2.25
9,5,source,6,583,2,4,9.75
9,5,span,4,584,1,3,2.25
9,5,spending,8,585,2,6,4.25
9,5,spill,5,586,2,3,8.75
9,5,split,5,587,2,3,2.25
9,5,spoil,5,588,2,3,2.25
9,5,sponsor,7,589,3,4,3
9,5,spoon,5,590,3,2,8.25
9,5,sport,5,591,3,2,2
9,5,spot,4,592,3,1,1.25
9,5,squeeze,7,593,1,6,4
9,5,stabilize,9,594,1,8,11.5
9,5,stadium,7,595,3,4,3
9,5,statement,9,596,3,6,11.25
9,5,status,6,597,4,2,2
9,5,steel,5,598,2,3,2.25
9,5,stimulate,9,599,2,7,4.75
9,5,stunning,8,600,2,6,10.5
9,5,style,5,601,2,3,2.5
9,5,suddenly,8,602,1,7,11.5
9,5,suffer,6,603,2,4,3
9,5,superior,8,604,2,6,4.25
9,5,suppress,8,605,3,5,10.5
9,5,surface,7,606,2,5,3.5
9,5,surge,5,607,3,2,1.75
9,5,surprised,9,608,3,6,11
9,5,surrender,9,609,3,6,4.25
9,5,sustain,7,610,2,5,10
9,5,sweet,5,611,1,4,2.75
9,5,swing,5,612,2,3,2.25
9,5,talented,8,613,0,8,11.5
9,5,tax,3,614,2,1,1
9,5,teach,5,615,1,4,2.75
9,5,technical,9,616,2,7,11.25
9,5,tennis,6,617,2,4,3
9,5,terminal,8,618,2,6,4
9,5,testify,7,619,2,5,10
9,5,testing,7,620,5,2,2.25
9,5,text,4,621,2,2,1.75
9,5,theft,5,622,1,4,2.75
9,5,their,5,623,3,2,2
9,5,theirs,6,624,5,1,1.5
9,5,then,4,625,3,1,8.5
9,5,therefore,9,626,3,6,4.25
9,5,they,4,627,3,1,1.25
9,5,thick,5,628,2,3,2.5
9,5,thief,5,629,3,2,1.75
9,5,think,5,630,3,2,9.25
9,5,thinking,8,631,5,3,3
9,5,third,5,632,3,2,2.75
9,5,though,6,633,2,4,3.25
9,5,thrive,6,634,2,4,9.5
9,5,throat,6,635,3,3,2.5
9,5,throw,5,636,4,1,1.5
9,5,thursday,8,637,2,6,4
9,5,timber,6,638,1,5,10.25
9,5,tiny,4,639,2,2,1.75
9,5,tired,5,640,2,3,2.25
9,5,tobacco,7,641,1,6,10.5
9,5,ton,3,642,2,1,1
9,5,touch,5,643,2,3,2.25
9,5,tourist,7,644,3,4,3
9,5,towel,5,645,2,3,2.25
9,5,trading,7,646,1,6,10.25
9,5,tradition,9,647,5,4,3.25
9,5,tribunal,8,648,2,6,10.75
9,5,trillion,8,649,3,5,3.75
9,5,troubled,8,650,2,6,4
9,5,trust,5,651,2,3,8.75
9,5,tuesday,7,652,1,6,4
9,5,turn,4,653,2,2,1.75
9,5,twenty,6,654,1,5,10.25
9,5,type,4,655,1,3,2.25
9,5,ugly,4,656,0,4,2.5
9,5,umbrella,8,657,1,7,11.5
9,5,unfold,6,658,1,5,3.25
9,5,unless,6,659,2,4,3
9,5,upper,5,660,1,4,9.5
9,5,upwards,7,661,2,5,3.75
9,5,us,2,662,1,1,0.75
9,5,use,3,663,2,1,1
9,5,user,4,664,3,1,1
9,5,utterly,7,665,1,6,10.5
9,5,valid,5,666,0,5,3.25
9,5,variation,9,667,2,7,4.75
9,5,very,4,668,1,3,9.75
9,5,victim,6,669,1,5,3.5
9,5,village,7,670,2,5,3.5
9,5,violation,9,671,2,7,11.75
9,5,vitamin,7,672,2,5,3.5
9,5,volume,6,673,1,5,10.25
9,5,vote,4,674,2,2,1.75
9,5,wage,4,675,0,4,2.75
9,5,want,4,676,2,2,1.75
9,5,warfare,7,677,2,5,10.25
9,5,we,2,678,1,1,0.75
9,5,weak,4,679,2,2,1.5
9,5,wear,4,680,3,1,1.25
9,5,week,4,681,2,2,1.5
9,5,well,4,682,2,2,1.5
9,5,wide,4,683,1,3,5.25
9,5,widely,6,684,4,2,6
9,5,winter,6,685,2,4,3
9,5,wise,4,686,2,2,1.75
9,5,wish,4,687,3,1,1.25
9,5,withdraw,8,688,2,6,11
9,5,workout,7,689,1,6,4
9,5,worse,5,690,3,2,1.75
9,5,worst,5,691,4,1,1.5
9,5,wound,5,692,2,3,9.25
9,5,wrong,5,693,1,4,2.75
9,5,yours,5,694,0,5,3.25
9,5,yourself,8,695,5,3,2.25
9,6,ability,7,0,0,7,4.5
9,6,able,4,1,2,2,1.75
9,6,above,5,2,2,3,8.75
9,6,academy,7,3,1,6,4
9,6,accent,6,4,2,4,3
9,6,account,7,5,3,4,9.75
9,6,accuracy,8,6,3,5,3.75
9,6,action,6,7,2,4,2.75
9,6,addition,8,8,1,7,12.5
9,6,adult,5,9,2,3,2.25
9,6,advertise,9,10,2,7,4.75
9,6,afford,6,11,1,5,11
9,6,aid,3,12,1,2,1.5
9,6,alert,5,13,1,4,2.75
9,6,alien,5,14,2,3,8.5
9,6,alike,5,15,3,2,1.25
9,6,all,3,16,2,1,0.75
9,6,allege,6,17,3,3,1.25
9,6,alliance,8,18,3,5,1.75
9,6,alone,5,19,2,3,5.5
9,6,also,4,20,2,2,1
9,6,ambitious,9,21,1,8,2.5
9,6,anyone,6,22,1,5,6.25
9,6,arbitrary,9,23,1,8,2.5
9,6,archive,7,24,2,5,5.75
9,6,armed,5,25,2,3,1.25
9,6,array,5,26,2,3,1
9,6,article,7,27,2,5,1.75
9,6,assess,6,28,1,5,6
9,6,assign,6,29,3,3,1.25
9,6,attempt,7,30,1,6,1.75
9,6,attorney,8,31,3,5,6
9,6,attribute,9,32,3,6,2
9,6,audience,8,33,1,7,6.5
9,6,audit,5,34,4,1,0.75
9,6,august,6,35,2,4,1.5
9,6,author,6,36,2,4,1.25
9,6,autumn,6,37,3,3,6
9,6,away,4,38,1,3,1
9,6,backdrop,8,39,0,8,6.5
9,6,backwards,9,40,4,5,1.75
9,6,bake,4,41,2,2,0.75
9,6,banana,6,42,2,4,1.25
9,6,basis,5,43,2,3,5.75
9,6,bean,4,44,1,3,1
9,6,because,7,45,2,5,1.75
9,6,become,6,46,3,3,1.25
9,6,beef,4,47,2,2,5.25
9,6,behind,6,48,2,4,1.5
9,6,beneath,7,49,2,5,1.5
9,6,bent,4,50,3,1,0.5
9,6,beside,6,51,2,4,5.5
9,6,bet,3,52,2,1,0.5
9,6,bicycle,7,53,1,6,1.75
9,6,big,3,54,2,1,0.5
9,6,blanket,7,55,1,6,6
9,6,blast,5,56,3,2,1
9,6,blend,5,57,2,3,1.25
9,6,blood,5,58,2,3,1
9,6,body,4,59,1,3,1
9,6,bond,4,60,2,2,5.5
9,6,bonus,5,61,3,2,1
9,6,booking,7,62,2,5,1.5
9,6,born,4,63,2,2,0.75
9,6,bounce,6,64,2,4,6
9,6,breast,6,65,1,5,1.5
9,6,breath,6,66,4,2,1
9,6,brick,5,67,2,3,1
9,6,broad,5,68,2,3,5.25
9,6,broadband,9,69,5,4,1.75
9,6,broadcast,9,70,5,4,1.75
9,6,broadly,7,71,5,2,1
9,6,brown,5,72,3,2,1
9,6,building,8,73,1,7,6.5
9,6,burst,5,74,2,3,1.25
9,6,bus,3,75,2,1,0.5
9,6,busy,4,76,3,1,0.5
9,6,calm,4,77,0,4,5.75
9,6,camp,4,78,2,2,1
9,6,cat,3,79,2,1,0.5
9,6,catch,5,80,3,2,0.75
9,6,cause,5,81,2,3,1
9,6,caution,7,82,3,4,5.75
9,6,chance,6,83,1,5,1.75
9,6,chaos,5,84,3,2,1
9,6,charge,6,85,3,3,1.25
9,6,chat,4,86,3,1,0.5
9,6,chef,4,87,2,2,8.75
9,6,chest,5,88,3,2,103.25
9,6,civic,5,89,1,4,1.75
9,6,climate,7,90,1,6,5.25
9,6,climb,5,91,4,1,1.75
9,6,clinic,6,92,3,3,8.75
9,6,clock,5,93,2,3,2.75
9,6,close,5,94,3,2,2.5
9,6,cloth,5,95,3,2,1.5
9,6,clothes,7,96,5,2,1.5
9,6,cocktail,8,97,1,7,7
9,6,collapse,8,98,2,6,3.75
9,6,collision,9,99,4,5,6.5
9,6,colour,6,100,3,3,1.5
9,6,coloured,8,101,6,2,1.25
9,6,comic,5,102,2,3,1.5
9,6,commander,9,103,3,6,6.75
9,6,commerce,8,104,4,4,2
9,6,common,6,105,4,2,1.5
9,6,communist,9,106,4,5,2.25
9,6,compare,7,107,3,4,6.25
9,6,complain,8,108,4,4,2.25
9,6,complex,7,109,5,2,1.5
9,6,compose,7,110,4,3,1.75
9,6,comprise,8,111,4,4,11.25
9,6,computer,8,112,4,4,3.25
9,6,conclude,8,113,2,6,6
9,6,confident,9,114,3,6,9.75
9,6,conflict,8,115,4,4,2.5
9,6,construct,9,116,3,6,7.75
9,6,consume,7,117,4,3,4
9,6,contact,7,118,3,4,4.25
9,6,context,7,119,4,3,2.5
9,6,continue,8,120,4,4,8.25
9,6,contract,8,121,4,4,2.5
9,6,contrary,8,122,6,2,1.5
9,6,cook,4,123,2,2,1
9,6,cooking,7,124,4,3,1.75
9,6,cool,4,125,3,1,4.75
9,6,cooperate,9,126,3,6,2.75
9,6,council,7,127,2,5,2
9,6,countless,9,128,4,5,6.25
9,6,crack,5,129,1,4,1.25
9,6,crash,5,130,3,2,1
9,6,cream,5,131,2,3,1.25
9,6,creator,7,132,4,3,4.75
9,6,criterion,9,133,2,7,2.25
9,6,criticism,9,134,4,5,4.75
9,6,crown,5,135,2,3,1.25
9,6,cue,3,136,1,2,0.75
9,6,cult,4,137,2,2,1
9,6,custody,7,138,2,5,1.5
9,6,customer,8,139,5,3,4.25
9,6,cutting,7,140,2,5,1.5
9,6,dad,3,141,0,3,0.75
9,6,dancer,6,142,2,4,4.5
9,6,dark,4,143,2,2,0.75
9,6,daughter,8,144,2,6,2
9,6,deadline,8,145,1,7,5.25
9,6,dear,4,146,3,1,0.75
9,6,debris,6,147,2,4,1.5
9,6,deck,4,148,2,2,1
9,6,decorate,8,149,3,5,5.25
9,6,denial,6,150,2,4,1.25
9,6,depart,6,151,2,4,1.5
9,6,depend,6,152,3,3,1
9,6,desert,6,153,2,4,4.5
9,6,desperate,9,154,3,6,2
9,6,destroy,7,155,3,4,1.5
9,6,detail,6,156,2,4,4.5
9,6,detection,9,157,3,6,3
9,6,devise,6,158,2,4,3
9,6,die,3,159,1,2,6.75
9,6,different,9,160,2,7,4.75
9,6,dilemma,7,161,2,5,3.5
9,6,dimension,9,162,2,7,10.25
9,6,dip,3,163,2,1,1
9,6,direction,9,164,2,7,9.75
9,6,directly,8,165,6,2,2.5
9,6,disagree,8,166,2,6,4.5
9,6,discourse,9,167,3,6,9.5
9,6,disease,7,168,3,4,3.25
9,6,disorder,8,169,3,5,3.5
9,6,dispose,7,170,3,4,8
9,6,disrupt,7,171,3,4,3.25
9,6,distract,8,172,3,5,3.75
9,6,disturb,7,173,4,3,4.75
9,6,diversity,9,174,2,7,7.75
9,6,divert,6,175,5,1,1.5
9,6,divorce,7,176,3,4,3.25
9,6,doctrine,8,177,1,7,9.5
9,6,dog,3,178,2,1,1
9,6,dominance,9,179,2,7,7.25
9,6,door,4,180,2,2,4.75
9,6,dose,4,181,2,2,1.75
9,6,dramatic,8,182,1,7,5
9,6,draw,4,183,3,1,1.25
9,6,dress,5,184,2,3,8.5
9,6,drive,5,185,2,3,2.25
9,6,drown,5,186,2,3,2.25
9,6,drug,4,187,2,2,1.75
9,6,drum,4,188,3,1,1.25
9,6,easily,6,189,0,6,10.25
9,6,eat,3,190,2,1,1
9,6,echo,4,191,1,3,2.25
9,6,edge,4,192,1,3,2.25
9,6,editorial,9,193,2,7,11.5
9,6,educated,8,194,2,6,4.5
9,6,educator,8,195,6,2,2.5
9,6,election,8,196,1,7,13
9,6,electoral,9,197,5,4,3.5
9,6,element,7,198,3,4,11
9,6,elevate,7,199,3,4,5
9,6,else,4,200,2,2,1.75
9,6,emotional,9,201,1,8,12.75
9,6,empire,6,202,2,4,4
9,6,employ,6,203,3,3,2.75
9,6,encourage,9,204,1,8,12.25
9,6,energy,6,205,2,4,3
9,6,enough,6,206,2,4,3.25
9,6,enquire,7,207,2,5,9.5
9,6,ensue,5,208,2,3,2.5
9,6,entire,6,209,2,4,3.25
9,6,entirely,8,210,6,2,2
9,6,era,3,211,1,2,1.5
9,6,error,5,212,2,3,8
9,6,escalate,8,213,1,7,4.75
9,6,escape,6,214,4,2,2
9,6,essential,9,215,2,7,11.25
9,6,ethical,7,216,1,6,4.25
9,6,ethnic,6,217,3,3,8.75
9,6,evil,4,218,1,3,2.25
9,6,evolution,9,219,2,7,5
9,6,evolve,6,220,4,2,2
9,6,exam,4,221,1,3,7.25
9,6,example,7,222,4,3,2.5
9,6,except,6,223,2,4,3
9,6,excess,6,224,4,2,2
9,6,expect,6,225,2,4,8.25
9,6,export,6,226,3,3,2.75
9,6,exposure,8,227,4,4,4.25
9,6,external,8,228,2,6,10.75
9,6,fabulous,8,229,0,8,5.25
9,6,factor,6,230,2,4,3.25
9,6,faith,5,231,2,3,8.75
9,6,fan,3,232,2,1,1
9,6,farm,4,233,2,2,1.75
9,6,feed,4,234,1,3,2.5
9,6,feedback,8,235,4,4,3
9,6,fence,5,236,2,3,8
9,6,festival,8,237,2,6,4.25
9,6,fifth,5,238,1,4,2.75
9,6,figure,6,239,2,4,8.5
9,6,film,4,240,2,2,1.75
9,6,final,5,241,2,3,2.25
9,6,find,4,242,3,1,1
9,6,finish,6,243,3,3,2.25
9,6,fire,4,244,2,2,6.75
9,6,firework,8,245,4,4,3.5
9,6,fishing,7,246,2,5,3.5
9,6,flaw,4,247,1,3,2.25
9,6,flawed,6,248,4,2,7
9,6,flour,5,249,2,3,2.25
9,6,fold,4,250,1,3,2
9,6,follow,6,251,3,3,2.25
9,6,following,9,252,6,3,2.5
9,6,fond,4,253,2,2,7
9,6,fool,4,254,2,2,1.5
9,6,forecast,8,255,2,6,4.25
9,6,forest,6,256,4,2,2
9,6,formal,6,257,3,3,8.25
9,6,forum,5,258,3,2,2
9,6,framework,9,259,1,8,6
9,6,frankly,7,260,3,4,8.75
9,6,freely,6,261,2,4,3
9,6,freeze,6,262,4,2,2
9,6,from,4,263,2,2,1.5
9,6,function,8,264,1,7,10
9,6,fund,4,265,3,1,1.25
9,6,funny,5,266,3,2,1.75
9,6,gambling,8,267,0,8,10.25
9,6,gang,4,268,2,2,1.75
9,6,gas,3,269,2,1,1
9,6,generous,8,270,1,7,4.5
9,6,gentle,6,271,3,3,7.75
9,6,genuine,7,272,3,4,3
9,6,get,3,273,2,1,1
9,6,goal,4,274,1,3,2.25
9,6,golden,6,275,2,4,3
9,6,gorgeous,8,276,2,6,9.5
9,6,gradually,9,277,1,8,5.25
9,6,grain,5,278,3,2,7.5
9,6,grand,5,279,3,2,2
9,6,grant,5,280,4,1,1.25
9,6,grass,5,281,3,2,1.75
9,6,greatly,7,282,2,5,3.5
9,6,guard,5,283,1,4,8.25
9,6,halt,4,284,0,4,2.75
9,6,hardly,6,285,2,4,3
9,6,hatred,6,286,2,4,8.75
9,6,he,2,287,1,1,0.75
9,6,heating,7,288,2,5,3.5
9,6,heavily,7,289,3,4,3
9,6,hence,5,290,2,3,7.5
9,6,here,4,291,2,2,1.75
9,6,hero,4,292,3,1,1.25
9,6,hidden,6,293,1,5,3.5
9,6,himself,7,294,2,5,9.25
9,6,history,7,295,2,5,3.5
9,6,hold,4,296,1,3,2.25
9,6,holy,4,297,3,1,1
9,6,honour,6,298,2,4,8.25
9,6,hook,4,299,2,2,1.75
9,6,hope,4,300,2,2,1.5
9,6,hopefully,9,301,4,5,3.75
9,6,host,4,302,2,2,1.75
9,6,hostility,9,303,4,5,9.75
9,6,housing,7,304,2,5,3.5
9,6,hungry,6,305,1,5,3.5
9,6,husband,7,306,2,5,9
9,6,if,2,307,0,2,1.5
9,6,ignore,6,308,1,5,3.5
9,6,imagine,7,309,1,6,9.75
9,6,imminent,8,310,2,6,4.25
9,6,incentive,9,311,1,8,11.25
9,6,including,9,312,3,6,4.5
9,6,indoor,6,313,2,4,9
9,6,indoors,7,314,6,1,1.75
9,6,infect,6,315,2,4,3
9,6,infection,9,316,6,3,2.5
9,6,innocent,8,317,2,6,10.25
9,6,input,5,318,2,3,2.25
9,6,insider,7,319,2,5,3.5
9,6,insight,7,320,4,3,2.75
9,6,intention,9,321,2,7,10.25
9,6,interact,8,322,4,4,3.25
9,6,interrupt,9,323,5,4,7
9,6,invent,6,324,2,4,1.5
9,6,isolation,9,325,1,8,2.5
9,6,joint,5,326,0,5,5
9,6,july,4,327,1,3,1.25
9,6,keen,4,328,0,4,1
9,6,kidnap,6,329,1,5,5.25
9,6,kiss,4,330,2,2,1
9,6,label,5,331,0,5,1.5
9,6,labour,6,332,3,3,1
9,6,ladder,6,333,2,4,4.75
9,6,lamp,4,334,2,2,0.75
9,6,landlord,8,335,2,6,1.75
9,6,lane,4,336,3,1,0.5
9,6,laptop,6,337,2,4,4.5
9,6,late,4,338,2,2,0.75
9,6,lately,6,339,4,2,0.75
9,6,lawyer,6,340,2,4,1.25
9,6,legacy,6,341,1,5,5
9,6,legal,5,342,4,1,0.75
9,6,lend,4,343,2,2,0.75
9,6,less,4,344,2,2,0.75
9,6,lifetime,8,345,1,7,5.5
9,6,limit,5,346,2,3,1
9,6,listener,8,347,2,6,1.75
9,6,loan,4,348,1,3,1
9,6,logic,5,349,2,3,4.5
9,6,logo,4,350,3,1,0.5
9,6,loop,4,351,2,2,0.75
9,6,lord,4,352,2,2,0.75
9,6,lose,4,353,2,2,1
9,6,lovely,6,354,2,4,4.75
9,6,lower,5,355,2,3,1
9,6,luck,4,356,1,3,1
9,6,lung,4,357,2,2,0.75
9,6,magnitude,9,358,0,9,6
9,6,mall,4,359,2,2,0.75
9,6,man,3,360,2,1,0.5
9,6,marathon,8,361,2,6,1.75
9,6,march,5,362,3,2,4
9,6,marginal,8,363,3,5,1.75
9,6,marketing,9,364,3,6,2
9,6,matching,8,365,2,6,5.5
9,6,maths,5,366,3,2,0.75
9,6,matter,6,367,3,3,1
9,6,maximize,8,368,2,6,5.25
9,6,maybe,5,369,2,3,1
9,6,mayor,5,370,3,2,1
9,6,mechanism,9,371,1,8,5.75
9,6,menu,4,372,2,2,1
9,6,military,8,373,1,7,2
9,6,milk,4,374,3,1,0.75
9,6,miner,5,375,2,3,4.75
9,6,mining,6,376,3,3,1.25
9,6,minor,5,377,3,2,0.75
9,6,minority,8,378,5,3,1
9,6,minute,6,379,3,3,1
9,6,miracle,7,380,2,5,750.5
9,6,missile,7,381,2,5,3.5
9,6,mobile,6,382,1,5,3.5
9,6,mode,4,383,2,2,9.75
9,6,modern,6,384,4,2,2
9,6,momentum,8,385,2,6,4.25
9,6,monitor,7,386,2,5,10.75
9,6,morality,8,387,2,6,4.75
9,6,morning,7,388,3,4,3.25
9,6,motive,6,389,2,4,10
9,6,mountain,8,390,2,6,4.25
9,6,move,4,391,2,2,1.75
9,6,movement,8,392,4,4,3.25
9,6,multiply,8,393,1,7,13.25
9,6,musical,7,394,2,5,6
9,6,myself,6,395,1,5,11
9,6,mystery,7,396,3,4,3.25
9,6,native,6,397,0,6,4
9,6,naturally,9,398,3,6,10.5
9,6,naval,5,399,2,3,2.25
9,6,network,7,400,1,6,9.5
9,6,nod,3,401,1,2,1.5
9,6,noon,4,402,2,2,1.75
9,6,notable,7,403,2,5,3.5
9,6,notably,7,404,6,1,1.25
9,6,number,6,405,1,5,9
9,6,nursery,7,406,2,5,3.75
9,6,nursing,7,407,4,3,2.75
9,6,object,6,408,0,6,9.5
9,6,observer,8,409,2,6,4.25
9,6,obsession,9,410,4,5,10
9,6,obtain,6,411,2,4,3
9,6,obvious,7,412,2,5,3.5
9,6,occur,5,413,1,4,2.75
9,6,offender,8,414,1,7,10.25
9,6,offer,5,415,4,1,1.25
9,6,onto,4,416,1,3,2
9,6,operate,7,417,1,6,9.75
9,6,operator,8,418,6,2,2.5
9,6,opinion,7,419,2,5,3.75
9,6,optimism,8,420,2,6,10.25
9,6,over,4,421,1,3,2.25
9,6,overly,6,422,4,2,1.75
9,6,overnight,9,423,4,5,3.5
9,6,overseas,8,424,4,4,9.25
9,6,packet,6,425,0,6,4
9,6,pair,4,426,2,2,1.75
9,6,palm,4,427,2,2,4.5
9,6,parental,8,428,2,6,7.25
9,6,parish,6,429,3,3,2.5
9,6,pass,4,430,2,2,1.75
9,6,passing,7,431,4,3,8.5
9,6,payment,7,432,2,5,3.5
9,6,peak,4,433,1,3,2.25
9,6,peasant,7,434,3,4,3
9,6,penalty,7,435,2,5,9.75
9,6,pension,7,436,3,4,3
9,6,person,6,437,2,4,2.75
9,6,persuade,8,438,4,4,9.25
9,6,phase,5,439,1,4,2.75
9,6,physics,7,440,2,5,3.5
9,6,plain,5,441,1,4,8.75
9,6,plunge,6,442,2,4,3
9,6,poet,4,443,1,3,2
9,6,policeman,9,444,2,7,10.75
9,6,policy,6,445,5,1,1.5
9,6,pop,3,446,2,1,1
9,6,popular,7,447,3,4,3
9,6,portray,7,448,2,5,9.75
9,6,positive,8,449,2,6,4.5
9,6,potential,9,450,2,7,5
9,6,poverty,7,451,2,5,9.5
9,6,powder,6,452,2,4,3
9,6,powerful,8,453,3,5,9.75
9,6,practice,8,454,1,7,4.5
9,6,pray,4,455,3,1,1.25
9,6,preach,6,456,2,4,3
9,6,precision,9,457,3,6,10.25
9,6,premium,7,458,3,4,2
9,6,prepare,7,459,3,4,1.75
9,6,president,9,460,3,6,5.75
9,6,prevent,7,461,3,4,1.5
9,6,previous,8,462,4,4,1.5
9,6,prey,4,463,3,1,4.5
9,6,price,5,464,2,3,1
9,6,pride,5,465,3,2,0.75
9,6,primarily,9,466,3,6,1.75
9,6,prince,6,467,3,3,4.75
9,6,princess,8,468,6,2,1.25
9,6,privilege,9,469,3,6,1.75
9,6,probable,8,470,2,6,5.75
9,6,probably,8,471,7,1,0.75
9,6,pronounce,9,472,3,6,2
9,6,protein,7,473,3,4,1.5
9,6,protocol,8,474,4,4,5.25
9,6,provide,7,475,3,4,1.25
9,6,province,8,476,5,3,1.25
9,6,provoke,7,477,4,3,5
9,6,purchase,8,478,1,7,2
9,6,purely,6,479,3,3,1.25
9,6,purple,6,480,3,3,1.25
9,6,pursue,6,481,3,3,4.75
9,6,quarter,7,482,0,7,2
9,6,question,8,483,2,6,5.5
9,6,quickly,7,484,2,5,1.75
9,6,quietly,7,485,3,4,1.5
9,6,quota,5,486,2,3,4.75
9,6,quote,5,487,4,1,0.75
9,6,rain,4,488,0,4,1.25
9,6,random,6,489,2,4,1.25
9,6,range,5,490,3,2,1
9,6,rapid,5,491,2,3,5
9,6,rare,4,492,2,2,0.75
9,6,read,4,493,1,3,1
9,6,reader,6,494,4,2,0.75
9,6,readily,7,495,4,3,1
9,6,reading,7,496,5,2,4.75
9,6,realize,7,497,3,4,1.5
9,6,receiver,8,498,2,6,1.75
9,6,recipe,6,499,3,3,1.25
9,6,recipient,9,500,5,4,5.5
9,6,recovery,8,501,3,5,1.5
9,6,refugee,7,502,2,5,5.5
9,6,relaxing,8,503,2,6,2
9,6,reliable,8,504,3,5,1.75
9,6,remember,8,505,2,6,5.5
9,6,remote,6,506,3,3,1.25
9,6,renowned,8,507,2,6,2.25
9,6,rental,6,508,3,3,5
9,6,report,6,509,2,4,1.25
9,6,represent,9,510,3,6,2
9,6,request,7,511,2,5,5.5
9,6,restraint,9,512,2,7,2.25
9,6,resume,6,513,3,3,5
9,6,retreat,7,514,2,5,1.75
9,6,reverse,7,515,2,5,1.5
9,6,review,6,516,3,3,1.25
9,6,rhetoric,8,517,1,7,5.75
9,6,rhythm,6,518,2,4,1.5
9,6,rice,4,519,1,3,4.75
9,6,risk,4,520,2,2,1
9,6,role,4,521,1,3,1
9,6,romantic,8,522,2,6,2
9,6,route,5,523,2,3,5
9,6,rugby,5,524,1,4,1.25
9,6,sad,3,525,0,3,0.75
9,6,sadly,5,526,3,2,0.75
9,6,say,3,527,2,1,0.5
9,6,scratch,7,528,1,6,5.75
9,6,script,6,529,3,3,1.25
9,6,sculpture,9,530,2,7,2.25
9,6,sea,3,531,1,2,4.5
9,6,see,3,532,2,1,0.5
9,6,senator,7,533,2,5,1.5
9,6,sensation,9,534,3,6,5.75
9,6,sentence,8,535,3,5,1.75
9,6,set,3,536,2,1,0.5
9,6,seventeen,9,537,2,7,4
9,6,sex,3,538,2,1,2.75
9,6,shadow,6,539,1,5,1.5
9,6,shaped,6,540,3,3,1.25
9,6,shop,4,541,2,2,1
9,6,show,4,542,3,1,0.75
9,6,shrink,6,543,2,4,5.5
9,6,shrug,5,544,3,2,1
9,6,sigh,4,545,1,3,1
9,6,silence,7,546,2,5,1.5
9,6,silent,6,547,5,1,4.5
9,6,sir,3,548,2,1,0.5
9,6,skill,5,549,1,4,1.25
9,6,sky,3,550,2,1,0.5
9,6,sleep,5,551,1,4,1.25
9,6,slot,4,552,2,2,0.75
9,6,smart,5,553,1,4,5.25
9,6,smash,5,554,3,2,1
9,6,soak,4,555,1,3,1
9,6,soar,4,556,3,1,0.5
9,6,socialist,9,557,2,7,6
9,6,soldier,7,558,2,5,1.75
9,6,solely,6,559,3,3,1.25
9,6,solicitor,9,560,3,6,6.25
9,6,son,3,561,2,1,0.5
9,6,soon,4,562,2,2,0.75
9,6,sort,4,563,2,2,0.75
9,6,source,6,564,2,4,1.25
9,6,speculate,9,565,1,8,6.25
9,6,spending,8,566,3,5,1.75
9,6,spicy,5,567,2,3,5.25
9,6,spill,5,568,3,2,1
9,6,split,5,569,2,3,1
9,6,spoil,5,570,2,3,1
9,6,spoon,5,571,3,2,1
9,6,sport,5,572,3,2,4.75
9,6,spot,4,573,3,1,0.75
9,6,spy,3,574,2,1,0.5
9,6,station,7,575,1,6,1.75
9,6,status,6,576,4,2,1
9,6,steel,5,577,2,3,5
9,6,steep,5,578,4,1,0.75
9,6,stress,6,579,2,4,1.25
9,6,strive,6,580,3,3,1.25
9,6,student,7,581,2,5,1.5
9,6,stupid,6,582,3,3,5.25
9,6,style,5,583,2,3,1
9,6,suburb,6,584,1,5,1.5
9,6,suffer,6,585,2,4,5.75
9,6,suffering,9,586,6,3,1.5
9,6,summarize,9,587,2,7,2.25
9,6,summer,6,588,4,2,5
9,6,superb,6,589,2,4,1.5
9,6,superior,8,590,5,3,1.25
9,6,surge,5,591,2,3,1
9,6,surprised,9,592,3,6,6.25
9,6,surrender,9,593,3,6,2
9,6,sustain,7,594,2,5,5.5
9,6,swing,5,595,1,4,1.25
9,6,talented,8,596,0,8,2.25
9,6,teach,5,597,1,4,5.25
9,6,technical,9,598,2,7,2.25
9,6,technique,9,599,6,3,1.25
9,6,teenager,8,600,2,6,6
9,6,tell,4,601,2,2,0.75
9,6,tent,4,602,2,2,0.75
9,6,tenure,6,603,3,3,1
9,6,terrain,7,604,2,5,5.5
9,6,testify,7,605,2,5,1.5
9,6,text,4,606,2,2,0.75
9,6,than,4,607,1,3,4.75
9,6,theft,5,608,2,3,1.25
9,6,their,5,609,3,2,1
9,6,theirs,6,610,5,1,0.5
9,6,them,4,611,3,1,0.5
9,6,then,4,612,3,1,0.5
9,6,theology,8,613,3,5,5.5
9,6,there,5,614,3,2,1
9,6,they,4,615,3,1,0.5
9,6,thick,5,616,2,3,1
9,6,thief,5,617,3,2,0.75
9,6,thin,4,618,3,1,0.5
9,6,thing,5,619,4,1,0.5
9,6,thinking,8,620,4,4,5.25
9,6,third,5,621,3,2,1
9,6,though,6,622,2,4,1.25
9,6,threat,6,623,2,4,1.25
9,6,thrive,6,624,3,3,5.5
9,6,throat,6,625,3,3,1.25
9,6,timber,6,626,1,5,1.75
9,6,tiny,4,627,2,2,0.75
9,6,tired,5,628,2,3,5
9,6,tomato,6,629,1,5,1.5
9,6,ton,3,630,2,1,0.5
9,6,tone,4,631,3,1,0.5
9,6,touch,5,632,2,3,1
9,6,towel,5,633,2,3,4.75
9,6,toy,3,634,2,1,0.5
9,6,trace,5,635,1,4,1.25
9,6,trading,7,636,3,4,1.5
9,6,tradition,9,637,5,4,1.5
9,6,training,8,638,3,5,5.75
9,6,truly,5,639,2,3,1
9,6,trustee,7,640,3,4,1.5
9,6,truth,5,641,3,2,5
9,6,try,3,642,2,1,0.5
9,6,tuesday,7,643,1,6,1.75
9,6,tuition,7,644,2,5,1.75
9,6,tunnel,6,645,2,4,5.5
9,6,turnout,7,646,2,5,1.75
9,6,turnover,8,647,5,3,1.25
9,6,twenty,6,648,1,5,5.5
9,6,ugly,4,649,0,4,1.25
9,6,umbrella,8,650,1,7,6
9,6,unfold,6,651,1,5,1.5
9,6,unit,4,652,2,2,0.75
9,6,unless,6,653,2,4,1.25
9,6,unlike,6,654,3,3,5.25
9,6,unlikely,8,655,6,2,1.25
9,6,up,2,656,1,1,0.5
9,6,upwards,7,657,2,5,1.5
9,6,us,2,658,1,1,0.25
9,6,use,3,659,2,1,0.5
9,6,used,4,660,3,1,0.5
9,6,utterly,7,661,1,6,6
9,6,valid,5,662,0,5,1.5
9,6,variation,9,663,2,7,6.5
9,6,victim,6,664,1,5,1.5
9,6,village,7,665,2,5,1.75
9,6,volume,6,666,1,5,5.75
9,6,vote,4,667,2,2,1
9,6,wage,4,668,0,4,1.25
9,6,want,4,669,2,2,0.75
9,6,wash,4,670,2,2,4.75
9,6,wear,4,671,1,3,1
9,6,weather,7,672,3,4,1.25
9,6,web,3,673,2,1,0.5
9,6,wedding,7,674,2,5,5.75
9,6,weekly,6,675,2,4,1.25
9,6,wet,3,676,2,1,0.5
9,6,what,4,677,1,3,1
9,6,wheat,5,678,2,3,1.25
9,6,when,4,679,3,1,1.25
9,6,while,5,680,2,3,8.75
9,6,whilst,6,681,4,2,1.75
9,6,whole,5,682,2,3,2.25
9,6,winner,6,683,1,5,3.25
9,6,winter,6,684,3,3,8.75
9,6,withdraw,8,685,2,6,4
9,6,wooden,6,686,1,5,3.25
9,6,workout,7,687,2,5,10.25
9,6,worldwide,9,688,3,6,4.25
9,6,worm,4,689,3,1,1.25
9,6,wound,5,690,2,3,8.75
9,6,writer,6,691,1,5,3.5
9,6,wrong,5,692,2,3,2.5
9,6,yell,4,693,0,4,9.25
9,6,yesterday,9,694,2,7,4.75
9,6,zero,4,695,0,4,2.75
9,7,able,4,0,0,4,6.25
9,7,abortion,8,1,2,6,4.25
9,7,about,5,2,3,2,2
9,7,absent,6,3,2,4,9.75
9,7,academy,7,4,1,6,4
9,7,accent,6,5,2,4,10.25
9,7,acquire,7,6,2,5,3.75
9,7,act,3,7,2,1,1
9,7,action,6,8,3,3,2.5
9,7,adult,5,9,1,4,9.5
9,7,advance,7,10,2,5,3.75
9,7,advertise,9,11,3,6,4.25
9,7,afford,6,12,1,5,10.5
9,7,afraid,6,13,2,4,3
9,7,agent,5,14,1,4,2.75
9,7,aircraft,8,15,1,7,11.25
9,7,alert,5,16,1,4,2.75
9,7,alien,5,17,2,3,2.25
9,7,allege,6,18,2,4,10
9,7,alliance,8,19,3,5,3.75
9,7,although,8,20,2,6,4.25
9,7,ambitious,9,21,1,8,12.75
9,7,amid,4,22,2,2,1.75
9,7,angry,5,23,1,4,2.75
9,7,answer,6,24,2,4,9.75
9,7,anyone,6,25,2,4,3
9,7,apart,5,26,1,4,2.75
9,7,apple,5,27,2,3,9.75
9,7,april,5,28,2,3,2.25
9,7,armed,5,29,1,4,2.75
9,7,arrival,7,30,2,5,3.5
9,7,assess,6,31,1,5,10
9,7,athlete,7,32,1,6,4
9,7,attach,6,33,2,4,9.5
9,7,attack,6,34,5,1,1.5
9,7,attempt,7,35,3,4,3.25
9,7,attribute,9,36,3,6,4.25
9,7,audience,8,37,1,7,11.25
9,7,authority,9,38,2,7,4.75
9,7,avoid,5,39,1,4,9.5
9,7,aware,5,40,1,4,2.75
9,7,back,4,41,0,4,2.75
9,7,ballot,6,42,2,4,9.75
9,7,banana,6,43,2,4,3
9,7,bank,4,44,3,1,1.25
9,7,bare,4,45,2,2,1.75
9,7,bear,4,46,1,3,2.25
9,7,bee,3,47,2,1,1
9,7,beef,4,48,3,1,8.5
9,7,behind,6,49,2,4,3.25
9,7,being,5,50,2,3,2.5
9,7,beneath,7,51,2,5,3.5
9,7,bent,4,52,3,1,9.25
9,7,bet,3,53,2,1,1.5
9,7,bias,4,54,1,3,2.25
9,7,body,4,55,1,3,2
9,7,bold,4,56,2,2,1.75
9,7,bond,4,57,2,2,1.75
9,7,booking,7,58,2,5,11.5
9,7,born,4,59,2,2,3.75
9,7,branch,6,60,1,5,4.75
9,7,bread,5,61,2,3,3
9,7,breast,6,62,4,2,10.25
9,7,breath,6,63,4,2,2
9,7,brick,5,64,2,3,2.25
9,7,brilliant,9,65,3,6,4.75
9,7,bring,5,66,3,2,8.75
9,7,broad,5,67,2,3,2.25
9,7,broadband,9,68,5,4,3.25
9,7,broadcast,9,69,5,4,3.25
9,7,broadly,7,70,5,2,9
9,7,brother,7,71,3,4,3
9,7,brown,5,72,3,2,1.75
9,7,burst,5,73,1,4,3
9,7,bus,3,74,2,1,1
9,7,but,3,75,2,1,1
9,7,button,6,76,3,3,10
9,7,bye,3,77,1,2,1.5
9,7,cabin,5,78,0,5,3.5
9,7,calm,4,79,2,2,1.75
9,7,captain,7,80,2,5,10.5
9,7,capture,7,81,4,3,2.75
9,7,case,4,82,2,2,1.5
9,7,castle,6,83,3,3,2.5
9,7,cat,3,84,2,1,1
9,7,cattle,6,85,3,3,9.25
9,7,cause,5,86,2,3,2.25
9,7,cautious,8,87,3,5,4
9,7,centre,6,88,1,5,10.5
9,7,chance,6,89,1,5,3.5
9,7,charge,6,90,3,3,2.5
9,7,cheek,5,91,2,3,2.25
9,7,chest,5,92,3,2,8.75
9,7,clarify,7,93,1,6,4.5
9,7,class,5,94,3,2,2
9,7,classical,9,95,5,4,3.25
9,7,classify,8,96,6,2,9.5
9,7,climate,7,97,2,5,3.5
9,7,clip,4,98,3,1,1.25
9,7,close,5,99,2,3,2.25
9,7,cloth,5,100,3,2,2
9,7,clothes,7,101,5,2,9.25
9,7,cognitive,9,102,1,8,5.25
9,7,college,7,103,2,5,10.75
9,7,collision,9,104,4,5,4
9,7,coloured,8,105,3,5,3.75
9,7,columnist,9,106,3,6,12.75
9,7,combat,6,107,2,4,3
9,7,common,6,108,3,3,2.5
9,7,communist,9,109,4,5,12.25
9,7,compare,7,110,3,4,3.25
9,7,compose,7,111,4,3,3
9,7,comprise,8,112,4,4,3.5
9,7,computer,8,113,4,4,11.25
9,7,concerned,9,114,2,7,5.25
9,7,confusion,9,115,3,6,11.75
9,7,consensus,9,116,3,6,4.25
9,7,conserve,8,117,5,3,2.75
9,7,consist,7,118,4,3,9.5
9,7,contact,7,119,3,4,3
9,7,container,9,120,5,4,3.5
9,7,contest,7,121,4,3,2.5
9,7,context,7,122,5,2,9.5
9,7,contract,8,123,4,4,3.25
9,7,cook,4,124,2,2,1.75
9,7,cooking,7,125,4,3,2.5
9,7,corrupt,7,126,2,5,10.75
9,7,council,7,127,2,5,3.5
9,7,courage,7,128,3,4,3
9,7,covered,7,129,2,5,10.5
9,7,cow,3,130,2,1,1
9,7,crack,5,131,1,4,3
9,7,cream,5,132,2,3,2.25
9,7,creator,7,133,4,3,9.75
9,7,crown,5,134,2,3,2.25
9,7,cupboard,8,135,1,7,4.75
9,7,cure,4,136,2,2,1.75
9,7,curiosity,9,137,3,6,10.25
9,7,custom,6,138,2,4,1.5
9,7,cutting,7,139,2,5,6.25
9,7,data,4,140,0,4,1.25
9,7,daughter,8,141,2,6,2
9,7,dead,4,142,1,3,1
9,7,deadline,8,143,4,4,6
9,7,deadly,6,144,5,1,1
9,7,debate,6,145,2,4,1.5
9,7,debris,6,146,3,3,1.25
9,7,debut,5,147,3,2,5.75
9,7,deck,4,148,2,2,0.75
9,7,dedicated,9,149,2,7,2.25
9,7,defeat,6,150,2,4,3.75
9,7,defend,6,151,4,2,3.5
9,7,depart,6,152,2,4,1.5
9,7,descend,7,153,2,5,1.75
9,7,descent,7,154,6,1,0.75
9,7,desperate,9,155,3,6,6.75
9,7,destroy,7,156,3,4,1.5
9,7,detail,6,157,2,4,1.5
9,7,detection,9,158,3,6,6.75
9,7,diary,5,159,1,4,1.25
9,7,die,3,160,2,1,0.5
9,7,disagree,8,161,2,6,6.5
9,7,discard,7,162,3,4,1.5
9,7,discourse,9,163,4,5,2
9,7,disorder,8,164,3,5,6.5
9,7,dispute,7,165,3,4,1.5
9,7,distance,8,166,3,5,1.75
9,7,distinct,8,167,4,4,6.25
9,7,district,8,168,4,4,1.75
9,7,diverse,7,169,2,5,1.75
9,7,divert,6,170,5,1,0.75
9,7,doctrine,8,171,1,7,7.25
9,7,dominance,9,172,2,7,4
9,7,donate,6,173,2,4,6.75
9,7,door,4,174,2,2,1
9,7,dose,4,175,2,2,0.75
9,7,dozen,5,176,2,3,1.25
9,7,drag,4,177,1,3,5.75
9,7,dramatic,8,178,3,5,1.75
9,7,draw,4,179,3,1,0.5
9,7,drive,5,180,2,3,1
9,7,driver,6,181,5,1,0.5
9,7,drown,5,182,2,3,5.25
9,7,drum,4,183,2,2,0.75
9,7,dump,4,184,1,3,1
9,7,duty,4,185,2,2,0.75
9,7,dynamic,7,186,1,6,1.75
9,7,each,4,187,0,4,6
9,7,east,4,188,2,2,1
9,7,eat,3,189,2,1,0.75
9,7,echo,4,190,1,3,1
9,7,economy,7,191,2,5,6.75
9,7,edge,4,192,1,3,1
9,7,education,9,193,2,7,2.25
9,7,elaborate,9,194,1,8,7
9,7,election,8,195,2,6,2
9,7,electric,8,196,5,3,6.25
9,7,elevate,7,197,3,4,1.5
9,7,emotional,9,198,1,8,2.25
9,7,emphasize,9,199,2,7,7
9,7,empire,6,200,3,3,1.25
9,7,encourage,9,201,1,8,7.25
9,7,enough,6,202,2,4,1.5
9,7,ensue,5,203,2,3,1.25
9,7,entire,6,204,2,4,6.25
9,7,epidemic,8,205,1,7,2.25
9,7,equal,5,206,1,4,1.25
9,7,error,5,207,1,4,6
9,7,erupt,5,208,2,3,1.25
9,7,escalate,8,209,1,7,2.25
9,7,escape,6,210,4,2,6.5
9,7,eternal,7,211,1,6,2
9,7,ethic,5,212,2,3,1.25
9,7,every,5,213,1,4,10.5
9,7,everybody,9,214,5,4,314.5
9,7,everyday,8,215,5,3,3.5
9,7,evolution,9,216,2,7,6.25
9,7,exam,4,217,1,3,14.75
9,7,example,7,218,4,3,5.75
9,7,excess,6,219,2,4,3.75
9,7,exclude,7,220,3,4,4.75
9,7,exotic,6,221,2,4,18.75
9,7,explosion,9,222,2,7,13
9,7,export,6,223,3,3,6.5
9,7,extra,5,224,2,3,14
9,7,extract,7,225,5,2,2.75
9,7,facility,8,226,0,8,6.25
9,7,faction,7,227,3,4,13
9,7,fame,4,228,2,2,2.25
9,7,fan,3,229,2,1,2
9,7,farm,4,230,2,2,2
9,7,favour,6,231,2,4,3.75
9,7,favourite,9,232,6,3,16.5
9,7,feedback,8,233,1,7,7.5
9,7,feel,4,234,3,1,1.5
9,7,fence,5,235,2,3,4.75
9,7,fifth,5,236,1,4,17
9,7,fighting,8,237,2,6,4.5
9,7,fill,4,238,2,2,1.75
9,7,final,5,239,2,3,7.75
9,7,find,4,240,3,1,1.25
9,7,finger,6,241,3,3,2.5
9,7,firearm,7,242,2,5,3.5
9,7,first,5,243,3,2,1.75
9,7,fish,4,244,2,2,7.25
9,7,fishing,7,245,4,3,2.75
9,7,fit,3,246,2,1,1
9,7,flash,5,247,1,4,2.75
9,7,flaw,4,248,3,1,1.25
9,7,flawed,6,249,4,2,1.75
9,7,fluid,5,250,2,3,8.25
9,7,fold,4,251,1,3,2.25
9,7,follow,6,252,3,3,2.25
9,7,fond,4,253,2,2,1.75
9,7,fool,4,254,2,2,1.75
9,7,forest,6,255,2,4,8.75
9,7,forever,7,256,4,3,3
9,7,forgive,7,257,3,4,3.25
9,7,fork,4,258,3,1,1.25
9,7,formal,6,259,3,3,3
9,7,forth,5,260,3,2,7.75
9,7,forum,5,261,3,2,1.75
9,7,fossil,6,262,2,4,3.25
9,7,frame,5,263,1,4,2.75
9,7,frankly,7,264,3,4,8.75
9,7,freeze,6,265,2,4,3
9,7,fruit,5,266,2,3,2.25
9,7,generic,7,267,0,7,10
9,7,generous,8,268,5,3,2.5
9,7,gentleman,9,269,3,6,4.25
9,7,get,3,270,2,1,1
9,7,glad,4,271,1,3,7.5
9,7,goal,4,272,1,3,2.25
9,7,goods,5,273,2,3,2.25
9,7,graduate,8,274,1,7,9.75
9,7,grain,5,275,3,2,2
9,7,grand,5,276,3,2,2
9,7,great,5,277,2,3,2.25
9,7,guard,5,278,1,4,2.75
9,7,hand,4,279,0,4,8
9,7,happy,5,280,2,3,2.25
9,7,harmful,7,281,2,5,3.5
9,7,hatred,6,282,2,4,9
9,7,he,2,283,1,1,1
9,7,heating,7,284,2,5,3.75
9,7,heavily,7,285,3,4,3.25
9,7,helmet,6,286,2,4,9
9,7,helpful,7,287,3,4,3.25
9,7,here,4,288,2,2,1.75
9,7,hidden,6,289,1,5,10
9,7,hierarchy,9,290,2,7,4.75
9,7,hill,4,291,2,2,1.75
9,7,himself,7,292,2,5,10
9,7,historian,9,293,2,7,5
9,7,history,7,294,6,1,2.25
9,7,hockey,6,295,1,5,9.25
9,7,hold,4,296,2,2,1.75
9,7,homework,8,297,2,6,4.25
9,7,hook,4,298,2,2,1.75
9,7,hope,4,299,2,2,1.5
9,7,hopefully,9,300,4,5,10
9,7,hostile,7,301,2,5,3.75
9,7,house,5,302,2,3,2.25
9,7,ideology,8,303,0,8,10.75
9,7,ignore,6,304,1,5,3.5
9,7,illness,7,305,1,6,9.25
9,7,immigrant,9,306,1,8,5.25
9,7,imminent,8,307,4,4,8.75
9,7,impact,6,308,2,4,3
9,7,inclined,8,309,1,7,4.5
9,7,increase,8,310,3,5,9.5
9,7,indicator,9,311,2,7,4.75
9,7,indoor,6,312,3,3,8.25
9,7,indoors,7,313,6,1,1.75
9,7,infect,6,314,2,4,3
9,7,infection,9,315,6,3,2.5
9,7,inflation,9,316,3,6,10
9,7,injured,7,317,2,5,4.5
9,7,inmate,6,318,2,4,3
9,7,innocent,8,319,2,6,12.25
9,7,insect,6,320,2,4,3
9,7,insider,7,321,3,4,4
9,7,intention,9,322,2,7,11
9,7,interact,8,323,4,4,3.25
9,7,interface,9,324,5,4,3.5
9,7,interpret,9,325,5,4,9
9,7,interrupt,9,326,5,4,3.5
9,7,introduce,9,327,3,6,4.25
9,7,invasion,8,328,2,6,9.75
9,7,invent,6,329,3,3,2.5
9,7,investor,8,330,4,4,3.25
9,7,invoke,6,331,3,3,8
9,7,jam,3,332,0,3,2
9,7,jeans,5,333,1,4,2.75
9,7,join,4,334,1,3,2.25
9,7,kill,4,335,0,4,8.5
9,7,knock,5,336,1,4,2.75
9,7,knowledge,9,337,3,6,4.5
9,7,label,5,338,0,5,8.75
9,7,labour,6,339,3,3,2.5
9,7,ladder,6,340,2,4,3
9,7,lady,4,341,3,1,1.25
9,7,lane,4,342,2,2,7.75
9,7,laptop,6,343,2,4,3
9,7,late,4,344,2,2,1.75
9,7,lawyer,6,345,2,4,3
9,7,leap,4,346,1,3,7.75
9,7,learn,5,347,3,2,2
9,7,legal,5,348,2,3,2.25
9,7,leisure,7,349,2,5,3.5
9,7,lend,4,350,2,2,1.5
9,7,length,6,351,3,3,8.25
9,7,less,4,352,2,2,1.75
9,7,lifetime,8,353,1,7,4.5
9,7,light,5,354,2,3,8.75
9,7,likewise,8,355,2,6,4.25
9,7,listener,8,356,2,6,4
9,7,literacy,8,357,2,6,10
9,7,lively,6,358,2,4,2.5
9,7,loan,4,359,1,3,1.25
9,7,lobby,5,360,2,3,4.5
9,7,logo,4,361,2,2,0.75
9,7,loop,4,362,2,2,0.75
9,7,loss,4,363,2,2,0.75
9,7,lost,4,364,3,1,0.5
9,7,lower,5,365,2,3,1
9,7,luck,4,366,1,3,4.5
9,7,lung,4,367,2,2,0.75
9,7,magazine,8,368,0,8,2.25
9,7,magical,7,369,3,4,5
9,7,major,5,370,2,3,1
9,7,mall,4,371,2,2,0.75
9,7,manifest,8,372,2,6,5
9,7,manner,6,373,3,3,1.25
9,7,marginal,8,374,2,6,1.75
9,7,marker,6,375,3,3,1
9,7,marketing,9,376,5,4,5.25
9,7,marry,5,377,3,2,0.75
9,7,matching,8,378,2,6,1.75
9,7,mate,4,379,3,1,0.5
9,7,maths,5,380,3,2,4.25
9,7,matter,6,381,3,3,1.25
9,7,maybe,5,382,2,3,1
9,7,means,5,383,1,4,1.25
9,7,mechanism,9,384,2,7,5.75
9,7,medical,7,385,2,5,1.5
9,7,mile,4,386,1,3,1
9,7,militant,8,387,3,5,5.25
9,7,minimize,8,388,2,6,1.75
9,7,minor,5,389,3,2,1
9,7,minority,8,390,5,3,5
9,7,minute,6,391,3,3,1.25
9,7,mobile,6,392,1,5,1.5
9,7,mode,4,393,2,2,0.75
9,7,momentum,8,394,2,6,5.5
9,7,moral,5,395,2,3,1
9,7,morning,7,396,3,4,1.5
9,7,motive,6,397,2,4,4.75
9,7,motorist,8,398,3,5,1.75
9,7,move,4,399,2,2,0.75
9,7,movement,8,400,4,4,1.25
9,7,multiply,8,401,1,7,5.75
9,7,musical,7,402,2,5,1.75
9,7,national,8,403,0,8,6
9,7,native,6,404,4,2,1
9,7,naturally,9,405,3,6,2
9,7,naval,5,406,2,3,4.5
9,7,nest,4,407,1,3,1
9,7,nineteen,8,408,1,7,2
9,7,ninety,6,409,5,1,4.25
9,7,notable,7,410,1,6,1.75
9,7,now,3,411,2,1,0.5
9,7,number,6,412,1,5,1.5
9,7,nurse,5,413,2,3,4.75
9,7,nursing,7,414,4,3,1.5
9,7,obey,4,415,0,4,1.25
9,7,observer,8,416,2,6,5.25
9,7,obsession,9,417,4,5,2
9,7,obvious,7,418,2,5,1.5
9,7,of,2,419,1,1,0.25
9,7,offering,8,420,2,6,5.5
9,7,ongoing,7,421,1,6,1.75
9,7,onion,5,422,2,3,4.5
9,7,onto,4,423,2,2,0.75
9,7,operate,7,424,1,6,2
9,7,operator,8,425,6,2,1
9,7,oral,4,426,1,3,1
9,7,orchestra,9,427,2,7,6
9,7,organize,8,428,2,6,2
9,7,over,4,429,1,3,4.75
9,7,overly,6,430,4,2,0.75
9,7,overseas,8,431,4,4,1.25
9,7,own,3,432,1,2,0.75
9,7,owner,5,433,3,2,0.75
9,7,packet,6,434,0,6,5.75
9,7,pair,4,435,2,2,0.75
9,7,parameter,9,436,2,7,5.75
9,7,parent,6,437,3,3,1.25
9,7,party,5,438,3,2,1
9,7,pass,4,439,2,2,0.75
9,7,passage,7,440,4,3,1
9,7,passing,7,441,4,3,4.75
9,7,pathway,7,442,2,5,1.75
9,7,peasant,7,443,1,6,1.75
9,7,penalty,7,444,2,5,5.5
9,7,pension,7,445,3,4,1.5
9,7,people,6,446,2,4,1.25
9,7,period,6,447,2,4,5
9,7,permanent,9,448,3,6,2
9,7,petition,8,449,2,6,2
9,7,phase,5,450,1,4,5
9,7,pill,4,451,1,3,1
9,7,pilot,5,452,3,2,0.75
9,7,pit,3,453,2,1,0.5
9,7,placement,9,454,1,8,6
9,7,plain,5,455,3,2,1
9,7,plate,5,456,3,2,1
9,7,player,6,457,3,3,1.25
9,7,pleasure,8,458,2,6,5.5
9,7,plunge,6,459,2,4,1.25
9,7,poet,4,460,1,3,1
9,7,poetry,6,461,4,2,0.75
9,7,policeman,9,462,2,7,6
9,7,policy,6,463,5,1,0.75
9,7,pool,4,464,2,2,0.75
9,7,positive,8,465,2,6,7.5
9,7,potential,9,466,2,7,4.75
9,7,pray,4,467,1,3,2.25
9,7,precede,7,468,2,5,9.5
9,7,precision,9,469,4,5,3.75
9,7,present,7,470,3,4,3.25
9,7,president,9,471,4,5,10
9,7,pretty,6,472,3,3,2.5
9,7,previous,8,473,3,5,3.75
9,7,prey,4,474,3,1,1.25
9,7,priest,6,475,2,4,9
9,7,primarily,9,476,3,6,4.5
9,7,prison,6,477,3,3,2.5
9,7,prisoner,8,478,6,2,8.75
9,7,probably,8,479,2,6,4.25
9,7,proceed,7,480,3,4,3
9,7,promotion,9,481,3,6,10.75
9,7,protect,7,482,3,4,3
9,7,province,8,483,3,5,3.75
9,7,provision,9,484,5,4,9.75
9,7,provoke,7,485,4,3,2.75
9,7,pub,3,486,1,2,1.5
9,7,punch,5,487,2,3,2.25
9,7,purely,6,488,2,4,9
9,7,purple,6,489,3,3,2.5
9,7,qualify,7,490,0,7,4.5
9,7,question,8,491,2,6,10.25
9,7,queue,5,492,3,2,2
9,7,quietly,7,493,2,5,3.5
9,7,quota,5,494,2,3,8.25
9,7,racist,6,495,0,6,4
9,7,radio,5,496,2,3,2.5
9,7,rain,4,497,2,2,1.75
9,7,range,5,498,2,3,8.5
9,7,rare,4,499,2,2,1.75
9,7,read,4,500,1,3,2.25
9,7,reading,7,501,4,3,2.5
9,7,real,4,502,3,1,1.25
9,7,recession,9,503,2,7,11.25
9,7,recovery,8,504,3,5,3.75
9,7,red,3,505,2,1,1
9,7,refuge,6,506,2,4,9
9,7,refugee,7,507,6,1,1.75
9,7,regulator,9,508,2,7,4.75
9,7,reinforce,9,509,2,7,11
9,7,relaxing,8,510,2,6,4.25
9,7,rely,4,511,3,1,1.25
9,7,remains,7,512,2,5,9.75
9,7,remember,8,513,3,5,4
9,7,repeated,8,514,2,6,4.25
9,7,report,6,515,3,3,8.75
9,7,represent,9,516,3,6,4.25
9,7,request,7,517,2,5,3.75
9,7,respect,7,518,2,5,10.75
9,7,response,8,519,4,4,3.25
9,7,restraint,9,520,3,6,10.5
9,7,reverse,7,521,2,5,3.5
9,7,rhetoric,8,522,1,7,4.75
9,7,rice,4,523,1,3,8.5
9,7,risk,4,524,2,2,1.75
9,7,role,4,525,1,3,2.25
9,7,route,5,526,2,3,2.25
9,7,royal,5,527,2,3,2.25
9,7,rugby,5,528,1,4,8.75
9,7,rule,4,529,2,2,1.75
9,7,rumour,6,530,2,4,3
9,7,sad,3,531,0,3,2
9,7,sadly,5,532,3,2,7.75
9,7,sail,4,533,2,2,1.75
9,7,saint,5,534,3,2,1.75
9,7,salary,6,535,2,4,2.75
9,7,sanction,8,536,2,6,10.5
9,7,say,3,537,2,1,1
9,7,scale,5,538,1,4,2.75
9,7,scratch,7,539,2,5,3.5
9,7,sea,3,540,1,2,7.75
9,7,see,3,541,2,1,1
9,7,seize,5,542,2,3,2.25
9,7,seldom,6,543,2,4,2.75
9,7,self,4,544,3,1,1.25
9,7,senator,7,545,2,5,10
9,7,send,4,546,3,1,1.5
9,7,sensitive,9,547,3,6,4.5
9,7,sentence,8,548,3,5,3.75
9,7,session,7,549,2,5,10.25
9,7,set,3,550,2,1,1
9,7,seventeen,9,551,2,7,4.75
9,7,seventy,7,552,6,1,7.75
9,7,shadow,6,553,1,5,3.5
9,7,shake,5,554,3,2,1.75
9,7,sheet,5,555,2,3,2.25
9,7,shop,4,556,2,2,1.5
9,7,shot,4,557,3,1,7.5
9,7,show,4,558,3,1,1.25
9,7,shrug,5,559,2,3,2.25
9,7,sigh,4,560,1,3,2.25
9,7,silent,6,561,2,4,3
9,7,silly,5,562,3,2,4.75
9,7,sincere,7,563,2,5,7
9,7,situation,9,564,2,7,4.75
9,7,size,4,565,2,2,7.75
9,7,skill,5,566,1,4,2.75
9,7,slogan,6,567,1,5,3.5
9,7,slot,4,568,3,1,1.25
9,7,slow,4,569,3,1,1.25
9,7,small,5,570,1,4,9.25
9,7,smart,5,571,3,2,2
9,7,soccer,6,572,1,5,3.25
9,7,soldier,7,573,2,5,9.75
9,7,solicitor,9,574,3,6,4.5
9,7,soon,4,575,2,2,1.75
9,7,spill,5,576,1,4,2.75
9,7,spite,5,577,3,2,6
9,7,split,5,578,2,3,1
9,7,sponsor,7,579,2,5,1.75
9,7,spoon,5,580,3,2,0.75
9,7,spot,4,581,3,1,0.5
9,7,squeeze,7,582,1,6,5.75
9,7,statement,9,583,1,8,2.5
9,7,station,7,584,4,3,5.25
9,7,status,6,585,4,2,1
9,7,steel,5,586,2,3,1
9,7,steep,5,587,4,1,0.75
9,7,stimulate,9,588,2,7,6
9,7,structure,9,589,2,7,2.25
9,7,struggle,8,590,4,4,1.5
9,7,student,7,591,2,5,6
9,7,stunning,8,592,3,5,1.75
9,7,stupid,6,593,3,3,1.25
9,7,style,5,594,2,3,5.25
9,7,suburb,6,595,1,5,1.5
9,7,suburban,8,596,6,2,1
9,7,success,7,597,2,5,5.5
9,7,suddenly,8,598,2,6,2
9,7,suffer,6,599,2,4,1.5
9,7,summer,6,600,2,4,5.25
9,7,superb,6,601,2,4,1.25
9,7,superior,8,602,5,3,1.25
9,7,suppress,8,603,3,5,1.75
9,7,surge,5,604,2,3,5
9,7,surrender,9,605,3,6,2
9,7,sweet,5,606,1,4,1.25
9,7,syndrome,8,607,1,7,6
9,7,teach,5,608,0,5,1.5
9,7,technical,9,609,2,7,6.25
9,7,teenage,7,610,2,5,1.5
9,7,teenager,8,611,7,1,0.75
9,7,tell,4,612,2,2,0.75
9,7,tennis,6,613,2,4,5.25
9,7,tenure,6,614,3,3,1.25
9,7,terminal,8,615,2,6,2.25
9,7,terrain,7,616,3,4,5.5
9,7,testify,7,617,2,5,1.5
9,7,text,4,618,2,2,0.75
9,7,that,4,619,1,3,1
9,7,theft,5,620,2,3,5.25
9,7,their,5,621,3,2,1
9,7,theirs,6,622,5,1,0.75
9,7,theology,8,623,3,5,1.75
9,7,there,5,624,3,2,0.75
9,7,they,4,625,3,1,4.75
9,7,thief,5,626,2,3,1
9,7,thing,5,627,3,2,1
9,7,think,5,628,4,1,0.75
9,7,thinking,8,629,5,3,1.25
9,7,though,6,630,2,4,5.75
9,7,threaten,8,631,2,6,2.25
9,7,threshold,9,632,4,5,2
9,7,throat,6,633,3,3,6
9,7,thursday,8,634,2,6,2.25
9,7,timber,6,635,1,5,1.75
9,7,tired,5,636,2,3,5.5
9,7,toll,4,637,1,3,1
9,7,tomato,6,638,2,4,1.5
9,7,tone,4,639,2,2,0.75
9,7,touch,5,640,2,3,1
9,7,tradition,9,641,1,8,6.5
9,7,training,8,642,3,5,1.75
9,7,transfer,8,643,3,5,6.25
9,7,transform,9,644,6,3,1.5
9,7,trillion,8,645,2,6,2
9,7,true,4,646,2,2,5
9,7,truly,5,647,3,2,1
9,7,truth,5,648,3,2,0.75
9,7,try,3,649,2,1,0.5
9,7,tuition,7,650,1,6,1.75
9,7,tunnel,6,651,2,4,5.5
9,7,turn,4,652,2,2,0.75
9,7,ugly,4,653,0,4,1.5
9,7,umbrella,8,654,1,7,6.25
9,7,under,5,655,1,4,1.25
9,7,unfold,6,656,2,4,1.25
9,7,unless,6,657,2,4,5.5
9,7,up,2,658,1,1,0.5
9,7,upset,5,659,2,3,1
9,7,upwards,7,660,2,5,1.5
9,7,use,3,661,1,2,0.75
9,7,used,4,662,3,1,4.5
9,7,utterly,7,663,1,6,1.75
9,7,vast,4,664,0,4,1.25
9,7,vehicle,7,665,1,6,6
9,7,versus,6,666,2,4,1.5
9,7,victim,6,667,1,5,1.5
9,7,voluntary,9,668,1,8,6.5
9,7,wage,4,669,0,4,1.25
9,7,wall,4,670,2,2,0.75
9,7,want,4,671,2,2,5
9,7,warfare,7,672,2,5,1.75
9,7,warm,4,673,3,1,0.5
9,7,weather,7,674,1,6,1.75
9,7,web,3,675,2,1,4.5
9,7,website,7,676,3,4,1.5
9,7,wedding,7,677,2,5,1.75
9,7,well,4,678,2,2,0.75
9,7,what,4,679,1,3,5.5
9,7,wheat,5,680,2,3,1.25
9,7,whilst,6,681,2,4,1.25
9,7,whisper,7,682,3,4,1.5
9,7,who,3,683,2,1,0.5
9,7,whole,5,684,3,2,5
9,7,wide,4,685,1,3,1
9,7,widely,6,686,4,2,0.75
9,7,winner,6,687,2,4,1.5
9,7,worm,4,688,1,3,5.25
9,7,worse,5,689,3,2,1
9,7,writer,6,690,1,5,1.75
9,7,year,4,691,0,4,1.25
9,7,yesterday,9,692,2,7,6.25
9,7,you,3,693,1,2,0.75
9,7,yours,5,694,3,2,0.75
9,7,yourself,8,695,5,3,1
9,8,ability,7,0,0,7,2
9,8,above,5,1,2,3,1
9,8,access,6,2,1,5,5.75
9,8,according,9,3,3,6,2.25
9,8,acquire,7,4,2,5,6
9,8,act,3,5,2,1,0.75
9,8,action,6,6,3,3,1.25
9,8,addition,8,7,1,7,2
9,8,adhere,6,8,2,4,5.75
9,8,admission,9,9,2,7,2.25
9,8,adult,5,10,2,3,1
9,8,advance,7,11,2,5,6
9,8,advanced,8,12,7,1,1
9,8,affair,6,13,1,5,1.5
9,8,affection,9,14,3,6,6.25
9,8,afford,6,15,3,3,1.25
9,8,afraid,6,16,2,4,1.5
9,8,aged,4,17,1,3,1.25
9,8,agent,5,18,3,2,5.5
9,8,ah,2,19,1,1,0.5
9,8,air,3,20,1,2,0.75
9,8,aircraft,8,21,3,5,1.75
9,8,alert,5,22,1,4,1.5
9,8,alien,5,23,2,3,6.25
9,8,alike,5,24,3,2,1
9,8,all,3,25,2,1,0.5
9,8,allege,6,26,3,3,1.25
9,8,allow,5,27,3,2,1
9,8,along,5,28,2,3,6.25
9,8,although,8,29,2,6,3.25
9,8,angry,5,30,1,4,1.25
9,8,answer,6,31,2,4,6.75
9,8,anything,8,32,2,6,2
9,8,apple,5,33,1,4,1.25
9,8,apply,5,34,4,1,0.75
9,8,appoint,7,35,3,4,5.75
9,8,april,5,36,2,3,1
9,8,article,7,37,1,6,1.75
9,8,assess,6,38,1,5,5.75
9,8,attach,6,39,1,5,1.5
9,8,attempt,7,40,3,4,1.25
9,8,attend,6,41,4,2,5.25
9,8,attribute,9,42,3,6,2
9,8,audience,8,43,1,7,2
9,8,audit,5,44,4,1,4.75
9,8,august,6,45,2,4,1.5
9,8,avoid,5,46,1,4,1.25
9,8,back,4,47,0,4,1.25
9,8,backwards,9,48,4,5,6.25
9,8,bake,4,49,2,2,0.75
9,8,banana,6,50,2,4,1.25
9,8,because,7,51,1,6,6
9,8,beef,4,52,2,2,0.75
9,8,beginning,9,53,2,7,2.25
9,8,behind,6,54,2,4,5.5
9,8,being,5,55,2,3,1
9,8,beside,6,56,2,4,1.25
9,8,big,3,57,1,2,0.75
9,8,biology,7,58,2,5,6
9,8,blanket,7,59,1,6,2.25
9,8,blast,5,60,3,2,1
9,8,bleed,5,61,2,3,5.5
9,8,blend,5,62,3,2,1
9,8,blood,5,63,2,3,1
9,8,body,4,64,1,3,1
9,8,booking,7,65,2,5,6.25
9,8,boring,6,66,2,4,1.5
9,8,born,4,67,3,1,0.5
9,8,brilliant,9,68,1,8,2.25
9,8,broadly,7,69,2,5,6.25
9,8,brother,7,70,3,4,1.5
9,8,buck,4,71,1,3,1
9,8,building,8,72,2,6,6.5
9,8,burial,6,73,2,4,1.5
9,8,burst,5,74,3,2,1
9,8,bury,4,75,3,1,0.75
9,8,busy,4,76,2,2,0.75
9,8,calm,4,77,0,4,6.25
9,8,carriage,8,78,2,6,2
9,8,case,4,79,2,2,0.75
9,8,cat,3,80,2,1,1
9,8,cattle,6,81,3,3,10.25
9,8,cause,5,82,2,3,2.25
9,8,cautious,8,83,3,5,3.75
9,8,cent,4,84,1,3,9
9,8,champion,8,85,1,7,4.75
9,8,chance,6,86,3,3,2.5
9,8,charge,6,87,3,3,2.5
9,8,chat,4,88,3,1,9
9,8,cheek,5,89,2,3,2.25
9,8,chef,4,90,3,1,1.5
9,8,cinema,6,91,1,5,3.5
9,8,classic,7,92,1,6,11.75
9,8,classical,9,93,7,2,2.5
9,8,classify,8,94,6,2,2.25
9,8,cleaning,8,95,2,6,5
9,8,climate,7,96,2,5,12
9,8,cling,5,97,3,2,2
9,8,clock,5,98,2,3,4
9,8,close,5,99,3,2,2.75
9,8,clothing,8,100,3,5,10.75
9,8,coalition,9,101,1,8,5.25
9,8,coastal,7,102,3,4,10
9,8,collapse,8,103,2,6,4
9,8,collision,9,104,4,5,3.75
9,8,coloured,8,105,3,5,11.25
9,8,columnist,9,106,3,6,4.25
9,8,commander,9,107,2,7,11.5
9,8,commit,6,108,4,2,2
9,8,common,6,109,4,2,2
9,8,communist,9,110,4,5,4
9,8,complaint,9,111,3,6,12.5
9,8,complex,7,112,5,2,2.5
9,8,compose,7,113,4,3,2.75
9,8,comprise,8,114,4,4,11
9,8,concerned,9,115,2,7,4.75
9,8,concrete,8,116,4,4,3.25
9,8,confident,9,117,3,6,11.75
9,8,confirm,7,118,5,2,2.25
9,8,conflict,8,119,4,4,3.5
9,8,confusion,9,120,4,5,11.25
9,8,conserve,8,121,3,5,3.75
9,8,consume,7,122,4,3,2.75
9,8,consumer,8,123,7,1,1.75
9,8,context,7,124,3,4,15.25
9,8,continue,8,125,4,4,296.5
9,8,contrary,8,126,4,4,2.25
9,8,convert,7,127,3,4,2
9,8,convict,7,128,4,3,5.5
9,8,cooking,7,129,2,5,5.5
9,8,cooperate,9,130,3,6,3.25
9,8,cop,3,131,2,1,0.75
9,8,correlate,9,132,2,7,10.25
9,8,corrupt,7,133,4,3,3
9,8,costume,7,134,2,5,6.75
9,8,council,7,135,2,5,4.75
9,8,courage,7,136,3,4,2.25
9,8,covered,7,137,2,5,7.75
9,8,crazy,5,138,1,4,2
9,8,creation,8,139,2,6,3
9,8,criterion,9,140,2,7,10.5
9,8,critique,8,141,4,4,2.5
9,8,crop,4,142,2,2,1.25
9,8,crystal,7,143,2,5,12.25
9,8,cult,4,144,1,3,1.5
9,8,custody,7,145,2,5,2.25
9,8,custom,6,146,5,1,1
9,8,cutting,7,147,2,5,12.25
9,8,dancer,6,148,0,6,1.75
9,8,dark,4,149,2,2,1
9,8,data,4,150,2,2,1
9,8,date,4,151,3,1,0.75
9,8,daughter,8,152,2,6,5.75
9,8,dead,4,153,1,3,1
9,8,deadly,6,154,4,2,0.75
9,8,debris,6,155,2,4,5
9,8,deck,4,156,2,2,1
9,8,defend,6,157,2,4,1.5
9,8,defensive,9,158,5,4,1.5
9,8,defy,4,159,3,1,0.75
9,8,depend,6,160,2,4,5
9,8,dependent,9,161,6,3,1.5
9,8,desert,6,162,2,4,1.25
9,8,detail,6,163,2,4,5
9,8,detection,9,164,3,6,2.5
9,8,dialogue,8,165,1,7,5.25
9,8,diary,5,166,3,2,1
9,8,differ,6,167,2,4,1.25
9,8,different,9,168,6,3,1.25
9,8,dimension,9,169,2,7,5
9,8,discard,7,170,2,5,1.5
9,8,disorder,8,171,3,5,1.75
9,8,distance,8,172,3,5,4.75
9,8,distinct,8,173,4,4,1.5
9,8,distract,8,174,4,4,1.5
9,8,district,8,175,5,3,4.5
9,8,diverse,7,176,2,5,1.75
9,8,diversity,9,177,6,3,1.25
9,8,divorce,7,178,3,4,4.5
9,8,dominate,8,179,1,7,2.25
9,8,donate,6,180,2,4,1.5
9,8,dose,4,181,2,2,0.75
9,8,drag,4,182,1,3,4
9,8,drain,5,183,3,2,1
9,8,dramatic,8,184,3,5,1.5
9,8,drown,5,185,2,3,1
9,8,drug,4,186,2,2,4
9,8,drum,4,187,3,1,0.75
9,8,drunk,5,188,3,2,0.75
9,8,dull,4,189,1,3,1
9,8,during,6,190,2,4,1.5
9,8,duty,4,191,2,2,4
9,8,dynamic,7,192,1,6,2
9,8,early,5,193,0,5,1.5
9,8,east,4,194,2,2,0.75
9,8,economics,9,195,1,8,7.5
9,8,edge,4,196,1,3,2
9,8,education,9,197,2,7,10
9,8,educator,8,198,6,2,2.5
9,8,elaborate,9,199,1,8,10.5
9,8,element,7,200,2,5,3.5
9,8,elevate,7,201,3,4,3.25
9,8,emerge,6,202,1,5,9
9,8,encourage,9,203,1,8,5.25
9,8,endorse,7,204,2,5,9
9,8,energy,6,205,2,4,3
9,8,enforce,7,206,2,5,3.5
9,8,enrol,5,207,2,3,2.25
9,8,entire,6,208,2,4,8
9,8,equal,5,209,1,4,2.75
9,8,equation,8,210,4,4,3
9,8,error,5,211,1,4,8
9,8,escalate,8,212,1,7,4.5
9,8,escape,6,213,4,2,2
9,8,eternal,7,214,1,6,9.5
9,8,ethical,7,215,2,5,3.75
9,8,ethnic,6,216,3,3,2.5
9,8,every,5,217,1,4,8
9,8,everybody,9,218,5,4,3.25
9,8,example,7,219,1,6,4
9,8,excess,6,220,2,4,8.25
9,8,exert,5,221,2,3,2.25
9,8,exotic,6,222,2,4,3
9,8,export,6,223,2,4,3
9,8,exposure,8,224,4,4,8.5
9,8,external,8,225,2,6,4.25
9,8,extra,5,226,3,2,2
9,8,extremely,9,227,4,5,9.75
9,8,fact,4,228,0,4,2.75
9,8,factor,6,229,4,2,1.75
9,8,factory,7,230,6,1,1.25
9,8,fairness,8,231,2,6,9.5
9,8,fan,3,232,2,1,1
9,8,farm,4,233,2,2,1.75
9,8,favourite,9,234,2,7,4.75
9,8,feather,7,235,1,6,9.25
9,8,festival,8,236,2,6,4.25
9,8,fifth,5,237,1,4,8
9,8,fighting,8,238,2,6,4.25
9,8,figure,6,239,3,3,2.5
9,8,filter,6,240,2,4,8.25
9,8,fire,4,241,2,2,1.75
9,8,first,5,242,3,2,1.75
9,8,fit,3,243,2,1,1
9,8,five,4,244,2,2,1.75
9,8,flame,5,245,1,4,2.75
9,8,flash,5,246,3,2,7.25
9,8,flood,5,247,2,3,2.25
9,8,flour,5,248,3,2,1.75
9,8,fluid,5,249,2,3,2.25
9,8,fold,4,250,1,3,2.25
9,8,follow,6,251,3,3,9
9,8,fond,4,252,2,2,1.75
9,8,forest,6,253,2,4,3
9,8,formal,6,254,3,3,2.75
9,8,forum,5,255,3,2,2
9,8,frame,5,256,1,4,8.75
9,8,freeze,6,257,2,4,3
9,8,from,4,258,2,2,1.75
9,8,fully,5,259,1,4,9
9,8,function,8,260,2,6,4.5
9,8,fund,4,261,3,1,1.25
9,8,furious,7,262,2,5,3.5
9,8,gambling,8,263,0,8,11
9,8,gang,4,264,2,2,1.75
9,8,gas,3,265,2,1,1
9,8,generic,7,266,1,6,9.25
9,8,generous,8,267,5,3,2.75
9,8,gentle,6,268,3,3,2.5
9,8,gentleman,9,269,6,3,2.75
9,8,goal,4,270,1,3,7.5
9,8,goods,5,271,2,3,2.25
9,8,gradually,9,272,1,8,5.25
9,8,graduate,8,273,6,2,7.75
9,8,grain,5,274,3,2,2
9,8,grand,5,275,3,2,1.75
9,8,grass,5,276,3,2,1.75
9,8,greatly,7,277,2,5,3.5
9,8,guard,5,278,1,4,8.5
9,8,guideline,9,279,2,7,4.75
9,8,half,4,280,0,4,2.75
9,8,hand,4,281,2,2,7
9,8,hardware,8,282,2,6,4.25
9,8,harmful,7,283,3,4,3
9,8,harmony,7,284,4,3,8.5
9,8,hatred,6,285,2,4,3
9,8,he,2,286,1,1,1.25
9,8,help,4,287,2,2,1.75
9,8,helpful,7,288,4,3,2.25
9,8,hidden,6,289,1,5,9
9,8,hide,4,290,3,1,1.25
9,8,hierarchy,9,291,2,7,4.75
9,8,highway,7,292,2,5,9.75
9,8,himself,7,293,2,5,3.5
9,8,history,7,294,2,5,4.25
9,8,hobby,5,295,1,4,8.5
9,8,hockey,6,296,2,4,3
9,8,holy,4,297,2,2,1.75
9,8,homeless,8,298,2,6,9.5
9,8,honour,6,299,2,4,3
9,8,hostile,7,300,2,5,3.5
9,8,house,5,301,2,3,7.75
9,8,housing,7,302,4,3,2.75
9,8,hungry,6,303,1,5,3.5
9,8,hurry,5,304,2,3,2.25
9,8,ideology,8,305,0,8,11.5
9,8,if,2,306,1,1,1
9,8,imagine,7,307,1,6,4
9,8,immigrant,9,308,2,7,10.25
9,8,impress,7,309,2,5,3.75
9,8,in,2,310,1,1,0.75
9,8,including,9,311,2,7,10.75
9,8,increase,8,312,3,5,3.75
9,8,indeed,6,313,2,4,8.5
9,8,indicator,9,314,3,6,4.5
9,8,indoor,6,315,3,3,2.5
9,8,indoors,7,316,6,1,1.5
9,8,induce,6,317,3,3,8.25
9,8,initial,7,318,2,5,3.75
9,8,input,5,319,2,3,2.5
9,8,insight,7,320,2,5,10
9,8,instantly,9,321,3,6,4.5
9,8,insult,6,322,3,3,2.75
9,8,intensity,9,323,2,7,14.25
9,8,interface,9,324,4,5,4
9,8,interpret,9,325,5,4,3.5
9,8,introduce,9,326,3,6,10.5
9,8,invisible,9,327,2,7,4.75
9,8,invoke,6,328,3,3,8.5
9,8,jam,3,329,0,3,2
9,8,jeans,5,330,1,4,2.75
9,8,join,4,331,1,3,2.25
9,8,joint,5,332,4,1,1
9,8,justice,7,333,1,6,9.5
9,8,keen,4,334,0,4,2.75
9,8,kill,4,335,1,3,2.25
9,8,killing,7,336,4,3,8.75
9,8,kiss,4,337,2,2,1.75
9,8,knock,5,338,1,4,2.75
9,8,knowledge,9,339,3,6,4.25
9,8,label,5,340,0,5,8.75
9,8,labour,6,341,3,3,2.5
9,8,lamp,4,342,2,2,1.75
9,8,landlord,8,343,2,6,9.5
9,8,lane,4,344,3,1,1.25
9,8,late,4,345,2,2,1.75
9,8,lawsuit,7,346,2,5,3.5
9,8,lawyer,6,347,3,3,2.5
9,8,layout,6,348,2,4,8.5
9,8,lead,4,349,1,3,2.25
9,8,lend,4,350,2,2,1.75
9,8,length,6,351,3,3,2.5
9,8,lesson,6,352,2,4,8.25
9,8,let,3,353,2,1,1
9,8,limit,5,354,1,4,2.75
9,8,listener,8,355,2,6,4
9,8,literacy,8,356,2,6,9.75
9,8,loan,4,357,1,3,2.25
9,8,lock,4,358,2,2,1.75
9,8,loom,4,359,2,2,1.75
9,8,lose,4,360,2,2,7.25
9,8,lost,4,361,3,1,1.25
9,8,lovely,6,362,2,4,2.75
9,8,luck,4,363,1,3,1.75
9,8,lung,4,364,2,2,1.25
9,8,magazine,8,365,0,8,6
9,8,magical,7,366,3,4,1.5
9,8,major,5,367,2,3,1.25
9,8,mall,4,368,2,2,4.25
9,8,marathon,8,369,2,6,1.75
9,8,march,5,370,3,2,0.75
9,8,mate,4,371,2,2,0.75
9,8,maths,5,372,3,2,4.5
9,8,matter,6,373,3,3,1.5
9,8,maximize,8,374,2,6,2
9,8,maybe,5,375,2,3,1
9,8,mayor,5,376,3,2,4.5
9,8,me,2,377,1,1,0.5
9,8,meaning,7,378,2,5,1.5
9,8,measure,7,379,3,4,1.5
9,8,mechanism,9,380,2,7,5.75
9,8,medical,7,381,2,5,1.5
9,8,medicine,8,382,5,3,1.25
9,8,meet,4,383,2,2,4.25
9,8,menu,4,384,2,2,0.75
9,8,metal,5,385,2,3,1
9,8,metaphor,8,386,4,4,1.5
9,8,mile,4,387,1,3,1
9,8,militant,8,388,3,5,5.25
9,8,milk,4,389,3,1,0.5
9,8,mill,4,390,3,1,0.5
9,8,mine,4,391,2,2,0.75
9,8,mining,6,392,3,3,1
9,8,minority,8,393,3,5,5.25
9,8,minute,6,394,3,3,1.25
9,8,mistake,7,395,2,5,1.5
9,8,monk,4,396,1,3,4.5
9,8,moral,5,397,2,3,1.25
9,8,morality,8,398,5,3,1.25
9,8,motor,5,399,2,3,1
9,8,motorist,8,400,5,3,2.75
9,8,mount,5,401,2,3,3
9,8,mountain,8,402,5,3,1.25
9,8,move,4,403,2,2,0.75
9,8,movement,8,404,4,4,1.25
9,8,multiply,8,405,1,7,5.75
9,8,musical,7,406,2,5,1.5
9,8,myself,6,407,1,5,5.25
9,8,nail,4,408,0,4,1.25
9,8,native,6,409,2,4,1.5
9,8,naval,5,410,2,3,1
9,8,nerve,5,411,1,4,4.75
9,8,nest,4,412,2,2,0.75
9,8,net,3,413,2,1,0.5
9,8,ninety,6,414,1,5,1.5
9,8,noble,5,415,1,4,5
9,8,nod,3,416,2,1,0.5
9,8,nonsense,8,417,2,6,2
9,8,now,3,418,2,1,0.5
9,8,nursery,7,419,1,6,5.5
9,8,obey,4,420,0,4,1.25
9,8,observer,8,421,2,6,2
9,8,occur,5,422,1,4,5
9,8,of,2,423,1,1,0.5
9,8,offering,8,424,2,6,1.75
9,8,ongoing,7,425,1,6,5.5
9,8,onion,5,426,2,3,1.25
9,8,open,4,427,1,3,1
9,8,operate,7,428,3,4,1.25
9,8,opinion,7,429,2,5,5.25
9,8,or,2,430,1,1,0.5
9,8,oral,4,431,2,2,0.75
9,8,orange,6,432,3,3,1
9,8,orchestra,9,433,2,7,6.25
9,8,ordinary,8,434,2,6,2
9,8,out,3,435,1,2,0.75
9,8,oven,4,436,1,3,4.5
9,8,over,4,437,3,1,0.5
9,8,overly,6,438,4,2,1
9,8,own,3,439,1,2,0.75
9,8,owner,5,440,3,2,0.75
9,8,packet,6,441,0,6,5.5
9,8,palm,4,442,2,2,0.75
9,8,pan,3,443,2,1,0.5
9,8,parameter,9,444,2,7,2.25
9,8,parent,6,445,3,3,5
9,8,parental,8,446,6,2,1.25
9,8,parish,6,447,3,3,1.25
9,8,passage,7,448,2,5,1.75
9,8,payment,7,449,2,5,5.75
9,8,pension,7,450,1,6,1.75
9,8,people,6,451,2,4,1.5
9,8,permanent,9,452,2,7,6
9,8,person,6,453,3,3,1.25
9,8,petition,8,454,2,6,5.5
9,8,physics,7,455,1,6,1.75
9,8,pill,4,456,1,3,1
9,8,pink,4,457,2,2,0.75
9,8,plain,5,458,1,4,5
9,8,plate,5,459,3,2,1
9,8,player,6,460,3,3,1.25
9,8,pleasure,8,461,2,6,5.75
9,8,plug,4,462,2,2,0.75
9,8,plunge,6,463,3,3,1.25
9,8,poet,4,464,1,3,1
9,8,pole,4,465,2,2,1
9,8,policeman,9,466,3,6,6
9,8,policy,6,467,5,1,0.75
9,8,politics,8,468,4,4,1.75
9,8,pool,4,469,2,2,0.75
9,8,pop,3,470,2,1,0.5
9,8,port,4,471,2,2,4.5
9,8,portray,7,472,4,3,1.5
9,8,pose,4,473,2,2,0.75
9,8,positive,8,474,3,5,1.75
9,8,potential,9,475,2,7,6
9,8,poverty,7,476,2,5,1.5
9,8,powder,6,477,2,4,1.25
9,8,practice,8,478,1,7,6
9,8,precision,9,479,2,7,2.25
9,8,present,7,480,3,4,5.25
9,8,president,9,481,4,5,1.75
9,8,prevent,7,482,3,4,1.5
9,8,price,5,483,2,3,5
9,8,pride,5,484,3,2,1
9,8,prince,6,485,3,3,1
9,8,princess,8,486,6,2,1
9,8,prison,6,487,3,3,1
9,8,probable,8,488,2,6,5.5
9,8,promotion,9,489,3,6,2
9,8,pronounce,9,490,3,6,5.75
9,8,protect,7,491,3,4,1.5
9,8,protein,7,492,5,2,1
9,8,provide,7,493,3,4,5
9,8,provision,9,494,5,4,1.75
9,8,provoke,7,495,4,3,1.25
9,8,pub,3,496,1,2,0.75
9,8,purely,6,497,2,4,1.25
9,8,purple,6,498,3,3,5
9,8,qualify,7,499,0,7,2
9,8,queue,5,500,2,3,1
9,8,quota,5,501,2,3,5
9,8,quote,5,502,4,1,0.75
9,8,radio,5,503,0,5,1.5
9,8,range,5,504,2,3,1
9,8,rare,4,505,2,2,0.75
9,8,reader,6,506,1,5,5.25
9,8,reading,7,507,4,3,1.25
9,8,real,4,508,3,1,0.75
9,8,realize,7,509,4,3,1.25
9,8,really,6,510,4,2,4.75
9,8,recipe,6,511,2,4,1.5
9,8,recovery,8,512,3,5,1.75
9,8,refuge,6,513,2,4,5
9,8,refugee,7,514,6,1,1
9,8,regulator,9,515,2,7,2.25
9,8,relaxing,8,516,2,6,5.75
9,8,remember,8,517,2,6,2
9,8,reminder,8,518,3,5,1.75
9,8,remote,6,519,3,3,5
9,8,renowned,8,520,2,6,2
9,8,reporter,8,521,2,6,1.75
9,8,represent,9,522,3,6,6
9,8,request,7,523,2,5,1.5
9,8,response,8,524,2,6,6
9,8,result,6,525,3,3,1.25
9,8,retreat,7,526,2,5,1.75
9,8,reverse,7,527,2,5,5.75
9,8,rhetoric,8,528,1,7,2.5
9,8,rid,3,529,1,2,0.75
9,8,riot,4,530,2,2,4.75
9,8,risk,4,531,2,2,1
9,8,role,4,532,1,3,1
9,8,romantic,8,533,2,6,2
9,8,route,5,534,2,3,5.25
9,8,rule,4,535,1,3,1.25
9,8,runner,6,536,2,4,1.5
9,8,sad,3,537,0,3,1
9,8,sail,4,538,2,2,0.75
9,8,saint,5,539,3,2,4.75
9,8,salary,6,540,2,4,1.5
9,8,sanction,8,541,2,6,1.75
9,8,sandwich,8,542,3,5,9.25
9,8,scale,5,543,1,4,1230.25
9,8,scratch,7,544,2,5,2
9,8,scream,6,545,3,3,1.5
9,8,sea,3,546,1,2,0.75
9,8,section,7,547,2,5,7.75
9,8,see,3,548,2,1,0.75
9,8,seize,5,549,2,3,1.25
9,8,seldom,6,550,2,4,1.75
9,8,senator,7,551,2,5,6.75
9,8,sensation,9,552,3,6,2.5
9,8,seventeen,9,553,2,7,7.25
9,8,seventy,7,554,6,1,1.25
9,8,several,7,555,4,3,1.75
9,8,shadow,6,556,1,5,1.75
9,8,shine,5,557,2,3,6.5
9,8,shock,5,558,2,3,1.25
9,8,short,5,559,3,2,1.25
9,8,sigh,4,560,1,3,1.25
9,8,silence,7,561,2,5,6.5
9,8,silent,6,562,5,1,1
9,8,silly,5,563,3,2,1.25
9,8,sir,3,564,2,1,0.75
9,8,sixty,5,565,2,3,2
9,8,sky,3,566,1,2,1.25
9,8,small,5,567,1,4,6.5
9,8,smash,5,568,3,2,1.25
9,8,soar,4,569,1,3,1.25
9,8,soccer,6,570,2,4,2.5
9,8,socialist,9,571,3,6,7.75
9,8,society,7,572,4,3,1.75
9,8,software,8,573,2,6,2.5
9,8,soldier,7,574,2,5,5.75
9,8,somebody,8,575,2,6,2
9,8,sorry,5,576,2,3,1.25
9,8,source,6,577,2,4,5.25
9,8,span,4,578,1,3,1
9,8,spending,8,579,2,6,2
9,8,spill,5,580,2,3,5
9,8,split,5,581,2,3,1
9,8,spoon,5,582,2,3,1
9,8,spot,4,583,3,1,0.5
9,8,squeeze,7,584,1,6,7.75
9,8,stadium,7,585,1,6,4
9,8,statement,9,586,3,6,10.75
9,8,steel,5,587,2,3,2.75
9,8,stiff,5,588,2,3,2.25
9,8,stimulate,9,589,3,6,4.25
9,8,stream,6,590,2,4,9.25
9,8,strive,6,591,3,3,2.5
9,8,structure,9,592,3,6,4.25
9,8,struggle,8,593,4,4,9.75
9,8,stunning,8,594,2,6,4.25
9,8,stupid,6,595,3,3,2.5
9,8,suburban,8,596,1,7,11.25
9,8,suddenly,8,597,2,6,4.25
9,8,suffer,6,598,2,4,9.25
9,8,suffering,9,599,6,3,3.25
9,8,superb,6,600,2,4,3
9,8,supply,6,601,3,3,2.5
9,8,surface,7,602,2,5,9.75
9,8,surge,5,603,3,2,1.75
9,8,survive,7,604,3,4,3.25
9,8,sustain,7,605,2,5,10
9,8,swing,5,606,1,4,3
9,8,syndrome,8,607,1,7,4.5
9,8,t,1,608,0,1,0.75
9,8,talented,8,609,1,7,11.5
9,8,tax,3,610,2,1,1
9,8,teach,5,611,1,4,2.75
9,8,technique,9,612,2,7,11.25
9,8,teenager,8,613,2,6,4.25
9,8,tennis,6,614,2,4,10
9,8,tent,4,615,3,1,1.25
9,8,tenure,6,616,3,3,2.75
9,8,terminal,8,617,2,6,4.25
9,8,terrorist,9,618,3,6,10.75
9,8,testify,7,619,2,5,3.75
9,8,theatre,7,620,1,6,10.75
9,8,theft,5,621,3,2,1.75
9,8,their,5,622,3,2,1.75
9,8,then,4,623,3,1,1
9,8,theology,8,624,3,5,3.75
9,8,therefore,9,625,3,6,11
9,8,they,4,626,3,1,1.25
9,8,thick,5,627,2,3,2.25
9,8,thin,4,628,3,1,1.25
9,8,think,5,629,4,1,1.25
9,8,though,6,630,2,4,9.75
9,8,thought,7,631,6,1,1.75
9,8,threat,6,632,2,4,3
9,8,threshold,9,633,4,5,4
9,8,thrive,6,634,3,3,9.25
9,8,throw,5,635,3,2,2
9,8,timber,6,636,1,5,3.25
9,8,tiny,4,637,2,2,1.75
9,8,toll,4,638,1,3,2.25
9,8,tomato,6,639,2,4,10.25
9,8,tongue,6,640,2,4,3.25
9,8,total,5,641,2,3,2.5
9,8,training,8,642,1,7,12
9,8,transform,9,643,3,6,4.5
9,8,tribunal,8,644,2,6,11.5
9,8,trillion,8,645,3,5,4.25
9,8,truly,5,646,2,3,2.5
9,8,trustee,7,647,3,4,9.75
9,8,truth,5,648,3,2,1.75
9,8,try,3,649,2,1,1
9,8,tunnel,6,650,1,5,3.5
9,8,turnout,7,651,2,5,10
9,8,type,4,652,1,3,2.25
9,8,typical,7,653,3,4,3
9,8,typically,9,654,7,2,2
9,8,unfold,6,655,0,6,10.75
9,8,unless,6,656,2,4,3
9,8,upper,5,657,1,4,2.75
9,8,us,2,658,1,1,0.75
9,8,use,3,659,2,1,1
9,8,user,4,660,3,1,1
9,8,valid,5,661,0,5,10
9,8,variation,9,662,2,7,4.75
9,8,versus,6,663,1,5,10.75
9,8,vicious,7,664,1,6,4
9,8,village,7,665,2,5,10.25
9,8,violate,7,666,2,5,3.5
9,8,violation,9,667,6,3,2.5
9,8,voluntary,9,668,1,8,11.75
9,8,vote,4,669,2,2,1.75
9,8,ward,4,670,0,4,2.75
9,8,warfare,7,671,3,4,3
9,8,we,2,672,1,1,7.25
9,8,wedding,7,673,2,5,3.5
9,8,week,4,674,2,2,1.75
9,8,weekly,6,675,4,2,1.75
9,8,well,4,676,2,2,1.5
9,8,wet,3,677,2,1,1
9,8,wheat,5,678,1,4,9.25
9,8,when,4,679,3,1,1.25
9,8,where,5,680,3,2,1.75
9,8,while,5,681,2,3,2.25
9,8,whilst,6,682,4,2,2
9,8,wide,4,683,1,3,9
9,8,winner,6,684,2,4,3
9,8,wise,4,685,2,2,1.75
9,8,wish,4,686,3,1,1.25
9,8,wooden,6,687,1,5,3.5
9,8,worst,5,688,2,3,14
9,8,wrong,5,689,1,4,2.75
9,8,year,4,690,0,4,2.75
9,8,yell,4,691,2,2,2
9,8,yesterday,9,692,2,7,7.25
9,8,you,3,693,1,2,0.75
9,8,zero,4,694,0,4,1.25
9,8,zone,4,695,1,3,5
9,9,ability,7,0,0,7,2
9,9,abolish,7,1,2,5,5.5
9,9,abortion,8,2,3,5,1.75
9,9,about,5,3,3,2,0.75
9,9,abstract,8,4,2,6,6
9,9,academy,7,5,1,6,1.75
9,9,accent,6,6,2,4,1.25
9,9,access,6,7,4,2,5
9,9,according,9,8,3,6,2
9,9,accuracy,8,9,3,5,2
9,9,acquire,7,10,2,5,5.75
9,9,action,6,11,2,4,1.25
9,9,adhere,6,12,1,5,1.5
9,9,advance,7,13,2,5,6
9,9,affair,6,14,1,5,1.5
9,9,afford,6,15,3,3,1.25
9,9,afraid,6,16,2,4,5.75
9,9,aged,4,17,1,3,1
9,9,agent,5,18,3,2,0.75
9,9,air,3,19,1,2,0.75
9,9,aircraft,8,20,3,5,6.75
9,9,alert,5,21,1,4,1.5
9,9,alien,5,22,2,3,1.25
9,9,alignment,9,23,3,6,6.75
9,9,alike,5,24,3,2,1
9,9,allegedly,9,25,2,7,2.25
9,9,alone,5,26,2,3,1
9,9,also,4,27,2,2,5.25
9,9,angry,5,28,1,4,1.25
9,9,answer,6,29,2,4,1.5
9,9,anything,8,30,2,6,6.5
9,9,april,5,31,1,4,1.25
9,9,arbitrary,9,32,1,8,6.5
9,9,arena,5,33,2,3,1.25
9,9,armed,5,34,2,3,1.25
9,9,array,5,35,2,3,1
9,9,assess,6,36,1,5,6
9,9,assign,6,37,3,3,1.25
9,9,athlete,7,38,1,6,1.75
9,9,attack,6,39,2,4,6
9,9,attorney,8,40,3,5,2
9,9,author,6,41,1,5,1.5
9,9,autumn,6,42,3,3,5.5
9,9,awkward,7,43,1,6,2
9,9,backwards,9,44,0,9,7
9,9,bad,3,45,2,1,0.5
9,9,bake,4,46,2,2,0.75
9,9,ballot,6,47,2,4,1.5
9,9,banana,6,48,2,4,1.25
9,9,bank,4,49,3,1,5
9,9,bare,4,50,2,2,0.75
9,9,barrier,7,51,3,4,1.5
9,9,bean,4,52,1,3,1
9,9,bee,3,53,2,1,0.5
9,9,beef,4,54,3,1,0.5
9,9,before,6,55,2,4,5.5
9,9,beginning,9,56,2,7,2.25
9,9,behind,6,57,2,4,1.5
9,9,being,5,58,2,3,5.25
9,9,beneath,7,59,2,5,1.5
9,9,bet,3,60,2,1,0.5
9,9,bicycle,7,61,1,6,6
9,9,big,3,62,2,1,0.5
9,9,biology,7,63,2,5,1.75
9,9,blast,5,64,1,4,1.25
9,9,blessing,8,65,2,6,6.25
9,9,bold,4,66,1,3,1
9,9,bond,4,67,2,2,0.75
9,9,bonus,5,68,3,2,1
9,9,booking,7,69,2,5,6
9,9,born,4,70,2,2,0.75
9,9,bounce,6,71,2,4,1.25
9,9,breath,6,72,1,5,1.5
9,9,broad,5,73,2,3,5.75
9,9,broadband,9,74,5,4,1.5
9,9,broadly,7,75,5,2,1
9,9,brother,7,76,3,4,1.5
9,9,buck,4,77,1,3,5.5
9,9,building,8,78,2,6,2
9,9,but,3,79,2,1,0.5
9,9,button,6,80,3,3,1
9,9,captain,7,81,0,7,6.25
9,9,carriage,8,82,2,6,2
9,9,carrot,6,83,4,2,5.75
9,9,catch,5,84,2,3,1.25
9,9,cause,5,85,2,3,1
9,9,cent,4,86,1,3,1
9,9,centre,6,87,4,2,0.75
9,9,champion,8,88,1,7,6.75
9,9,chaos,5,89,3,2,1
9,9,chat,4,90,3,1,0.75
9,9,chef,4,91,2,2,0.75
9,9,chest,5,92,3,2,1
9,9,classify,8,93,1,7,6.5
9,9,climate,7,94,2,5,1.75
9,9,clinic,6,95,3,3,6
9,9,clip,4,96,3,1,0.75
9,9,closure,7,97,2,5,2
9,9,clothing,8,98,3,5,2.25
9,9,clue,4,99,2,2,6
9,9,cocktail,8,100,1,7,2.25
9,9,collapse,8,101,2,6,2.25
9,9,college,7,102,4,3,6
9,9,collision,9,103,4,5,2
9,9,colour,6,104,3,3,1.25
9,9,columnist,9,105,3,6,7.25
9,9,combine,7,106,2,5,1.75
9,9,comic,5,107,3,2,1
9,9,commerce,8,108,3,5,6.25
9,9,common,6,109,4,2,1.5
9,9,communist,9,110,4,5,2
9,9,complaint,9,111,3,6,6.75
9,9,compose,7,112,4,3,1.25
9,9,comprise,8,113,4,4,1.5
9,9,concerned,9,114,2,7,6.75
9,9,conclude,8,115,4,4,1.5
9,9,concrete,8,116,4,4,1.5
9,9,confirm,7,117,3,4,6
9,9,construct,9,118,3,6,2
9,9,consumer,8,119,4,4,1.75
9,9,container,9,120,3,6,6.75
9,9,contest,7,121,4,3,1.25
9,9,continue,8,122,4,4,1.5
9,9,contract,8,123,4,4,6.5
9,9,convert,7,124,3,4,1.5
9,9,cooking,7,125,2,5,1.75
9,9,cooperate,9,126,3,6,6.5
9,9,cop,3,127,2,1,0.5
9,9,correlate,9,128,2,7,2.25
9,9,corrupt,7,129,4,3,1.25
9,9,costume,7,130,2,5,6
9,9,cotton,6,131,2,4,1.5
9,9,countless,9,132,2,7,6.75
9,9,courage,7,133,3,4,1.5
9,9,crack,5,134,1,4,1.25
9,9,crash,5,135,3,2,1
9,9,crazy,5,136,3,2,5.25
9,9,cream,5,137,2,3,1
9,9,creative,8,138,4,4,1.5
9,9,creator,7,139,5,2,1.25
9,9,criticism,9,140,2,7,7
9,9,critique,8,141,5,3,1.5
9,9,crown,5,142,2,3,1
9,9,crystal,7,143,2,5,6
9,9,curiosity,9,144,1,8,2.5
9,9,custom,6,145,2,4,1.5
9,9,dad,3,146,0,3,5.25
9,9,dancer,6,147,2,4,1.5
9,9,decision,8,148,1,7,2
9,9,deck,4,149,3,1,5.5
9,9,define,6,150,2,4,1.5
9,9,defy,4,151,3,1,0.75
9,9,delivery,8,152,2,6,2
9,9,denial,6,153,2,4,6.25
9,9,depend,6,154,2,4,1.5
9,9,descent,7,155,2,5,1.75
9,9,desire,6,156,3,3,5.75
9,9,destroy,7,157,3,4,1.75
9,9,detail,6,158,2,4,1.5
9,9,detection,9,159,3,6,6.75
9,9,devise,6,160,2,4,1.5
9,9,diary,5,161,1,4,1.25
9,9,differ,6,162,2,4,1.5
9,9,dimension,9,163,2,7,6.75
9,9,direction,9,164,2,7,6.5
9,9,directly,8,165,6,2,1.5
9,9,directory,9,166,6,3,1.75
9,9,discharge,9,167,2,7,2.25
9,9,discourse,9,168,4,5,6.75
9,9,disease,7,169,3,4,1.5
9,9,dispose,7,170,3,4,1.25
9,9,distinct,8,171,3,5,6.25
9,9,district,8,172,4,4,1.75
9,9,disturb,7,173,4,3,1.25
9,9,diversity,9,174,2,7,10.75
9,9,doctrine,8,175,1,7,4.75
9,9,dog,3,176,2,1,1
9,9,dominance,9,177,2,7,11.75
9,9,dominate,8,178,6,2,2.25
9,9,donate,6,179,2,4,3
9,9,donor,5,180,3,2,2
9,9,dozen,5,181,2,3,10.5
9,9,draw,4,182,1,3,2.25
9,9,dress,5,183,2,3,2.25
9,9,driver,6,184,2,4,3
9,9,drug,4,185,2,2,9.5
9,9,drum,4,186,3,1,1.25
9,9,drunk,5,187,3,2,1.75
9,9,dry,3,188,2,1,1
9,9,due,3,189,1,2,1.75
9,9,dull,4,190,2,2,1.75
9,9,easily,6,191,0,6,11.5
9,9,east,4,192,3,1,1.25
9,9,eastern,7,193,4,3,2.5
9,9,economics,9,194,1,8,12.25
9,9,economy,7,195,6,1,1.75
9,9,edge,4,196,1,3,2.25
9,9,educated,8,197,2,6,4.25
9,9,educator,8,198,6,2,2.25
9,9,eighteen,8,199,1,7,12
9,9,election,8,200,1,7,4.75
9,9,electoral,9,201,5,4,11.25
9,9,element,7,202,3,4,3.25
9,9,else,4,203,2,2,1.75
9,9,embed,5,204,1,4,10.25
9,9,emerge,6,205,2,4,3
9,9,emotional,9,206,2,7,5
9,9,emphasize,9,207,2,7,12.75
9,9,energy,6,208,1,5,3.5
9,9,enforce,7,209,2,5,11.5
9,9,enough,6,210,2,4,3
9,9,enquire,7,211,2,5,3.5
9,9,enrol,5,212,2,3,2.25
9,9,ensue,5,213,2,3,9.75
9,9,entity,6,214,2,4,3
9,9,epidemic,8,215,1,7,12.5
9,9,equal,5,216,1,4,3
9,9,equation,8,217,4,4,3.25
9,9,equip,5,218,3,2,1.75
9,9,era,3,219,1,2,1.5
9,9,error,5,220,2,3,9.75
9,9,erupt,5,221,2,3,2.25
9,9,escalate,8,222,1,7,4.5
9,9,eternal,7,223,1,6,12
9,9,ethic,5,224,2,3,2.25
9,9,every,5,225,1,4,3
9,9,evolution,9,226,2,7,12.25
9,9,evolve,6,227,4,2,2
9,9,example,7,228,1,6,4
9,9,exclude,7,229,2,5,11.25
9,9,exert,5,230,2,3,2.25
9,9,exotic,6,231,2,4,3.25
9,9,expect,6,232,2,4,11.25
9,9,explosion,9,233,3,6,4.5
9,9,external,8,234,2,6,12.25
9,9,extract,7,235,3,4,3.25
9,9,fabulous,8,236,0,8,5
9,9,facility,8,237,2,6,12
9,9,fairness,8,238,2,6,4.25
9,9,faith,5,239,3,2,1.75
9,9,fame,4,240,2,2,9
9,9,fan,3,241,2,1,1
9,9,farm,4,242,2,2,1.5
9,9,feat,4,243,1,3,2
9,9,feather,7,244,4,3,2.25
9,9,feature,7,245,4,3,10
9,9,feedback,8,246,2,6,4.25
9,9,feel,4,247,3,1,1.25
9,9,figure,6,248,1,5,3.25
9,9,fill,4,249,2,2,9.25
9,9,filter,6,250,3,3,2.5
9,9,final,5,251,2,3,2.25
9,9,find,4,252,3,1,1.25
9,9,finger,6,253,3,3,2.5
9,9,firework,8,254,2,6,11.75
9,9,fish,4,255,2,2,1.5
9,9,flame,5,256,1,4,3
9,9,flash,5,257,3,2,2
9,9,flour,5,258,2,3,10
9,9,fluid,5,259,2,3,2.25
9,9,fold,4,260,1,3,2.25
9,9,fond,4,261,2,2,1.75
9,9,forecast,8,262,2,6,11.75
9,9,formal,6,263,3,3,2.5
9,9,format,6,264,5,1,1.5
9,9,fossil,6,265,2,4,3
9,9,freely,6,266,1,5,11.25
9,9,freeze,6,267,4,2,2
9,9,fruit,5,268,2,3,2.25
9,9,fully,5,269,1,4,2.75
9,9,garden,6,270,0,6,11.5
9,9,gas,3,271,2,1,1
9,9,gathering,9,272,2,7,4.75
9,9,generous,8,273,1,7,12
9,9,gentle,6,274,3,3,2.5
9,9,gentleman,9,275,6,3,2.75
9,9,glad,4,276,1,3,10
9,9,golden,6,277,1,5,3.5
9,9,goods,5,278,2,3,2.25
9,9,gorgeous,8,279,2,6,20.75
9,9,grain,5,280,1,4,540
9,9,greatly,7,281,2,5,4
9,9,guard,5,282,1,4,3.25
9,9,halt,4,283,0,4,8.5
9,9,hand,4,284,2,2,1.25
9,9,happy,5,285,2,3,1.5
9,9,hardly,6,286,2,4,2
9,9,harmful,7,287,3,4,7.25
9,9,harmony,7,288,4,3,2.25
9,9,hear,4,289,1,3,2
9,9,heavily,7,290,3,4,2.25
9,9,hello,5,291,2,3,8
9,9,help,4,292,3,1,1.5
9,9,helpful,7,293,4,3,3.25
9,9,hidden,6,294,1,5,3.5
9,9,hierarchy,9,295,2,7,11
9,9,hill,4,296,2,2,1.75
9,9,historian,9,297,2,7,5
9,9,hobby,5,298,1,4,10.25
9,9,homeless,8,299,2,6,2.75
9,9,homework,8,300,4,4,12
9,9,hook,4,301,2,2,0.75
9,9,hope,4,302,2,2,0.75
9,9,host,4,303,2,2,0.75
9,9,hostile,7,304,4,3,1
9,9,housing,7,305,2,5,5
9,9,hungry,6,306,1,5,1.75
9,9,hurry,5,307,2,3,1.25
9,9,if,2,308,0,2,0.75
9,9,ignore,6,309,1,5,4.75
9,9,imagine,7,310,1,6,2
9,9,immense,7,311,2,5,1.75
9,9,immigrant,9,312,3,6,5.5
9,9,imminent,8,313,4,4,1.75
9,9,impact,6,314,2,4,5
9,9,in,2,315,1,1,0.5
9,9,incentive,9,316,2,7,3.5
9,9,including,9,317,3,6,6.5
9,9,increase,8,318,3,5,2
9,9,indeed,6,319,2,4,1.5
9,9,indicator,9,320,3,6,6
9,9,indoor,6,321,3,3,1.25
9,9,induce,6,322,3,3,1.25
9,9,infection,9,323,2,7,5.75
9,9,inflation,9,324,3,6,2.25
9,9,initial,7,325,2,5,1.75
9,9,injured,7,326,2,5,5.25
9,9,innocent,8,327,2,6,2
9,9,input,5,328,2,3,1.25
9,9,insight,7,329,2,5,5.25
9,9,inspire,7,330,3,4,1.5
9,9,insult,6,331,3,3,1.25
9,9,intention,9,332,2,7,9.75
9,9,interact,8,333,4,4,3.25
9,9,interface,9,334,5,4,3.5
9,9,interpret,9,335,5,4,9.75
9,9,interrupt,9,336,5,4,3.5
9,9,invasion,8,337,2,6,10.25
9,9,invent,6,338,3,3,2.5
9,9,investor,8,339,4,4,3.5
9,9,invisible,9,340,3,6,4.5
9,9,invoke,6,341,3,3,8.75
9,9,isolation,9,342,1,8,5.25
9,9,jam,3,343,0,3,8.25
9,9,joint,5,344,1,4,2.75
9,9,july,4,345,1,3,2
9,9,kill,4,346,0,4,2.75
9,9,killing,7,347,4,3,8.75
9,9,knowledge,9,348,1,8,5.25
9,9,labour,6,349,0,6,10
9,9,ladder,6,350,2,4,3
9,9,lamp,4,351,2,2,1.75
9,9,landing,7,352,2,5,3.75
9,9,landlord,8,353,4,4,10
9,9,language,8,354,3,5,3.75
9,9,lawsuit,7,355,2,5,3.75
9,9,leap,4,356,1,3,9
9,9,leave,5,357,3,2,1.75
9,9,leisure,7,358,2,5,3.5
9,9,lend,4,359,2,2,1.75
9,9,length,6,360,3,3,8.5
9,9,less,4,361,2,2,1.75
9,9,let,3,362,2,1,1
9,9,level,5,363,2,3,2.25
9,9,likewise,8,364,1,7,10.75
9,9,limit,5,365,2,3,2.25
9,9,listener,8,366,2,6,4.25
9,9,lively,6,367,2,4,9.25
9,9,lock,4,368,1,3,2.25
9,9,logo,4,369,2,2,1.75
9,9,loom,4,370,2,2,1.75
9,9,lovely,6,371,2,4,3
9,9,lower,5,372,2,3,9
9,9,luck,4,373,1,3,2.5
9,9,lung,4,374,2,2,1.75
9,9,magical,7,375,0,7,4.5
9,9,mall,4,376,2,2,7.75
9,9,march,5,377,2,3,2.5
9,9,marker,6,378,3,3,2.5
9,9,massive,7,379,2,5,3.5
9,9,matching,8,380,2,6,10.25
9,9,mate,4,381,3,1,1.25
9,9,maths,5,382,3,2,2
9,9,mayor,5,383,2,3,2.25
9,9,me,2,384,1,1,0.75
9,9,mechanism,9,385,2,7,11
9,9,medical,7,386,2,5,3.5
9,9,medicine,8,387,5,3,8.75
9,9,meet,4,388,2,2,1.75
9,9,menu,4,389,2,2,1.5
9,9,metal,5,390,2,3,2.25
9,9,migration,9,391,1,8,11.25
9,9,militant,8,392,2,6,4.25
9,9,milk,4,393,3,1,1.25
9,9,mill,4,394,3,1,1.25
9,9,mine,4,395,2,2,1.75
9,9,miner,5,396,4,1,1
9,9,minimize,8,397,3,5,10
9,9,minor,5,398,3,2,2
9,9,minute,6,399,3,3,2.75
9,9,mistake,7,400,2,5,10
9,9,mode,4,401,1,3,2.25
9,9,modern,6,402,4,2,1.75
9,9,morality,8,403,2,6,4.25
9,9,morning,7,404,3,4,13.5
9,9,motive,6,405,2,4,3
9,9,motorist,8,406,3,5,3.75
9,9,mount,5,407,2,3,8.25
9,9,movement,8,408,2,6,4.25
9,9,multiply,8,409,1,7,10.5
9,9,musical,7,410,2,5,3.75
9,9,myself,6,411,1,5,3.5
9,9,native,6,412,0,6,9.5
9,9,naturally,9,413,3,6,4.5
9,9,naval,5,414,2,3,2.5
9,9,nest,4,415,1,3,8.5
9,9,news,4,416,2,2,1.75
9,9,nineteen,8,417,1,7,4.5
9,9,noble,5,418,1,4,8.75
9,9,nod,3,419,2,1,1
9,9,now,3,420,2,1,1
9,9,nowadays,8,421,3,5,3.5
9,9,number,6,422,1,5,9
9,9,nursing,7,423,2,5,3.5
9,9,nutrition,9,424,2,7,4.75
9,9,obey,4,425,0,4,10
9,9,object,6,426,2,4,3
9,9,observe,7,427,2,5,3.5
9,9,obsession,9,428,4,5,11
9,9,obtain,6,429,2,4,3
9,9,occasion,8,430,1,7,18
9,9,of,2,431,1,1,1.25
9,9,offender,8,432,2,6,4.5
9,9,onion,5,433,1,4,2.75
9,9,operate,7,434,1,6,9.75
9,9,operator,8,435,6,2,2.25
9,9,opinion,7,436,2,5,3.5
9,9,optimism,8,437,2,6,10.25
9,9,or,2,438,1,1,0.75
9,9,orange,6,439,2,4,2.75
9,9,order,5,440,2,3,2.25
9,9,out,3,441,1,2,7.5
9,9,outrage,7,442,3,4,3.25
9,9,oven,4,443,1,3,2.25
9,9,over,4,444,3,1,1
9,9,overnight,9,445,4,5,3.75
9,9,owner,5,446,1,4,8.5
9,9,packet,6,447,0,6,3.75
9,9,palm,4,448,2,2,1.75
9,9,pan,3,449,2,1,1
9,9,paper,5,450,2,3,8.25
9,9,parameter,9,451,2,7,5.5
9,9,parental,8,452,3,5,10.25
9,9,pass,4,453,2,2,1.5
9,9,passage,7,454,4,3,2.5
9,9,pathway,7,455,2,5,3.5
9,9,payment,7,456,2,5,9.5
9,9,peak,4,457,1,3,2.25
9,9,penalty,7,458,2,5,3.5
9,9,people,6,459,2,4,9.25
9,9,period,6,460,2,4,3
9,9,persuade,8,461,3,5,3.75
9,9,petition,8,462,2,6,10.5
9,9,pill,4,463,1,3,2.25
9,9,pilot,5,464,3,2,1.75
9,9,pink,4,465,2,2,1.75
9,9,plain,5,466,1,4,9.5
9,9,planet,6,467,3,3,2.75
9,9,plate,5,468,3,2,2
9,9,plug,4,469,2,2,1.75
9,9,plunge,6,470,3,3,2.5
9,9,pocket,6,471,1,5,10
9,9,poet,4,472,2,2,1.75
9,9,pole,4,473,2,2,1.75
9,9,policeman,9,474,3,6,4.25
9,9,policy,6,475,5,1,1.5
9,9,pool,4,476,2,2,7.75
9,9,pop,3,477,2,1,1
9,9,popular,7,478,3,4,3
9,9,port,4,479,2,2,1.5
9,9,positive,8,480,2,6,10
9,9,poverty,7,481,2,5,3.75
9,9,practice,8,482,1,7,4.75
9,9,preach,6,483,2,4,9.25
9,9,precision,9,484,3,6,4.5
9,9,present,7,485,3,4,9.5
9,9,previous,8,486,3,5,3.75
9,9,prey,4,487,3,1,1.25
9,9,priest,6,488,2,4,3.5
9,9,primarily,9,489,3,6,12.75
9,9,princess,8,490,3,5,4.5
9,9,prison,6,491,3,3,1.75
9,9,prisoner,8,492,6,2,1.75
9,9,privilege,9,493,3,6,6.75
9,9,probable,8,494,2,6,2.25
9,9,probably,8,495,7,1,0.75
9,9,pronounce,9,496,3,6,8.5
9,9,province,8,497,3,5,2.75
9,9,provision,9,498,5,4,6.5
9,9,pub,3,499,1,2,1.25
9,9,purchase,8,500,2,6,2.25
9,9,pursue,6,501,3,3,1.5
9,9,queen,5,502,0,5,6.75
9,9,question,8,503,3,5,2
9,9,quickly,7,504,2,5,2
9,9,quietly,7,505,3,4,6.75
9,9,quota,5,506,2,3,1.25
9,9,radio,5,507,0,5,1.5
9,9,rain,4,508,2,2,5.5
9,9,random,6,509,2,4,1.5
9,9,read,4,510,1,3,1
9,9,reader,6,511,4,2,0.75
9,9,readily,7,512,4,3,1
9,9,reading,7,513,5,2,4.75
9,9,realize,7,514,3,4,1.5
9,9,really,6,515,4,2,1
9,9,receiver,8,516,2,6,1.75
9,9,recession,9,517,4,5,6
9,9,recovery,8,518,3,5,1.75
9,9,red,3,519,2,1,0.5
9,9,regularly,9,520,2,7,6.25
9,9,regulator,9,521,6,3,1.25
9,9,reinforce,9,522,2,7,5.75
9,9,relaxing,8,523,2,6,2
9,9,reliable,8,524,3,5,1.75
9,9,rely,4,525,3,1,1
9,9,remains,7,526,2,5,5.5
9,9,reminder,8,527,3,5,1.75
9,9,remote,6,528,3,3,1.25
9,9,renowned,8,529,2,6,5.75
9,9,rental,6,530,3,3,1.25
9,9,report,6,531,2,4,1.25
9,9,reporter,8,532,6,2,4.75
9,9,request,7,533,2,5,1.75
9,9,response,8,534,2,6,1.75
9,9,restraint,9,535,3,6,6
9,9,resume,6,536,3,3,1.25
9,9,retreat,7,537,2,5,1.5
9,9,reverse,7,538,2,5,5.75
9,9,review,6,539,3,3,1.25
9,9,rhythm,6,540,1,5,1.5
9,9,rice,4,541,1,3,4.75
9,9,risk,4,542,2,2,1
9,9,rock,4,543,1,3,1
9,9,rumour,6,544,1,5,1.5
9,9,run,3,545,2,1,0.5
9,9,sadly,5,546,0,5,5.5
9,9,sanction,8,547,2,6,2
9,9,sandwich,8,548,3,5,6
9,9,scratch,7,549,1,6,1.75
9,9,sea,3,550,1,2,0.75
9,9,see,3,551,2,1,0.5
9,9,seize,5,552,2,3,1
9,9,seldom,6,553,2,4,5.25
9,9,self,4,554,3,1,0.5
9,9,senator,7,555,2,5,1.5
9,9,senior,6,556,3,3,1.25
9,9,sensitive,9,557,3,6,6
9,9,seventeen,9,558,2,7,2.25
9,9,several,7,559,4,3,5.25
9,9,sex,3,560,2,1,0.5
9,9,shadow,6,561,1,5,1.5
9,9,shake,5,562,3,2,1
9,9,sheet,5,563,2,3,1
9,9,shine,5,564,2,3,5.25
9,9,shop,4,565,2,2,1
9,9,short,5,566,3,2,1
9,9,show,4,567,3,1,0.5
9,9,shrink,6,568,2,4,1.25
9,9,silly,5,569,1,4,5.25
9,9,sincere,7,570,2,5,1.75
9,9,situation,9,571,2,7,6.25
9,9,sixty,5,572,2,3,1.25
9,9,size,4,573,2,2,0.75
9,9,skiing,6,574,1,5,1.5
9,9,skill,5,575,3,2,0.75
9,9,slogan,6,576,1,5,5.75
9,9,slow,4,577,3,1,0.75
9,9,smash,5,578,1,4,1.25
9,9,snap,4,579,1,3,1
9,9,socialist,9,580,1,8,6.5
9,9,society,7,581,4,3,1.25
9,9,somebody,8,582,2,6,6.25
9,9,span,4,583,1,3,1
9,9,spending,8,584,2,6,2
9,9,spill,5,585,2,3,5.5
9,9,spoil,5,586,2,3,1
9,9,sport,5,587,3,2,1
9,9,spy,3,588,2,1,0.5
9,9,squeeze,7,589,1,6,2
9,9,stadium,7,590,1,6,6
9,9,stark,5,591,3,2,1
9,9,statement,9,592,3,6,2
9,9,steel,5,593,2,3,5.25
9,9,steep,5,594,4,1,0.75
9,9,stress,6,595,2,4,1.25
9,9,strive,6,596,3,3,1.25
9,9,struggle,8,597,3,5,6
9,9,stupid,6,598,2,4,1.25
9,9,suddenly,8,599,1,7,2
9,9,suffering,9,600,2,7,6.25
9,9,suicide,7,601,2,5,1.75
9,9,sum,3,602,2,1,0.5
9,9,summarize,9,603,3,6,6
9,9,summit,6,604,4,2,1
9,9,superior,8,605,2,6,2
9,9,supply,6,606,3,3,5.25
9,9,supporter,9,607,4,5,1.75
9,9,surface,7,608,2,5,1.5
9,9,surge,5,609,3,2,5
9,9,surprised,9,610,3,6,2
9,9,surrender,9,611,3,6,2
9,9,survive,7,612,3,4,5.5
9,9,swing,5,613,1,4,1.25
9,9,symbol,6,614,1,5,1.5
9,9,tax,3,615,0,3,5
9,9,teach,5,616,1,4,1.25
9,9,teenager,8,617,2,6,1.75
9,9,tennis,6,618,2,4,5.5
9,9,tenure,6,619,3,3,1.25
9,9,terminal,8,620,2,6,2.25
9,9,terrain,7,621,3,4,5.75
9,9,testify,7,622,2,5,1.75
9,9,testing,7,623,5,2,1
9,9,text,4,624,2,2,0.75
9,9,than,4,625,1,3,5
9,9,that,4,626,3,1,0.75
9,9,theft,5,627,2,3,1.25
9,9,then,4,628,3,1,0.75
9,9,they,4,629,3,1,0.5
9,9,thief,5,630,2,3,1
9,9,think,5,631,3,2,0.75
9,9,thinking,8,632,5,3,5.75
9,9,though,6,633,2,4,1.5
9,9,thought,7,634,6,1,0.5
9,9,threat,6,635,2,4,1.25
9,9,thrive,6,636,3,3,5.25
9,9,throat,6,637,3,3,1.25
9,9,tobacco,7,638,1,6,1.75
9,9,tomato,6,639,2,4,5.5
9,9,tone,4,640,2,2,0.75
9,9,tongue,6,641,3,3,1.25
9,9,touch,5,642,2,3,1
9,9,tourist,7,643,3,4,1.5
9,9,towards,7,644,2,5,5.75
9,9,towel,5,645,3,2,1
9,9,transfer,8,646,1,7,2
9,9,tribunal,8,647,2,6,6.25
9,9,trillion,8,648,3,5,1.75
9,9,troubled,8,649,2,6,6.25
9,9,true,4,650,2,2,1
9,9,truly,5,651,3,2,1
9,9,trust,5,652,3,2,1
9,9,trustee,7,653,5,2,1
9,9,tunnel,6,654,1,5,6.25
9,9,turn,4,655,2,2,1
9,9,turnover,8,656,4,4,1.75
9,9,typically,9,657,1,8,7.25
9,9,ugly,4,658,0,4,1.25
9,9,umbrella,8,659,1,7,6.75
9,9,under,5,660,1,4,1.25
9,9,unlikely,8,661,2,6,2
9,9,up,2,662,1,1,0.5
9,9,upset,5,663,2,3,5.5
9,9,upwards,7,664,2,5,1.75
9,9,us,2,665,1,1,0.5
9,9,use,3,666,2,1,0.5
9,9,used,4,667,3,1,0.5
9,9,valid,5,668,0,5,6.25
9,9,vast,4,669,2,2,1
9,9,versus,6,670,1,5,1.5
9,9,very,4,671,3,1,0.75
9,9,victim,6,672,1,5,5.75
9,9,village,7,673,2,5,1.75
9,9,voluntary,9,674,1,8,6.5
9,9,wage,4,675,0,4,1.25
9,9,want,4,676,2,2,0.75
9,9,ward,4,677,2,2,0.75
9,9,warehouse,9,678,3,6,6.25
9,9,warfare,7,679,3,4,1.5
9,9,we,2,680,1,1,0.5
9,9,weather,7,681,2,5,1.5
9,9,weekly,6,682,2,4,5.25
9,9,well,4,683,2,2,0.75
9,9,wet,3,684,2,1,0.5
9,9,when,4,685,1,3,1
9,9,whilst,6,686,2,4,1.25
9,9,whisper,7,687,3,4,6
9,9,winter,6,688,1,5,3.25
9,9,wise,4,689,2,2,1.75
9,9,withdraw,8,690,2,6,11
9,9,wound,5,691,1,4,2.75
9,9,writing,7,692,1,6,4
9,9,year,4,693,0,4,9.75
9,9,yours,5,694,1,4,2.75
9,9,zone,4,695,0,4,2.75
